CTPRVN_NM,SIG_NM,EMD_NM,VOTE_NM,N_People,N_Vote,Moon_J,Hong_J,Ahn_Ch,You_S,Shim_S,Cho_W,Oh,Chang,Lee_J,Kim,Lee_K,Yoon_H,Kim_M,Sum,Invalid,blank
전국,,,,42479710,32807908,13423800,7852849,6998342,2208771,2017458,42949,6040,21709,9140,27229,11355,18543,33990,32672175,135733,9671802
서울특별시,합계,,,8382999,6590646,2781345,1365285,1492767,476973,425459,9987,789,3554,1938,3416,1277,2177,3950,6568917,21729,1792353
서울특별시,종로구,합계,,133769,102566,42512,22325,22313,7412,7113,228,5,78,31,63,26,47,49,102202,364,31203
서울특별시,종로구,거소·선상투표,,218,206,64,42,65,8,15,0,1,3,1,0,0,0,2,201,5,12
서울특별시,종로구,관외사전투표,,12803,12803,5842,2025,2509,1156,1145,17,0,4,2,15,6,9,6,12736,67,0
서울특별시,종로구,재외투표,,2490,1813,987,215,304,75,214,8,0,1,0,1,0,0,0,1805,8,677
서울특별시,종로구,청운효자동,합계,9378,7295,3109,1677,1438,475,531,13,0,11,1,6,1,5,6,7273,22,2083
서울특별시,종로구,청운효자동,관내사전투표,1784,1784,819,331,352,120,149,1,0,3,0,3,0,1,2,1781,3,0
서울특별시,종로구,청운효자동,청운효자동제1투,2493,1682,664,451,342,107,96,6,0,5,0,0,1,3,2,1677,5,811
서울특별시,종로구,청운효자동,청운효자동제2투,2644,1986,793,509,382,144,143,1,0,0,0,1,0,1,2,1976,10,658
서울특별시,종로구,청운효자동,청운효자동제3투,2457,1843,833,386,362,104,143,5,0,3,1,2,0,0,0,1839,4,614
서울특별시,종로구,사직동,관내사전투표,2008,2008,890,447,359,134,162,1,0,9,0,0,0,0,1,2003,5,0
서울특별시,종로구,사직동,합계,7613,5788,2146,1617,1161,455,366,8,0,11,0,1,0,2,3,5770,18,1825
서울특별시,종로구,사직동,사직동제1투,2341,1375,520,380,298,92,76,2,0,1,0,0,0,0,1,1370,5,966
서울특별시,종로구,사직동,사직동제2투,3264,2405,736,790,504,229,128,5,0,1,0,1,0,2,1,2397,8,859
서울특별시,종로구,삼청동,합계,2271,1654,617,456,316,113,131,11,0,1,2,1,2,0,0,1650,4,617
서울특별시,종로구,삼청동,관내사전투표,421,421,189,97,65,23,43,1,0,0,0,1,0,0,0,419,2,0
서울특별시,종로구,삼청동,삼청동투표소,1850,1233,428,359,251,90,88,10,0,1,2,0,2,0,0,1231,2,617
서울특별시,종로구,부암동,관내사전투표,1474,1474,676,309,235,106,139,4,0,0,1,1,1,0,0,1472,2,0
서울특별시,종로구,부암동,합계,7702,5916,2354,1502,1139,429,441,25,0,1,1,5,2,5,0,5904,12,1786
서울특별시,종로구,부암동,부암동제1투,2329,1531,616,369,305,111,110,8,0,1,0,2,1,4,0,1527,4,798
서울특별시,종로구,부암동,부암동제2투,2047,1564,611,397,321,120,107,4,0,0,0,2,0,0,0,1562,2,483
서울특별시,종로구,부암동,부암동제3투,1852,1347,451,427,278,92,85,9,0,0,0,0,0,1,0,1343,4,505
서울특별시,종로구,평창동,합계,14118,10881,3762,3362,2087,917,659,33,0,6,2,3,2,8,3,10844,37,3237
서울특별시,종로구,평창동,관내사전투표,2949,2949,1154,824,533,232,184,7,0,1,0,1,1,2,1,2940,9,0
서울특별시,종로구,평창동,평창동제1투,2174,1427,481,440,296,116,89,1,0,0,0,1,0,0,0,1424,3,747
서울특별시,종로구,평창동,평창동제2투,3211,2239,631,796,461,217,115,5,0,1,0,0,0,1,2,2229,10,972
서울특별시,종로구,평창동,평창동제3투,1936,1433,491,440,280,127,82,5,0,0,1,0,0,3,0,1429,4,503
서울특별시,종로구,평창동,평창동제4투,1916,1443,555,416,243,114,96,6,0,2,0,1,1,2,0,1436,7,473
서울특별시,종로구,평창동,평창동제5투,1932,1390,450,446,274,111,93,9,0,2,1,0,0,0,0,1386,4,542
서울특별시,종로구,무악동,합계,6002,4796,1953,1047,1098,366,291,9,0,3,3,1,1,1,0,4773,23,1206
서울특별시,종로구,무악동,관내사전투표,1390,1390,625,254,308,105,81,3,0,0,1,1,1,0,0,1379,11,0
서울특별시,종로구,무악동,무악동제1투,1700,1350,533,304,308,105,90,2,0,2,1,0,0,0,0,1345,5,350
서울특별시,종로구,무악동,무악동제2투,2912,2056,795,489,482,156,120,4,0,1,1,0,0,1,0,2049,7,856
서울특별시,종로구,교남동,합계,5000,3743,1507,802,939,258,212,9,0,2,4,2,0,0,3,3738,5,1257
서울특별시,종로구,교남동,관내사전투표,1060,1060,469,191,256,71,69,2,0,0,0,1,0,0,0,1059,1,0
서울특별시,종로구,교남동,교남동제1투,1828,1245,483,289,336,63,65,3,0,0,1,1,0,0,1,1242,3,583
서울특별시,종로구,교남동,교남동제2투,987,532,217,121,128,28,34,3,0,0,1,0,0,0,0,532,0,455
서울특별시,종로구,교남동,교남동제3투,1125,906,338,201,219,96,44,1,0,2,2,0,0,0,2,905,1,219
서울특별시,종로구,가회동,합계,3769,2902,1219,722,579,170,182,9,0,2,1,4,0,3,2,2893,9,867
서울특별시,종로구,가회동,관내사전투표,937,937,436,189,169,60,76,1,0,0,0,1,0,0,0,932,5,0
서울특별시,종로구,가회동,가회동투표소,2832,1965,783,533,410,110,106,8,0,2,1,3,0,3,2,1961,4,867
서울특별시,종로구,종로1·2·3·4가동,합계,6210,3684,1311,1100,838,228,181,10,0,3,1,0,1,0,0,3673,11,2526
서울특별시,종로구,종로1·2·3·4가동,관내사전투표,902,902,398,185,189,63,63,1,0,2,0,0,0,0,0,901,1,0
서울특별시,종로구,종로1·2·3·4가동,종로1·2·3·4가동제1투,2972,1247,362,480,302,60,30,4,0,1,1,0,0,0,0,1240,7,1725
서울특별시,종로구,종로1·2·3·4가동,종로1·2·3·4가동제2투,2336,1535,551,435,347,105,88,5,0,0,0,0,1,0,0,1532,3,801
서울특별시,종로구,종로5·6가동,합계,4531,3110,1132,795,811,199,146,3,1,1,4,5,0,2,2,3101,9,1421
서울특별시,종로구,종로5·6가동,관내사전투표,861,861,334,220,200,56,46,2,0,0,2,0,0,0,0,860,1,0
서울특별시,종로구,종로5·6가동,종로5·6가동제1투,1720,973,286,289,278,66,43,0,1,0,1,3,0,2,0,969,4,747
서울특별시,종로구,종로5·6가동,종로5·6가동제2투,1950,1276,512,286,333,77,57,1,0,1,1,2,0,0,2,1272,4,674
서울특별시,종로구,이화동,합계,6783,5100,2335,921,1077,364,366,9,0,3,1,1,1,1,5,5084,16,1683
서울특별시,종로구,이화동,관내사전투표,1456,1456,710,218,274,99,142,2,0,2,0,1,0,0,2,1450,6,0
서울특별시,종로구,이화동,이화동제1투,2714,1996,904,406,420,125,128,4,0,0,0,0,1,0,3,1991,5,718
서울특별시,종로구,이화동,이화동제2투,2613,1648,721,297,383,140,96,3,0,1,1,0,0,1,0,1643,5,965
서울특별시,종로구,혜화동,합계,13606,10704,4653,1928,2082,980,984,20,0,4,4,7,2,6,2,10672,32,2902
서울특별시,종로구,혜화동,관내사전투표,3448,3448,1678,475,568,330,382,3,0,1,0,3,0,0,1,3441,7,0
서울특별시,종로구,혜화동,혜화동제1투,2444,1859,787,381,363,164,146,6,0,2,1,1,0,2,0,1853,6,585
서울특별시,종로구,혜화동,혜화동제2투,2280,1495,607,310,288,128,147,3,0,0,0,1,1,1,0,1486,9,785
서울특별시,종로구,혜화동,혜화동제3투,2170,1594,613,345,347,161,116,5,0,0,1,2,0,0,0,1590,4,576
서울특별시,종로구,혜화동,혜화동제4투,1654,1211,521,200,262,101,117,2,0,0,1,0,0,1,1,1206,5,443
서울특별시,종로구,혜화동,혜화동제5투,1610,1097,447,217,254,96,76,1,0,1,1,0,1,2,0,1096,1,513
서울특별시,종로구,창신제1동,합계,4619,3089,1300,638,843,138,139,11,0,2,1,2,1,0,2,3077,12,1530
서울특별시,종로구,창신제1동,관내사전투표,502,502,230,100,128,22,18,2,0,0,0,0,0,0,1,501,1,0
서울특별시,종로구,창신제1동,창신제1동제1투,1304,595,220,163,169,21,18,0,0,1,0,0,0,0,0,592,3,709
서울특별시,종로구,창신제1동,창신제1동제2투,2813,1992,850,375,546,95,103,9,0,1,1,2,1,0,1,1984,8,821
서울특별시,종로구,창신제2동,합계,7768,5508,2330,981,1596,257,290,13,1,6,0,1,1,2,3,5481,27,2260
서울특별시,종로구,창신제2동,관내사전투표,1172,1172,561,169,307,51,70,3,0,0,0,0,0,1,1,1163,9,0
서울특별시,종로구,창신제2동,창신제2동제1투,1815,1069,418,207,324,45,59,5,0,4,0,1,0,0,1,1064,5,746
서울특별시,종로구,창신제2동,창신제2동제2투,2371,1618,653,326,484,74,67,1,1,2,0,0,1,1,0,1610,8,753
서울특별시,종로구,창신제2동,창신제2동제3투,2410,1649,698,279,481,87,94,4,0,0,0,0,0,0,1,1644,5,761
서울특별시,종로구,창신제3동,합계,5804,4489,1934,804,1129,305,283,5,1,4,1,2,2,1,4,4475,14,1315
서울특별시,종로구,창신제3동,관내사전투표,1123,1123,544,165,248,58,100,2,1,0,0,1,2,0,0,1121,2,0
서울특별시,종로구,창신제3동,창신제3동제1투,1848,1193,476,212,373,65,56,1,0,2,0,0,0,1,1,1187,6,655
서울특별시,종로구,창신제3동,창신제3동제2투,2833,2173,914,427,508,182,127,2,0,2,1,1,0,0,3,2167,6,660
서울특별시,종로구,숭인제1동,합계,5259,3746,1580,724,1004,214,191,8,0,4,0,0,2,1,3,3731,15,1513
서울특별시,종로구,숭인제1동,관내사전투표,975,975,449,157,248,52,64,0,0,1,0,0,1,1,0,973,2,0
서울특별시,종로구,숭인제1동,숭인제1동제1투,2471,1498,576,333,413,92,69,6,0,1,0,0,1,0,1,1492,6,973
서울특별시,종로구,숭인제1동,숭인제1동제2투,1813,1273,555,234,343,70,58,2,0,2,0,0,0,0,2,1266,7,540
서울특별시,종로구,숭인제2동,합계,7825,5339,2377,967,1298,305,346,7,1,6,2,6,2,1,3,5321,18,2486
서울특별시,종로구,숭인제2동,관내사전투표,1339,1339,669,206,284,84,84,3,0,0,0,1,1,0,1,1333,6,0
서울특별시,종로구,숭인제2동,숭인제2동제1투,1892,1167,490,201,298,84,86,0,0,1,0,4,0,1,1,1166,1,725
서울특별시,종로구,숭인제2동,숭인제2동제2투,2397,1356,565,255,349,81,90,3,1,3,1,1,1,0,1,1351,5,1041
서울특별시,종로구,숭인제2동,숭인제2동제3투,2197,1477,653,305,367,56,86,1,0,2,1,0,0,0,0,1471,6,720
서울특별시,종로구,잘못 투입·구분된 투표지,,0,0,0,0,0,0,0,0,0,0,0,0,0,0,0,0,0,0
서울특별시,중구,합계,,109836,82852,34062,17901,19372,5874,4993,158,12,53,21,55,18,25,51,82595,257,26984
서울특별시,중구,거소·선상투표,,174,157,60,34,48,8,3,0,0,0,0,0,0,0,1,154,3,17
서울특별시,중구,관외사전투표,,10177,10173,4848,1596,2093,809,757,13,2,1,0,9,3,4,7,10142,31,4
서울특별시,중구,재외투표,,1715,1156,633,164,189,35,116,15,0,0,1,2,0,0,0,1155,1,559
서울특별시,중구,소공동,합계,1461,1084,442,240,233,99,61,2,0,0,0,0,1,2,1,1081,3,377
서울특별시,중구,소공동,관내사전투표,266,266,130,46,54,22,12,1,0,0,0,0,0,0,0,265,1,0
서울특별시,중구,소공동,소공동제1투,372,197,80,50,45,10,8,1,0,0,0,0,1,2,0,197,0,175
서울특별시,중구,소공동,소공동제2투,823,621,232,144,134,67,41,0,0,0,0,0,0,0,1,619,2,202
서울특별시,중구,회현동,합계,4404,2595,809,824,642,173,114,6,3,6,1,0,0,1,3,2582,13,1809
서울특별시,중구,회현동,관내사전투표,687,687,279,181,145,41,34,1,3,2,0,0,0,1,0,687,0,0
서울특별시,중구,회현동,회현동제1투,2845,1491,436,495,380,102,65,2,0,3,0,0,0,0,1,1484,7,1354
서울특별시,중구,회현동,회현동제2투,872,417,94,148,117,30,15,3,0,1,1,0,0,0,2,411,6,455
서울특별시,중구,명동,합계,2247,1483,537,452,299,109,79,1,1,1,1,0,0,0,1,1481,2,764
서울특별시,중구,명동,관내사전투표,483,483,200,125,103,29,25,0,0,0,0,0,0,0,0,482,1,0
서울특별시,중구,명동,명동제1투,1598,910,317,295,163,77,53,1,1,1,0,0,0,0,1,909,1,688
서울특별시,중구,명동,명동제2투,166,90,20,32,33,3,1,0,0,0,1,0,0,0,0,90,0,76
서울특별시,중구,필동,합계,3661,2708,1051,685,571,193,182,2,0,4,1,4,1,1,2,2697,11,953
서울특별시,중구,필동,관내사전투표,1106,1106,496,215,224,72,86,0,0,2,1,3,1,0,0,1100,6,0
서울특별시,중구,필동,필동제1투,1337,793,263,220,178,70,56,1,0,1,0,1,0,1,0,791,2,544
서울특별시,중구,필동,필동제2투,1218,809,292,250,169,51,40,1,0,1,0,0,0,0,2,806,3,409
서울특별시,중구,장충동,합계,3879,2912,1230,605,610,226,218,7,0,1,2,4,0,2,0,2905,7,967
서울특별시,중구,장충동,관내사전투표,866,866,383,167,167,66,79,2,0,0,0,1,0,0,0,865,1,0
서울특별시,중구,장충동,장충동제1투,1592,1040,387,267,218,87,69,2,0,0,2,2,0,2,0,1036,4,552
서울특별시,중구,장충동,장충동제2투,1421,1006,460,171,225,73,70,3,0,1,0,1,0,0,0,1004,2,415
서울특별시,중구,광희동,합계,3949,2569,918,749,597,148,135,3,0,4,1,0,0,0,1,2556,13,1380
서울특별시,중구,광희동,관내사전투표,483,483,211,99,112,28,27,1,0,2,0,0,0,0,0,480,3,0
서울특별시,중구,광희동,광희동제1투,1692,907,311,289,203,47,49,0,0,1,1,0,0,0,0,901,6,785
서울특별시,중구,광희동,광희동제2투,1774,1179,396,361,282,73,59,2,0,1,0,0,0,0,1,1175,4,595
서울특별시,중구,을지로동,합계,1472,934,301,329,224,31,42,4,0,0,1,0,1,0,0,933,1,538
서울특별시,중구,을지로동,관내사전투표,302,302,124,97,54,8,16,0,0,0,1,0,1,0,0,301,1,0
서울특별시,중구,을지로동,을지로동제1투,640,288,61,123,82,12,9,1,0,0,0,0,0,0,0,288,0,352
서울특별시,중구,을지로동,을지로동제2투,530,344,116,109,88,11,17,3,0,0,0,0,0,0,0,344,0,186
서울특별시,중구,신당동,합계,6970,4899,2102,1006,1135,321,293,4,0,5,1,5,1,0,5,4878,21,2071
서울특별시,중구,신당동,관내사전투표,1510,1510,729,268,300,103,102,1,0,0,0,1,1,0,1,1506,4,0
서울특별시,중구,신당동,신당동제1투,2167,1202,491,272,300,57,72,1,0,1,0,4,0,0,1,1199,3,965
서울특별시,중구,신당동,신당동제2투,1358,924,387,170,218,87,55,1,0,2,0,0,0,0,0,920,4,434
서울특별시,중구,신당동,신당동제3투,1935,1263,495,296,317,74,64,1,0,2,1,0,0,0,3,1253,10,672
서울특별시,중구,다산동,합계,11272,8151,3341,1707,1989,535,518,22,3,2,1,3,3,1,2,8127,24,3121
서울특별시,중구,다산동,관내사전투표,1642,1642,695,331,363,103,135,4,1,0,0,2,1,0,0,1635,7,0
서울특별시,중구,다산동,다산동제1투,2483,1539,618,341,363,116,87,2,2,1,1,1,0,1,1,1534,5,944
서울특별시,중구,다산동,다산동제2투,2500,1726,678,389,442,106,102,3,0,0,0,0,2,0,0,1722,4,774
서울특별시,중구,다산동,다산동제3투,2222,1507,606,298,388,92,108,11,0,1,0,0,0,0,1,1505,2,715
서울특별시,중구,다산동,다산동제4투,2425,1737,744,348,433,118,86,2,0,0,0,0,0,0,0,1731,6,688
서울특별시,중구,약수동,합계,14500,11212,4426,2573,2607,874,644,27,2,8,0,5,1,5,7,11179,33,3288
서울특별시,중구,약수동,관내사전투표,2585,2585,1131,521,553,192,169,6,1,1,0,3,1,0,1,2579,6,0
서울특별시,중구,약수동,약수동제1투,1619,922,349,237,224,64,40,2,0,0,0,0,0,0,1,917,5,697
서울특별시,중구,약수동,약수동제2투,1859,1419,585,329,318,83,89,2,0,2,0,1,0,4,3,1416,3,440
서울특별시,중구,약수동,약수동제3투,2774,2152,825,508,475,225,109,4,0,0,0,0,0,0,1,2147,5,622
서울특별시,중구,약수동,약수동제4투,2783,2188,833,511,487,205,134,7,1,3,0,0,0,0,0,2181,7,595
서울특별시,중구,약수동,약수동제5투,2880,1946,703,467,550,105,103,6,0,2,0,1,0,1,1,1939,7,934
서울특별시,중구,청구동,합계,11364,8798,3526,1912,2143,673,467,20,0,5,4,6,3,3,6,8768,30,2566
서울특별시,중구,청구동,관내사전투표,1537,1537,729,248,333,108,109,3,0,0,1,0,2,0,0,1533,4,0
서울특별시,중구,청구동,청구동제1투,1404,943,374,222,247,52,40,3,0,1,1,0,0,1,2,943,0,461
서울특별시,중구,청구동,청구동제2투,1880,1114,451,233,268,88,67,1,0,1,0,0,0,0,0,1109,5,766
서울특별시,중구,청구동,청구동제3투,2134,1781,645,453,428,161,80,4,0,0,1,1,0,2,2,1777,4,353
서울특별시,중구,청구동,청구동제4투,1842,1443,568,293,369,121,77,5,0,0,1,4,0,0,1,1439,4,399
서울특별시,중구,청구동,청구동제5투,2567,1980,759,463,498,143,94,4,0,3,0,1,1,0,1,1967,13,587
서울특별시,중구,신당제5동,합계,7744,5549,2257,1136,1486,314,312,12,0,4,1,10,0,0,5,5537,12,2195
서울특별시,중구,신당제5동,관내사전투표,1571,1571,691,322,377,91,77,4,0,1,0,3,0,0,1,1567,4,0
서울특별시,중구,신당제5동,신당제5동제1투,2154,1254,503,271,354,50,69,3,0,0,0,3,0,0,0,1253,1,900
서울특별시,중구,신당제5동,신당제5동제2투,3155,2147,836,418,605,135,140,2,0,1,1,1,0,0,1,2140,7,1008
서울특별시,중구,신당제5동,신당제5동제3투,864,577,227,125,150,38,26,3,0,2,0,3,0,0,3,577,0,287
서울특별시,중구,동화동,합계,8687,6805,2736,1471,1643,536,388,5,1,1,1,3,0,2,2,6789,16,1882
서울특별시,중구,동화동,관내사전투표,1688,1688,765,327,357,116,117,0,0,0,0,1,0,0,0,1683,5,0
서울특별시,중구,동화동,동화동제1투,1461,992,379,210,252,86,58,2,0,0,0,2,0,1,0,990,2,469
서울특별시,중구,동화동,동화동제2투,1833,1403,539,341,345,109,64,1,0,0,0,0,0,0,1,1400,3,430
서울특별시,중구,동화동,동화동제3투,2115,1607,623,339,402,150,87,2,0,0,0,0,0,0,0,1603,4,508
서울특별시,중구,동화동,동화동제4투,1590,1115,430,254,287,75,62,0,1,1,1,0,0,1,1,1113,2,475
서울특별시,중구,황학동,합계,9623,6845,2909,1322,1736,458,369,9,0,4,4,2,2,3,7,6825,20,2778
서울특별시,중구,황학동,관내사전투표,1362,1362,634,250,307,82,83,1,0,1,0,0,0,0,1,1359,3,0
서울특별시,중구,황학동,황학동제1투,3557,2143,847,429,588,136,120,5,0,3,2,1,2,2,2,2137,6,1414
서울특별시,중구,황학동,황학동제2투,1636,1049,400,226,293,67,59,1,0,0,0,0,0,0,1,1047,2,587
서울특별시,중구,황학동,황학동제3투,3068,2291,1028,417,548,173,107,2,0,0,2,1,0,1,3,2282,9,777
서울특별시,중구,중림동,합계,6537,4822,1936,1096,1127,332,295,6,0,7,1,2,2,1,1,4806,16,1715
서울특별시,중구,중림동,관내사전투표,1322,1322,571,289,277,90,87,0,0,1,1,1,1,0,1,1319,3,0
서울특별시,중구,중림동,중림동제1투,1172,672,295,126,158,51,39,0,0,1,0,0,0,0,0,670,2,500
서울특별시,중구,중림동,중림동제2투,2333,1446,524,359,367,99,81,4,0,2,0,1,1,1,0,1439,7,887
서울특별시,중구,중림동,중림동제3투,1710,1382,546,322,325,92,88,2,0,3,0,0,0,0,0,1378,4,328
서울특별시,중구,잘못 투입·구분된 투표지,,0,0,0,0,0,0,0,0,0,0,0,0,0,0,0,0,0,0
서울특별시,용산구,합계,,197962,148157,58081,35230,32109,11825,9773,299,17,68,23,72,32,51,80,147660,497,49805
서울특별시,용산구,거소·선상투표,,244,231,88,51,66,16,6,1,0,1,0,0,0,0,0,229,2,13
서울특별시,용산구,관외사전투표,,18318,18288,8077,3320,3690,1531,1493,35,3,5,3,20,4,7,19,18207,81,30
서울특별시,용산구,재외투표,,3497,2547,1277,351,443,144,289,23,0,1,0,1,1,1,1,2532,15,950
서울특별시,용산구,후암동,관내사전투표,2845,2845,1345,552,528,187,203,8,0,1,1,1,1,1,5,2833,12,0
서울특별시,용산구,후암동,합계,14106,10142,4502,2139,2121,634,650,37,3,2,1,5,2,3,7,10106,36,3964
서울특별시,용산구,후암동,후암동제1투,3353,1967,887,398,419,143,110,4,1,0,0,0,1,0,1,1964,3,1386
서울특별시,용산구,후암동,후암동제2투,2545,1654,699,366,374,92,107,10,0,0,0,0,0,0,0,1648,6,891
서울특별시,용산구,후암동,후암동제3투,2667,1839,760,416,411,115,123,4,1,1,0,2,0,1,1,1835,4,828
서울특별시,용산구,후암동,후암동제4투,2696,1837,811,407,389,97,107,11,1,0,0,2,0,1,0,1826,11,859
서울특별시,용산구,용산2가동,합계,8981,6365,2597,1452,1358,397,512,6,1,6,1,1,1,3,2,6337,28,2616
서울특별시,용산구,용산2가동,관내사전투표,1675,1675,775,331,329,82,151,0,0,1,0,0,1,0,0,1670,5,0
서울특별시,용산구,용산2가동,용산2가동제1투,2460,1438,541,331,329,104,116,2,1,2,1,1,0,3,0,1431,7,1022
서울특별시,용산구,용산2가동,용산2가동제2투,1626,1079,407,294,242,60,73,0,0,0,0,0,0,0,0,1076,3,547
서울특별시,용산구,용산2가동,용산2가동제3투,1601,1121,449,259,245,69,87,2,0,1,0,0,0,0,1,1113,8,480
서울특별시,용산구,용산2가동,용산2가동제4투,1619,1052,425,237,213,82,85,2,0,2,0,0,0,0,1,1047,5,567
서울특별시,용산구,남영동,합계,7381,4727,1880,1077,1085,298,344,16,3,3,1,0,1,4,1,4713,14,2654
서울특별시,용산구,남영동,관내사전투표,1607,1607,690,333,318,118,135,5,0,2,0,0,0,1,0,1602,5,0
서울특별시,용산구,남영동,남영동제1투,3082,1622,663,328,385,104,126,8,1,0,0,0,0,2,0,1617,5,1460
서울특별시,용산구,남영동,남영동제2투,2692,1498,527,416,382,76,83,3,2,1,1,0,1,1,1,1494,4,1194
서울특별시,용산구,청파동,합계,15405,10843,4874,2158,2327,699,700,20,0,6,2,6,3,4,9,10808,35,4562
서울특별시,용산구,청파동,관내사전투표,2225,2225,1173,316,350,154,216,6,0,0,0,3,0,0,1,2219,6,0
서울특별시,용산구,청파동,청파동제1투,1858,1215,498,301,293,66,50,3,0,1,1,0,1,0,1,1215,0,643
서울특별시,용산구,청파동,청파동제2투,2147,1444,609,298,364,90,71,3,0,2,0,0,1,2,1,1441,3,703
서울특별시,용산구,청파동,청파동제3투,2271,1540,664,315,354,101,90,1,0,1,1,2,0,0,3,1532,8,731
서울특별시,용산구,청파동,청파동제4투,2677,1864,824,398,410,120,98,3,0,0,0,0,0,2,2,1857,7,813
서울특별시,용산구,청파동,청파동제5투,1894,1281,540,249,300,89,95,2,0,1,0,0,1,0,0,1277,4,613
서울특별시,용산구,청파동,청파동제6투,2333,1274,566,281,256,79,80,2,0,1,0,1,0,0,1,1267,7,1059
서울특별시,용산구,원효로제1동,관내사전투표,2228,2228,1092,369,393,197,163,1,1,1,0,3,0,0,0,2220,8,0
서울특별시,용산구,원효로제1동,합계,10629,8174,3519,1591,1732,718,563,8,1,2,0,7,2,2,3,8148,26,2455
서울특별시,용산구,원효로제1동,원효로제1동제1투,2545,1850,778,423,403,103,133,2,0,0,0,2,0,0,0,1844,6,695
서울특별시,용산구,원효로제1동,원효로제1동제2투,2255,1598,648,329,395,116,95,1,0,1,0,1,1,1,2,1590,8,657
서울특별시,용산구,원효로제1동,원효로제1동제3투,3601,2498,1001,470,541,302,172,4,0,0,0,1,1,1,1,2494,4,1103
서울특별시,용산구,원효로제2동,합계,10958,8477,3531,1862,1832,659,528,13,0,7,1,4,4,4,6,8451,26,2481
서울특별시,용산구,원효로제2동,관내사전투표,2004,2004,973,357,349,163,151,0,0,1,0,1,0,2,1,1998,6,0
서울특별시,용산구,원효로제2동,원효로제2동제1투,3709,2670,1050,613,597,238,152,2,0,2,1,1,2,1,2,2661,9,1039
서울특별시,용산구,원효로제2동,원효로제2동제2투,2624,1927,763,449,447,131,120,8,0,2,0,1,0,0,0,1921,6,697
서울특별시,용산구,원효로제2동,원효로제2동제3투,2621,1876,745,443,439,127,105,3,0,2,0,1,2,1,3,1871,5,745
서울특별시,용산구,효창동,합계,7362,5829,2378,1260,1355,417,391,10,1,2,1,2,1,1,1,5820,9,1533
서울특별시,용산구,효창동,관내사전투표,1722,1722,812,298,342,133,129,3,0,0,1,1,0,0,0,1719,3,0
서울특별시,용산구,효창동,효창동제1투,1935,1338,549,281,324,80,97,3,0,1,0,1,0,0,0,1336,2,597
서울특별시,용산구,효창동,효창동제2투,1835,1434,546,306,352,127,97,1,0,0,0,0,1,0,1,1431,3,401
서울특별시,용산구,효창동,효창동제3투,1870,1335,471,375,337,77,68,3,1,1,0,0,0,1,0,1334,1,535
서울특별시,용산구,용문동,합계,9628,7494,3147,1546,1723,571,450,13,2,3,1,6,1,1,5,7469,25,2134
서울특별시,용산구,용문동,관내사전투표,2088,2088,996,358,423,162,134,1,0,1,1,2,0,1,0,2079,9,0
서울특별시,용산구,용문동,용문동제1투,2890,1838,762,398,428,134,105,2,0,1,0,4,0,0,0,1834,4,1052
서울특별시,용산구,용문동,용문동제2투,2190,1518,565,352,409,101,67,7,1,1,0,0,1,0,3,1507,11,672
서울특별시,용산구,용문동,용문동제3투,2460,2050,824,438,463,174,144,3,1,0,0,0,0,0,2,2049,1,410
서울특별시,용산구,한강로동,합계,11551,8011,2709,2251,1890,706,405,12,0,6,4,2,1,1,3,7990,21,3540
서울특별시,용산구,한강로동,관내사전투표,1943,1943,832,412,416,144,131,1,0,2,1,1,0,0,0,1940,3,0
서울특별시,용산구,한강로동,한강로동제1투,2105,1488,474,404,365,150,83,4,0,2,0,0,0,0,0,1482,6,617
서울특별시,용산구,한강로동,한강로동제2투,1553,492,156,148,121,38,24,2,0,0,0,0,0,1,0,490,2,1061
서울특별시,용산구,한강로동,한강로동제3투,1264,879,347,223,168,92,44,0,0,1,1,0,0,0,0,876,3,385
서울특별시,용산구,한강로동,한강로동제4투,3282,2345,596,849,562,231,92,4,0,1,2,1,1,0,3,2342,3,937
서울특별시,용산구,한강로동,한강로동제5투,1404,864,304,215,258,51,31,1,0,0,0,0,0,0,0,860,4,540
서울특별시,용산구,이촌제1동,합계,20363,15704,4860,4854,3329,1862,723,24,1,2,2,2,1,6,2,15668,36,4659
서울특별시,용산구,이촌제1동,관내사전투표,4560,4560,1616,1281,887,523,235,5,0,0,1,1,0,1,0,4550,10,0
서울특별시,용산구,이촌제1동,이촌제1동제1투,3263,2281,562,901,481,242,80,8,0,0,1,0,0,2,0,2277,4,982
서울특별시,용산구,이촌제1동,이촌제1동제2투,4278,2636,878,690,610,331,118,1,1,2,0,1,1,1,0,2634,2,1642
서울특별시,용산구,이촌제1동,이촌제1동제3투,2844,2129,596,764,434,229,95,4,0,0,0,0,0,0,0,2122,7,715
서울특별시,용산구,이촌제1동,이촌제1동제4투,3031,2371,799,605,532,293,127,6,0,0,0,0,0,1,2,2365,6,660
서울특별시,용산구,이촌제1동,이촌제1동제5투,2387,1727,409,613,385,244,68,0,0,0,0,0,0,1,0,1720,7,660
서울특별시,용산구,이촌제2동,관내사전투표,1293,1293,533,281,292,99,74,3,0,0,0,0,1,0,0,1283,10,0
서울특별시,용산구,이촌제2동,합계,7068,5515,2023,1439,1269,432,314,10,0,2,1,1,2,0,1,5494,21,1553
서울특별시,용산구,이촌제2동,이촌제2동제1투,1909,1229,440,326,278,90,89,2,0,0,0,0,0,0,1,1226,3,680
서울특별시,용산구,이촌제2동,이촌제2동제2투,1732,1293,428,403,299,89,67,3,0,1,0,0,0,0,0,1290,3,439
서울특별시,용산구,이촌제2동,이촌제2동제3투,2134,1700,622,429,400,154,84,2,0,1,1,1,1,0,0,1695,5,434
서울특별시,용산구,이태원제1동,합계,6308,4062,1401,1219,822,306,294,5,1,2,0,2,2,0,2,4056,6,2246
서울특별시,용산구,이태원제1동,관내사전투표,1114,1114,443,245,208,87,122,4,0,1,0,0,1,0,1,1112,2,0
서울특별시,용산구,이태원제1동,이태원제1동제1투,3325,1772,566,602,370,131,96,1,0,1,0,2,0,0,1,1770,2,1553
서울특별시,용산구,이태원제1동,이태원제1동제2투,1869,1176,392,372,244,88,76,0,1,0,0,0,1,0,0,1174,2,693
서울특별시,용산구,이태원제2동,관내사전투표,1330,1330,616,273,229,91,113,1,0,0,0,0,0,1,3,1327,3,0
서울특별시,용산구,이태원제2동,합계,7614,5265,2031,1320,1087,388,398,12,0,6,0,0,0,2,4,5248,17,2349
서울특별시,용산구,이태원제2동,이태원제2동제1투,2647,1465,501,391,311,137,112,5,0,0,0,0,0,1,1,1459,6,1182
서울특별시,용산구,이태원제2동,이태원제2동제2투,2063,1414,533,388,298,99,88,4,0,1,0,0,0,0,0,1411,3,649
서울특별시,용산구,이태원제2동,이태원제2동제3투,1574,1056,381,268,249,61,85,2,0,5,0,0,0,0,0,1051,5,518
서울특별시,용산구,한남동,관내사전투표,2347,2347,1047,466,425,191,194,9,1,0,1,2,1,2,0,2339,8,0
서울특별시,용산구,한남동,합계,16042,10380,3846,2767,2223,766,693,27,1,6,1,5,3,4,6,10348,32,5662
서울특별시,용산구,한남동,한남동제1투,2650,1813,624,508,432,129,113,0,0,0,0,0,0,0,4,1810,3,837
서울특별시,용산구,한남동,한남동제2투,2290,1350,551,298,320,69,97,7,0,1,0,1,1,0,0,1345,5,940
서울특별시,용산구,한남동,한남동제3투,3352,2097,563,773,429,208,113,1,0,3,0,1,0,2,1,2094,3,1255
서울특별시,용산구,한남동,한남동제4투,2270,1442,557,403,294,94,82,5,0,1,0,0,0,0,1,1437,5,828
서울특별시,용산구,한남동,한남동제5투,3133,1331,504,319,323,75,94,5,0,1,0,1,1,0,0,1323,8,1802
서울특별시,용산구,서빙고동,합계,9503,7115,1928,2393,1678,708,358,12,0,1,0,2,1,3,4,7088,27,2388
서울특별시,용산구,서빙고동,관내사전투표,1418,1418,502,431,299,95,79,3,0,0,0,0,0,0,1,1410,8,0
서울특별시,용산구,서빙고동,서빙고동제1투,2321,1774,433,483,530,219,98,4,0,1,0,1,1,1,0,1771,3,547
서울특별시,용산구,서빙고동,서빙고동제2투,1853,1201,444,318,275,81,69,4,0,0,0,1,0,1,3,1196,5,652
서울특별시,용산구,서빙고동,서빙고동제3투,2651,2029,343,943,412,263,58,1,0,0,0,0,0,1,0,2021,8,622
서울특별시,용산구,서빙고동,서빙고동제4투,1260,693,206,218,162,50,54,0,0,0,0,0,0,0,0,690,3,567
서울특별시,용산구,보광동,합계,13004,8988,3413,2180,2079,573,662,15,0,5,4,6,2,5,4,8948,40,4016
서울특별시,용산구,보광동,관내사전투표,2475,2475,1021,513,518,173,229,3,0,2,1,2,1,1,1,2465,10,0
서울특별시,용산구,보광동,보광동제1투,3131,1692,599,459,405,114,104,0,0,1,0,0,0,0,1,1683,9,1439
서울특별시,용산구,보광동,보광동제2투,2436,1608,656,394,359,82,105,4,0,0,0,0,0,1,1,1602,6,828
서울특별시,용산구,보광동,보광동제3투,2718,1690,605,423,393,118,134,3,0,1,1,1,1,3,0,1683,7,1028
서울특별시,용산구,보광동,보광동제4투,2244,1523,532,391,404,86,90,5,0,1,2,3,0,0,1,1515,8,721
서울특별시,용산구,잘못 투입·구분된 투표지,,0,0,0,0,0,0,0,0,0,0,0,0,0,0,0,0,0,0
서울특별시,성동구,합계,,259009,203175,86686,40566,45674,15859,12936,304,16,94,46,108,41,58,124,202512,663,55834
서울특별시,성동구,거소·선상투표,,358,342,125,54,115,24,10,2,1,0,0,1,1,1,0,334,8,16
서울특별시,성동구,관외사전투표,,23632,23616,11080,3532,4912,2033,1859,33,3,9,5,12,10,5,22,23515,101,16
서울특별시,성동구,재외투표,,3007,2309,1314,183,378,111,296,10,0,1,1,1,1,2,2,2300,9,698
서울특별시,성동구,금호1가동,합계,9945,7557,3131,1634,1774,533,433,15,1,0,0,3,0,4,4,7532,25,2388
서울특별시,성동구,금호1가동,관내사전투표,1569,1569,717,287,348,93,112,3,0,0,0,2,0,1,1,1564,5,0
서울특별시,성동구,금호1가동,금호1가동제1투,2123,1352,520,334,329,84,76,0,0,0,0,1,0,0,0,1344,8,771
서울특별시,성동구,금호1가동,금호1가동제2투,3110,2241,929,463,572,151,107,4,0,0,0,0,0,3,3,2232,9,869
서울특별시,성동구,금호1가동,금호1가동제3투,3143,2395,965,550,525,205,138,8,1,0,0,0,0,0,0,2392,3,748
서울특별시,성동구,금호2·3가동,관내사전투표,3289,3289,1538,537,737,248,202,7,1,2,0,1,0,2,1,3276,13,0
서울특별시,성동구,금호2·3가동,합계,18363,13657,5609,2760,3258,1112,836,12,2,6,1,3,0,2,8,13609,48,4706
서울특별시,성동구,금호2·3가동,금호2·3가동제1투,3448,2405,948,524,571,198,154,1,0,3,0,2,0,0,1,2402,3,1043
서울특별시,성동구,금호2·3가동,금호2·3가동제2투,3180,2129,865,448,497,158,150,1,0,1,0,0,0,0,0,2120,9,1051
서울특별시,성동구,금호2·3가동,금호2·3가동제3투,3308,2214,845,504,580,140,126,2,0,0,0,0,0,0,5,2202,12,1094
서울특별시,성동구,금호2·3가동,금호2·3가동제4투,2409,1956,703,466,480,185,112,1,0,0,0,0,0,0,0,1947,9,453
서울특별시,성동구,금호2·3가동,금호2·3가동제5투,2729,1664,710,281,393,183,92,0,1,0,1,0,0,0,1,1662,2,1065
서울특별시,성동구,금호4가동,합계,11162,8518,3516,1849,1926,722,446,10,0,4,4,2,3,6,8,8496,22,2644
서울특별시,성동구,금호4가동,관내사전투표,2502,2502,1110,469,547,218,135,4,0,2,1,0,3,4,4,2497,5,0
서울특별시,성동구,금호4가동,금호4가동제1투,2930,1971,794,436,440,192,97,6,0,0,0,1,0,1,1,1968,3,959
서울특별시,성동구,금호4가동,금호4가동제2투,2735,2049,843,470,442,188,96,0,0,1,2,0,0,1,1,2044,5,686
서울특별시,성동구,금호4가동,금호4가동제3투,2995,1996,769,474,497,124,118,0,0,1,1,1,0,0,2,1987,9,999
서울특별시,성동구,옥수동,합계,19958,15635,6106,3621,3401,1567,862,28,1,4,2,3,1,2,5,15603,32,4323
서울특별시,성동구,옥수동,관내사전투표,3619,3619,1562,708,733,359,239,2,0,1,1,2,1,1,2,3611,8,0
서울특별시,성동구,옥수동,옥수동제1투,2654,2041,819,449,436,242,85,5,0,0,0,1,0,0,1,2038,3,613
서울특별시,성동구,옥수동,옥수동제2투,2551,1773,588,505,403,169,98,5,0,1,0,0,0,0,1,1770,3,778
서울특별시,성동구,옥수동,옥수동제3투,2859,2204,861,522,486,219,106,5,0,1,1,0,0,0,0,2201,3,655
서울특별시,성동구,옥수동,옥수동제4투,3192,1988,659,582,445,190,101,5,0,0,0,0,0,1,0,1983,5,1204
서울특별시,성동구,옥수동,옥수동제5투,2346,1882,730,444,434,167,96,4,1,1,0,0,0,0,0,1877,5,464
서울특별시,성동구,옥수동,옥수동제6투,2737,2128,887,411,464,221,137,2,0,0,0,0,0,0,1,2123,5,609
서울특별시,성동구,응봉동,합계,12496,9924,4167,2150,2184,789,567,24,1,4,7,3,1,4,6,9907,17,2572
서울특별시,성동구,응봉동,관내사전투표,3164,3164,1475,586,645,242,205,4,1,0,0,1,1,0,0,3160,4,0
서울특별시,성동구,응봉동,응봉동제1투,3136,2031,794,470,481,155,109,4,0,3,0,1,0,3,5,2025,6,1105
서울특별시,성동구,응봉동,응봉동제2투,3341,2466,931,626,541,210,139,9,0,0,6,0,0,0,1,2463,3,875
서울특별시,성동구,응봉동,응봉동제3투,2855,2263,967,468,517,182,114,7,0,1,1,1,0,1,0,2259,4,592
서울특별시,성동구,성수1가제1동,합계,12772,9598,4039,2036,2091,741,606,15,1,6,6,12,3,2,5,9563,35,3174
서울특별시,성동구,성수1가제1동,관내사전투표,2385,2385,1165,399,461,167,169,3,0,2,1,4,0,0,2,2373,12,0
서울특별시,성동구,성수1가제1동,성수1가제1동제1투,2895,1793,711,409,438,114,104,5,0,0,1,3,2,1,0,1788,5,1102
서울특별시,성동구,성수1가제1동,성수1가제1동제2투,2968,2247,914,510,470,194,136,4,1,2,1,2,1,1,2,2238,9,721
서울특별시,성동구,성수1가제1동,성수1가제1동제3투,2410,1767,673,424,410,142,109,1,0,2,2,0,0,0,0,1763,4,643
서울특별시,성동구,성수1가제1동,성수1가제1동제4투,2114,1406,576,294,312,124,88,2,0,0,1,3,0,0,1,1401,5,708
서울특별시,성동구,성수1가제2동,합계,12720,9913,4339,2092,2078,688,646,8,2,4,1,8,0,3,12,9881,32,2807
서울특별시,성동구,성수1가제2동,관내사전투표,2374,2373,1221,378,408,186,165,1,0,1,0,6,0,0,1,2367,6,1
서울특별시,성동구,성수1가제2동,성수1가제2동제1투,2162,1424,591,345,312,75,89,1,1,2,0,1,0,1,1,1419,5,738
서울특별시,성동구,성수1가제2동,성수1가제2동제2투,2213,1614,614,411,358,107,109,2,1,1,1,0,0,0,4,1608,6,599
서울특별시,성동구,성수1가제2동,성수1가제2동제3투,2769,1979,850,405,437,143,126,2,0,0,0,1,0,1,3,1968,11,790
서울특별시,성동구,성수1가제2동,성수1가제2동제4투,3202,2523,1063,553,563,177,157,2,0,0,0,0,0,1,3,2519,4,679
서울특별시,성동구,성수2가제1동,합계,15089,10960,4381,2487,2614,723,666,19,0,6,3,8,2,2,4,10915,45,4129
서울특별시,성동구,성수2가제1동,관내사전투표,3258,3258,1510,646,686,184,206,6,0,2,1,4,1,0,3,3249,9,0
서울특별시,성동구,성수2가제1동,성수2가제1동제1투,2740,1746,625,416,438,146,106,4,0,1,1,0,1,1,1,1740,6,994
서울특별시,성동구,성수2가제1동,성수2가제1동제2투,3247,2257,827,569,570,150,132,1,0,0,0,0,0,0,0,2249,8,990
서울특별시,성동구,성수2가제1동,성수2가제1동제3투,2953,1767,693,417,428,112,97,5,0,0,1,2,0,1,0,1756,11,1186
서울특별시,성동구,성수2가제1동,성수2가제1동제4투,2891,1932,726,439,492,131,125,3,0,3,0,2,0,0,0,1921,11,959
서울특별시,성동구,성수2가제3동,합계,9235,7052,2867,1663,1535,527,422,5,0,3,0,3,2,2,1,7030,22,2183
서울특별시,성동구,성수2가제3동,관내사전투표,2114,2114,958,424,421,149,155,0,0,0,0,0,1,0,0,2108,6,0
서울특별시,성동구,성수2가제3동,성수2가제3동제1투,2816,1777,763,381,387,127,106,2,0,1,0,2,0,1,0,1770,7,1039
서울특별시,성동구,성수2가제3동,성수2가제3동제2투,2842,2208,744,680,493,181,98,1,0,1,0,1,0,1,1,2201,7,634
서울특별시,성동구,성수2가제3동,성수2가제3동제3투,1463,953,402,178,234,70,63,2,0,1,0,0,1,0,0,951,2,510
서울특별시,성동구,왕십리도선동,합계,19711,15256,6550,2936,3507,1232,942,15,1,4,2,4,7,8,6,15214,42,4455
서울특별시,성동구,왕십리도선동,관내사전투표,3522,3522,1733,526,720,307,224,3,0,1,0,1,1,1,0,3517,5,0
서울특별시,성동구,왕십리도선동,왕십리도선동제1투,3306,2293,945,516,534,139,137,1,0,1,2,1,1,3,1,2281,12,1013
서울특별시,성동구,왕십리도선동,왕십리도선동제2투,2024,1371,567,303,325,73,96,0,0,0,0,1,0,1,1,1367,4,653
서울특별시,성동구,왕십리도선동,왕십리도선동제3투,2511,1949,690,508,479,153,99,4,0,1,0,0,3,2,2,1941,8,562
서울특별시,성동구,왕십리도선동,왕십리도선동제4투,3295,2199,1013,345,518,178,134,3,0,0,0,0,0,1,1,2193,6,1096
서울특별시,성동구,왕십리도선동,왕십리도선동제5투,2986,2295,929,458,528,232,138,3,1,0,0,1,1,0,1,2292,3,691
서울특별시,성동구,왕십리도선동,왕십리도선동제6투,2067,1627,673,280,403,150,114,1,0,1,0,0,1,0,0,1623,4,440
서울특별시,성동구,왕십리제2동,합계,12663,9689,4308,1769,2230,650,662,15,1,6,0,3,1,6,6,9657,32,2974
서울특별시,성동구,왕십리제2동,관내사전투표,2396,2396,1181,347,488,150,216,2,0,0,0,1,1,1,2,2389,7,0
서울특별시,성동구,왕십리제2동,왕십리제2동제1투,3417,2134,892,439,527,134,128,3,0,3,0,0,0,1,0,2127,7,1283
서울특별시,성동구,왕십리제2동,왕십리제2동제2투,2741,1888,747,394,481,131,112,5,0,1,0,1,0,3,3,1878,10,853
서울특별시,성동구,왕십리제2동,왕십리제2동제3투,1464,1155,488,253,270,71,66,2,0,0,0,0,0,1,0,1151,4,309
서울특별시,성동구,왕십리제2동,왕십리제2동제4투,2645,2116,1000,336,464,164,140,3,1,2,0,1,0,0,1,2112,4,529
서울특별시,성동구,행당제1동,관내사전투표,2991,2991,1409,514,572,242,230,5,0,2,0,1,2,0,3,2980,11,0
서울특별시,성동구,행당제1동,합계,11485,8863,3676,1877,2028,662,547,19,0,7,1,4,3,1,9,8834,29,2622
서울특별시,성동구,행당제1동,행당제1동제1투,3256,2119,786,531,528,150,106,6,0,3,0,2,0,0,2,2114,5,1137
서울특별시,성동구,행당제1동,행당제1동제2투,3376,2499,985,526,633,199,139,6,0,2,0,0,0,1,3,2494,5,877
서울특별시,성동구,행당제1동,행당제1동제3투,1862,1254,496,306,295,71,72,2,0,0,1,1,1,0,1,1246,8,608
서울특별시,성동구,행당제2동,합계,18235,14591,6443,2776,3239,1185,860,31,1,1,4,10,3,1,4,14558,33,3644
서울특별시,성동구,행당제2동,관내사전투표,3487,3486,1748,545,658,270,242,10,0,0,0,1,1,0,1,3476,10,1
서울특별시,성동구,행당제2동,행당제2동제1투,3138,2309,924,503,527,222,121,7,0,0,1,0,0,0,0,2305,4,829
서울특별시,성동구,행당제2동,행당제2동제2투,2713,1945,830,324,471,176,131,3,0,0,1,5,0,0,0,1941,4,768
서울특별시,성동구,행당제2동,행당제2동제3투,3099,2316,981,453,576,155,141,1,0,0,1,1,1,0,1,2311,5,783
서울특별시,성동구,행당제2동,행당제2동제4투,2797,2230,984,476,478,188,93,3,0,1,1,0,0,1,2,2227,3,567
서울특별시,성동구,행당제2동,행당제2동제5투,3001,2305,976,475,529,174,132,7,1,0,0,3,1,0,0,2298,7,696
서울특별시,성동구,마장동,관내사전투표,2795,2795,1403,466,580,165,165,4,0,1,0,1,1,1,0,2787,8,0
서울특별시,성동구,마장동,합계,18134,13934,5848,2904,3244,982,859,21,1,8,4,9,2,2,7,13891,43,4200
서울특별시,성동구,마장동,마장동제1투,2488,1696,652,388,404,139,101,5,0,0,1,0,0,0,1,1691,5,792
서울특별시,성동구,마장동,마장동제2투,2612,2037,800,423,497,160,146,2,0,2,0,0,0,0,2,2032,5,575
서울특별시,성동구,마장동,마장동제3투,2970,2319,961,507,529,176,127,5,0,1,1,1,0,0,4,2312,7,651
서울특별시,성동구,마장동,마장동제4투,2482,1717,696,398,417,89,104,2,0,1,2,1,1,0,0,1711,6,765
서울특별시,성동구,마장동,마장동제5투,2600,1708,663,401,434,92,103,2,1,2,0,1,0,1,0,1700,8,892
서울특별시,성동구,마장동,마장동제6투,2187,1662,673,321,383,161,113,1,0,1,0,5,0,0,0,1658,4,525
서울특별시,성동구,사근동,관내사전투표,1685,1685,766,205,343,204,161,0,0,2,1,0,0,0,1,1683,2,0
서울특별시,성동구,사근동,합계,8412,6461,2713,1055,1448,678,509,3,0,8,3,8,1,4,6,6436,25,1951
서울특별시,성동구,사근동,사근동제1투,1578,1198,522,195,272,108,82,1,0,2,2,4,1,1,1,1191,7,380
서울특별시,성동구,사근동,사근동제2투,2206,1462,562,305,383,90,105,0,0,3,0,1,0,1,2,1452,10,744
서울특별시,성동구,사근동,사근동제3투,2943,2116,863,350,450,276,161,2,0,1,0,3,0,2,2,2110,6,827
서울특별시,성동구,송정동,관내사전투표,1430,1430,689,278,286,74,89,3,0,3,0,0,0,0,1,1423,7,0
서울특별시,성동구,송정동,합계,8949,6376,2720,1351,1499,384,370,10,0,6,1,1,0,1,5,6348,28,2573
서울특별시,성동구,송정동,송정동제1투,2618,1734,757,340,401,110,115,1,0,2,0,0,0,0,2,1728,6,884
서울특별시,성동구,송정동,송정동제2투,2411,1605,656,362,383,114,81,2,0,1,1,1,0,0,0,1601,4,806
서울특별시,성동구,송정동,송정동제3투,2490,1607,618,371,429,86,85,4,0,0,0,0,0,1,2,1596,11,883
서울특별시,성동구,용답동,관내사전투표,2143,2143,1060,362,442,112,148,1,0,3,1,3,0,0,0,2132,11,0
서울특별시,성동구,용답동,합계,12683,8922,3753,1837,2212,516,538,9,0,7,1,10,0,0,4,8887,35,3761
서울특별시,성동구,용답동,용답동제1투,3027,1704,720,321,444,97,111,0,0,3,0,1,0,0,3,1700,4,1323
서울특별시,성동구,용답동,용답동제2투,2672,1790,695,407,474,110,95,2,0,0,0,1,0,0,1,1785,5,882
서울특별시,성동구,용답동,용답동제3투,2478,1650,683,354,406,85,108,1,0,0,0,4,0,0,0,1641,9,828
서울특별시,성동구,용답동,용답동제4투,2363,1635,595,393,446,112,76,5,0,1,0,1,0,0,0,1629,6,728
서울특별시,성동구,잘못 투입·구분된 투표지,,0,2,1,0,1,0,0,0,0,0,0,0,0,0,0,2,0,-2
서울특별시,광진구,합계,,305172,240030,105512,46368,52824,17114,16540,312,24,120,48,127,48,65,129,239231,799,65142
서울특별시,광진구,거소·선상투표,,384,370,145,53,123,28,9,1,1,0,1,0,2,1,0,364,6,14
서울특별시,광진구,관외사전투표,,27805,27803,13607,3918,5565,2084,2362,44,6,9,6,17,7,8,29,27662,141,2
서울특별시,광진구,재외투표,,3250,2494,1472,208,398,107,288,9,0,1,0,4,0,1,0,2488,6,756
서울특별시,광진구,중곡제1동,합계,12296,8978,3830,1871,2019,596,599,3,0,6,1,6,1,3,2,8937,41,3318
서울특별시,광진구,중곡제1동,관내사전투표,2062,2062,970,349,447,121,159,0,0,1,1,1,0,0,1,2050,12,0
서울특별시,광진구,중곡제1동,중곡제1동제1투,3002,1926,860,403,398,129,123,0,0,2,0,1,0,0,0,1916,10,1076
서울특별시,광진구,중곡제1동,중곡제1동제2투,1999,1369,565,322,291,91,90,0,0,1,0,1,0,1,0,1362,7,630
서울특별시,광진구,중곡제1동,중곡제1동제3투,2779,1856,695,427,469,124,128,2,0,1,0,3,0,1,1,1851,5,923
서울특별시,광진구,중곡제1동,중곡제1동제4투,2454,1765,740,370,414,131,99,1,0,1,0,0,1,1,0,1758,7,689
서울특별시,광진구,중곡제2동,합계,17625,13301,5878,2630,2977,816,924,12,1,4,1,3,2,6,6,13260,41,4324
서울특별시,광진구,중곡제2동,관내사전투표,3331,3331,1671,561,637,200,249,3,1,2,0,0,0,0,1,3325,6,0
서울특별시,광진구,중곡제2동,중곡제2동제1투,2796,1871,794,361,459,119,132,2,0,0,0,0,0,1,0,1868,3,925
서울특별시,광진구,중곡제2동,중곡제2동제2투,3092,2271,997,431,521,151,149,2,0,0,1,3,1,0,3,2259,12,821
서울특별시,광진구,중곡제2동,중곡제2동제3투,3200,2287,990,493,499,142,151,0,0,0,0,0,0,2,1,2278,9,913
서울특별시,광진구,중곡제2동,중곡제2동제4투,2227,1485,596,331,357,88,103,2,0,0,0,0,0,1,1,1479,6,742
서울특별시,광진구,중곡제2동,중곡제2동제5투,2979,2056,830,453,504,116,140,3,0,2,0,0,1,2,0,2051,5,923
서울특별시,광진구,중곡제3동,합계,13889,10163,4220,2171,2366,641,685,22,2,10,5,3,4,2,5,10136,27,3726
서울특별시,광진구,중곡제3동,관내사전투표,2241,2241,1082,420,428,120,176,4,1,1,0,1,2,0,0,2235,6,0
서울특별시,광진구,중곡제3동,중곡제3동제1투,2250,1617,635,365,373,113,116,2,0,5,1,0,1,0,1,1612,5,633
서울특별시,광진구,중곡제3동,중곡제3동제2투,2149,1536,619,337,362,106,100,3,0,1,2,0,0,0,1,1531,5,613
서울특별시,광진구,중곡제3동,중곡제3동제3투,2464,1664,671,333,412,115,119,2,0,1,1,1,0,1,1,1657,7,800
서울특별시,광진구,중곡제3동,중곡제3동제4투,2658,1685,651,377,453,91,101,6,0,0,1,0,0,1,2,1683,2,973
서울특별시,광진구,중곡제3동,중곡제3동제5투,2127,1420,562,339,338,96,73,5,1,2,0,1,1,0,0,1418,2,707
서울특별시,광진구,중곡제4동,합계,24412,18468,7729,3978,4218,1161,1238,29,1,12,6,15,5,3,14,18409,59,5944
서울특별시,광진구,중곡제4동,관내사전투표,4211,4211,1948,825,886,251,277,5,0,0,1,2,2,0,1,4198,13,0
서울특별시,광진구,중곡제4동,중곡제4동제1투,2521,1874,758,406,438,131,131,3,0,1,0,0,0,0,0,1868,6,647
서울특별시,광진구,중곡제4동,중곡제4동제2투,3018,2294,986,465,520,148,158,1,1,3,1,3,0,1,1,2288,6,724
서울특별시,광진구,중곡제4동,중곡제4동제3투,2781,1719,709,390,377,98,122,5,0,3,2,2,0,2,2,1712,7,1062
서울특별시,광진구,중곡제4동,중곡제4동제4투,2607,1770,666,420,461,87,120,2,0,1,1,0,1,0,1,1760,10,837
서울특별시,광진구,중곡제4동,중곡제4동제5투,3021,2137,908,460,453,141,153,10,0,1,1,1,0,0,2,2130,7,884
서울특별시,광진구,중곡제4동,중곡제4동제6투,2888,1969,735,504,471,125,120,1,0,3,0,1,0,0,3,1963,6,919
서울특별시,광진구,중곡제4동,중곡제4동제7투,3365,2494,1019,508,612,180,157,2,0,0,0,6,2,0,4,2490,4,871
서울특별시,광진구,능동,합계,9103,7136,3333,1290,1452,517,512,11,0,0,0,2,0,1,4,7122,14,1967
서울특별시,광진구,능동,관내사전투표,2093,2093,1105,278,377,139,187,1,0,0,0,1,0,0,2,2090,3,0
서울특별시,광진구,능동,능동제1투,2029,1354,597,257,297,99,98,4,0,0,0,0,0,0,0,1352,2,675
서울특별시,광진구,능동,능동제2투,2252,1645,720,328,340,131,113,3,0,0,0,1,0,1,2,1639,6,607
서울특별시,광진구,능동,능동제3투,2729,2044,911,427,438,148,114,3,0,0,0,0,0,0,0,2041,3,685
서울특별시,광진구,구의제1동,합계,18054,13665,6231,2443,3034,939,930,21,1,7,4,8,3,3,3,13627,38,4389
서울특별시,광진구,구의제1동,관내사전투표,3907,3907,2020,556,757,262,284,5,0,2,3,2,0,1,1,3893,14,0
서울특별시,광진구,구의제1동,구의제1동제1투,2977,1961,818,378,476,150,127,4,1,0,0,0,1,0,1,1956,5,1016
서울특별시,광진구,구의제1동,구의제1동제2투,2968,2076,896,424,484,133,126,5,0,1,0,0,0,0,0,2069,7,892
서울특별시,광진구,구의제1동,구의제1동제3투,2921,2079,888,409,463,154,143,4,0,2,1,3,2,1,0,2070,9,842
서울특별시,광진구,구의제1동,구의제1동제4투,2540,1789,809,327,401,112,134,1,0,1,0,2,0,0,1,1788,1,751
서울특별시,광진구,구의제1동,구의제1동제5투,2741,1853,800,349,453,128,116,2,0,1,0,1,0,1,0,1851,2,888
서울특별시,광진구,구의제2동,합계,19268,14536,6335,3100,3210,884,900,24,0,9,6,10,6,6,5,14495,41,4732
서울특별시,광진구,구의제2동,관내사전투표,3193,3193,1629,558,586,194,201,5,0,1,3,4,3,1,0,3185,8,0
서울특별시,광진구,구의제2동,구의제2동제1투,2832,1801,761,376,414,106,132,6,0,1,0,0,0,0,1,1797,4,1031
서울특별시,광진구,구의제2동,구의제2동제2투,2966,2038,830,470,466,129,132,1,0,1,0,2,1,1,0,2033,5,928
서울특별시,광진구,구의제2동,구의제2동제3투,2611,1946,788,470,467,112,96,2,0,2,2,2,1,1,1,1944,2,665
서울특별시,광진구,구의제2동,구의제2동제4투,2916,2181,903,465,525,137,137,1,0,1,0,0,0,2,1,2172,9,735
서울특별시,광진구,구의제2동,구의제2동제5투,2355,1599,672,360,365,99,89,3,0,2,1,1,0,0,0,1592,7,756
서울특별시,광진구,구의제2동,구의제2동제6투,2395,1778,752,401,387,107,113,6,0,1,0,1,1,1,2,1772,6,617
서울특별시,광진구,구의제3동,합계,22778,18696,7823,3959,4132,1555,1131,16,0,6,1,5,2,8,5,18643,53,4082
서울특별시,광진구,구의제3동,관내사전투표,4839,4839,2403,801,844,422,350,5,0,0,1,0,0,2,2,4830,9,0
서울특별시,광진구,구의제3동,구의제3동제1투,3200,2696,1046,557,667,259,155,0,0,0,0,0,0,1,1,2686,10,504
서울특별시,광진구,구의제3동,구의제3동제2투,2891,2137,926,439,501,122,135,1,0,1,0,2,0,2,0,2129,8,754
서울특별시,광진구,구의제3동,구의제3동제3투,3095,2277,985,437,562,153,133,0,0,2,0,0,0,0,0,2272,5,818
서울특별시,광진구,구의제3동,구의제3동제4투,2649,1901,710,457,438,168,117,2,0,0,0,0,1,1,0,1894,7,748
서울특별시,광진구,구의제3동,구의제3동제5투,3111,2391,894,569,574,201,131,4,0,2,0,3,0,2,1,2381,10,720
서울특별시,광진구,구의제3동,구의제3동제6투,2993,2455,859,699,546,230,110,4,0,1,0,0,1,0,1,2451,4,538
서울특별시,광진구,광장동,합계,23754,19569,8126,4075,4295,1809,1160,24,1,9,2,5,1,6,8,19521,48,4185
서울특별시,광진구,광장동,관내사전투표,3991,3991,1774,790,786,377,240,6,0,1,1,2,0,1,1,3979,12,0
서울특별시,광진구,광장동,광장동제1투,3621,2442,830,630,622,213,130,5,0,2,0,1,0,2,0,2435,7,1179
서울특별시,광진구,광장동,광장동제2투,2535,1862,555,718,378,130,64,2,1,2,0,1,1,1,3,1856,6,673
서울특별시,광진구,광장동,광장동제3투,3041,2542,1168,395,570,225,174,2,0,1,0,0,0,0,0,2535,7,499
서울특별시,광진구,광장동,광장동제4투,3463,2967,1391,427,661,293,179,4,0,1,0,1,0,0,1,2958,9,496
서울특별시,광진구,광장동,광장동제5투,3819,3111,1410,511,655,308,219,3,0,0,1,0,0,1,2,3110,1,708
서울특별시,광진구,광장동,광장동제6투,3284,2654,998,604,623,263,154,2,0,2,0,0,0,1,1,2648,6,630
서울특별시,광진구,자양제1동,합계,18261,13495,6046,2514,3073,836,927,16,2,9,0,12,2,2,8,13447,48,4766
서울특별시,광진구,자양제1동,관내사전투표,3929,3929,1913,646,832,215,295,3,1,4,0,6,1,1,1,3918,11,0
서울특별시,광진구,자양제1동,자양제1동제1투,2586,1533,655,298,384,93,90,2,0,0,0,2,0,0,2,1526,7,1053
서울특별시,광진구,자양제1동,자양제1동제2투,2047,1431,606,287,325,108,96,2,0,0,0,0,0,0,2,1426,5,616
서울특별시,광진구,자양제1동,자양제1동제3투,2985,2141,963,383,479,142,154,5,0,0,0,1,0,1,0,2128,13,844
서울특별시,광진구,자양제1동,자양제1동제4투,2172,1516,639,313,359,90,107,0,1,2,0,0,1,0,1,1513,3,656
서울특별시,광진구,자양제1동,자양제1동제5투,2226,1369,598,256,343,82,78,4,0,1,0,1,0,0,1,1364,5,857
서울특별시,광진구,자양제1동,자양제1동제6투,2316,1576,672,331,351,106,107,0,0,2,0,2,0,0,1,1572,4,740
서울특별시,광진구,자양제2동,관내사전투표,3016,3016,1482,535,584,187,214,4,0,2,1,1,1,0,0,3011,5,0
서울특별시,광진구,자양제2동,합계,19930,15085,6439,3057,3523,1005,971,19,2,10,4,8,5,3,5,15051,34,4845
서울특별시,광진구,자양제2동,자양제2동제1투,3200,2168,873,477,510,155,142,3,0,1,1,1,0,1,0,2164,4,1032
서울특별시,광진구,자양제2동,자양제2동제2투,3137,2353,808,645,576,180,124,7,0,2,1,0,1,1,2,2347,6,784
서울특별시,광진구,자양제2동,자양제2동제3투,2606,1822,785,327,449,127,125,2,0,1,0,1,0,0,1,1818,4,784
서울특별시,광진구,자양제2동,자양제2동제4투,2548,1924,831,376,463,123,120,0,1,0,1,3,2,0,0,1920,4,624
서울특별시,광진구,자양제2동,자양제2동제5투,2486,1736,739,322,429,113,121,2,1,1,0,1,1,1,1,1732,4,750
서울특별시,광진구,자양제2동,자양제2동제6투,2937,2066,921,375,512,120,125,1,0,3,0,1,0,0,1,2059,7,871
서울특별시,광진구,자양제3동,합계,22572,18546,7545,4068,4281,1469,1082,18,0,6,2,6,2,4,3,18486,60,4026
서울특별시,광진구,자양제3동,관내사전투표,4941,4941,2405,815,1010,352,337,5,0,0,1,2,1,1,2,4931,10,0
서울특별시,광진구,자양제3동,자양제3동제1투,2765,1961,835,425,456,136,97,0,0,1,0,2,0,0,0,1952,9,804
서울특별시,광진구,자양제3동,자양제3동제2투,2920,2155,797,472,556,184,133,4,0,2,0,1,1,0,0,2150,5,765
서울특별시,광진구,자양제3동,자양제3동제3투,2603,2111,858,449,497,154,145,2,0,1,0,0,0,1,0,2107,4,492
서울특별시,광진구,자양제3동,자양제3동제4투,2351,1899,782,406,435,164,99,1,0,2,0,0,0,0,0,1889,10,452
서울특별시,광진구,자양제3동,자양제3동제5투,2290,1851,792,306,454,175,116,0,0,0,0,1,0,0,1,1845,6,439
서울특별시,광진구,자양제3동,자양제3동제6투,1432,1009,418,217,227,78,62,2,0,0,0,0,0,1,0,1005,4,423
서울특별시,광진구,자양제3동,자양제3동제7투,3270,2619,658,978,646,226,93,4,0,0,1,0,0,1,0,2607,12,651
서울특별시,광진구,자양제4동,합계,18112,12882,5431,2782,3112,771,685,16,0,5,4,10,1,4,8,12829,53,5230
서울특별시,광진구,자양제4동,관내사전투표,3054,3054,1436,563,668,169,192,2,0,2,1,5,0,1,1,3040,14,0
서울특별시,광진구,자양제4동,자양제4동제1투,2384,1313,536,292,337,89,54,0,0,1,0,0,0,0,0,1309,4,1071
서울특별시,광진구,자양제4동,자양제4동제2투,2496,1733,694,388,418,125,96,3,0,0,0,1,0,0,1,1726,7,763
서울특별시,광진구,자양제4동,자양제4동제3투,2685,1770,700,383,498,90,86,2,0,0,2,1,0,0,1,1763,7,915
서울특별시,광진구,자양제4동,자양제4동제4투,2838,1843,749,423,432,115,108,6,0,1,0,3,1,1,0,1839,4,995
서울특별시,광진구,자양제4동,자양제4동제5투,2528,1657,686,394,394,99,69,0,0,1,1,0,0,2,4,1650,7,871
서울특별시,광진구,자양제4동,자양제4동제6투,2127,1512,630,339,365,84,80,3,0,0,0,0,0,0,1,1502,10,615
서울특별시,광진구,화양동,합계,17782,12845,6055,1943,2386,1143,1225,9,4,6,2,5,2,2,13,12795,50,4937
서울특별시,광진구,화양동,관내사전투표,3677,3677,1937,378,582,354,401,3,1,1,0,1,0,2,5,3665,12,0
서울특별시,광진구,화양동,화양동제1투,3448,2031,935,290,382,190,223,1,2,2,0,0,0,0,1,2026,5,1417
서울특별시,광진구,화양동,화양동제2투,2343,1597,749,271,272,162,135,1,0,1,0,0,1,0,1,1593,4,746
서울특별시,광진구,화양동,화양동제3투,2675,1807,800,311,407,124,144,2,0,1,1,3,0,0,2,1795,12,868
서울특별시,광진구,화양동,화양동제4투,2152,1383,620,224,301,115,117,0,0,1,0,0,0,0,1,1379,4,769
서울특별시,광진구,화양동,화양동제5투,2025,1391,615,261,253,123,129,0,1,0,1,0,1,0,1,1385,6,634
서울특별시,광진구,화양동,화양동제6투,1462,959,399,208,189,75,76,2,0,0,0,1,0,0,2,952,7,503
서울특별시,광진구,군자동,합계,15897,11998,5267,2308,2660,753,912,18,3,11,3,8,3,2,11,11959,39,3899
서울특별시,광진구,군자동,관내사전투표,2630,2630,1361,361,464,185,229,4,2,1,1,4,2,2,4,2620,10,0
서울특별시,광진구,군자동,군자동제1투,2749,1799,813,333,386,112,140,4,1,3,0,2,1,0,0,1795,4,950
서울특별시,광진구,군자동,군자동제2투,1779,1309,568,228,324,88,97,0,0,0,0,1,0,0,0,1306,3,470
서울특별시,광진구,군자동,군자동제3투,1999,1400,597,272,330,65,118,2,0,5,2,0,0,0,3,1394,6,599
서울특별시,광진구,군자동,군자동제4투,2309,1619,678,339,372,98,120,2,0,2,0,0,0,0,2,1613,6,690
서울특별시,광진구,군자동,군자동제5투,2081,1571,583,393,397,111,78,4,0,0,0,0,0,0,2,1568,3,510
서울특별시,광진구,군자동,군자동제6투,2350,1670,667,382,387,94,130,2,0,0,0,1,0,0,0,1663,7,680
서울특별시,광진구,잘못 투입·구분된 투표지,,0,0,0,0,0,0,0,0,0,0,0,0,0,0,0,0,0,0
서울특별시,동대문구,합계,,304972,236092,98958,51631,53359,15129,15107,360,41,150,44,160,80,84,162,235265,827,68880
서울특별시,동대문구,거소·선상투표,,399,376,117,76,135,23,13,0,1,0,0,0,1,0,0,366,10,23
서울특별시,동대문구,관외사전투표,,27360,27359,13276,3791,5501,2108,2425,39,5,15,7,26,8,6,34,27241,118,1
서울특별시,동대문구,재외투표,,2946,2186,1292,207,334,90,239,14,0,0,0,0,0,0,0,2176,10,760
서울특별시,동대문구,용신동,관내사전투표,4165,4165,1978,774,842,260,278,9,0,1,1,3,2,3,0,4151,14,0
서울특별시,동대문구,용신동,합계,25309,18014,7358,4203,4162,1095,1054,36,7,7,4,10,5,13,4,17958,56,7295
서울특별시,동대문구,용신동,용신동제1투,3418,2012,743,452,524,167,110,4,3,2,0,0,2,1,0,2008,4,1406
서울특별시,동대문구,용신동,용신동제2투,2798,2023,800,488,496,107,117,3,0,1,2,1,0,1,1,2017,6,775
서울특별시,동대문구,용신동,용신동제3투,2823,1832,682,468,503,86,78,3,2,0,0,0,0,2,2,1826,6,991
서울특별시,동대문구,용신동,용신동제4투,2213,1507,593,390,340,98,74,1,1,1,0,0,1,1,1,1501,6,706
서울특별시,동대문구,용신동,용신동제5투,2480,1610,674,334,379,103,113,3,0,0,0,0,0,1,0,1607,3,870
서울특별시,동대문구,용신동,용신동제6투,2200,1424,528,414,321,76,78,2,0,0,0,2,0,0,0,1421,3,776
서울특별시,동대문구,용신동,용신동제7투,2641,1656,623,470,346,88,105,9,0,0,1,3,0,4,0,1649,7,985
서울특별시,동대문구,용신동,용신동제8투,2571,1785,737,413,411,110,101,2,1,2,0,1,0,0,0,1778,7,786
서울특별시,동대문구,제기동,관내사전투표,3647,3647,1572,782,829,213,218,4,1,4,1,2,1,1,3,3631,16,0
서울특별시,동대문구,제기동,합계,20595,14982,5790,3743,3509,952,852,22,1,15,4,7,4,11,19,14929,53,5613
서울특별시,동대문구,제기동,제기동제1투,3326,2026,656,676,487,105,75,3,0,4,1,1,1,3,5,2017,9,1300
서울특별시,동대문구,제기동,제기동제2투,2996,2161,780,564,530,139,129,5,0,1,1,1,0,2,3,2155,6,835
서울특별시,동대문구,제기동,제기동제3투,3038,1681,613,446,401,103,102,4,0,0,0,2,1,3,2,1677,4,1357
서울특별시,동대문구,제기동,제기동제4투,2691,1796,666,490,385,124,115,0,0,2,0,1,0,1,3,1787,9,895
서울특별시,동대문구,제기동,제기동제5투,2293,1704,710,345,391,144,105,0,0,2,0,0,1,1,1,1700,4,589
서울특별시,동대문구,제기동,제기동제6투,2604,1967,793,440,486,124,108,6,0,2,1,0,0,0,2,1962,5,637
서울특별시,동대문구,전농제1동,합계,22921,16596,6707,3826,3982,1006,918,30,4,15,4,12,4,4,10,16522,74,6325
서울특별시,동대문구,전농제1동,관내사전투표,3345,3345,1488,670,729,233,199,3,0,3,1,1,0,0,1,3328,17,0
서울특별시,동대문구,전농제1동,전농제1동제1투,3289,1791,688,425,476,99,84,2,1,3,1,1,1,1,2,1784,7,1498
서울특별시,동대문구,전농제1동,전농제1동제2투,1817,1096,443,239,293,45,62,1,3,2,0,2,0,0,1,1091,5,721
서울특별시,동대문구,전농제1동,전농제1동제3투,2926,2066,764,523,502,137,117,5,0,1,1,0,0,1,2,2053,13,860
서울특별시,동대문구,전농제1동,전농제1동제4투,2261,1513,623,398,320,79,74,3,0,3,1,2,1,1,2,1507,6,748
서울특별시,동대문구,전농제1동,전농제1동제5투,2475,1599,600,418,402,80,86,5,0,2,0,1,0,1,0,1595,4,876
서울특별시,동대문구,전농제1동,전농제1동제6투,2185,1423,533,392,348,59,75,2,0,1,0,2,1,0,1,1414,9,762
서울특별시,동대문구,전농제1동,전농제1동제7투,2191,1732,730,345,431,108,103,4,0,0,0,1,0,0,1,1723,9,459
서울특별시,동대문구,전농제1동,전농제1동제8투,2432,2031,838,416,481,166,118,5,0,0,0,2,1,0,0,2027,4,401
서울특별시,동대문구,전농제2동,관내사전투표,3727,3727,1718,726,750,243,262,5,1,4,1,2,1,1,1,3715,12,0
서울특별시,동대문구,전농제2동,합계,16019,12807,5157,3033,2978,804,750,15,2,9,4,8,5,3,7,12775,32,3212
서울특별시,동대문구,전농제2동,전농제2동제1투,1998,1510,568,395,373,72,95,4,0,0,1,1,0,0,0,1509,1,488
서울특별시,동대문구,전농제2동,전농제2동제2투,2717,2163,816,546,533,148,109,1,0,1,1,1,1,0,1,2158,5,554
서울특별시,동대문구,전농제2동,전농제2동제3투,2262,1649,633,400,418,98,81,3,0,2,0,3,0,0,3,1641,8,613
서울특별시,동대문구,전농제2동,전농제2동제4투,3264,2354,848,656,551,157,131,1,0,2,1,1,0,1,1,2350,4,910
서울특별시,동대문구,전농제2동,전농제2동제5투,2051,1404,574,310,353,86,72,1,1,0,0,0,3,1,1,1402,2,647
서울특별시,동대문구,답십리제1동,합계,18732,14341,6189,2896,3346,954,864,17,3,2,1,12,3,6,8,14301,40,4391
서울특별시,동대문구,답십리제1동,관내사전투표,2703,2703,1350,460,511,182,187,2,0,0,0,3,0,1,2,2698,5,0
서울특별시,동대문구,답십리제1동,답십리제1동제1투,2451,1329,564,268,322,89,75,4,0,0,0,1,0,0,1,1324,5,1122
서울특별시,동대문구,답십리제1동,답십리제1동제2투,2927,2003,794,482,485,112,116,2,1,2,0,0,1,0,2,1997,6,924
서울특별시,동대문구,답십리제1동,답십리제1동제3투,2403,1969,810,379,513,140,120,2,0,0,0,0,1,1,0,1966,3,434
서울특별시,동대문구,답십리제1동,답십리제1동제4투,2582,2074,949,350,482,148,128,3,1,0,1,4,0,0,1,2067,7,508
서울특별시,동대문구,답십리제1동,답십리제1동제5투,1662,1155,472,267,283,61,66,0,0,0,0,2,1,0,0,1152,3,507
서울특별시,동대문구,답십리제1동,답십리제1동제6투,1738,1289,501,315,330,82,51,1,1,0,0,0,0,2,1,1284,5,449
서울특별시,동대문구,답십리제1동,답십리제1동제7투,2266,1819,749,375,420,140,121,3,0,0,0,2,0,2,1,1813,6,447
서울특별시,동대문구,답십리제2동,합계,22565,17330,7023,3999,4174,995,1002,26,1,14,3,7,5,5,15,17269,61,5235
서울특별시,동대문구,답십리제2동,관내사전투표,3128,3128,1457,622,698,167,158,3,0,4,0,0,2,0,3,3114,14,0
서울특별시,동대문구,답십리제2동,답십리제2동제1투,2596,1591,650,318,399,116,91,3,0,2,0,1,0,0,2,1582,9,1005
서울특별시,동대문구,답십리제2동,답십리제2동제2투,2535,1890,749,440,457,113,113,4,0,2,0,1,1,2,2,1884,6,645
서울특별시,동대문구,답십리제2동,답십리제2동제3투,2069,1580,574,392,379,97,122,0,0,2,2,1,1,0,0,1570,10,489
서울특별시,동대문구,답십리제2동,답십리제2동제4투,2713,2104,900,437,485,121,142,5,1,1,0,1,0,0,2,2095,9,609
서울특별시,동대문구,답십리제2동,답십리제2동제5투,2959,2277,927,533,555,134,112,4,0,2,0,0,0,3,4,2274,3,682
서울특별시,동대문구,답십리제2동,답십리제2동제6투,3184,2545,958,656,617,152,150,4,0,0,0,0,1,0,1,2539,6,639
서울특별시,동대문구,답십리제2동,답십리제2동제7투,3381,2215,808,601,584,95,114,3,0,1,1,3,0,0,1,2211,4,1166
서울특별시,동대문구,장안제1동,합계,30075,22610,9464,5211,5270,1288,1242,26,0,8,1,12,4,7,11,22544,66,7465
서울특별시,동대문구,장안제1동,관내사전투표,4758,4758,2296,906,998,254,278,5,0,3,1,4,0,3,3,4751,7,0
서울특별시,동대문구,장안제1동,장안제1동제1투,3125,1796,739,397,476,82,90,2,0,0,0,1,2,0,0,1789,7,1329
서울특별시,동대문구,장안제1동,장안제1동제2투,3405,2333,906,554,578,139,142,1,0,0,0,2,0,2,3,2327,6,1072
서울특별시,동대문구,장안제1동,장안제1동제3투,3547,2221,939,472,551,127,117,2,0,1,0,0,0,2,2,2213,8,1326
서울특별시,동대문구,장안제1동,장안제1동제4투,3550,2512,1008,611,596,128,157,3,0,0,0,0,0,0,2,2505,7,1038
서울특별시,동대문구,장안제1동,장안제1동제5투,2705,1949,783,444,474,117,116,6,0,1,0,1,2,0,1,1945,4,756
서울특별시,동대문구,장안제1동,장안제1동제6투,3174,2240,897,513,560,141,109,4,0,0,0,4,0,0,0,2228,12,934
서울특별시,동대문구,장안제1동,장안제1동제7투,2866,2351,909,666,516,143,106,3,0,2,0,0,0,0,0,2345,6,515
서울특별시,동대문구,장안제1동,장안제1동제8투,2945,2450,987,648,521,157,127,0,0,1,0,0,0,0,0,2441,9,495
서울특별시,동대문구,장안제2동,합계,24266,18671,7655,4366,4359,1124,1037,30,3,10,5,4,2,8,12,18615,56,5595
서울특별시,동대문구,장안제2동,관내사전투표,4641,4641,2064,1046,945,257,296,4,1,2,4,2,0,3,2,4626,15,0
서울특별시,동대문구,장안제2동,장안제2동제1투,1933,1143,402,321,309,60,42,3,0,1,0,0,0,0,2,1140,3,790
서울특별시,동대문구,장안제2동,장안제2동제2투,2772,1986,723,510,488,118,126,4,2,1,0,0,1,1,2,1976,10,786
서울특별시,동대문구,장안제2동,장안제2동제3투,1662,1081,393,284,256,78,67,2,0,0,0,0,0,0,0,1080,1,581
서울특별시,동대문구,장안제2동,장안제2동제4투,2166,1439,505,378,378,80,83,5,0,1,1,1,1,0,2,1435,4,727
서울특별시,동대문구,장안제2동,장안제2동제5투,3197,2260,951,512,541,125,114,4,0,1,0,1,0,2,2,2253,7,937
서울특별시,동대문구,장안제2동,장안제2동제6투,1920,1350,515,341,319,92,76,2,0,1,0,0,0,0,2,1348,2,570
서울특별시,동대문구,장안제2동,장안제2동제7투,3466,2843,1256,586,685,178,124,4,0,2,0,0,0,1,0,2836,7,623
서울특별시,동대문구,장안제2동,장안제2동제8투,2509,1928,846,388,438,136,109,2,0,1,0,0,0,1,0,1921,7,581
서울특별시,동대문구,청량리동,관내사전투표,2780,2780,1230,629,544,178,178,5,1,4,0,0,1,0,1,2771,9,0
서울특별시,동대문구,청량리동,합계,18205,13261,4692,3828,3135,786,704,29,3,12,4,9,3,2,7,13214,47,4944
서울특별시,동대문구,청량리동,청량리동제1투,2612,1353,485,363,319,91,81,3,0,0,0,0,2,0,0,1344,9,1259
서울특별시,동대문구,청량리동,청량리동제2투,2837,2216,813,608,535,126,114,5,0,4,1,5,0,0,0,2211,5,621
서울특별시,동대문구,청량리동,청량리동제3투,2081,1361,491,363,343,76,72,3,0,0,3,0,0,0,3,1354,7,720
서울특별시,동대문구,청량리동,청량리동제4투,2195,1416,442,488,339,66,64,5,0,3,0,0,0,1,1,1409,7,779
서울특별시,동대문구,청량리동,청량리동제5투,2562,1848,568,573,500,103,88,3,1,1,0,3,0,1,1,1842,6,714
서울특별시,동대문구,청량리동,청량리동제6투,3138,2287,663,804,555,146,107,5,1,0,0,1,0,0,1,2283,4,851
서울특별시,동대문구,회기동,관내사전투표,3501,3501,1833,440,503,328,362,4,0,0,1,10,4,1,2,3488,13,0
서울특별시,동대문구,회기동,합계,9546,7652,3614,1325,1360,660,628,7,0,2,2,12,6,1,5,7622,30,1894
서울특별시,동대문구,회기동,회기동제1투,2317,1484,604,308,304,145,107,0,0,1,0,1,0,0,2,1472,12,833
서울특별시,동대문구,회기동,회기동제2투,2063,1537,681,314,324,111,99,2,0,1,1,0,0,0,0,1533,4,526
서울특별시,동대문구,회기동,회기동제3투,1665,1130,496,263,229,76,60,1,0,0,0,1,2,0,1,1129,1,535
서울특별시,동대문구,휘경제1동,합계,10269,7441,2997,1753,1689,450,493,12,0,7,1,3,2,5,7,7419,22,2828
서울특별시,동대문구,휘경제1동,관내사전투표,1900,1900,859,386,383,119,140,1,0,3,1,1,0,2,2,1897,3,0
서울특별시,동대문구,휘경제1동,휘경제1동제1투,1859,1105,378,321,271,56,68,2,0,0,0,1,0,1,0,1098,7,754
서울특별시,동대문구,휘경제1동,휘경제1동제2투,2103,1283,473,342,324,53,78,1,0,2,0,1,0,2,3,1279,4,820
서울특별시,동대문구,휘경제1동,휘경제1동제3투,2348,1606,754,279,303,136,118,7,0,2,0,0,0,0,1,1600,6,742
서울특별시,동대문구,휘경제1동,휘경제1동제4투,2059,1547,533,425,408,86,89,1,0,0,0,0,2,0,1,1545,2,512
서울특별시,동대문구,휘경제2동,합계,17753,13975,5887,3040,3063,863,1006,19,7,14,0,13,6,3,9,13930,45,3778
서울특별시,동대문구,휘경제2동,관내사전투표,2166,2166,1063,397,389,131,170,3,3,4,0,0,0,0,0,2160,6,0
서울특별시,동대문구,휘경제2동,휘경제2동제1투,2136,1451,561,349,311,99,121,1,1,0,0,2,0,0,1,1446,5,685
서울특별시,동대문구,휘경제2동,휘경제2동제2투,2311,1894,812,405,454,98,114,2,1,2,0,0,0,1,1,1890,4,417
서울특별시,동대문구,휘경제2동,휘경제2동제3투,2898,2181,868,436,487,172,198,2,0,1,0,3,1,0,5,2173,8,717
서울특별시,동대문구,휘경제2동,휘경제2동제4투,3080,2253,897,519,506,139,170,3,2,0,0,3,3,1,1,2244,9,827
서울특별시,동대문구,휘경제2동,휘경제2동제5투,2828,2305,965,529,521,136,133,4,0,3,0,4,1,1,0,2297,8,523
서울특별시,동대문구,휘경제2동,휘경제2동제6투,2334,1725,721,405,395,88,100,4,0,4,0,1,1,0,1,1720,5,609
서울특별시,동대문구,이문제1동,관내사전투표,3305,3305,1568,588,612,246,268,0,0,1,0,5,3,1,1,3293,12,0
서울특별시,동대문구,이문제1동,합계,21656,15831,6470,3540,3457,1116,1099,18,2,8,3,16,16,6,7,15758,73,5825
서울특별시,동대문구,이문제1동,이문제1동제1투,2497,1354,525,349,333,64,69,2,0,0,1,2,0,1,0,1346,8,1143
서울특별시,동대문구,이문제1동,이문제1동제2투,2131,1429,564,324,384,73,67,0,1,2,0,0,2,0,2,1419,10,702
서울특별시,동대문구,이문제1동,이문제1동제3투,1845,1253,507,287,290,85,70,3,0,2,0,2,0,0,1,1247,6,592
서울특별시,동대문구,이문제1동,이문제1동제4투,2110,1323,503,338,281,76,112,0,0,0,0,0,3,1,1,1315,8,787
서울특별시,동대문구,이문제1동,이문제1동제5투,2156,1677,667,408,347,123,119,3,0,1,0,2,0,1,1,1672,5,479
서울특별시,동대문구,이문제1동,이문제1동제6투,2111,1539,630,335,310,133,110,4,0,1,1,1,4,1,0,1530,9,572
서울특별시,동대문구,이문제1동,이문제1동제7투,1970,1558,573,388,329,146,113,5,0,0,0,0,1,0,0,1555,3,412
서울특별시,동대문구,이문제1동,이문제1동제8투,1661,1148,495,217,249,83,89,1,0,1,1,3,1,0,0,1140,8,513
서울특별시,동대문구,이문제1동,이문제1동제9투,1870,1245,438,306,322,87,82,0,1,0,0,1,2,1,1,1241,4,625
서울특별시,동대문구,이문제2동,합계,16356,12659,5270,2794,2904,815,781,20,2,12,1,9,6,4,7,12625,34,3697
서울특별시,동대문구,이문제2동,관내사전투표,2667,2667,1238,537,524,182,166,6,0,4,0,2,1,0,1,2661,6,0
서울특별시,동대문구,이문제2동,이문제2동제1투,2707,1650,601,407,387,111,128,1,0,3,0,1,2,1,1,1643,7,1057
서울특별시,동대문구,이문제2동,이문제2동제2투,2569,1646,609,394,447,79,109,0,0,1,0,1,0,2,0,1642,4,923
서울특별시,동대문구,이문제2동,이문제2동제3투,2728,2060,882,430,478,134,115,6,0,0,0,5,2,0,3,2055,5,668
서울특별시,동대문구,이문제2동,이문제2동제4투,2828,2329,972,489,546,162,149,4,0,2,1,0,0,0,0,2325,4,499
서울특별시,동대문구,이문제2동,이문제2동제5투,2857,2307,968,537,522,147,114,3,2,2,0,0,1,1,2,2299,8,550
서울특별시,동대문구,잘못 투입·구분된 투표지,,0,1,0,0,1,0,0,0,0,0,0,0,0,0,0,1,0,-1
서울특별시,중랑구,합계,,351986,265706,111450,56545,62778,15996,16817,373,34,155,74,152,65,90,215,264744,962,86280
서울특별시,중랑구,거소·선상투표,,630,598,212,111,192,30,24,3,2,1,0,0,1,1,1,578,20,32
서울특별시,중랑구,관외사전투표,,28364,28358,13462,4327,6099,1955,2207,27,5,24,14,17,8,8,40,28193,165,6
서울특별시,중랑구,재외투표,,2371,1813,1173,146,235,57,189,4,0,0,0,1,0,1,1,1807,6,558
서울특별시,중랑구,면목본동,관내사전투표,5342,5342,2459,956,1194,313,361,11,0,7,0,3,1,5,6,5316,26,0
서울특별시,중랑구,면목본동,합계,29571,20758,8575,4352,5124,1204,1331,29,2,12,6,12,6,11,16,20680,78,8813
서울특별시,중랑구,면목본동,면목본동제1투,4193,2418,888,595,604,149,169,2,0,1,2,0,1,1,1,2413,5,1775
서울특별시,중랑구,면목본동,면목본동제2투,3230,2121,822,494,572,109,114,2,0,0,0,1,0,1,2,2117,4,1109
서울특별시,중랑구,면목본동,면목본동제3투,3513,2315,914,508,610,124,136,0,1,1,3,3,2,1,1,2304,11,1198
서울특별시,중랑구,면목본동,면목본동제4투,3362,2186,897,450,545,135,142,3,0,1,0,1,2,1,1,2178,8,1176
서울특별시,중랑구,면목본동,면목본동제5투,3256,2130,827,530,507,122,130,1,0,0,0,0,0,1,1,2119,11,1126
서울특별시,중랑구,면목본동,면목본동제6투,3525,2168,900,410,561,125,156,2,0,1,1,3,0,0,4,2163,5,1357
서울특별시,중랑구,면목본동,면목본동제7투,3150,2078,868,409,531,127,123,8,1,1,0,1,0,1,0,2070,8,1072
서울특별시,중랑구,면목제2동,관내사전투표,2921,2921,1370,545,659,141,187,3,0,1,1,1,0,0,2,2910,11,0
서울특별시,중랑구,면목제2동,합계,20766,14488,5924,3168,3587,784,914,19,0,12,9,5,4,2,9,14437,51,6278
서울특별시,중랑구,면목제2동,면목제2동제1투,4043,2424,976,535,617,130,140,7,0,5,2,1,0,0,2,2415,9,1619
서울특별시,중랑구,면목제2동,면목제2동제2투,3211,2280,873,545,576,130,141,2,0,2,1,1,1,1,0,2273,7,931
서울특별시,중랑구,면목제2동,면목제2동제3투,3895,2607,1017,589,668,149,167,1,0,2,2,0,2,0,3,2600,7,1288
서울특별시,중랑구,면목제2동,면목제2동제4투,3349,2098,818,464,543,111,146,5,0,2,0,2,1,1,0,2093,5,1251
서울특별시,중랑구,면목제2동,면목제2동제5투,3347,2158,870,490,524,123,133,1,0,0,3,0,0,0,2,2146,12,1189
서울특별시,중랑구,면목제3·8동,합계,21515,15077,6113,3461,3648,834,879,25,3,18,2,15,3,12,20,15033,44,6438
서울특별시,중랑구,면목제3·8동,관내사전투표,3133,3133,1410,664,661,174,193,6,2,5,0,1,1,2,3,3122,11,0
서울특별시,중랑구,면목제3·8동,면목제3·8동제1투,3065,1733,643,469,424,84,104,0,0,1,1,1,1,1,1,1730,3,1332
서울특별시,중랑구,면목제3·8동,면목제3·8동제2투,2500,1672,674,362,428,91,101,3,1,1,0,0,0,0,6,1667,5,828
서울특별시,중랑구,면목제3·8동,면목제3·8동제3투,2518,1581,660,326,382,92,100,3,0,2,1,4,0,3,4,1577,4,937
서울특별시,중랑구,면목제3·8동,면목제3·8동제4투,2534,1658,692,371,398,98,81,4,0,0,0,4,0,2,2,1652,6,876
서울특별시,중랑구,면목제3·8동,면목제3·8동제5투,2810,2025,804,474,502,123,112,1,0,1,0,3,0,2,1,2023,2,785
서울특별시,중랑구,면목제3·8동,면목제3·8동제6투,2372,1462,526,368,369,88,99,2,0,3,0,1,0,1,1,1458,4,910
서울특별시,중랑구,면목제3·8동,면목제3·8동제7투,2583,1813,704,427,484,84,89,6,0,5,0,1,1,1,2,1804,9,770
서울특별시,중랑구,면목제4동,관내사전투표,2941,2941,1349,542,658,165,201,8,0,2,3,2,0,0,1,2931,10,0
서울특별시,중랑구,면목제4동,합계,16902,12334,5120,2718,2995,689,713,21,1,4,6,9,0,2,9,12287,47,4568
서울특별시,중랑구,면목제4동,면목제4동제1투,2499,1635,632,400,407,95,93,1,0,0,1,2,0,0,1,1632,3,864
서울특별시,중랑구,면목제4동,면목제4동제2투,3136,2179,913,493,528,117,110,0,0,1,2,0,0,2,1,2167,12,957
서울특별시,중랑구,면목제4동,면목제4동제3투,2770,1982,832,431,468,111,122,2,0,0,0,3,0,0,2,1971,11,788
서울특별시,중랑구,면목제4동,면목제4동제4투,2851,1752,732,373,422,104,106,7,1,1,0,1,0,0,3,1750,2,1099
서울특별시,중랑구,면목제4동,면목제4동제5투,2705,1845,662,479,512,97,81,3,0,0,0,1,0,0,1,1836,9,860
서울특별시,중랑구,면목제5동,합계,8565,6004,2570,1125,1553,305,399,5,1,3,0,3,2,1,7,5974,30,2561
서울특별시,중랑구,면목제5동,관내사전투표,1719,1719,825,291,389,77,119,0,0,2,0,1,2,0,1,1707,12,0
서울특별시,중랑구,면목제5동,면목제5동제1투,3468,2147,874,413,591,113,140,4,1,1,0,0,0,1,2,2140,7,1321
서울특별시,중랑구,면목제5동,면목제5동제2투,3378,2138,871,421,573,115,140,1,0,0,0,2,0,0,4,2127,11,1240
서울특별시,중랑구,면목제7동,합계,18125,13127,5329,3070,3089,738,789,27,1,8,6,12,2,3,9,13083,44,4998
서울특별시,중랑구,면목제7동,관내사전투표,3770,3770,1694,830,791,193,234,5,0,6,3,1,1,1,1,3760,10,0
서울특별시,중랑구,면목제7동,면목제7동제1투,2844,1677,676,379,413,79,119,3,1,0,0,1,0,0,1,1672,5,1167
서울특별시,중랑구,면목제7동,면목제7동제2투,3311,2151,836,514,516,125,132,4,0,1,1,6,0,1,5,2141,10,1160
서울특별시,중랑구,면목제7동,면목제7동제3투,2910,1857,740,430,453,120,94,7,0,1,1,2,1,0,2,1851,6,1053
서울특별시,중랑구,면목제7동,면목제7동제4투,2967,2108,803,541,506,132,111,2,0,0,1,2,0,1,0,2099,9,859
서울특별시,중랑구,면목제7동,면목제7동제5투,2323,1564,580,376,410,89,99,6,0,0,0,0,0,0,0,1560,4,759
서울특별시,중랑구,상봉제1동,합계,18595,14231,5944,2985,3312,921,925,32,2,13,3,13,3,4,21,14178,53,4364
서울특별시,중랑구,상봉제1동,관내사전투표,2879,2879,1360,514,579,189,208,7,0,1,2,5,0,0,5,2870,9,0
서울특별시,중랑구,상봉제1동,상봉제1동제1투,3580,2185,849,508,512,138,156,3,0,2,0,1,0,1,4,2174,11,1395
서울특별시,중랑구,상봉제1동,상봉제1동제2투,3775,3031,1273,580,716,218,213,6,1,5,0,2,0,0,5,3019,12,744
서울특별시,중랑구,상봉제1동,상봉제1동제3투,3224,2397,1008,505,576,151,139,3,1,1,0,4,0,0,1,2389,8,827
서울특별시,중랑구,상봉제1동,상봉제1동제4투,3649,2587,1066,562,624,153,149,8,0,4,1,1,3,3,3,2577,10,1062
서울특별시,중랑구,상봉제1동,상봉제1동제5투,1488,1152,388,316,305,72,60,5,0,0,0,0,0,0,3,1149,3,336
서울특별시,중랑구,상봉제2동,합계,15166,10714,4478,2341,2490,645,683,14,1,4,1,8,3,2,2,10672,42,4452
서울특별시,중랑구,상봉제2동,관내사전투표,2581,2581,1239,463,545,146,169,3,1,1,0,4,0,0,0,2571,10,0
서울특별시,중랑구,상봉제2동,상봉제2동제1투,3437,2075,866,464,459,139,129,3,0,1,1,3,0,2,1,2068,7,1362
서울특별시,중랑구,상봉제2동,상봉제2동제2투,3506,2408,874,619,642,142,118,3,0,1,0,0,0,0,0,2399,9,1098
서울특별시,중랑구,상봉제2동,상봉제2동제3투,2960,1876,768,439,420,112,125,2,0,1,0,0,1,0,1,1869,7,1084
서울특별시,중랑구,상봉제2동,상봉제2동제4투,2682,1774,731,356,424,106,142,3,0,0,0,1,2,0,0,1765,9,908
서울특별시,중랑구,중화제1동,합계,16289,12240,5137,2509,2983,727,802,13,1,3,1,9,4,7,8,12204,36,4049
서울특별시,중랑구,중화제1동,관내사전투표,2775,2775,1325,496,585,149,202,3,0,1,0,1,2,1,3,2768,7,0
서울특별시,중랑구,중화제1동,중화제1동제1투,3725,2377,917,560,581,146,162,0,0,1,0,0,1,2,0,2370,7,1348
서울특별시,중랑구,중화제1동,중화제1동제2투,3197,2127,849,408,593,123,137,1,0,0,0,4,0,3,2,2120,7,1070
서울특별시,중랑구,중화제1동,중화제1동제3투,3590,2487,991,551,628,135,157,7,1,1,1,3,1,1,1,2478,9,1103
서울특별시,중랑구,중화제1동,중화제1동제4투,3002,2474,1055,494,596,174,144,2,0,0,0,1,0,0,2,2468,6,528
서울특별시,중랑구,중화제2동,합계,22762,15225,5978,3462,3895,863,904,28,5,8,5,4,4,4,10,15170,55,7537
서울특별시,중랑구,중화제2동,관내사전투표,2912,2912,1327,526,671,173,195,7,1,1,0,0,1,0,0,2902,10,0
서울특별시,중랑구,중화제2동,중화제2동제1투,2364,1257,460,290,351,64,81,3,0,0,0,0,0,1,1,1251,6,1107
서울특별시,중랑구,중화제2동,중화제2동제2투,2108,1374,530,341,348,73,75,1,0,2,0,0,0,0,1,1371,3,734
서울특별시,중랑구,중화제2동,중화제2동제3투,2785,1713,626,433,447,99,93,2,0,0,0,0,1,2,2,1705,8,1072
서울특별시,중랑구,중화제2동,중화제2동제4투,3792,2504,1004,567,602,150,156,8,2,2,1,3,1,0,1,2497,7,1288
서울특별시,중랑구,중화제2동,중화제2동제5투,3061,1921,723,456,496,117,115,1,1,0,2,0,1,0,1,1913,8,1140
서울특별시,중랑구,중화제2동,중화제2동제6투,2725,1734,650,397,490,82,101,4,0,0,1,1,0,0,1,1727,7,991
서울특별시,중랑구,중화제2동,중화제2동제7투,3015,1810,658,452,490,105,88,2,1,3,1,0,0,1,3,1804,6,1205
서울특별시,중랑구,묵제1동,합계,25544,19872,8361,4267,4593,1305,1195,20,2,12,1,8,6,9,19,19798,74,5672
서울특별시,중랑구,묵제1동,관내사전투표,4556,4556,2215,931,869,258,259,6,0,0,0,2,1,0,5,4546,10,0
서울특별시,중랑구,묵제1동,묵제1동제1투,2503,1864,742,385,476,145,93,3,2,0,0,1,2,3,0,1852,12,639
서울특별시,중랑구,묵제1동,묵제1동제2투,1906,1339,495,299,368,93,73,0,0,1,0,1,1,2,3,1336,3,567
서울특별시,중랑구,묵제1동,묵제1동제3투,2769,2300,826,620,518,195,127,1,0,0,0,1,0,0,1,2289,11,469
서울특별시,중랑구,묵제1동,묵제1동제4투,3684,2851,1257,509,667,200,201,2,0,2,0,2,0,1,2,2843,8,833
서울특별시,중랑구,묵제1동,묵제1동제5투,4026,2833,1156,628,685,148,191,2,0,5,0,0,0,2,1,2818,15,1193
서울특별시,중랑구,묵제1동,묵제1동제6투,3196,2337,880,533,610,167,131,2,0,3,1,0,0,0,2,2329,8,859
서울특별시,중랑구,묵제1동,묵제1동제7투,2904,1792,790,362,400,99,120,4,0,1,0,1,2,1,5,1785,7,1112
서울특별시,중랑구,묵제2동,합계,15824,11725,4857,2544,2867,634,746,22,1,4,3,3,1,4,2,11688,37,4099
서울특별시,중랑구,묵제2동,관내사전투표,3421,3421,1528,695,780,174,219,1,1,2,1,1,0,1,1,3404,17,0
서울특별시,중랑구,묵제2동,묵제2동제1투,3346,2238,927,502,569,120,111,0,0,1,1,1,0,2,0,2234,4,1108
서울특별시,중랑구,묵제2동,묵제2동제2투,2894,1871,776,365,438,124,153,8,0,0,0,0,0,0,0,1864,7,1023
서울특별시,중랑구,묵제2동,묵제2동제3투,3018,2086,806,480,547,109,134,4,0,1,0,1,0,0,1,2083,3,932
서울특별시,중랑구,묵제2동,묵제2동제4투,3145,2109,820,502,533,107,129,9,0,0,1,0,1,1,0,2103,6,1036
서울특별시,중랑구,망우본동,합계,26338,18851,7173,5094,4316,1070,1071,27,2,7,7,8,5,2,16,18798,53,7487
서울특별시,중랑구,망우본동,관내사전투표,4495,4495,1971,1096,898,239,262,4,0,2,2,3,2,0,3,4482,13,0
서울특별시,중랑구,망우본동,망우본동제1투,3344,1887,655,559,456,100,104,3,1,1,0,1,1,0,2,1883,4,1457
서울특별시,중랑구,망우본동,망우본동제2투,3176,2180,795,572,552,128,122,1,0,1,0,0,0,0,3,2174,6,996
서울특별시,중랑구,망우본동,망우본동제3투,2630,1874,665,530,429,132,109,3,0,0,1,0,0,1,0,1870,4,756
서울특별시,중랑구,망우본동,망우본동제4투,2479,1704,559,541,412,94,89,2,0,1,0,0,1,0,1,1700,4,775
서울특별시,중랑구,망우본동,망우본동제5투,2717,1752,646,491,410,94,93,3,0,0,1,0,1,1,3,1743,9,965
서울특별시,중랑구,망우본동,망우본동제6투,3825,2463,907,706,566,138,127,7,0,1,0,4,0,0,1,2457,6,1362
서울특별시,중랑구,망우본동,망우본동제7투,3672,2496,975,599,593,145,165,4,1,1,3,0,0,0,3,2489,7,1176
서울특별시,중랑구,망우제3동,합계,15247,10650,4194,2472,2625,580,699,15,0,10,0,10,4,4,9,10622,28,4597
서울특별시,중랑구,망우제3동,관내사전투표,2891,2891,1299,572,664,149,189,2,0,3,0,1,1,2,3,2885,6,0
서울특별시,중랑구,망우제3동,망우제3동제1투,2824,1713,648,430,409,94,121,4,0,0,0,1,1,1,1,1710,3,1111
서울특별시,중랑구,망우제3동,망우제3동제2투,3188,1995,719,485,516,136,124,1,0,1,0,5,1,0,1,1989,6,1193
서울특별시,중랑구,망우제3동,망우제3동제3투,3403,2178,819,508,554,117,158,6,0,5,0,2,0,1,1,2171,7,1225
서울특별시,중랑구,망우제3동,망우제3동제4투,2941,1873,709,477,482,84,107,2,0,1,0,1,1,0,3,1867,6,1068
서울특별시,중랑구,신내제1동,합계,28791,22536,9301,4958,5402,1481,1274,22,5,7,4,9,7,6,7,22483,53,6255
서울특별시,중랑구,신내제1동,관내사전투표,3382,3382,1556,681,728,219,187,0,1,0,0,2,0,0,0,3374,8,0
서울특별시,중랑구,신내제1동,신내제1동제1투,3053,2127,777,540,527,126,144,1,1,0,1,0,1,0,2,2120,7,926
서울특별시,중랑구,신내제1동,신내제1동제2투,2374,1916,767,446,450,132,109,4,0,1,0,1,1,2,0,1913,3,458
서울특별시,중랑구,신내제1동,신내제1동제3투,2589,1959,781,420,526,112,114,0,0,1,1,0,1,0,0,1956,3,630
서울특별시,중랑구,신내제1동,신내제1동제4투,3581,2682,1167,564,616,166,156,3,0,1,0,2,0,0,2,2677,5,899
서울특별시,중랑구,신내제1동,신내제1동제5투,2876,2231,915,523,538,132,110,1,2,2,0,0,1,1,2,2227,4,645
서울특별시,중랑구,신내제1동,신내제1동제6투,2149,1382,474,391,332,104,68,0,1,1,0,1,1,1,0,1374,8,767
서울특별시,중랑구,신내제1동,신내제1동제7투,2640,2061,742,508,528,167,103,6,0,1,1,0,1,0,0,2057,4,579
서울특별시,중랑구,신내제1동,신내제1동제8투,3569,2751,1224,529,649,176,158,2,0,0,1,2,1,0,1,2743,8,818
서울특별시,중랑구,신내제1동,신내제1동제9투,2578,2045,898,356,508,147,125,5,0,0,0,1,0,2,0,2042,3,533
서울특별시,중랑구,신내제2동,합계,20621,17104,7549,3435,3773,1174,1073,20,0,5,6,6,2,7,9,17059,45,3517
서울특별시,중랑구,신내제2동,관내사전투표,5713,5713,2767,900,1173,442,403,9,0,0,3,1,1,1,2,5702,11,0
서울특별시,중랑구,신내제2동,신내제2동제1투,2650,1968,806,443,455,125,129,0,0,1,0,1,0,1,1,1962,6,682
서울특별시,중랑구,신내제2동,신내제2동제2투,2912,2357,1119,423,492,157,159,2,0,1,0,0,0,0,0,2353,4,555
서울특별시,중랑구,신내제2동,신내제2동제3투,3322,2655,1098,622,534,211,175,5,0,1,0,2,0,1,0,2649,6,667
서울특별시,중랑구,신내제2동,신내제2동제4투,3082,2298,933,536,580,124,109,2,0,0,2,1,1,1,2,2291,7,784
서울특별시,중랑구,신내제2동,신내제2동제5투,2942,2113,826,511,539,115,98,2,0,2,1,1,0,3,4,2102,11,829
서울특별시,중랑구,잘못 투입·구분된 투표지,,0,1,0,0,0,0,0,0,0,0,0,0,0,0,0,0,1,-1
서울특별시,성북구,합계,,378024,295866,129263,57584,66518,19830,20519,407,34,190,55,172,65,107,178,294922,944,82158
서울특별시,성북구,거소·선상투표,,494,463,169,71,154,26,23,3,1,1,1,1,0,0,2,452,11,31
서울특별시,성북구,관외사전투표,,34776,34766,16872,4789,6966,2702,3139,50,5,24,8,27,8,5,30,34625,141,10
서울특별시,성북구,재외투표,,4235,3256,1914,254,517,122,419,16,0,1,0,1,1,1,0,3246,10,979
서울특별시,성북구,성북동,합계,13649,10320,4425,2279,2010,698,844,14,0,7,4,8,2,2,4,10297,23,3329
서울특별시,성북구,성북동,관내사전투표,3180,3180,1558,548,541,220,299,2,0,1,1,2,0,1,3,3176,4,0
서울특별시,성북구,성북동,성북동제1투,2758,2008,826,408,429,144,193,0,0,0,1,1,0,0,0,2002,6,750
서울특별시,성북구,성북동,성북동제2투,3006,1805,743,502,328,89,129,4,0,5,1,2,0,0,0,1803,2,1201
서울특별시,성북구,성북동,성북동제3투,2230,1544,496,498,354,95,90,5,0,1,0,1,0,0,0,1540,4,686
서울특별시,성북구,성북동,성북동제4투,2475,1783,802,323,358,150,133,3,0,0,1,2,2,1,1,1776,7,692
서울특별시,성북구,삼선동,합계,22486,17327,7800,3084,3829,1159,1349,20,2,10,5,7,1,11,10,17287,40,5159
서울특별시,성북구,삼선동,관내사전투표,5876,5876,2946,780,1197,421,501,7,0,1,2,3,0,2,4,5864,12,0
서울특별시,성북구,삼선동,삼선동제1투,3754,2385,945,545,529,163,182,5,0,2,1,1,1,2,1,2377,8,1369
서울특별시,성북구,삼선동,삼선동제2투,2662,1855,803,403,396,109,130,4,1,1,0,0,0,1,0,1848,7,807
서울특별시,성북구,삼선동,삼선동제3투,2970,2321,1024,392,577,170,146,1,1,1,0,1,0,2,1,2316,5,649
서울특별시,성북구,삼선동,삼선동제4투,4095,2888,1204,585,681,174,230,1,0,1,2,2,0,3,2,2885,3,1207
서울특별시,성북구,삼선동,삼선동제5투,3129,2002,878,379,449,122,160,2,0,4,0,0,0,1,2,1997,5,1127
서울특별시,성북구,동선동,합계,12614,9699,4436,1718,1857,770,853,8,1,4,1,5,0,5,9,9667,32,2915
서울특별시,성북구,동선동,관내사전투표,2687,2687,1341,398,445,214,273,1,0,0,1,3,0,1,1,2678,9,0
서울특별시,성북구,동선동,동선동제1투,2153,1355,572,274,280,95,121,1,0,0,0,0,0,1,4,1348,7,798
서울특별시,성북구,동선동,동선동제2투,2553,1825,853,302,331,150,179,3,0,0,0,2,0,0,1,1821,4,728
서울특별시,성북구,동선동,동선동제3투,2337,1716,712,373,378,124,113,2,0,2,0,0,0,1,2,1707,9,621
서울특별시,성북구,동선동,동선동제4투,2884,2116,958,371,423,187,167,1,1,2,0,0,0,2,1,2113,3,768
서울특별시,성북구,돈암제1동,관내사전투표,2281,2281,1077,400,498,146,148,1,0,2,0,2,0,1,0,2275,6,0
서울특별시,성북구,돈암제1동,합계,12822,10255,4276,2134,2408,698,664,11,2,4,3,12,2,6,2,10222,33,2567
서울특별시,성북구,돈암제1동,돈암제1동제1투,2391,1742,738,350,412,106,117,4,2,0,0,5,1,1,0,1736,6,649
서울특별시,성북구,돈암제1동,돈암제1동제2투,2500,1857,646,464,510,110,114,2,0,2,1,1,0,1,0,1851,6,643
서울특별시,성북구,돈암제1동,돈암제1동제3투,3316,2692,1105,576,609,210,177,2,0,0,1,2,1,1,0,2684,8,624
서울특별시,성북구,돈암제1동,돈암제1동제4투,2334,1683,710,344,379,126,108,2,0,0,1,2,0,2,2,1676,7,651
서울특별시,성북구,돈암제2동,합계,16854,13703,5882,2831,2942,1059,914,13,1,8,3,4,1,3,3,13664,39,3151
서울특별시,성북구,돈암제2동,관내사전투표,3044,3044,1477,534,572,222,221,0,1,2,1,1,0,2,2,3035,9,0
서울특별시,성북구,돈암제2동,돈암제2동제1투,3274,2451,1004,506,599,168,161,3,0,1,1,0,0,0,0,2443,8,823
서울특별시,성북구,돈암제2동,돈암제2동제2투,2504,1955,792,420,424,168,140,3,0,0,1,0,1,1,0,1950,5,549
서울특별시,성북구,돈암제2동,돈암제2동제3투,2673,2166,1081,320,446,150,161,3,0,0,0,2,0,0,0,2163,3,507
서울특별시,성북구,돈암제2동,돈암제2동제4투,2871,2276,840,621,470,194,136,3,0,2,0,0,0,0,1,2267,9,595
서울특별시,성북구,돈암제2동,돈암제2동제5투,2488,1811,688,430,431,157,95,1,0,3,0,1,0,0,0,1806,5,677
서울특별시,성북구,안암동,합계,12599,9585,4121,1703,2029,827,822,21,1,1,2,6,3,3,6,9545,40,3014
서울특별시,성북구,안암동,관내사전투표,3020,3020,1467,429,544,255,306,2,0,0,0,3,0,0,2,3008,12,0
서울특별시,성북구,안암동,안암동제1투,2269,1367,540,301,332,92,91,1,0,1,0,1,1,1,1,1362,5,902
서울특별시,성북구,안암동,안암동제2투,1970,1412,535,245,315,171,135,2,0,0,0,0,0,1,0,1404,8,558
서울특별시,성북구,안암동,안암동제3투,3016,2129,925,366,466,181,168,6,0,0,2,2,1,1,0,2118,11,887
서울특별시,성북구,안암동,안암동제4투,2324,1657,654,362,372,128,122,10,1,0,0,0,1,0,3,1653,4,667
서울특별시,성북구,보문동,합계,12421,9110,4035,1723,2089,596,605,12,2,4,0,2,1,1,6,9076,34,3311
서울특별시,성북구,보문동,관내사전투표,2095,2095,1052,336,425,127,144,0,1,0,0,0,0,1,1,2087,8,0
서울특별시,성북구,보문동,보문동제1투,3792,2337,970,495,585,129,136,6,1,1,0,1,1,0,4,2329,8,1455
서울특별시,성북구,보문동,보문동제2투,3118,2204,947,457,459,153,173,3,0,0,0,1,0,0,0,2193,11,914
서울특별시,성북구,보문동,보문동제3투,3416,2474,1066,435,620,187,152,3,0,3,0,0,0,0,1,2467,7,942
서울특별시,성북구,정릉제1동,합계,13683,10828,4700,2224,2432,729,676,10,1,8,2,3,0,5,6,10796,32,2855
서울특별시,성북구,정릉제1동,관내사전투표,2780,2780,1358,522,550,167,173,1,0,1,0,1,0,0,0,2773,7,0
서울특별시,성북구,정릉제1동,정릉제1동제1투,2998,2161,918,434,501,159,136,0,0,2,0,0,0,1,3,2154,7,837
서울특별시,성북구,정릉제1동,정릉제1동제2투,3117,2171,871,499,516,137,131,7,1,1,2,0,0,2,1,2168,3,946
서울특별시,성북구,정릉제1동,정릉제1동제3투,2165,1628,642,364,386,116,110,1,0,2,0,0,0,1,1,1623,5,537
서울특별시,성북구,정릉제1동,정릉제1동제4투,2623,2088,911,405,479,150,126,1,0,2,0,2,0,1,1,2078,10,535
서울특별시,성북구,정릉제2동,합계,17972,13585,5609,2977,3166,875,861,19,1,7,5,6,4,11,9,13550,35,4387
서울특별시,성북구,정릉제2동,관내사전투표,4109,4109,1771,887,882,260,278,5,0,2,0,2,4,3,3,4097,12,0
서울특별시,성북구,정릉제2동,정릉제2동제1투,3499,2617,1068,539,658,171,162,2,0,0,1,2,0,6,2,2611,6,882
서울특별시,성북구,정릉제2동,정릉제2동제2투,3532,2344,929,554,537,147,154,5,1,2,2,2,0,2,1,2336,8,1188
서울특별시,성북구,정릉제2동,정릉제2동제3투,3459,2220,904,478,550,148,130,3,0,1,0,0,0,0,2,2216,4,1239
서울특별시,성북구,정릉제2동,정릉제2동제4투,3373,2295,937,519,539,149,137,4,0,2,2,0,0,0,1,2290,5,1078
서울특별시,성북구,정릉제3동,관내사전투표,2320,2320,985,467,483,179,189,1,0,0,0,5,0,2,1,2312,8,0
서울특별시,성북구,정릉제3동,합계,11926,8514,3314,1981,1998,560,589,11,1,4,2,9,0,5,3,8477,37,3412
서울특별시,성북구,정릉제3동,정릉제3동제1투,2717,1694,633,375,385,128,158,3,0,1,0,1,0,2,0,1686,8,1023
서울특별시,성북구,정릉제3동,정릉제3동제2투,1392,852,291,281,206,32,29,2,0,0,0,0,0,0,2,843,9,540
서울특별시,성북구,정릉제3동,정릉제3동제3투,3338,2200,862,477,583,131,131,3,1,2,1,1,0,1,0,2193,7,1138
서울특별시,성북구,정릉제3동,정릉제3동제4투,2159,1448,543,381,341,90,82,2,0,1,1,2,0,0,0,1443,5,711
서울특별시,성북구,정릉제4동,합계,20306,15443,6645,3168,3570,994,958,23,2,11,1,13,3,4,12,15404,39,4863
서울특별시,성북구,정릉제4동,관내사전투표,4266,4266,2044,798,881,241,267,9,1,2,0,7,1,0,6,4257,9,0
서울특별시,성북구,정릉제4동,정릉제4동제1투,2829,2030,838,452,439,152,132,3,1,2,1,1,0,0,4,2025,5,799
서울특별시,성북구,정릉제4동,정릉제4동제2투,3829,2463,993,542,587,149,170,3,0,3,0,3,2,1,0,2453,10,1366
서울특별시,성북구,정릉제4동,정릉제4동제3투,3268,2094,874,404,514,165,126,6,0,1,0,0,0,0,0,2090,4,1174
서울특별시,성북구,정릉제4동,정릉제4동제4투,2185,1509,567,369,381,103,81,0,0,1,0,0,0,2,1,1505,4,676
서울특별시,성북구,정릉제4동,정릉제4동제5투,3929,3081,1329,603,768,184,182,2,0,2,0,2,0,1,1,3074,7,848
서울특별시,성북구,길음제1동,합계,25371,20949,9860,3474,4653,1567,1276,31,0,7,0,8,7,8,10,20901,48,4422
서울특별시,성북구,길음제1동,관내사전투표,4998,4998,2663,688,969,311,344,8,0,3,0,1,1,1,1,4990,8,0
서울특별시,성북구,길음제1동,길음제1동제1투,2960,2439,1125,414,542,196,150,2,0,0,0,1,2,0,2,2434,5,521
서울특별시,성북구,길음제1동,길음제1동제2투,3345,2659,1284,462,566,193,136,8,0,0,0,2,1,1,0,2653,6,686
서울특별시,성북구,길음제1동,길음제1동제3투,3531,2424,1129,394,574,190,125,0,0,0,0,2,3,0,1,2418,6,1107
서울특별시,성북구,길음제1동,길음제1동제4투,3355,2502,1003,544,608,180,149,2,0,2,0,1,0,3,3,2495,7,853
서울특별시,성북구,길음제1동,길음제1동제5투,2890,2386,1081,394,551,194,157,2,0,0,0,1,0,1,0,2381,5,504
서울특별시,성북구,길음제1동,길음제1동제6투,2035,1711,753,260,418,147,122,4,0,2,0,0,0,0,1,1707,4,324
서울특별시,성북구,길음제1동,길음제1동제7투,2257,1830,822,318,425,156,93,5,0,0,0,0,0,2,2,1823,7,427
서울특별시,성북구,길음제2동,합계,9278,6657,2744,1417,1647,405,388,13,1,10,4,5,1,3,3,6641,16,2621
서울특별시,성북구,길음제2동,관내사전투표,1384,1384,597,280,324,75,100,2,1,0,1,0,0,0,0,1380,4,0
서울특별시,성북구,길음제2동,길음제2동제1투,1406,629,236,178,152,27,29,0,0,2,0,1,0,0,0,625,4,777
서울특별시,성북구,길음제2동,길음제2동제2투,3006,1971,804,425,503,132,95,2,0,2,1,1,1,1,2,1969,2,1035
서울특별시,성북구,길음제2동,길음제2동제3투,3482,2673,1107,534,668,171,164,9,0,6,2,3,0,2,1,2667,6,809
서울특별시,성북구,종암동,합계,30880,24034,10462,4760,5478,1601,1575,32,2,11,6,10,5,10,17,23969,65,6846
서울특별시,성북구,종암동,관내사전투표,5761,5761,2865,900,1166,354,432,11,0,3,3,2,0,2,3,5741,20,0
서울특별시,성북구,종암동,종암동제1투,3377,2623,1165,485,597,183,170,6,0,0,0,1,0,5,1,2613,10,754
서울특별시,성북구,종암동,종암동제2투,3411,2548,1055,543,608,185,148,3,0,0,0,0,0,0,1,2543,5,863
서울특별시,성북구,종암동,종암동제3투,3262,2466,990,575,614,145,129,0,1,0,1,1,2,2,2,2462,4,796
서울특별시,성북구,종암동,종암동제4투,3224,2413,948,559,523,196,176,2,0,0,1,0,1,0,1,2407,6,811
서울특별시,성북구,종암동,종암동제5투,2661,1463,555,364,355,86,94,0,0,2,1,1,2,0,0,1460,3,1198
서울특별시,성북구,종암동,종암동제6투,3254,2619,1116,525,627,186,147,5,0,4,0,1,0,0,4,2615,4,635
서울특별시,성북구,종암동,종암동제7투,3245,2103,869,435,506,129,148,1,1,1,0,2,0,0,3,2095,8,1142
서울특별시,성북구,종암동,종암동제8투,2685,2038,899,374,482,137,131,4,0,1,0,2,0,1,2,2033,5,647
서울특별시,성북구,월곡제1동,합계,20965,16226,7373,2881,3917,992,946,19,2,15,2,15,5,5,9,16181,45,4739
서울특별시,성북구,월곡제1동,관내사전투표,3662,3662,1862,512,789,227,247,7,1,2,0,4,0,2,1,3654,8,0
서울특별시,성북구,월곡제1동,월곡제1동제1투,3135,2098,952,330,522,155,130,1,0,0,0,2,0,0,2,2094,4,1037
서울특별시,성북구,월곡제1동,월곡제1동제2투,2421,1551,627,321,446,63,78,3,1,2,1,0,2,2,0,1546,5,870
서울특별시,성북구,월곡제1동,월곡제1동제3투,2829,1959,800,421,508,106,108,0,0,6,0,3,1,0,3,1956,3,870
서울특별시,성북구,월곡제1동,월곡제1동제4투,2582,2025,838,442,493,122,114,1,0,3,0,2,1,1,1,2018,7,557
서울특별시,성북구,월곡제1동,월곡제1동제5투,2940,2226,971,428,537,148,121,4,0,1,1,2,1,0,1,2215,11,714
서울특별시,성북구,월곡제1동,월곡제1동제6투,3396,2705,1323,427,622,171,148,3,0,1,0,2,0,0,1,2698,7,691
서울특별시,성북구,월곡제2동,합계,15969,12240,5221,2575,2725,814,825,21,0,6,1,8,4,0,4,12204,36,3729
서울특별시,성북구,월곡제2동,관내사전투표,2921,2921,1404,510,588,174,229,6,0,0,0,1,1,0,1,2914,7,0
서울특별시,성북구,월곡제2동,월곡제2동제1투,3324,2128,875,483,492,132,131,2,0,4,0,0,2,0,3,2124,4,1196
서울특별시,성북구,월곡제2동,월곡제2동제2투,3032,2265,909,510,528,164,146,2,0,1,0,1,0,0,0,2261,4,767
서울특별시,성북구,월곡제2동,월곡제2동제3투,3162,2216,928,462,510,135,158,4,0,1,1,6,1,0,0,2206,10,946
서울특별시,성북구,월곡제2동,월곡제2동제4투,3530,2710,1105,610,607,209,161,7,0,0,0,0,0,0,0,2699,11,820
서울특별시,성북구,장위제1동,합계,16908,11659,4714,2490,3040,618,701,23,6,16,1,1,2,3,10,11625,34,5249
서울특별시,성북구,장위제1동,관내사전투표,2944,2944,1333,585,661,149,193,6,3,4,0,0,0,0,2,2936,8,0
서울특별시,성북구,장위제1동,장위제1동제1투,3404,2077,811,417,569,128,139,4,0,2,0,0,0,0,1,2071,6,1327
서울특별시,성북구,장위제1동,장위제1동제2투,988,618,220,159,159,34,39,4,1,0,0,0,0,0,0,616,2,370
서울특별시,성북구,장위제1동,장위제1동제3투,2745,1807,694,410,489,88,107,4,1,3,1,0,0,2,1,1800,7,938
서울특별시,성북구,장위제1동,장위제1동제4투,2202,1360,537,322,355,65,67,3,0,4,0,0,1,0,2,1356,4,842
서울특별시,성북구,장위제1동,장위제1동제5투,2057,1315,505,283,381,65,70,1,1,1,0,0,1,1,2,1311,4,742
서울특별시,성북구,장위제1동,장위제1동제6투,2568,1538,614,314,426,89,86,1,0,2,0,1,0,0,2,1535,3,1030
서울특별시,성북구,장위제2동,합계,15755,11011,4177,2876,2750,532,566,13,1,15,0,9,3,5,12,10959,52,4744
서울특별시,성북구,장위제2동,관내사전투표,2280,2280,986,552,508,116,104,1,0,0,0,2,0,2,1,2272,8,0
서울특별시,성북구,장위제2동,장위제2동제1투,2749,1861,664,495,487,93,102,1,1,6,0,0,1,2,2,1854,7,888
서울특별시,성북구,장위제2동,장위제2동제2투,2570,1485,520,469,360,56,65,2,0,3,0,1,0,1,1,1478,7,1085
서울특별시,성북구,장위제2동,장위제2동제3투,2402,1655,609,390,462,80,93,4,0,2,0,1,2,0,3,1646,9,747
서울특별시,성북구,장위제2동,장위제2동제4투,2903,1881,656,509,503,91,106,1,0,3,0,1,0,0,2,1872,9,1022
서울특별시,성북구,장위제2동,장위제2동제5투,2851,1849,742,461,430,96,96,4,0,1,0,4,0,0,3,1837,12,1002
서울특별시,성북구,장위제3동,합계,9536,6833,2648,1669,1740,361,363,9,1,2,2,4,3,5,3,6810,23,2703
서울특별시,성북구,장위제3동,관내사전투표,1214,1214,524,262,284,54,80,0,0,0,0,1,1,2,0,1208,6,0
서울특별시,성북구,장위제3동,장위제3동제1투,2485,1446,486,436,378,59,77,2,0,0,0,0,2,0,2,1442,4,1039
서울특별시,성북구,장위제3동,장위제3동제2투,2705,1753,646,461,472,72,87,0,0,2,1,2,0,2,1,1746,7,952
서울특별시,성북구,장위제3동,장위제3동제3투,3132,2420,992,510,606,176,119,7,1,0,1,1,0,1,0,2414,6,712
서울특별시,성북구,석관동,합계,26525,19403,7866,4506,4601,1125,1163,15,1,14,2,8,9,6,8,19324,79,7122
서울특별시,성북구,석관동,관내사전투표,3762,3762,1707,771,794,212,257,2,0,0,0,2,2,0,1,3748,14,0
서울특별시,성북구,석관동,석관동제1투,3584,2185,881,521,525,116,125,1,0,2,0,1,0,0,2,2174,11,1399
서울특별시,성북구,석관동,석관동제2투,2969,1995,772,482,498,104,121,2,0,3,1,0,1,1,0,1985,10,974
서울특별시,성북구,석관동,석관동제3투,3757,2346,886,621,589,100,128,1,1,4,0,1,1,1,1,2334,12,1411
서울특별시,성북구,석관동,석관동제4투,1422,1040,392,250,266,75,50,1,0,1,0,0,0,2,1,1038,2,382
서울특별시,성북구,석관동,석관동제5투,3710,2916,1193,690,677,224,119,2,0,0,0,2,1,1,0,2909,7,794
서울특별시,성북구,석관동,석관동제6투,2403,1624,608,410,405,86,100,2,0,1,0,1,2,0,1,1616,8,779
서울특별시,성북구,석관동,석관동제7투,3243,2321,938,481,567,136,181,3,0,0,1,1,2,1,0,2311,10,922
서울특별시,성북구,석관동,석관동제8투,1675,1214,489,280,280,72,82,1,0,3,0,0,0,0,2,1209,5,461
서울특별시,성북구,잘못 투입·구분된 투표지,,0,0,0,0,0,0,0,0,0,0,0,0,0,0,0,0,0,0
서울특별시,강북구,합계,,281434,210614,89645,42268,51669,11871,13482,324,34,145,45,123,53,93,150,209902,712,70820
서울특별시,강북구,거소·선상투표,,429,405,148,63,137,27,9,1,3,1,0,1,0,0,2,392,13,24
서울특별시,강북구,관외사전투표,,22519,22516,10780,3302,4950,1448,1826,31,5,7,2,11,7,10,26,22405,111,3
서울특별시,강북구,재외투표,,2193,1626,1005,125,248,50,183,10,0,1,0,0,0,1,1,1624,2,567
서울특별시,강북구,삼양동,합계,21885,15162,6430,2977,3852,850,957,18,2,14,1,7,2,8,7,15125,37,6723
서울특별시,강북구,삼양동,관내사전투표,2413,2413,1121,442,572,115,155,2,0,1,0,1,0,1,0,2410,3,0
서울특별시,강북구,삼양동,삼양동제1투,2915,1584,621,330,441,94,85,2,0,2,0,1,2,0,2,1580,4,1331
서울특별시,강북구,삼양동,삼양동제2투,2323,1510,618,333,398,79,74,0,0,2,0,0,0,1,1,1506,4,813
서울특별시,강북구,삼양동,삼양동제3투,2485,1564,696,282,393,80,104,2,0,4,0,1,0,1,0,1563,1,921
서울특별시,강북구,삼양동,삼양동제4투,2867,1926,768,399,488,111,145,6,0,2,0,0,0,0,1,1920,6,941
서울특별시,강북구,삼양동,삼양동제5투,2981,2104,903,400,512,128,149,1,0,2,0,0,0,3,1,2099,5,877
서울특별시,강북구,삼양동,삼양동제6투,2121,1337,573,246,359,68,76,2,0,1,1,2,0,0,1,1329,8,784
서울특별시,강북구,삼양동,삼양동제7투,1399,892,333,218,235,51,48,1,2,0,0,0,0,1,0,889,3,507
서울특별시,강북구,삼양동,삼양동제8투,2381,1832,797,327,454,124,121,2,0,0,0,2,0,1,1,1829,3,549
서울특별시,강북구,미아동,관내사전투표,3972,3972,1942,609,806,247,338,4,0,1,0,2,1,2,1,3953,19,0
서울특별시,강북구,미아동,합계,19670,14483,6289,2771,3571,814,937,23,2,9,1,8,6,6,4,14441,42,5187
서울특별시,강북구,미아동,미아동제1투,2990,1896,805,352,500,116,114,3,1,0,0,1,0,0,1,1893,3,1094
서울특별시,강북구,미아동,미아동제2투,1614,1121,461,241,302,53,56,1,0,1,1,0,1,1,1,1119,2,493
서울특별시,강북구,미아동,미아동제3투,3477,2352,952,488,612,132,150,6,0,4,0,0,1,1,0,2346,6,1125
서울특별시,강북구,미아동,미아동제4투,2609,1744,715,377,464,76,106,2,0,1,0,1,0,1,0,1743,1,865
서울특별시,강북구,미아동,미아동제5투,2418,1670,699,371,411,85,86,5,1,1,0,1,3,1,1,1665,5,748
서울특별시,강북구,미아동,미아동제6투,2590,1728,715,333,476,105,87,2,0,1,0,3,0,0,0,1722,6,862
서울특별시,강북구,송중동,합계,22470,15914,6783,3237,3961,888,920,16,5,20,1,9,3,7,9,15859,55,6556
서울특별시,강북구,송중동,관내사전투표,2889,2889,1423,464,630,157,193,2,1,1,0,3,1,3,1,2879,10,0
서울특별시,강북구,송중동,송중동제1투,2310,1305,558,241,327,79,89,0,0,2,0,0,0,0,2,1298,7,1005
서울특별시,강북구,송중동,송중동제2투,2367,1533,623,322,395,94,84,1,0,2,0,3,0,1,1,1526,7,834
서울특별시,강북구,송중동,송중동제3투,2737,1880,754,436,455,113,106,4,2,3,0,1,1,0,0,1875,5,857
서울특별시,강북구,송중동,송중동제4투,3023,2103,852,471,542,115,107,6,0,1,1,0,1,1,0,2097,6,920
서울특별시,강북구,송중동,송중동제5투,1375,971,448,186,221,44,64,0,0,4,0,0,0,1,0,968,3,404
서울특별시,강북구,송중동,송중동제6투,2133,1401,538,307,421,65,63,0,1,1,0,0,0,0,1,1397,4,732
서울특별시,강북구,송중동,송중동제7투,2925,2075,836,447,553,113,109,2,1,5,0,0,0,0,2,2068,7,850
서울특별시,강북구,송중동,송중동제8투,2711,1757,751,363,417,108,105,1,0,1,0,2,0,1,2,1751,6,954
서울특별시,강북구,송천동,합계,24133,17273,7206,3540,4539,861,982,26,1,15,7,12,3,5,15,17212,61,6860
서울특별시,강북구,송천동,관내사전투표,3484,3484,1667,638,784,163,199,8,0,3,1,3,1,0,4,3471,13,0
서울특별시,강북구,송천동,송천동제1투,3054,1678,639,374,482,82,84,1,0,1,2,2,0,0,3,1670,8,1376
서울특별시,강북구,송천동,송천동제2투,2321,1538,627,305,431,77,83,4,0,4,0,0,0,0,0,1531,7,783
서울특별시,강북구,송천동,송천동제3투,2419,1685,666,382,457,96,77,2,0,1,1,0,0,0,1,1683,2,734
서울특별시,강북구,송천동,송천동제4투,2419,1807,725,367,480,106,116,3,0,1,0,1,1,0,1,1801,6,612
서울특별시,강북구,송천동,송천동제5투,2756,1894,745,424,505,83,122,4,0,2,0,3,0,1,2,1891,3,862
서울특별시,강북구,송천동,송천동제6투,2358,1578,626,324,445,79,84,2,1,1,2,3,1,3,1,1572,6,780
서울특별시,강북구,송천동,송천동제7투,2670,1861,800,344,504,85,117,1,0,1,1,0,0,0,2,1855,6,809
서울특별시,강북구,송천동,송천동제8투,2652,1748,711,382,451,90,100,1,0,1,0,0,0,1,1,1738,10,904
서울특별시,강북구,삼각산동,합계,23551,19085,8969,3100,4548,1204,1177,17,2,6,4,7,5,7,7,19053,32,4466
서울특별시,강북구,삼각산동,관내사전투표,4109,4109,2194,493,868,243,293,6,0,0,0,0,2,0,2,4101,8,0
서울특별시,강북구,삼각산동,삼각산동제1투,2449,1836,779,350,491,112,95,0,0,1,0,4,1,1,1,1835,1,613
서울특별시,강북구,삼각산동,삼각산동제2투,2305,1443,583,344,383,53,70,1,0,1,0,0,0,1,3,1439,4,862
서울특별시,강북구,삼각산동,삼각산동제3투,2755,2269,1110,340,531,136,143,4,1,0,0,0,1,0,0,2266,3,486
서울특별시,강북구,삼각산동,삼각산동제4투,2093,1753,776,340,418,105,104,2,0,1,2,0,0,0,0,1748,5,340
서울특별시,강북구,삼각산동,삼각산동제5투,2789,2346,1142,376,537,143,135,1,0,2,2,1,1,1,0,2341,5,443
서울특별시,강북구,삼각산동,삼각산동제6투,2658,1831,795,350,454,125,102,1,1,0,0,0,0,1,0,1829,2,827
서울특별시,강북구,삼각산동,삼각산동제7투,2078,1670,729,256,398,143,137,0,0,1,0,1,0,2,1,1668,2,408
서울특별시,강북구,삼각산동,삼각산동제8투,2315,1828,861,251,468,144,98,2,0,0,0,1,0,1,0,1826,2,487
서울특별시,강북구,번제1동,합계,15898,10884,4395,2341,2773,603,676,23,3,12,1,7,3,5,4,10846,38,5014
서울특별시,강북구,번제1동,관내사전투표,2520,2520,1160,442,585,127,186,4,0,4,0,0,1,1,1,2511,9,0
서울특별시,강북구,번제1동,번제1동제1투,2974,1667,654,352,431,106,106,2,1,1,1,3,0,1,0,1658,9,1307
서울특별시,강북구,번제1동,번제1동제2투,2524,1664,668,330,463,102,91,4,1,1,0,1,0,1,0,1662,2,860
서울특별시,강북구,번제1동,번제1동제3투,2999,1876,717,446,480,106,112,3,0,2,0,2,1,0,2,1871,5,1123
서울특별시,강북구,번제1동,번제1동제4투,2699,1760,679,441,440,84,101,3,0,2,0,0,0,1,1,1752,8,939
서울특별시,강북구,번제1동,번제1동제5투,2182,1397,517,330,374,78,80,7,1,2,0,1,1,1,0,1392,5,785
서울특별시,강북구,번제2동,합계,14541,10624,4465,2162,2713,550,630,19,2,8,4,5,7,12,6,10583,41,3917
서울특별시,강북구,번제2동,관내사전투표,2484,2484,1139,479,568,114,162,3,0,3,2,1,0,3,0,2474,10,0
서울특별시,강북구,번제2동,번제2동제1투,2731,1967,847,416,463,131,99,2,0,0,0,0,2,2,0,1962,5,764
서울특별시,강북구,번제2동,번제2동제2투,2022,1280,482,304,348,61,63,1,2,1,1,0,2,2,1,1268,12,742
서울특별시,강북구,번제2동,번제2동제3투,2569,1716,672,367,476,83,101,7,0,1,0,0,2,1,1,1711,5,853
서울특별시,강북구,번제2동,번제2동제4투,2397,1600,682,298,423,66,116,3,0,3,0,1,0,2,1,1595,5,797
서울특별시,강북구,번제2동,번제2동제5투,2338,1577,643,298,435,95,89,3,0,0,1,3,1,2,3,1573,4,761
서울특별시,강북구,번제3동,관내사전투표,2684,2684,1211,534,635,142,140,4,1,0,1,3,2,0,1,2674,10,0
서울특별시,강북구,번제3동,합계,15246,11426,4770,2458,2893,591,614,15,3,11,2,7,6,3,15,11388,38,3820
서울특별시,강북구,번제3동,번제3동제1투,2093,1255,474,329,317,58,61,2,0,4,1,2,0,1,0,1249,6,838
서울특별시,강북구,번제3동,번제3동제2투,2611,1959,819,384,500,122,121,1,0,4,0,1,2,1,1,1956,3,652
서울특별시,강북구,번제3동,번제3동제3투,2062,1337,574,277,317,70,85,3,1,1,0,0,0,0,5,1333,4,725
서울특별시,강북구,번제3동,번제3동제4투,2864,2064,816,480,564,92,93,1,1,1,0,1,1,1,3,2054,10,800
서울특별시,강북구,번제3동,번제3동제5투,2932,2127,876,454,560,107,114,4,0,1,0,0,1,0,5,2122,5,805
서울특별시,강북구,수유제1동,관내사전투표,3021,3021,1373,555,689,165,217,5,0,0,2,3,0,1,1,3011,10,0
서울특별시,강북구,수유제1동,합계,17856,12559,5167,2618,3169,706,797,21,2,7,5,8,3,1,7,12511,48,5297
서울특별시,강북구,수유제1동,수유제1동제1투,2920,1682,664,355,439,106,98,3,1,3,3,0,1,0,2,1675,7,1238
서울특별시,강북구,수유제1동,수유제1동제2투,2787,1902,752,400,514,106,115,4,0,2,0,1,1,0,1,1896,6,885
서울특별시,강북구,수유제1동,수유제1동제3투,2719,1767,685,382,465,103,122,2,0,0,0,3,0,0,0,1762,5,952
서울특별시,강북구,수유제1동,수유제1동제4투,2758,1860,748,400,489,93,114,3,0,0,0,1,1,0,2,1851,9,898
서울특별시,강북구,수유제1동,수유제1동제5투,3651,2327,945,526,573,133,131,4,1,2,0,0,0,0,1,2316,11,1324
서울특별시,강북구,수유제2동,합계,17803,13388,5127,3222,3391,806,735,32,1,6,5,3,1,6,13,13348,40,4415
서울특별시,강북구,수유제2동,관내사전투표,3743,3743,1663,722,856,226,244,14,0,1,2,1,0,0,2,3731,12,0
서울특별시,강북구,수유제2동,수유제2동제1투,2961,2007,733,532,521,118,89,4,0,1,0,0,0,0,3,2001,6,954
서울특별시,강북구,수유제2동,수유제2동제2투,3183,2074,774,491,564,123,106,3,1,2,1,1,0,1,0,2067,7,1109
서울특별시,강북구,수유제2동,수유제2동제3투,2483,1906,637,571,475,138,75,4,0,1,1,0,1,0,1,1904,2,577
서울특별시,강북구,수유제2동,수유제2동제4투,2539,1686,633,392,431,89,124,5,0,1,0,0,0,2,4,1681,5,853
서울특별시,강북구,수유제2동,수유제2동제5투,2894,1972,687,514,544,112,97,2,0,0,1,1,0,3,3,1964,8,922
서울특별시,강북구,수유제3동,관내사전투표,4462,4462,2149,710,907,263,398,5,0,1,1,4,0,1,3,4442,20,0
서울특별시,강북구,수유제3동,합계,20939,15147,6346,3152,3559,852,1100,25,1,9,6,15,0,7,17,15089,58,5792
서울특별시,강북구,수유제3동,수유제3동제1투,1881,1179,460,263,298,69,82,2,0,0,2,0,0,0,0,1176,3,702
서울특별시,강북구,수유제3동,수유제3동제2투,2745,1830,743,407,441,94,123,7,0,2,1,1,0,1,4,1824,6,915
서울특별시,강북구,수유제3동,수유제3동제3투,2631,1602,588,401,420,94,89,2,0,2,0,2,0,0,1,1599,3,1029
서울특별시,강북구,수유제3동,수유제3동제4투,2837,2011,793,452,490,117,144,2,0,1,1,3,0,1,1,2005,6,826
서울특별시,강북구,수유제3동,수유제3동제5투,3328,1940,775,447,489,102,107,1,0,1,1,3,0,1,4,1931,9,1388
서울특별시,강북구,수유제3동,수유제3동제6투,3055,2123,838,472,514,113,157,6,1,2,0,2,0,3,4,2112,11,932
서울특별시,강북구,우이동,합계,17036,12163,4638,3041,2921,677,795,17,2,9,2,9,4,7,5,12127,36,4873
서울특별시,강북구,우이동,관내사전투표,2748,2748,1201,605,574,155,190,5,0,0,0,7,0,1,0,2738,10,0
서울특별시,강북구,우이동,우이동제1투,3513,2094,733,583,514,122,128,4,2,2,1,0,0,0,1,2090,4,1419
서울특별시,강북구,우이동,우이동제2투,4290,2813,1082,661,688,156,209,0,0,5,0,2,1,2,0,2806,7,1477
서울특별시,강북구,우이동,우이동제3투,3372,2298,848,588,588,125,135,3,0,2,1,0,2,1,0,2293,5,1074
서울특별시,강북구,우이동,우이동제4투,3113,2210,774,604,557,119,133,5,0,0,0,0,1,3,4,2200,10,903
서울특별시,강북구,인수동,합계,25265,17959,7127,4159,4444,944,1144,30,0,10,4,14,3,8,12,17899,60,7306
서울특별시,강북구,인수동,관내사전투표,4109,4109,1890,816,933,191,249,7,0,4,1,2,0,4,0,4097,12,0
서울특별시,강북구,인수동,인수동제1투,2412,1395,483,375,362,79,92,1,0,0,0,0,0,0,1,1393,2,1017
서울특별시,강북구,인수동,인수동제2투,2112,1445,527,378,363,80,87,0,0,1,1,0,1,2,2,1442,3,667
서울특별시,강북구,인수동,인수동제3투,2584,1768,704,390,467,101,91,6,0,0,0,3,0,0,2,1764,4,816
서울특별시,강북구,인수동,인수동제4투,2206,1512,513,399,385,87,115,0,0,3,0,4,1,0,1,1508,4,694
서울특별시,강북구,인수동,인수동제5투,2430,1482,609,368,337,63,95,3,0,1,0,1,0,0,2,1479,3,948
서울특별시,강북구,인수동,인수동제6투,2883,1884,741,439,472,83,128,3,0,1,0,2,1,1,2,1873,11,999
서울특별시,강북구,인수동,인수동제7투,3216,2155,806,475,584,129,142,7,0,0,0,2,0,1,0,2146,9,1061
서울특별시,강북구,인수동,인수동제8투,3313,2209,854,519,541,131,145,3,0,0,2,0,0,0,2,2197,12,1104
서울특별시,강북구,잘못 투입·구분된 투표지,,0,0,0,0,0,0,0,0,0,0,0,0,0,0,0,0,0,0
서울특별시,도봉구,합계,,293679,229233,94898,47461,55600,14500,14923,352,30,162,43,152,38,79,144,228382,851,64446
서울특별시,도봉구,거소·선상투표,,445,418,151,92,123,26,14,2,0,1,0,0,0,1,0,410,8,27
서울특별시,도봉구,관외사전투표,,24222,24214,11268,3516,5478,1710,1964,34,5,13,4,19,9,8,35,24063,151,8
서울특별시,도봉구,재외투표,,2381,1798,1087,143,221,76,250,13,0,0,0,1,1,0,1,1793,5,583
서울특별시,도봉구,쌍문1동,합계,16912,12466,5148,2762,2899,772,782,25,1,10,3,11,0,8,7,12428,38,4446
서울특별시,도봉구,쌍문1동,관내사전투표,2869,2869,1359,545,546,177,216,9,1,0,0,1,0,2,3,2859,10,0
서울특별시,도봉구,쌍문1동,쌍문1동제1투,3167,2008,769,421,528,143,127,6,0,2,1,3,0,2,0,2002,6,1159
서울특별시,도봉구,쌍문1동,쌍문1동제2투,2773,1840,776,412,426,115,99,2,0,0,0,1,0,1,0,1832,8,933
서울특별시,도봉구,쌍문1동,쌍문1동제3투,2502,1824,714,402,474,104,118,1,0,1,1,3,0,0,1,1819,5,678
서울특별시,도봉구,쌍문1동,쌍문1동제4투,2753,1931,773,471,456,125,94,4,0,3,1,1,0,1,1,1930,1,822
서울특별시,도봉구,쌍문1동,쌍문1동제5투,2848,1994,757,511,469,108,128,3,0,4,0,2,0,2,2,1986,8,854
서울특별시,도봉구,쌍문2동,합계,16797,12596,5158,2674,3070,782,812,13,2,14,2,11,3,5,8,12554,42,4201
서울특별시,도봉구,쌍문2동,관내사전투표,3487,3486,1614,663,735,209,244,3,1,2,0,2,1,1,1,3476,10,1
서울특별시,도봉구,쌍문2동,쌍문2동제1투,3315,2112,833,444,536,131,152,0,0,2,0,0,1,1,2,2102,10,1203
서울특별시,도봉구,쌍문2동,쌍문2동제2투,2682,1699,619,392,478,109,85,3,0,0,1,2,0,1,2,1692,7,983
서울특별시,도봉구,쌍문2동,쌍문2동제3투,2138,1533,613,321,406,91,90,3,0,1,0,4,0,0,1,1530,3,605
서울특별시,도봉구,쌍문2동,쌍문2동제4투,2606,2055,805,461,498,133,137,3,0,4,1,0,1,1,2,2046,9,551
서울특별시,도봉구,쌍문2동,쌍문2동제5투,2569,1711,674,393,417,109,104,1,1,5,0,3,0,1,0,1708,3,858
서울특별시,도봉구,쌍문3동,합계,13937,10333,4129,2182,2650,568,703,17,1,11,2,9,1,3,7,10283,50,3604
서울특별시,도봉구,쌍문3동,관내사전투표,2332,2332,1026,456,550,100,175,7,0,1,0,2,0,0,2,2319,13,0
서울특별시,도봉구,쌍문3동,쌍문3동제1투,3505,2396,921,503,652,134,167,4,0,2,0,3,0,1,0,2387,9,1109
서울특별시,도봉구,쌍문3동,쌍문3동제2투,3029,2059,819,413,538,126,141,2,0,5,1,1,1,1,2,2050,9,970
서울특별시,도봉구,쌍문3동,쌍문3동제3투,2594,1746,671,394,452,89,122,2,1,2,0,0,0,1,2,1736,10,848
서울특별시,도봉구,쌍문3동,쌍문3동제4투,2477,1800,692,416,458,119,98,2,0,1,1,3,0,0,1,1791,9,677
서울특별시,도봉구,쌍문4동,관내사전투표,2662,2662,1244,479,558,177,192,3,1,0,1,0,0,1,0,2656,6,0
서울특별시,도봉구,쌍문4동,합계,14657,11630,4724,2466,2723,855,793,19,1,3,4,8,1,4,3,11604,26,3027
서울특별시,도봉구,쌍문4동,쌍문4동제1투,2921,2079,812,442,476,173,160,2,0,1,0,2,1,0,1,2070,9,842
서울특별시,도봉구,쌍문4동,쌍문4동제2투,3116,2373,892,534,610,184,142,3,0,1,1,0,0,1,1,2369,4,743
서울특별시,도봉구,쌍문4동,쌍문4동제3투,2777,2172,848,501,520,146,141,8,0,0,0,2,0,2,0,2168,4,605
서울특별시,도봉구,쌍문4동,쌍문4동제4투,3181,2344,928,510,559,175,158,3,0,1,2,4,0,0,1,2341,3,837
서울특별시,도봉구,방학1동,합계,23397,17165,6608,3889,4554,1039,962,24,3,7,3,9,2,5,9,17114,51,6232
서울특별시,도봉구,방학1동,관내사전투표,3610,3610,1579,728,852,206,223,4,0,1,0,2,0,1,3,3599,11,0
서울특별시,도봉구,방학1동,방학1동제1투,2986,1731,606,383,534,90,104,4,2,0,0,2,0,0,1,1726,5,1255
서울특별시,도봉구,방학1동,방학1동제2투,2754,1836,672,444,512,110,83,3,0,3,0,2,1,0,0,1830,6,918
서울특별시,도봉구,방학1동,방학1동제3투,3147,2046,760,513,539,96,124,2,1,1,0,1,0,0,1,2038,8,1101
서울특별시,도봉구,방학1동,방학1동제4투,3318,2283,872,541,588,127,139,0,0,1,2,2,1,2,1,2276,7,1035
서울특별시,도봉구,방학1동,방학1동제5투,2849,1993,805,365,559,135,115,4,0,1,0,0,0,2,1,1987,6,856
서울특별시,도봉구,방학1동,방학1동제6투,2308,1714,572,462,464,127,76,5,0,0,1,0,0,0,0,1707,7,594
서울특별시,도봉구,방학1동,방학1동제7투,2425,1952,742,453,506,148,98,2,0,0,0,0,0,0,2,1951,1,473
서울특별시,도봉구,방학2동,합계,17441,11998,4721,2737,3130,602,683,28,1,18,2,7,1,4,10,11944,54,5443
서울특별시,도봉구,방학2동,관내사전투표,2768,2768,1206,544,693,139,163,6,0,3,1,0,0,1,1,2757,11,0
서울특별시,도봉구,방학2동,방학2동제1투,2773,1612,602,396,409,80,106,6,1,0,0,2,1,0,2,1605,7,1161
서울특별시,도봉구,방학2동,방학2동제2투,2005,1317,502,313,342,70,73,1,0,1,0,2,0,2,3,1309,8,688
서울특별시,도봉구,방학2동,방학2동제3투,2486,1586,593,387,404,81,103,4,0,5,0,3,0,0,1,1581,5,900
서울특별시,도봉구,방학2동,방학2동제4투,2528,1681,648,398,426,96,96,2,0,4,0,0,0,0,3,1673,8,847
서울특별시,도봉구,방학2동,방학2동제5투,2294,1378,534,325,368,67,67,6,0,2,1,0,0,1,0,1371,7,916
서울특별시,도봉구,방학2동,방학2동제6투,2587,1656,636,374,488,69,75,3,0,3,0,0,0,0,0,1648,8,931
서울특별시,도봉구,방학3동,합계,22839,18325,7572,3791,4409,1280,1156,22,2,14,4,12,2,1,10,18275,50,4514
서울특별시,도봉구,방학3동,관내사전투표,5207,5207,2372,961,1148,362,328,5,0,5,3,2,1,1,4,5192,15,0
서울특별시,도봉구,방학3동,방학3동제1투,2687,1961,789,417,467,139,139,4,0,1,0,0,0,0,1,1957,4,726
서울특별시,도봉구,방학3동,방학3동제2투,2799,2064,736,515,542,141,120,3,0,0,0,1,0,0,1,2059,5,735
서울특별시,도봉구,방학3동,방학3동제3투,3057,2149,826,514,519,152,122,3,0,2,0,5,0,0,0,2143,6,908
서울특별시,도봉구,방학3동,방학3동제4투,2191,1569,665,311,374,102,108,1,0,2,1,0,1,0,0,1565,4,622
서울특별시,도봉구,방학3동,방학3동제5투,2170,1692,666,379,408,125,99,5,0,3,0,0,0,0,2,1687,5,478
서울특별시,도봉구,방학3동,방학3동제6투,2316,1881,791,329,494,126,129,1,2,0,0,1,0,0,0,1873,8,435
서울특별시,도봉구,방학3동,방학3동제7투,2412,1802,727,365,457,133,111,0,0,1,0,3,0,0,2,1799,3,610
서울특별시,도봉구,창1동,합계,20810,16230,7002,3233,3732,1069,1082,27,2,7,3,13,1,5,4,16180,50,4580
서울특별시,도봉구,창1동,관내사전투표,4299,4299,2164,664,843,265,337,3,0,0,3,7,1,2,2,4291,8,0
서울특별시,도봉구,창1동,창1동제1투,2990,2088,797,479,543,125,119,14,1,1,0,1,0,0,0,2080,8,902
서울특별시,도봉구,창1동,창1동제2투,2502,1556,568,357,414,91,112,1,0,0,0,1,0,0,0,1544,12,946
서울특별시,도봉구,창1동,창1동제3투,2651,1788,709,402,468,109,90,1,0,1,0,1,0,1,2,1784,4,863
서울특별시,도봉구,창1동,창1동제4투,2761,2092,932,415,457,146,131,1,0,2,0,1,0,0,0,2085,7,669
서울특별시,도봉구,창1동,창1동제5투,3007,2430,1014,470,551,204,178,4,1,1,0,1,0,1,0,2425,5,577
서울특별시,도봉구,창1동,창1동제6투,2600,1977,818,446,456,129,115,3,0,2,0,1,0,1,0,1971,6,623
서울특별시,도봉구,창2동,합계,24160,18084,7565,3611,4478,1110,1197,19,2,13,2,5,2,5,10,18019,65,6076
서울특별시,도봉구,창2동,관내사전투표,4524,4524,2092,799,1026,244,324,6,1,5,0,2,2,3,5,4509,15,0
서울특별시,도봉구,창2동,창2동제1투,3015,1975,779,417,492,140,134,0,0,1,1,0,0,1,0,1965,10,1040
서울특별시,도봉구,창2동,창2동제2투,3561,2285,896,494,549,150,174,5,0,4,0,0,0,1,0,2273,12,1276
서울특별시,도봉구,창2동,창2동제3투,3105,2308,957,419,607,164,152,1,0,0,0,0,0,0,1,2301,7,797
서울특별시,도봉구,창2동,창2동제4투,2860,2225,843,555,561,137,116,1,0,2,1,2,0,0,0,2218,7,635
서울특별시,도봉구,창2동,창2동제5투,3741,2587,1109,517,627,159,156,4,1,1,0,0,0,0,3,2577,10,1154
서울특별시,도봉구,창2동,창2동제6투,3354,2180,889,410,616,116,141,2,0,0,0,1,0,0,1,2176,4,1174
서울특별시,도봉구,창3동,합계,11707,8262,3328,1804,2085,446,518,23,0,7,0,7,2,7,5,8232,30,3445
서울특별시,도봉구,창3동,관내사전투표,1827,1827,829,377,416,76,111,6,0,1,0,1,0,1,3,1821,6,0
서울특별시,도봉구,창3동,창3동제1투,2300,1386,491,340,392,76,79,3,0,0,0,1,0,1,0,1383,3,914
서울특별시,도봉구,창3동,창3동제2투,2969,1932,772,427,469,112,140,2,0,0,0,1,0,1,1,1925,7,1037
서울특별시,도봉구,창3동,창3동제3투,2056,1296,528,261,345,69,74,4,0,3,0,2,1,2,1,1290,6,760
서울특별시,도봉구,창3동,창3동제4투,2555,1821,708,399,463,113,114,8,0,3,0,2,1,2,0,1813,8,734
서울특별시,도봉구,창4동,합계,21121,17297,7270,3324,4302,1220,1094,15,1,9,4,7,2,4,2,17254,43,3824
서울특별시,도봉구,창4동,관내사전투표,3209,3209,1498,517,744,202,235,2,0,3,1,2,0,1,0,3205,4,0
서울특별시,도봉구,창4동,창4동제1투,3135,2324,1009,411,570,164,154,2,0,1,0,1,0,0,0,2312,12,811
서울특별시,도봉구,창4동,창4동제2투,2557,1861,794,391,451,110,101,1,1,0,0,3,1,0,0,1853,8,696
서울특별시,도봉구,창4동,창4동제3투,3274,2567,996,589,623,189,157,1,0,0,1,1,0,1,1,2559,8,707
서울특별시,도봉구,창4동,창4동제4투,3124,2619,1019,542,669,211,166,0,0,1,0,0,0,2,1,2611,8,505
서울특별시,도봉구,창4동,창4동제5투,2621,2100,859,413,533,149,135,6,0,3,0,0,1,0,0,2099,1,521
서울특별시,도봉구,창4동,창4동제6투,3201,2617,1095,461,712,195,146,3,0,1,2,0,0,0,0,2615,2,584
서울특별시,도봉구,창5동,합계,20318,16122,6586,3429,3810,1140,1044,29,0,15,2,7,3,5,10,16080,42,4196
서울특별시,도봉구,창5동,관내사전투표,4350,4350,1972,748,931,345,328,6,0,6,0,1,0,2,1,4340,10,0
서울특별시,도봉구,창5동,창5동제1투,2774,2008,873,417,488,97,119,2,0,0,1,2,1,1,0,2001,7,766
서울특별시,도봉구,창5동,창5동제2투,2151,1599,684,337,375,97,96,3,0,1,0,0,0,0,1,1594,5,552
서울특별시,도봉구,창5동,창5동제3투,2755,2012,834,420,477,123,143,4,0,2,1,0,1,1,1,2007,5,743
서울특별시,도봉구,창5동,창5동제4투,2733,1837,684,428,464,143,103,6,0,2,0,2,0,1,1,1834,3,896
서울특별시,도봉구,창5동,창5동제5투,1592,1294,426,337,323,114,87,3,0,1,0,1,0,0,0,1292,2,298
서울특별시,도봉구,창5동,창5동제6투,2321,1885,646,481,489,152,101,4,0,1,0,1,1,0,4,1880,5,436
서울특별시,도봉구,창5동,창5동제7투,1642,1137,467,261,263,69,67,1,0,2,0,0,0,0,2,1132,5,505
서울특별시,도봉구,도봉1동,합계,19411,14124,5271,3580,3518,753,842,18,5,9,6,13,2,7,18,14042,82,5287
서울특별시,도봉구,도봉1동,관내사전투표,3430,3430,1503,741,750,173,220,2,4,1,0,5,1,2,4,3406,24,0
서울특별시,도봉구,도봉1동,도봉1동제1투,2787,1574,608,356,404,96,93,0,1,4,1,2,1,0,1,1567,7,1213
서울특별시,도봉구,도봉1동,도봉1동제2투,3769,2672,958,721,648,142,160,8,0,1,2,2,0,3,2,2647,25,1097
서울특별시,도봉구,도봉1동,도봉1동제3투,2064,1397,502,337,406,80,63,1,0,1,0,0,0,0,2,1392,5,667
서울특별시,도봉구,도봉1동,도봉1동제4투,1364,933,288,297,222,50,63,1,0,1,1,2,0,0,2,927,6,431
서울특별시,도봉구,도봉1동,도봉1동제5투,2396,1752,563,522,461,90,105,3,0,0,0,1,0,2,2,1749,3,644
서울특별시,도봉구,도봉1동,도봉1동제6투,3601,2366,849,606,627,122,138,3,0,1,2,1,0,0,5,2354,12,1235
서울특별시,도봉구,도봉2동,합계,23124,18171,7310,4228,4418,1052,1027,24,4,11,2,13,6,7,5,18107,64,4953
서울특별시,도봉구,도봉2동,관내사전투표,3821,3821,1767,785,800,218,230,3,0,3,0,3,2,1,2,3814,7,0
서울특별시,도봉구,도봉2동,도봉2동제1투,2204,1256,498,275,323,72,77,0,1,0,1,0,2,0,1,1250,6,948
서울특별시,도봉구,도봉2동,도봉2동제2투,2481,1917,720,476,499,97,109,5,0,1,1,0,0,1,0,1909,8,564
서울특별시,도봉구,도봉2동,도봉2동제3투,2377,1532,602,364,392,84,78,1,1,1,0,1,2,1,0,1527,5,845
서울특별시,도봉구,도봉2동,도봉2동제4투,2469,1814,713,388,479,106,113,5,1,2,0,1,0,0,0,1808,6,655
서울특별시,도봉구,도봉2동,도봉2동제5투,3099,2447,891,632,623,148,129,2,0,2,0,5,0,1,1,2434,13,652
서울특별시,도봉구,도봉2동,도봉2동제6투,3127,2546,1037,609,581,161,143,4,1,2,0,0,0,1,0,2539,7,581
서울특별시,도봉구,도봉2동,도봉2동제7투,3546,2838,1082,699,721,166,148,4,0,0,0,3,0,2,1,2826,12,708
서울특별시,도봉구,잘못 투입·구분된 투표지,,0,0,0,0,0,0,0,0,0,0,0,0,0,0,0,0,0,0
서울특별시,노원구,합계,,464422,374213,158167,67590,96325,24846,24498,548,37,168,85,210,81,120,232,372907,1306,90209
서울특별시,노원구,거소·선상투표,,885,806,256,139,300,44,22,2,3,2,3,1,7,0,5,784,22,79
서울특별시,노원구,관외사전투표,,41225,41218,19138,5677,9672,3047,3273,55,7,11,9,17,9,8,38,40961,257,7
서울특별시,노원구,재외투표,,4170,3291,2008,238,494,131,392,14,0,0,0,5,0,2,1,3285,6,879
서울특별시,노원구,월계1동,합계,18441,14214,5685,3086,3498,951,888,18,1,10,5,4,2,6,8,14162,52,4227
서울특별시,노원구,월계1동,관내사전투표,3578,3578,1637,650,738,276,260,2,0,0,0,0,0,2,1,3566,12,0
서울특별시,노원구,월계1동,월계1동제1투,2842,2025,749,477,509,143,123,8,0,4,2,0,1,0,1,2017,8,817
서울특별시,노원구,월계1동,월계1동제2투,2743,1943,685,511,524,105,103,1,0,1,1,1,0,0,1,1933,10,800
서울특별시,노원구,월계1동,월계1동제3투,3507,2570,983,559,661,184,164,3,1,3,0,1,0,0,4,2563,7,937
서울특별시,노원구,월계1동,월계1동제4투,3008,2123,853,473,523,130,128,1,0,0,2,1,1,1,0,2113,10,885
서울특별시,노원구,월계1동,월계1동제5투,2763,1975,778,416,543,113,110,3,0,2,0,1,0,3,1,1970,5,788
서울특별시,노원구,월계2동,합계,20324,15280,6054,3424,3879,938,836,28,1,7,3,17,6,6,12,15211,69,5044
서울특별시,노원구,월계2동,관내사전투표,2970,2970,1357,601,626,177,180,1,0,1,0,5,1,1,4,2954,16,0
서울특별시,노원구,월계2동,월계2동제1투,3360,2241,784,562,635,145,99,5,0,0,1,0,0,0,4,2235,6,1119
서울특별시,노원구,월계2동,월계2동제2투,2732,1977,870,405,477,100,113,2,1,2,0,1,1,0,1,1973,4,755
서울특별시,노원구,월계2동,월계2동제3투,2863,2217,886,488,547,157,120,4,0,0,2,3,0,0,1,2208,9,646
서울특별시,노원구,월계2동,월계2동제4투,3824,2839,1122,543,771,199,179,4,0,1,0,4,2,1,2,2828,11,985
서울특별시,노원구,월계2동,월계2동제5투,3236,2134,714,583,599,107,91,8,0,3,0,4,2,2,0,2113,21,1102
서울특별시,노원구,월계2동,월계2동제6투,1339,902,321,242,224,53,54,4,0,0,0,0,0,2,0,900,2,437
서울특별시,노원구,월계3동,합계,24847,19726,8397,4195,4609,1202,1172,33,3,10,5,15,11,4,10,19666,60,5121
서울특별시,노원구,월계3동,관내사전투표,2626,2626,1261,474,536,156,181,3,0,1,0,2,0,1,1,2616,10,0
서울특별시,노원구,월계3동,월계3동제1투,2267,1562,688,298,355,101,104,5,0,1,1,0,1,0,2,1556,6,705
서울특별시,노원구,월계3동,월계3동제2투,2602,2134,960,441,500,115,103,3,2,2,1,2,0,1,0,2130,4,468
서울특별시,노원구,월계3동,월계3동제3투,2588,2067,824,497,497,109,127,4,0,1,0,0,2,1,1,2063,4,521
서울특별시,노원구,월계3동,월계3동제4투,2684,2077,960,344,481,131,146,2,0,2,0,4,0,0,0,2070,7,607
서울특별시,노원구,월계3동,월계3동제5투,3140,2638,1111,585,587,180,161,2,0,1,1,2,0,0,3,2633,5,502
서울특별시,노원구,월계3동,월계3동제6투,3106,2561,1009,602,602,180,153,9,0,1,0,0,1,1,0,2558,3,545
서울특별시,노원구,월계3동,월계3동제7투,1715,1328,549,287,330,82,73,2,0,0,0,0,1,0,1,1325,3,387
서울특별시,노원구,월계3동,월계3동제8투,1917,1296,543,280,314,82,65,0,0,0,0,5,2,0,1,1292,4,621
서울특별시,노원구,월계3동,월계3동제9투,2202,1437,492,387,407,66,59,3,1,1,2,0,4,0,1,1423,14,765
서울특별시,노원구,공릉1동,합계,31117,23950,10233,4488,5824,1612,1622,35,1,9,5,13,6,13,19,23880,70,7167
서울특별시,노원구,공릉1동,관내사전투표,5511,5511,2699,787,1109,405,459,12,0,2,1,8,2,4,6,5494,17,0
서울특별시,노원구,공릉1동,공릉1동제1투,3085,2077,832,425,508,157,140,4,0,0,0,0,1,0,1,2068,9,1008
서울특별시,노원구,공릉1동,공릉1동제2투,3965,2932,1217,592,726,160,221,3,0,3,0,1,0,4,1,2928,4,1033
서울특별시,노원구,공릉1동,공릉1동제3투,3015,1770,699,319,470,145,130,0,0,0,1,0,0,0,1,1765,5,1245
서울특별시,노원구,공릉1동,공릉1동제4투,2720,1912,743,437,498,116,101,2,0,0,1,0,1,3,1,1903,9,808
서울특별시,노원구,공릉1동,공릉1동제5투,2490,1758,654,426,487,99,80,1,0,2,1,0,1,0,3,1754,4,732
서울특별시,노원구,공릉1동,공릉1동제6투,1942,1385,537,301,374,72,86,3,0,1,1,0,1,1,3,1380,5,557
서울특별시,노원구,공릉1동,공릉1동제7투,2695,2057,866,408,506,135,130,3,1,1,0,2,0,0,1,2053,4,638
서울특별시,노원구,공릉1동,공릉1동제8투,2707,2081,907,364,533,152,109,3,0,0,0,2,0,1,2,2073,8,626
서울특별시,노원구,공릉1동,공릉1동제9투,2987,2467,1079,429,613,171,166,4,0,0,0,0,0,0,0,2462,5,520
서울특별시,노원구,공릉2동,관내사전투표,5327,5327,2621,845,1031,403,403,7,1,2,0,4,0,0,1,5318,9,0
서울특별시,노원구,공릉2동,합계,30680,24751,10631,4846,5644,1833,1657,29,2,11,4,10,3,4,15,24689,62,5929
서울특별시,노원구,공릉2동,공릉2동제1투,3153,2214,1012,354,507,166,161,2,0,0,0,0,0,0,4,2206,8,939
서울특별시,노원구,공릉2동,공릉2동제2투,3115,2582,1092,495,600,204,181,2,0,0,0,0,0,1,1,2576,6,533
서울특별시,노원구,공릉2동,공릉2동제3투,3240,2545,1049,522,627,176,151,2,0,3,2,0,0,0,3,2535,10,695
서울특별시,노원구,공릉2동,공릉2동제4투,3003,2314,955,456,565,182,146,2,0,2,1,0,0,0,1,2310,4,689
서울특별시,노원구,공릉2동,공릉2동제5투,3266,2616,1098,561,635,157,146,3,0,1,1,1,1,0,3,2607,9,650
서울특별시,노원구,공릉2동,공릉2동제6투,3033,2247,852,507,557,171,149,3,0,0,0,3,0,3,1,2246,1,786
서울특별시,노원구,공릉2동,공릉2동제7투,2875,2108,864,499,467,132,130,5,0,1,0,1,0,0,0,2099,9,767
서울특별시,노원구,공릉2동,공릉2동제8투,1358,989,311,228,242,120,79,2,0,2,0,1,1,0,0,986,3,369
서울특별시,노원구,공릉2동,공릉2동제9투,2310,1809,777,379,413,122,111,1,1,0,0,0,1,0,1,1806,3,501
서울특별시,노원구,하계1동,관내사전투표,3211,3211,1462,530,722,250,224,7,0,2,0,2,0,2,4,3205,6,0
서울특별시,노원구,하계1동,합계,21031,16510,6713,3089,4244,1213,1107,25,1,8,3,16,6,6,17,16448,62,4521
서울특별시,노원구,하계1동,하계1동제1투,2337,1738,662,371,457,137,102,2,0,0,0,3,2,0,0,1736,2,599
서울특별시,노원구,하계1동,하계1동제2투,2838,2094,864,395,530,136,127,5,0,1,2,4,1,0,4,2069,25,744
서울특별시,노원구,하계1동,하계1동제3투,3266,2154,766,497,660,117,89,4,0,1,0,0,1,1,3,2139,15,1112
서울특별시,노원구,하계1동,하계1동제4투,3030,2362,936,453,595,195,171,1,0,1,0,2,1,0,1,2356,6,668
서울특별시,노원구,하계1동,하계1동제5투,3015,2234,905,368,557,186,202,2,1,2,0,1,1,1,3,2229,5,781
서울특별시,노원구,하계1동,하계1동제6투,3334,2717,1118,475,723,192,192,4,0,1,1,4,0,2,2,2714,3,617
서울특별시,노원구,하계2동,합계,18438,15171,6688,2489,3815,1108,975,19,0,13,3,3,1,1,10,15125,46,3267
서울특별시,노원구,하계2동,관내사전투표,3717,3717,1847,498,812,279,260,4,0,3,0,0,0,0,1,3704,13,0
서울특별시,노원구,하계2동,하계2동제1투,3031,2162,924,359,573,156,135,2,0,4,1,1,1,0,3,2159,3,869
서울특별시,노원구,하계2동,하계2동제2투,2283,1454,518,389,396,61,72,4,0,2,0,1,0,1,4,1448,6,829
서울특별시,노원구,하계2동,하계2동제3투,3352,2877,1255,445,779,216,162,6,0,3,2,1,0,0,0,2869,8,475
서울특별시,노원구,하계2동,하계2동제4투,2939,2421,1103,381,575,176,176,1,0,1,0,0,0,0,1,2414,7,518
서울특별시,노원구,하계2동,하계2동제5투,3116,2540,1041,417,680,220,170,2,0,0,0,0,0,0,1,2531,9,576
서울특별시,노원구,중계본동,합계,18781,15059,6476,2363,3910,1194,1027,17,0,6,3,8,0,1,12,15017,42,3722
서울특별시,노원구,중계본동,관내사전투표,3563,3563,1764,456,767,278,265,5,0,2,1,2,0,0,4,3544,19,0
서울특별시,노원구,중계본동,중계본동제1투,2089,1433,543,283,411,112,78,1,0,2,0,1,0,1,0,1432,1,656
서울특별시,노원구,중계본동,중계본동제2투,1470,824,289,210,251,29,38,1,0,1,1,2,0,0,1,823,1,646
서울특별시,노원구,중계본동,중계본동제3투,2991,2455,1048,335,674,209,176,4,0,0,0,1,0,0,0,2447,8,536
서울특별시,노원구,중계본동,중계본동제4투,3070,2463,1067,364,647,199,176,4,0,0,0,0,0,0,2,2459,4,607
서울특별시,노원구,중계본동,중계본동제5투,2723,2056,858,338,532,176,142,1,0,1,0,2,0,0,2,2052,4,667
서울특별시,노원구,중계본동,중계본동제6투,2875,2265,907,377,628,191,152,1,0,0,1,0,0,0,3,2260,5,610
서울특별시,노원구,중계1동,합계,19123,15893,7196,2299,3943,1285,1065,19,2,4,2,6,3,8,12,15844,49,3230
서울특별시,노원구,중계1동,관내사전투표,3799,3799,1903,472,837,275,286,3,1,2,0,1,1,1,4,3786,13,0
서울특별시,노원구,중계1동,중계1동제1투,3018,2250,960,344,606,171,145,9,0,1,1,1,2,1,2,2243,7,768
서울특별시,노원구,중계1동,중계1동제2투,3288,2448,984,407,671,209,161,1,0,0,0,2,0,2,2,2439,9,840
서울특별시,노원구,중계1동,중계1동제3투,2864,2357,1030,372,581,199,165,1,0,0,0,1,0,1,1,2351,6,507
서울특별시,노원구,중계1동,중계1동제4투,3174,2643,1294,305,631,239,165,0,0,0,1,0,0,0,1,2636,7,531
서울특별시,노원구,중계1동,중계1동제5투,2980,2396,1025,399,617,192,143,5,1,1,0,1,0,3,2,2389,7,584
서울특별시,노원구,중계2·3동,합계,30193,23725,10154,4376,6024,1541,1422,45,4,14,11,11,4,9,16,23631,94,6468
서울특별시,노원구,중계2·3동,관내사전투표,5314,5314,2608,721,1204,384,353,5,0,3,1,5,1,4,4,5293,21,0
서울특별시,노원구,중계2·3동,중계2·3동제1투,2656,2068,971,295,528,141,119,2,0,0,2,1,1,0,2,2062,6,588
서울특별시,노원구,중계2·3동,중계2·3동제2투,2817,2338,968,456,549,186,166,6,0,0,0,3,0,0,1,2335,3,479
서울특별시,노원구,중계2·3동,중계2·3동제3투,2311,1763,784,300,450,112,108,1,1,0,2,0,0,3,0,1761,2,548
서울특별시,노원구,중계2·3동,중계2·3동제4투,2417,1768,738,305,455,138,121,1,0,1,0,0,0,0,2,1761,7,649
서울특별시,노원구,중계2·3동,중계2·3동제5투,2670,1976,840,339,496,145,144,2,0,1,1,1,0,0,0,1969,7,694
서울특별시,노원구,중계2·3동,중계2·3동제6투,2383,1886,808,356,476,108,121,9,0,2,1,0,0,0,0,1881,5,497
서울특별시,노원구,중계2·3동,중계2·3동제7투,2286,1720,634,387,475,114,85,5,1,0,2,0,1,0,5,1709,11,566
서울특별시,노원구,중계2·3동,중계2·3동제8투,2593,1783,704,386,495,85,88,5,1,3,1,0,0,0,1,1769,14,810
서울특별시,노원구,중계2·3동,중계2·3동제9투,1809,1232,395,368,379,44,30,2,0,1,1,1,0,2,0,1223,9,577
서울특별시,노원구,중계2·3동,중계2·3동제10투,2937,1877,704,463,517,84,87,7,1,3,0,0,1,0,1,1868,9,1060
서울특별시,노원구,중계4동,관내사전투표,2872,2872,1339,497,671,154,190,8,0,1,0,2,1,1,1,2865,7,0
서울특별시,노원구,중계4동,합계,16460,12913,5342,2492,3475,742,772,22,1,5,5,9,2,5,6,12878,35,3547
서울특별시,노원구,중계4동,중계4동제1투,3610,2503,1002,473,713,144,151,3,1,1,1,3,0,0,2,2494,9,1107
서울특별시,노원구,중계4동,중계4동제2투,2850,1978,704,455,600,93,99,5,0,1,2,2,1,3,2,1967,11,872
서울특별시,노원구,중계4동,중계4동제3투,3844,3097,1298,539,866,213,169,6,0,0,2,1,0,0,0,3094,3,747
서울특별시,노원구,중계4동,중계4동제4투,3284,2463,999,528,625,138,163,0,0,2,0,1,0,1,1,2458,5,821
서울특별시,노원구,상계1동,관내사전투표,6176,6176,2722,1026,1645,343,391,6,0,4,1,6,1,5,3,6153,23,0
서울특별시,노원구,상계1동,합계,31811,24846,9617,4775,7411,1419,1445,36,3,11,4,15,4,11,11,24762,84,6965
서울특별시,노원구,상계1동,상계1동제1투,3656,2211,827,471,650,128,120,3,1,0,0,0,0,1,0,2201,10,1445
서울특별시,노원구,상계1동,상계1동제2투,2889,2086,865,350,605,119,132,3,0,2,0,0,1,1,3,2081,5,803
서울특별시,노원구,상계1동,상계1동제3투,3361,2584,1123,407,740,134,167,1,0,0,0,3,0,1,0,2576,8,777
서울특별시,노원구,상계1동,상계1동제4투,2998,2101,625,588,662,118,92,8,1,1,0,0,2,0,0,2097,4,897
서울특별시,노원구,상계1동,상계1동제5투,3127,2316,883,457,680,128,147,3,0,2,1,2,0,1,1,2305,11,811
서울특별시,노원구,상계1동,상계1동제6투,3108,2459,934,455,765,162,131,2,0,1,0,3,0,2,1,2456,3,649
서울특별시,노원구,상계1동,상계1동제7투,3035,2291,711,512,825,104,117,5,1,1,2,1,0,0,1,2280,11,744
서울특별시,노원구,상계1동,상계1동제8투,3461,2622,927,509,839,183,148,5,0,0,0,0,0,0,2,2613,9,839
서울특별시,노원구,상계2동,합계,17250,13087,5140,2459,3765,851,781,21,2,5,2,4,5,7,4,13046,41,4163
서울특별시,노원구,상계2동,관내사전투표,3981,3980,1708,658,1036,261,276,11,1,2,0,0,3,2,4,3962,18,1
서울특별시,노원구,상계2동,상계2동제1투,3332,2136,741,477,692,93,117,4,0,2,0,2,1,3,0,2132,4,1196
서울특별시,노원구,상계2동,상계2동제2투,3403,2374,886,461,727,165,123,3,1,0,1,2,0,0,0,2369,5,1029
서울특별시,노원구,상계2동,상계2동제3투,3204,2214,849,435,647,156,116,2,0,0,0,0,1,1,0,2207,7,990
서울특별시,노원구,상계2동,상계2동제4투,3330,2383,956,428,663,176,149,1,0,1,1,0,0,1,0,2376,7,947
서울특별시,노원구,상계3·4동,관내사전투표,3172,3172,1298,589,917,159,180,13,2,0,2,5,0,1,0,3166,6,0
서울특별시,노원구,상계3·4동,합계,22488,16045,5759,3537,4978,782,878,28,4,2,5,15,0,8,5,16001,44,6443
서울특별시,노원구,상계3·4동,상계3·4동제1투,3463,2181,772,491,727,94,80,3,0,0,0,2,0,1,1,2171,10,1282
서울특별시,노원구,상계3·4동,상계3·4동제2투,2787,2227,824,487,648,142,112,5,0,0,0,0,0,1,2,2221,6,560
서울특별시,노원구,상계3·4동,상계3·4동제3투,2536,1808,657,371,570,80,118,0,1,1,1,3,0,1,0,1803,5,728
서울특별시,노원구,상계3·4동,상계3·4동제4투,2095,1377,478,331,418,55,85,0,0,0,1,2,0,0,0,1370,7,718
서울특별시,노원구,상계3·4동,상계3·4동제5투,2587,1922,677,475,535,120,107,3,1,0,0,1,0,0,0,1919,3,665
서울특별시,노원구,상계3·4동,상계3·4동제6투,3035,1622,512,378,569,71,81,2,0,0,1,0,0,3,0,1617,5,1413
서울특별시,노원구,상계3·4동,상계3·4동제7투,2813,1736,541,415,594,61,115,2,0,1,0,2,0,1,2,1734,2,1077
서울특별시,노원구,상계5동,관내사전투표,3581,3580,1571,614,969,188,210,6,0,1,3,2,1,0,1,3566,14,1
서울특별시,노원구,상계5동,합계,21385,15835,5878,3235,4804,883,913,26,0,15,4,13,2,3,7,15783,52,5550
서울특별시,노원구,상계5동,상계5동제1투,2950,1661,509,402,561,70,101,4,0,2,0,2,1,1,1,1654,7,1289
서울특별시,노원구,상계5동,상계5동제2투,3342,2462,941,478,739,144,140,3,0,4,1,4,0,0,0,2454,8,880
서울특별시,노원구,상계5동,상계5동제3투,2597,1692,570,402,538,88,82,3,0,3,0,0,0,1,0,1687,5,905
서울특별시,노원구,상계5동,상계5동제4투,3210,2394,902,415,712,196,154,1,0,2,0,0,0,1,1,2384,10,816
서울특별시,노원구,상계5동,상계5동제5투,2711,1972,677,460,611,89,122,4,0,0,0,3,0,0,1,1967,5,739
서울특별시,노원구,상계5동,상계5동제6투,2994,2074,708,464,674,108,104,5,0,3,0,2,0,0,3,2071,3,920
서울특별시,노원구,상계6·7동,합계,27507,22282,9772,3860,5485,1509,1523,30,0,9,4,13,4,8,7,22224,58,5225
서울특별시,노원구,상계6·7동,관내사전투표,4884,4884,2440,623,1062,337,389,9,0,1,1,5,1,1,1,4870,14,0
서울특별시,노원구,상계6·7동,상계6·7동제1투,2838,2139,848,458,509,170,138,5,0,0,0,1,0,0,1,2130,9,699
서울특별시,노원구,상계6·7동,상계6·7동제2투,3121,2377,1003,475,581,160,147,2,0,0,1,0,0,0,0,2369,8,744
서울특별시,노원구,상계6·7동,상계6·7동제3투,3061,2481,1110,442,607,165,148,1,0,0,0,2,1,1,1,2478,3,580
서울특별시,노원구,상계6·7동,상계6·7동제4투,3771,2941,1270,488,800,183,182,1,0,2,0,2,1,3,1,2933,8,830
서울특별시,노원구,상계6·7동,상계6·7동제5투,3515,2602,1038,486,712,172,183,2,0,0,0,2,1,1,1,2598,4,913
서울특별시,노원구,상계6·7동,상계6·7동제6투,3225,2302,993,429,558,130,171,7,0,4,0,1,0,1,2,2296,6,923
서울특별시,노원구,상계6·7동,상계6·7동제7투,3092,2556,1070,459,656,192,165,3,0,2,2,0,0,1,0,2550,6,536
서울특별시,노원구,상계8동,합계,17021,14164,6598,2018,3615,908,945,15,1,6,1,5,3,4,10,14129,35,2857
서울특별시,노원구,상계8동,관내사전투표,3859,3859,2069,403,824,262,279,4,0,0,0,3,1,2,3,3850,9,0
서울특별시,노원구,상계8동,상계8동제1투,2522,1928,802,348,540,106,115,4,0,1,0,2,1,0,2,1921,7,594
서울특별시,노원구,상계8동,상계8동제2투,3122,2498,1082,383,712,147,156,4,0,3,1,0,0,0,0,2488,10,624
서울특별시,노원구,상계8동,상계8동제3투,2841,2200,890,408,593,144,154,3,1,1,0,0,1,1,1,2197,3,641
서울특별시,노원구,상계8동,상계8동제4투,1790,1359,858,78,256,91,75,0,0,0,0,0,0,0,0,1358,1,431
서울특별시,노원구,상계8동,상계8동제5투,2887,2320,897,398,690,158,166,0,0,1,0,0,0,1,4,2315,5,567
서울특별시,노원구,상계9동,관내사전투표,3633,3633,1663,600,853,242,266,2,1,0,0,1,1,0,0,3629,4,0
서울특별시,노원구,상계9동,합계,16764,13709,5567,2497,3697,898,977,13,1,8,0,8,2,2,3,13673,36,3055
서울특별시,노원구,상계9동,상계9동제1투,3114,2289,879,423,704,129,131,6,0,4,0,0,1,2,0,2279,10,825
서울특별시,노원구,상계9동,상계9동제2투,3270,2612,986,503,737,205,170,1,0,0,0,2,0,0,0,2604,8,658
서울특별시,노원구,상계9동,상계9동제3투,3101,2359,933,426,653,133,206,1,0,1,0,2,0,0,1,2356,3,742
서울특별시,노원구,상계9동,상계9동제4투,3646,2816,1106,545,750,189,204,3,0,3,0,3,0,0,2,2805,11,830
서울특별시,노원구,상계10동,합계,14481,11734,4862,2007,3239,755,806,18,0,2,4,2,1,4,4,11704,30,2747
서울특별시,노원구,상계10동,관내사전투표,3271,3271,1590,439,794,203,229,6,0,1,0,1,1,0,1,3265,6,0
서울특별시,노원구,상계10동,상계10동제1투,2963,2214,757,502,634,175,131,4,0,0,3,0,0,1,1,2208,6,749
서울특별시,노원구,상계10동,상계10동제2투,2860,2172,880,354,637,145,144,2,0,0,1,0,0,3,0,2166,6,688
서울특별시,노원구,상계10동,상계10동제3투,2522,1836,734,326,515,115,136,2,0,0,0,1,0,0,1,1830,6,686
서울특별시,노원구,상계10동,상계10동제4투,2865,2241,901,386,659,117,166,4,0,1,0,0,0,0,1,2235,6,624
서울특별시,노원구,잘못 투입·구분된 투표지,,0,4,3,1,0,0,0,0,0,0,0,0,0,0,0,4,0,-4
서울특별시,은평구,합계,,413086,317275,140180,60109,72582,19447,21955,432,49,188,656,160,61,115,181,316115,1160,95811
서울특별시,은평구,거소·선상투표,,679,632,219,103,181,34,16,4,2,3,10,3,1,0,8,584,48,47
서울특별시,은평구,관외사전투표,,36001,35902,17723,4770,7429,2475,3087,39,13,19,73,22,5,9,49,35713,189,99
서울특별시,은평구,재외투표,,3886,2963,1793,257,441,96,348,11,0,1,3,2,0,0,1,2953,10,923
서울특별시,은평구,녹번동,합계,25227,18650,8060,3837,4318,1101,1196,27,3,7,24,12,2,7,9,18603,47,6577
서울특별시,은평구,녹번동,관내사전투표,4701,4701,2304,772,966,279,342,7,0,1,7,4,1,1,2,4686,15,0
서울특별시,은평구,녹번동,녹번동제1투,4136,2495,1066,539,589,138,139,5,1,0,4,2,0,4,1,2488,7,1641
서울특별시,은평구,녹번동,녹번동제2투,1443,1058,403,263,239,78,71,1,0,0,1,1,0,0,0,1057,1,385
서울특별시,은평구,녹번동,녹번동제3투,2652,1713,734,375,425,85,80,3,0,0,1,2,1,1,1,1708,5,939
서울특별시,은평구,녹번동,녹번동제4투,3027,2070,822,474,509,124,128,1,1,1,3,0,0,0,1,2064,6,957
서울특별시,은평구,녹번동,녹번동제5투,2759,2222,911,442,538,158,160,2,1,0,3,0,0,0,1,2216,6,537
서울특별시,은평구,녹번동,녹번동제6투,3129,2043,832,464,483,111,137,5,0,3,2,1,0,1,2,2041,2,1086
서울특별시,은평구,녹번동,녹번동제7투,3380,2348,988,508,569,128,139,3,0,2,3,2,0,0,1,2343,5,1032
서울특별시,은평구,응암제1동,합계,19609,14463,6578,2726,3329,851,879,16,3,14,8,6,4,4,6,14424,39,5146
서울특별시,은평구,응암제1동,관내사전투표,3974,3974,2028,647,801,222,246,7,1,4,3,0,3,1,0,3963,11,0
서울특별시,은평구,응암제1동,응암제1동제1투,3280,2033,864,420,516,102,124,3,0,0,2,1,1,0,0,2033,0,1247
서울특별시,은평구,응암제1동,응암제1동제2투,1655,995,399,213,254,64,61,0,1,2,0,0,0,0,1,995,0,660
서울특별시,은평구,응암제1동,응암제1동제3투,3006,2112,860,452,520,129,133,1,1,2,1,2,0,0,2,2103,9,894
서울특별시,은평구,응암제1동,응암제1동제4투,3744,2628,1194,520,604,152,142,3,0,3,0,1,0,1,1,2621,7,1116
서울특별시,은평구,응암제1동,응암제1동제5투,3950,2721,1233,474,634,182,173,2,0,3,2,2,0,2,2,2709,12,1229
서울특별시,은평구,응암제2동,합계,13649,9907,4470,1884,2235,609,638,21,1,5,6,3,2,2,4,9880,27,3742
서울특별시,은평구,응암제2동,관내사전투표,2264,2264,1104,381,502,124,140,6,0,0,1,1,0,0,0,2259,5,0
서울특별시,은평구,응암제2동,응암제2동제1투,3405,2039,929,367,431,148,150,3,0,1,1,1,0,0,1,2032,7,1366
서울특별시,은평구,응암제2동,응암제2동제2투,1202,726,311,137,194,43,34,3,0,0,0,0,1,1,0,724,2,476
서울특별시,은평구,응암제2동,응암제2동제3투,1861,1423,690,228,329,87,78,3,0,2,1,0,0,0,0,1418,5,438
서울특별시,은평구,응암제2동,응암제2동제4투,2505,1794,791,351,409,119,112,5,1,0,2,0,0,0,0,1790,4,711
서울특별시,은평구,응암제2동,응암제2동제5투,2412,1661,645,420,370,88,124,1,0,2,1,1,1,1,3,1657,4,751
서울특별시,은평구,응암제3동,합계,21939,15765,6749,3200,3836,917,937,18,2,10,12,10,2,6,10,15709,56,6174
서울특별시,은평구,응암제3동,관내사전투표,4742,4742,2315,824,1011,252,304,3,0,3,7,4,2,1,4,4730,12,0
서울특별시,은평구,응암제3동,응암제3동제1투,3436,2050,891,386,482,148,132,2,0,1,0,1,0,1,0,2044,6,1386
서울특별시,은평구,응암제3동,응암제3동제2투,3056,2003,816,432,512,101,126,2,0,0,2,3,0,2,2,1998,5,1053
서울특별시,은평구,응암제3동,응암제3동제3투,3068,1955,800,419,484,122,111,3,0,2,0,1,0,1,2,1945,10,1113
서울특별시,은평구,응암제3동,응암제3동제4투,2300,1359,509,320,351,80,86,4,1,2,0,1,0,1,0,1355,4,941
서울특별시,은평구,응암제3동,응암제3동제5투,2520,1797,688,394,533,97,69,2,1,1,2,0,0,0,0,1787,10,723
서울특별시,은평구,응암제3동,응암제3동제6투,2817,1859,730,425,463,117,109,2,0,1,1,0,0,0,2,1850,9,958
서울특별시,은평구,증산동,합계,14651,11108,4651,2322,2596,704,756,10,0,4,7,9,1,6,4,11070,38,3543
서울특별시,은평구,증산동,관내사전투표,3415,3415,1573,666,731,177,241,7,0,0,0,6,0,4,0,3405,10,0
서울특별시,은평구,증산동,증산동제1투,2871,1848,746,392,453,122,123,0,0,2,0,2,0,1,1,1842,6,1023
서울특별시,은평구,증산동,증산동제2투,3264,2262,876,494,565,152,157,2,0,0,1,1,0,1,1,2250,12,1002
서울특별시,은평구,증산동,증산동제3투,2611,1807,706,435,419,127,108,0,0,2,2,0,0,0,1,1800,7,804
서울특별시,은평구,증산동,증산동제4투,2490,1776,750,335,428,126,127,1,0,0,4,0,1,0,1,1773,3,714
서울특별시,은평구,수색동,합계,12304,9276,3665,2073,2346,558,553,20,2,6,7,1,2,7,3,9243,33,3028
서울특별시,은평구,수색동,관내사전투표,2330,2330,1025,457,544,139,141,6,2,2,2,0,1,2,0,2321,9,0
서울특별시,은평구,수색동,수색동제1투,1947,1260,430,307,346,82,81,2,0,2,0,0,0,1,1,1252,8,687
서울특별시,은평구,수색동,수색동제2투,2181,1539,560,380,402,105,81,3,0,0,0,1,0,2,0,1534,5,642
서울특별시,은평구,수색동,수색동제3투,1793,1183,471,266,309,61,65,2,0,1,1,0,0,1,2,1179,4,610
서울특별시,은평구,수색동,수색동제4투,1550,1006,358,254,267,45,75,3,0,1,0,0,0,0,0,1003,3,544
서울특별시,은평구,수색동,수색동제5투,2503,1958,821,409,478,126,110,4,0,0,4,0,1,1,0,1954,4,545
서울특별시,은평구,신사제1동,합계,22490,17264,7728,3185,4035,1064,1125,22,2,10,17,9,2,1,9,17209,55,5226
서울특별시,은평구,신사제1동,관내사전투표,5619,5619,2719,955,1211,335,377,1,0,3,2,2,0,0,0,5605,14,0
서울특별시,은평구,신사제1동,신사제1동제1투,3831,2480,1096,458,612,151,140,4,0,2,2,3,0,1,2,2471,9,1351
서울특별시,은평구,신사제1동,신사제1동제2투,3594,2491,1085,486,561,167,170,2,1,3,6,0,0,0,3,2484,7,1103
서울특별시,은평구,신사제1동,신사제1동제3투,3632,2522,1092,462,638,156,149,5,0,1,2,0,1,0,1,2507,15,1110
서울특별시,은평구,신사제1동,신사제1동제4투,2254,1537,667,302,330,95,125,5,1,0,1,3,0,0,1,1530,7,717
서울특별시,은평구,신사제1동,신사제1동제5투,3560,2615,1069,522,683,160,164,5,0,1,4,1,1,0,2,2612,3,945
서울특별시,은평구,신사제2동,합계,15973,11709,5019,2312,2748,758,767,27,1,3,12,6,3,3,13,11672,37,4264
서울특별시,은평구,신사제2동,관내사전투표,2419,2419,1125,439,517,163,154,8,0,1,0,1,1,1,2,2412,7,0
서울특별시,은평구,신사제2동,신사제2동제1투,2443,1703,694,357,404,95,137,5,0,0,5,0,0,0,1,1698,5,740
서울특별시,은평구,신사제2동,신사제2동제2투,2828,2054,872,410,465,159,124,9,0,0,5,1,0,0,2,2047,7,774
서울특별시,은평구,신사제2동,신사제2동제3투,3144,2003,826,388,515,115,138,3,0,0,1,1,2,0,5,1994,9,1141
서울특별시,은평구,신사제2동,신사제2동제4투,2416,1744,747,339,422,121,104,0,1,1,1,0,0,1,0,1737,7,672
서울특별시,은평구,신사제2동,신사제2동제5투,2723,1786,755,379,425,105,110,2,0,1,0,3,0,1,3,1784,2,937
서울특별시,은평구,갈현제2동,합계,23394,17148,7372,3324,3896,1041,1324,15,3,15,71,6,2,7,9,17085,63,6246
서울특별시,은평구,갈현제2동,관내사전투표,4719,4719,2286,774,891,287,433,2,0,7,15,4,1,0,3,4703,16,0
서울특별시,은평구,갈현제2동,갈현제2동제1투,3864,2389,995,499,593,124,153,3,0,2,7,1,0,3,3,2383,6,1475
서울특별시,은평구,갈현제2동,갈현제2동제2투,3961,2681,1065,551,662,172,196,1,0,4,19,0,0,2,0,2672,9,1280
서울특별시,은평구,갈현제2동,갈현제2동제3투,4267,2697,1104,555,622,168,216,4,0,2,16,0,0,0,0,2687,10,1570
서울특별시,은평구,갈현제2동,갈현제2동제4투,3248,2247,870,488,559,139,163,3,1,0,10,1,1,0,2,2237,10,1001
서울특별시,은평구,갈현제2동,갈현제2동제5투,3335,2415,1052,457,569,151,163,2,2,0,4,0,0,2,1,2403,12,920
서울특별시,은평구,구산동,합계,25870,18643,7862,3794,4376,1047,1317,16,4,15,84,8,2,7,11,18543,100,7227
서울특별시,은평구,구산동,관내사전투표,4581,4581,2173,769,970,263,347,4,3,1,12,1,0,3,2,4548,33,0
서울특별시,은평구,구산동,구산동제1투,4415,2636,1081,584,597,145,199,0,0,4,19,0,0,2,0,2631,5,1779
서울특별시,은평구,구산동,구산동제2투,4103,2924,1234,559,689,194,219,0,0,1,11,1,1,0,3,2912,12,1179
서울특별시,은평구,구산동,구산동제3투,3530,2078,837,425,503,122,132,5,1,2,10,2,1,0,2,2042,36,1452
서울특별시,은평구,구산동,구산동제4투,1902,1312,562,254,326,69,92,0,0,3,1,0,0,0,1,1308,4,590
서울특별시,은평구,구산동,구산동제5투,3765,2630,1053,570,667,129,181,3,0,4,15,1,0,0,3,2626,4,1135
서울특별시,은평구,구산동,구산동제6투,3574,2482,922,633,624,125,147,4,0,0,16,3,0,2,0,2476,6,1092
서울특별시,은평구,갈현제1동,합계,19920,14468,6082,3105,3245,884,1014,20,2,11,34,6,1,5,6,14415,53,5452
서울특별시,은평구,갈현제1동,관내사전투표,4246,4246,1928,801,922,239,315,4,1,3,13,1,0,1,2,4230,16,0
서울특별시,은평구,갈현제1동,갈현제1동제1투,2865,1740,698,417,378,103,120,3,0,3,7,2,0,0,0,1731,9,1125
서울특별시,은평구,갈현제1동,갈현제1동제2투,2656,1754,647,442,430,96,121,1,0,2,6,0,0,2,2,1749,5,902
서울특별시,은평구,갈현제1동,갈현제1동제3투,3298,2121,895,452,477,137,143,3,0,1,2,0,0,2,1,2113,8,1177
서울특별시,은평구,갈현제1동,갈현제1동제4투,3423,2199,880,518,515,137,133,3,0,0,3,1,0,0,0,2190,9,1224
서울특별시,은평구,갈현제1동,갈현제1동제5투,3432,2408,1034,475,523,172,182,6,1,2,3,2,1,0,1,2402,6,1024
서울특별시,은평구,진관동,합계,37342,30597,14020,5651,6696,2014,1988,41,2,12,65,12,5,10,6,30522,75,6745
서울특별시,은평구,진관동,관내사전투표,7812,7812,3963,1276,1441,486,584,11,0,1,14,6,1,3,2,7788,24,0
서울특별시,은평구,진관동,진관동제1투,3048,2367,932,514,610,140,143,5,0,3,9,0,1,0,0,2357,10,681
서울특별시,은평구,진관동,진관동제2투,2827,2258,936,476,538,151,147,0,0,1,4,0,0,0,1,2254,4,569
서울특별시,은평구,진관동,진관동제3투,2759,2146,917,474,491,139,107,3,1,0,7,0,0,1,0,2140,6,613
서울특별시,은평구,진관동,진관동제4투,2444,1921,835,379,466,102,126,0,0,1,7,0,0,0,0,1916,5,523
서울특별시,은평구,진관동,진관동제5투,3031,2408,1056,474,527,181,149,2,1,1,8,0,1,3,2,2405,3,623
서울특별시,은평구,진관동,진관동제6투,2949,2295,969,490,523,162,139,4,0,0,3,0,1,0,0,2291,4,654
서울특별시,은평구,진관동,진관동제7투,2835,2224,1002,429,497,167,120,3,0,0,2,0,0,2,0,2222,2,611
서울특별시,은평구,진관동,진관동제8투,2106,1707,697,373,405,118,95,6,0,2,5,0,0,1,0,1702,5,399
서울특별시,은평구,진관동,진관동제9투,2799,2294,1093,373,524,145,147,1,0,1,1,4,0,0,0,2289,5,505
서울특별시,은평구,진관동,진관동제10투,2742,2206,1112,299,488,148,144,5,0,1,2,2,1,0,0,2202,4,536
서울특별시,은평구,진관동,진관동제11투,1990,959,508,94,186,75,87,1,0,1,3,0,0,0,1,956,3,1031
서울특별시,은평구,불광제1동,합계,32907,25334,10898,5063,5890,1608,1653,38,1,9,66,10,6,10,9,25261,73,7573
서울특별시,은평구,불광제1동,관내사전투표,6157,6157,2960,1025,1293,400,437,4,0,4,10,2,1,3,3,6142,15,0
서울특별시,은평구,불광제1동,불광제1동제1투,3360,1955,828,425,475,104,107,2,0,1,6,1,0,0,1,1950,5,1405
서울특별시,은평구,불광제1동,불광제1동제2투,3604,2822,1120,677,656,179,168,6,0,1,3,4,0,1,1,2816,6,782
서울특별시,은평구,불광제1동,불광제1동제3투,3109,2035,866,426,496,98,129,4,0,0,3,0,1,0,2,2025,10,1074
서울특별시,은평구,불광제1동,불광제1동제4투,2538,2027,791,479,448,156,131,7,1,1,11,0,0,0,0,2025,2,511
서울특별시,은평구,불광제1동,불광제1동제5투,3507,2753,1231,476,661,185,182,5,0,0,6,1,1,0,0,2748,5,754
서울특별시,은평구,불광제1동,불광제1동제6투,2871,2015,818,431,507,120,126,1,0,0,3,0,1,3,0,2010,5,856
서울특별시,은평구,불광제1동,불광제1동제7투,4563,3346,1384,701,776,233,208,6,0,2,14,0,0,3,2,3329,17,1217
서울특별시,은평구,불광제1동,불광제1동제8투,3198,2224,900,423,578,133,165,3,0,0,10,2,2,0,0,2216,8,974
서울특별시,은평구,불광제2동,합계,23291,16718,6771,3685,4102,886,1093,27,3,10,47,8,5,8,10,16655,63,6573
서울특별시,은평구,불광제2동,관내사전투표,4040,4040,1795,795,934,203,266,5,0,3,13,1,1,3,4,4023,17,0
서울특별시,은평구,불광제2동,불광제2동제1투,2624,1578,593,373,422,91,86,3,1,1,3,0,0,0,0,1573,5,1046
서울특별시,은평구,불광제2동,불광제2동제2투,2801,1875,752,379,482,104,137,2,0,0,3,3,1,0,2,1865,10,926
서울특별시,은평구,불광제2동,불광제2동제3투,3018,1948,794,412,478,90,156,3,1,0,6,0,1,0,1,1942,6,1070
서울특별시,은평구,불광제2동,불광제2동제4투,2417,1485,569,366,351,89,91,3,1,1,4,0,1,2,1,1479,6,932
서울특별시,은평구,불광제2동,불광제2동제5투,2967,1979,755,458,504,102,128,5,0,3,8,0,1,1,1,1966,13,988
서울특별시,은평구,불광제2동,불광제2동제6투,2534,1777,692,434,421,101,115,2,0,0,6,4,0,0,0,1775,2,757
서울특별시,은평구,불광제2동,불광제2동제7투,2890,2036,821,468,510,106,114,4,0,2,4,0,0,2,1,2032,4,854
서울특별시,은평구,대조동,합계,25563,18410,7888,3550,4336,1157,1289,20,0,15,54,12,5,8,4,18338,72,7153
서울특별시,은평구,대조동,관내사전투표,4690,4690,2245,763,974,311,338,5,0,8,22,1,2,2,1,4672,18,0
서울특별시,은평구,대조동,대조동제1투,3539,2308,924,494,534,168,164,2,0,3,6,0,0,0,0,2295,13,1231
서울특별시,은평구,대조동,대조동제2투,4029,2510,1048,451,646,166,175,3,0,1,7,1,0,1,2,2501,9,1519
서울특별시,은평구,대조동,대조동제3투,3454,2323,928,480,614,132,146,3,0,1,7,3,0,1,0,2315,8,1131
서울특별시,은평구,대조동,대조동제4투,3234,2154,906,450,529,101,151,1,0,0,4,0,0,1,1,2144,10,1080
서울특별시,은평구,대조동,대조동제5투,3061,1972,832,395,469,120,136,2,0,1,3,4,2,1,0,1965,7,1089
서울특별시,은평구,대조동,대조동제6투,3556,2453,1005,517,570,159,179,4,0,1,5,3,1,2,0,2446,7,1103
서울특별시,은평구,역촌동,합계,38391,28318,12632,5268,6547,1643,1975,40,5,19,56,15,11,15,10,28236,82,10073
서울특별시,은평구,역촌동,관내사전투표,7487,7487,3735,1170,1517,431,583,5,3,5,16,2,1,5,3,7476,11,0
서울특별시,은평구,역촌동,역촌동제1투,4292,2523,1146,479,547,145,173,1,0,3,8,0,4,3,0,2509,14,1769
서울특별시,은평구,역촌동,역촌동제2투,3595,2599,1108,479,636,180,169,6,0,0,7,2,0,2,2,2591,8,996
서울특별시,은평구,역촌동,역촌동제3투,3013,2114,878,471,493,126,126,6,0,1,3,3,1,0,1,2109,5,899
서울특별시,은평구,역촌동,역촌동제4투,3749,2448,1080,462,575,139,166,7,1,2,2,1,0,2,0,2437,11,1301
서울특별시,은평구,역촌동,역촌동제5투,2904,1904,776,372,480,122,139,4,0,2,2,0,1,0,0,1898,6,1000
서울특별시,은평구,역촌동,역촌동제6투,2633,1795,704,396,471,98,111,4,1,1,1,2,1,1,0,1791,4,838
서울특별시,은평구,역촌동,역촌동제7투,2916,2036,837,442,510,101,123,3,0,1,4,2,3,2,2,2030,6,880
서울특별시,은평구,역촌동,역촌동제8투,3734,2639,1204,469,635,143,167,2,0,4,8,0,0,0,0,2632,7,1095
서울특별시,은평구,역촌동,역촌동제9투,4068,2773,1164,528,683,158,218,2,0,0,5,3,0,0,2,2763,10,1295
서울특별시,은평구,잘못 투입·구분된 투표지,,0,0,0,0,0,0,0,0,0,0,0,0,0,0,0,0,0,0
서울특별시,서대문구,합계,,268987,212076,93768,40513,46237,14798,15165,336,25,110,72,119,27,64,125,211359,717,56911
서울특별시,서대문구,거소·선상투표,,460,437,138,71,154,40,16,1,0,0,2,1,2,0,0,425,12,23
서울특별시,서대문구,관외사전투표,,27115,27074,13155,3713,5258,2210,2490,37,4,13,5,26,3,11,24,26949,125,41
서울특별시,서대문구,재외투표,,3546,2699,1549,239,408,112,367,17,1,1,0,0,0,2,0,2696,3,847
서울특별시,서대문구,충현동,합계,13418,9415,3923,2159,2107,613,544,24,0,5,0,6,1,3,4,9389,26,4003
서울특별시,서대문구,충현동,관내사전투표,1568,1568,747,305,328,98,81,3,0,1,0,0,0,1,0,1564,4,0
서울특별시,서대문구,충현동,충현동제1투,3124,1825,730,444,434,105,101,4,0,0,0,1,1,2,1,1823,2,1299
서울특별시,서대문구,충현동,충현동제2투,2665,1772,669,447,407,123,103,6,0,4,0,4,0,0,1,1764,8,893
서울특별시,서대문구,충현동,충현동제3투,933,640,263,156,141,40,38,1,0,0,0,0,0,0,0,639,1,293
서울특별시,서대문구,충현동,충현동제4투,2673,1957,811,466,423,127,116,6,0,0,0,1,0,0,1,1951,6,716
서울특별시,서대문구,충현동,충현동제5투,2455,1653,703,341,374,120,105,4,0,0,0,0,0,0,1,1648,5,802
서울특별시,서대문구,천연동,관내사전투표,2602,2602,1270,455,483,166,209,4,0,0,0,4,0,0,0,2591,11,0
서울특별시,서대문구,천연동,합계,14496,11498,5084,2419,2402,791,728,14,2,4,2,7,2,1,8,11464,34,2998
서울특별시,서대문구,천연동,천연동제1투,2842,1886,724,468,443,141,95,6,0,0,1,1,0,0,1,1880,6,956
서울특별시,서대문구,천연동,천연동제2투,2868,2185,1028,448,444,117,134,1,1,1,0,1,0,0,5,2180,5,683
서울특별시,서대문구,천연동,천연동제3투,2485,1889,821,388,416,142,112,2,0,1,1,1,1,0,0,1885,4,596
서울특별시,서대문구,천연동,천연동제4투,599,459,230,83,86,24,33,0,1,1,0,0,0,0,1,459,0,140
서울특별시,서대문구,천연동,천연동제5투,3100,2477,1011,577,530,201,145,1,0,1,0,0,1,1,1,2469,8,623
서울특별시,서대문구,북아현동,합계,12244,9563,4271,1810,2057,721,645,11,1,2,3,2,0,3,6,9532,31,2681
서울특별시,서대문구,북아현동,관내사전투표,2763,2763,1369,474,513,199,199,2,0,0,1,0,0,0,1,2758,5,0
서울특별시,서대문구,북아현동,북아현동제1투,2376,1473,573,381,305,96,100,1,0,2,0,0,0,1,1,1460,13,903
서울특별시,서대문구,북아현동,북아현동제2투,2116,1426,629,296,337,63,89,2,0,0,1,2,0,1,1,1421,5,690
서울특별시,서대문구,북아현동,북아현동제3투,3034,2369,1058,375,551,207,161,5,1,0,1,0,0,1,2,2362,7,665
서울특별시,서대문구,북아현동,북아현동제4투,1955,1532,642,284,351,156,96,1,0,0,0,0,0,0,1,1531,1,423
서울특별시,서대문구,신촌동,합계,13417,9816,4407,1704,1796,945,898,13,1,3,1,3,0,2,7,9780,36,3601
서울특별시,서대문구,신촌동,관내사전투표,1895,1895,966,186,271,230,232,0,1,0,0,1,0,0,1,1888,7,0
서울특별시,서대문구,신촌동,신촌동제1투,1658,1181,441,295,223,114,94,3,0,2,0,0,0,0,1,1173,8,477
서울특별시,서대문구,신촌동,신촌동제2투,2559,1658,692,318,347,142,147,7,0,0,1,0,0,1,0,1655,3,901
서울특별시,서대문구,신촌동,신촌동제3투,1956,1258,532,263,229,111,114,1,0,0,0,0,0,1,0,1251,7,698
서울특별시,서대문구,신촌동,신촌동제4투,2697,1923,884,329,357,190,154,0,0,0,0,1,0,0,1,1916,7,774
서울특별시,서대문구,신촌동,신촌동제5투,2652,1901,892,313,369,158,157,2,0,1,0,1,0,0,4,1897,4,751
서울특별시,서대문구,연희동,합계,28217,21133,8928,4590,4287,1515,1672,33,0,9,6,4,2,5,10,21061,72,7084
서울특별시,서대문구,연희동,관내사전투표,4171,4171,2012,750,668,326,388,3,0,3,2,0,1,1,3,4157,14,0
서울특별시,서대문구,연희동,연희동제1투,3336,1910,776,459,412,139,116,3,0,0,0,0,0,1,1,1907,3,1426
서울특별시,서대문구,연희동,연희동제2투,1985,1510,553,446,296,105,104,1,0,0,0,1,0,0,0,1506,4,475
서울특별시,서대문구,연희동,연희동제3투,2529,1748,728,438,323,112,134,5,0,1,0,1,0,0,0,1742,6,781
서울특별시,서대문구,연희동,연희동제4투,3054,2150,901,459,525,99,145,4,0,0,1,0,0,1,4,2139,11,904
서울특별시,서대문구,연희동,연희동제5투,2202,1560,642,373,356,66,109,0,0,2,1,1,0,1,2,1553,7,642
서울특별시,서대문구,연희동,연희동제6투,2696,2014,821,421,468,144,140,7,0,2,2,0,0,1,0,2006,8,682
서울특별시,서대문구,연희동,연희동제7투,2672,1978,767,492,437,143,129,6,0,0,0,0,0,0,0,1974,4,694
서울특별시,서대문구,연희동,연희동제8투,2727,1977,802,393,382,193,198,1,0,0,0,0,0,0,0,1969,8,750
서울특별시,서대문구,연희동,연희동제9투,2845,2115,926,359,420,188,209,3,0,1,0,1,1,0,0,2108,7,730
서울특별시,서대문구,홍제제1동,합계,17977,13837,5967,2889,3066,920,899,17,5,9,7,9,2,4,8,13802,35,4140
서울특별시,서대문구,홍제제1동,관내사전투표,1974,1974,947,340,383,125,165,2,0,1,1,0,0,1,2,1967,7,0
서울특별시,서대문구,홍제제1동,홍제제1동제1투,2604,1670,701,366,371,124,96,1,0,1,1,0,0,2,0,1663,7,934
서울특별시,서대문구,홍제제1동,홍제제1동제2투,2800,2210,879,487,572,129,122,2,1,4,3,3,1,0,2,2205,5,590
서울특별시,서대문구,홍제제1동,홍제제1동제3투,2604,1973,845,433,446,107,127,5,2,1,0,0,0,0,0,1966,7,631
서울특별시,서대문구,홍제제1동,홍제제1동제4투,2263,1618,650,387,373,93,107,1,0,0,1,1,0,1,1,1615,3,645
서울특별시,서대문구,홍제제1동,홍제제1동제5투,1933,1472,642,309,315,91,101,4,1,1,1,1,1,0,2,1469,3,461
서울특별시,서대문구,홍제제1동,홍제제1동제6투,1769,1415,642,280,298,123,69,2,0,0,0,1,0,0,0,1415,0,354
서울특별시,서대문구,홍제제1동,홍제제1동제7투,2030,1505,661,287,308,128,112,0,1,1,0,3,0,0,1,1502,3,525
서울특별시,서대문구,홍제제2동,합계,12225,9834,4194,2067,2204,699,601,20,1,6,5,4,0,2,5,9808,26,2391
서울특별시,서대문구,홍제제2동,관내사전투표,3149,3149,1494,628,584,198,226,5,0,1,2,0,0,0,1,3139,10,0
서울특별시,서대문구,홍제제2동,홍제제2동제1투,1981,1245,486,282,323,70,66,3,0,1,2,2,0,1,1,1237,8,736
서울특별시,서대문구,홍제제2동,홍제제2동제2투,2743,2152,841,464,496,204,136,4,1,0,1,1,0,0,1,2149,3,591
서울특별시,서대문구,홍제제2동,홍제제2동제3투,2243,1682,719,361,395,122,76,2,0,2,0,0,0,0,2,1679,3,561
서울특별시,서대문구,홍제제2동,홍제제2동제4투,2109,1606,654,332,406,105,97,6,0,2,0,1,0,1,0,1604,2,503
서울특별시,서대문구,홍제제3동,합계,13755,10177,4313,2031,2502,600,645,15,0,6,8,5,2,11,5,10143,34,3578
서울특별시,서대문구,홍제제3동,관내사전투표,2295,2295,1125,356,511,134,147,4,0,1,2,0,0,3,0,2283,12,0
서울특별시,서대문구,홍제제3동,홍제제3동제1투,2539,1538,574,349,425,68,109,2,0,0,0,0,1,3,2,1533,5,1001
서울특별시,서대문구,홍제제3동,홍제제3동제2투,2356,1720,714,358,398,126,110,3,0,1,4,3,1,1,1,1720,0,636
서울특별시,서대문구,홍제제3동,홍제제3동제3투,2642,1965,860,358,486,125,123,2,0,1,0,1,0,1,1,1958,7,677
서울특별시,서대문구,홍제제3동,홍제제3동제4투,1504,989,379,207,263,68,61,1,0,2,1,1,0,1,0,984,5,515
서울특별시,서대문구,홍제제3동,홍제제3동제5투,2419,1670,661,403,419,79,95,3,0,1,1,0,0,2,1,1665,5,749
서울특별시,서대문구,홍은제1동,합계,18102,13908,5873,2842,3347,822,918,25,2,14,2,13,5,4,6,13873,35,4194
서울특별시,서대문구,홍은제1동,관내사전투표,3375,3375,1565,605,751,198,232,3,2,4,0,4,2,2,0,3368,7,0
서울특별시,서대문구,홍은제1동,홍은제1동제1투,2668,1596,679,296,443,67,97,4,0,3,0,0,0,0,1,1590,6,1072
서울특별시,서대문구,홍은제1동,홍은제1동제2투,2326,1741,732,402,390,102,108,2,0,0,0,0,0,1,1,1738,3,585
서울특별시,서대문구,홍은제1동,홍은제1동제3투,2802,2188,907,466,502,153,143,5,0,1,0,1,0,1,1,2180,8,614
서울특별시,서대문구,홍은제1동,홍은제1동제4투,1425,1017,435,218,221,57,78,5,0,1,1,0,0,0,1,1017,0,408
서울특별시,서대문구,홍은제1동,홍은제1동제5투,2793,2102,825,461,528,130,140,1,0,3,1,3,1,0,1,2094,8,691
서울특별시,서대문구,홍은제1동,홍은제1동제6투,2713,1889,730,394,512,115,120,5,0,2,0,5,2,0,1,1886,3,824
서울특별시,서대문구,홍은제2동,관내사전투표,3734,3734,1802,673,750,219,264,4,0,4,0,3,1,1,0,3721,13,0
서울특별시,서대문구,홍은제2동,합계,22127,16369,7052,3478,3630,1022,1067,23,1,12,5,12,2,5,6,16315,54,5758
서울특별시,서대문구,홍은제2동,홍은제2동제1투,3160,1894,799,408,430,123,117,6,0,1,1,1,0,2,0,1888,6,1266
서울특별시,서대문구,홍은제2동,홍은제2동제2투,2814,2087,852,467,480,142,131,1,0,4,1,4,0,0,1,2083,4,727
서울특별시,서대문구,홍은제2동,홍은제2동제3투,3414,2612,1103,626,569,153,134,8,1,2,0,0,0,1,3,2600,12,802
서울특별시,서대문구,홍은제2동,홍은제2동제4투,2780,1881,817,374,461,103,116,0,0,1,0,0,0,1,1,1874,7,899
서울특별시,서대문구,홍은제2동,홍은제2동제5투,2988,1973,814,442,450,121,138,2,0,0,1,1,0,0,0,1969,4,1015
서울특별시,서대문구,홍은제2동,홍은제2동제6투,3237,2188,865,488,490,161,167,2,0,0,2,3,1,0,1,2180,8,1049
서울특별시,서대문구,남가좌제1동,합계,13005,10732,4914,1845,2435,825,651,12,0,6,8,5,0,2,2,10705,27,2273
서울특별시,서대문구,남가좌제1동,관내사전투표,3502,3501,1787,516,705,253,217,4,0,1,3,4,0,1,1,3492,9,1
서울특별시,서대문구,남가좌제1동,남가좌제1동제1투,2652,1904,811,361,441,156,128,2,0,0,1,0,0,0,0,1900,4,748
서울특별시,서대문구,남가좌제1동,남가좌제1동제2투,2257,1824,835,300,450,130,99,0,0,5,0,0,0,0,0,1819,5,433
서울특별시,서대문구,남가좌제1동,남가좌제1동제3투,2683,2129,957,322,502,190,147,2,0,0,2,1,0,0,1,2124,5,554
서울특별시,서대문구,남가좌제1동,남가좌제1동제4투,1911,1374,524,346,337,96,60,4,0,0,2,0,0,1,0,1370,4,537
서울특별시,서대문구,남가좌제2동,합계,17741,13522,5847,2688,3024,868,962,24,3,7,7,10,3,3,9,13455,67,4219
서울특별시,서대문구,남가좌제2동,관내사전투표,3272,3272,1604,496,637,209,292,3,1,1,4,1,0,1,3,3252,20,0
서울특별시,서대문구,남가좌제2동,남가좌제2동제1투,2776,1623,628,362,389,105,122,6,0,0,1,0,0,0,1,1614,9,1153
서울특별시,서대문구,남가좌제2동,남가좌제2동제2투,2193,1551,679,349,355,78,79,0,0,1,1,1,0,0,1,1544,7,642
서울특별시,서대문구,남가좌제2동,남가좌제2동제3투,2580,2024,786,519,474,124,110,1,0,0,1,0,1,1,2,2019,5,556
서울특별시,서대문구,남가좌제2동,남가좌제2동제4투,1225,890,380,163,210,66,61,2,0,1,0,1,1,1,0,886,4,335
서울특별시,서대문구,남가좌제2동,남가좌제2동제5투,2634,2143,929,440,489,145,123,3,2,3,0,2,1,0,1,2138,5,491
서울특별시,서대문구,남가좌제2동,남가좌제2동제6투,3061,2019,841,359,470,141,175,9,0,1,0,5,0,0,1,2002,17,1042
서울특별시,서대문구,북가좌제1동,합계,15149,12358,5492,2302,2840,892,755,21,3,7,3,3,0,2,7,12327,31,2791
서울특별시,서대문구,북가좌제1동,관내사전투표,3926,3926,1962,634,785,272,258,4,0,0,2,0,0,0,0,3917,9,0
서울특별시,서대문구,북가좌제1동,북가좌제1동제1투,2560,1969,795,422,485,137,116,1,1,2,0,1,0,1,1,1962,7,591
서울특별시,서대문구,북가좌제1동,북가좌제1동제2투,1946,1386,563,289,355,79,93,2,0,1,1,0,0,0,1,1384,2,560
서울특별시,서대문구,북가좌제1동,북가좌제1동제3투,2115,1461,587,330,349,85,96,3,2,3,0,0,0,1,2,1458,3,654
서울특별시,서대문구,북가좌제1동,북가좌제1동제4투,2769,2257,1043,374,505,199,120,7,0,0,0,1,0,0,2,2251,6,512
서울특별시,서대문구,북가좌제1동,북가좌제1동제5투,1833,1359,542,253,361,120,72,4,0,1,0,1,0,0,1,1355,4,474
서울특별시,서대문구,북가좌제2동,합계,25993,19681,8648,3665,4717,1200,1304,29,1,6,8,9,3,4,18,19612,69,6312
서울특별시,서대문구,북가좌제2동,관내사전투표,4315,4315,2135,715,882,244,305,2,0,2,4,3,1,1,3,4297,18,0
서울특별시,서대문구,북가좌제2동,북가좌제2동제1투,3595,2337,1026,426,574,157,143,2,0,0,0,0,0,0,2,2330,7,1258
서울특별시,서대문구,북가좌제2동,북가좌제2동제2투,3167,2209,947,414,551,128,154,7,0,1,0,0,0,0,2,2204,5,958
서울특별시,서대문구,북가좌제2동,북가좌제2동제3투,2301,1611,647,355,420,86,93,3,0,2,2,0,0,0,0,1608,3,690
서울특별시,서대문구,북가좌제2동,북가좌제2동제4투,3036,2392,976,490,602,159,143,7,0,0,1,3,0,1,1,2383,9,644
서울특별시,서대문구,북가좌제2동,북가좌제2동제5투,2603,1852,804,354,441,108,122,3,1,1,1,1,1,0,3,1840,12,751
서울특별시,서대문구,북가좌제2동,북가좌제2동제6투,3376,2290,974,426,585,139,151,4,0,0,0,2,1,1,3,2286,4,1086
서울특별시,서대문구,북가좌제2동,북가좌제2동제7투,3600,2675,1139,485,662,179,193,1,0,0,0,0,0,1,4,2664,11,925
서울특별시,서대문구,잘못 투입·구분된 투표지,,0,23,13,1,3,3,3,0,0,0,0,0,0,0,0,23,0,-23
서울특별시,마포구,합계,,320483,256992,117336,46547,52545,19059,19795,381,26,134,38,108,47,86,131,256233,759,63491
서울특별시,마포구,거소·선상투표,,434,412,142,79,136,21,13,3,0,0,0,0,2,1,1,398,14,22
서울특별시,마포구,관외사전투표,,30862,30811,15188,4250,5765,2593,2771,29,6,9,5,16,12,13,24,30681,130,51
서울특별시,마포구,재외투표,,4422,3481,2079,304,554,114,407,14,0,1,0,1,1,0,0,3475,6,941
서울특별시,마포구,공덕동,합계,28635,21424,9212,4353,4873,1607,1270,27,2,16,2,2,2,2,10,21378,46,7211
서울특별시,마포구,공덕동,관내사전투표,3162,3162,1555,552,616,225,201,2,0,4,0,0,0,0,0,3155,7,0
서울특별시,마포구,공덕동,공덕동제1투,2545,1779,729,389,479,86,87,0,1,2,0,0,0,0,1,1774,5,766
서울특별시,마포구,공덕동,공덕동제2투,3603,2776,1119,623,645,240,138,0,0,2,0,1,0,0,1,2769,7,827
서울특별시,마포구,공덕동,공덕동제3투,2135,1438,606,303,367,66,85,3,0,2,0,0,0,0,2,1434,4,697
서울특별시,마포구,공덕동,공덕동제4투,3486,1860,841,338,414,148,108,4,0,3,0,0,0,1,1,1858,2,1626
서울특별시,마포구,공덕동,공덕동제5투,2656,1981,859,412,467,115,113,5,0,1,0,1,0,0,1,1974,7,675
서울특별시,마포구,공덕동,공덕동제6투,1961,1552,604,340,396,113,93,1,0,0,2,0,0,1,1,1551,1,409
서울특별시,마포구,공덕동,공덕동제7투,2948,2106,942,400,446,155,150,5,1,0,0,0,0,0,1,2100,6,842
서울특별시,마포구,공덕동,공덕동제8투,2811,2307,971,465,500,222,137,5,0,1,0,0,2,0,0,2303,4,504
서울특별시,마포구,공덕동,공덕동제9투,3328,2463,986,531,543,237,158,2,0,1,0,0,0,0,2,2460,3,865
서울특별시,마포구,아현동,합계,19292,15392,6680,2969,3190,1511,965,21,3,8,1,4,1,5,3,15361,31,3900
서울특별시,마포구,아현동,관내사전투표,3928,3928,1900,597,730,392,295,3,1,0,0,1,0,0,2,3921,7,0
서울특별시,마포구,아현동,아현동제1투,2397,1386,526,369,287,135,67,0,0,0,1,0,0,0,0,1385,1,1011
서울특별시,마포구,아현동,아현동제2투,1917,1517,662,320,315,119,95,0,0,0,0,0,0,1,0,1512,5,400
서울특별시,마포구,아현동,아현동제3투,2376,1899,851,369,379,190,102,3,0,2,0,1,0,0,0,1897,2,477
서울특별시,마포구,아현동,아현동제4투,2190,1393,545,373,292,84,79,9,1,0,0,1,0,2,1,1387,6,797
서울특별시,마포구,아현동,아현동제5투,3026,2444,1006,427,584,250,165,1,1,3,0,0,1,2,0,2440,4,582
서울특별시,마포구,아현동,아현동제6투,3458,2825,1190,514,603,341,162,5,0,3,0,1,0,0,0,2819,6,633
서울특별시,마포구,도화동,합계,18334,14799,6119,3162,3267,1253,907,34,2,6,4,1,2,7,3,14767,32,3535
서울특별시,마포구,도화동,관내사전투표,4163,4163,2019,679,799,350,309,3,0,0,2,0,0,0,0,4161,2,0
서울특별시,마포구,도화동,도화동제1투,2367,1397,611,295,292,108,78,4,0,1,0,0,1,1,2,1393,4,970
서울특별시,마포구,도화동,도화동제2투,2113,1633,601,356,414,148,110,2,0,0,0,0,0,0,0,1631,2,480
서울특별시,마포구,도화동,도화동제3투,1735,1412,510,370,300,155,62,5,1,1,0,0,0,2,1,1407,5,323
서울특별시,마포구,도화동,도화동제4투,1778,1478,610,297,335,144,82,5,1,0,0,0,0,0,0,1474,4,300
서울특별시,마포구,도화동,도화동제5투,1839,1284,471,321,358,62,60,3,0,1,0,1,1,1,0,1279,5,555
서울특별시,마포구,도화동,도화동제6투,2357,1912,669,515,435,178,102,7,0,1,1,0,0,3,0,1911,1,445
서울특별시,마포구,도화동,도화동제7투,1982,1520,628,329,334,108,104,5,0,2,1,0,0,0,0,1511,9,462
서울특별시,마포구,용강동,관내사전투표,3176,3176,1560,540,581,275,206,5,0,0,0,1,0,1,1,3170,6,0
서울특별시,마포구,용강동,합계,15778,12896,5582,2626,2765,1107,749,16,0,4,2,2,3,4,3,12863,33,2882
서울특별시,마포구,용강동,용강동제1투,2910,2216,973,418,500,197,119,1,0,0,0,0,0,1,1,2210,6,694
서울특별시,마포구,용강동,용강동제2투,2271,1678,657,367,400,137,105,2,0,2,0,0,0,1,1,1672,6,593
서울특별시,마포구,용강동,용강동제3투,2821,2162,889,476,445,218,124,3,0,1,0,0,1,0,0,2157,5,659
서울특별시,마포구,용강동,용강동제4투,2237,1816,740,401,419,154,93,2,0,0,0,0,2,0,0,1811,5,421
서울특별시,마포구,용강동,용강동제5투,2363,1848,763,424,420,126,102,3,0,1,2,1,0,1,0,1843,5,515
서울특별시,마포구,대흥동,합계,9577,6769,2973,1332,1351,523,538,9,0,4,1,3,2,6,5,6747,22,2808
서울특별시,마포구,대흥동,관내사전투표,1710,1710,839,262,282,140,174,1,0,1,0,2,0,2,3,1706,4,0
서울특별시,마포구,대흥동,대흥동제1투,2261,1634,675,365,375,119,92,2,0,0,1,0,0,2,1,1632,2,627
서울특별시,마포구,대흥동,대흥동제2투,1275,850,337,184,191,73,60,0,0,0,0,0,0,1,0,846,4,425
서울특별시,마포구,대흥동,대흥동제3투,1747,843,346,168,165,68,87,1,0,1,0,0,1,0,0,837,6,904
서울특별시,마포구,대흥동,대흥동제4투,2584,1732,776,353,338,123,125,5,0,2,0,1,1,1,1,1726,6,852
서울특별시,마포구,염리동,합계,8670,6424,2748,1371,1338,463,449,19,0,4,0,3,1,4,2,6402,22,2246
서울특별시,마포구,염리동,관내사전투표,2055,2055,992,357,408,137,148,2,0,1,0,2,0,3,1,2051,4,0
서울특별시,마포구,염리동,염리동제1투,1955,1173,450,278,253,99,73,11,0,0,0,0,0,0,1,1165,8,782
서울특별시,마포구,염리동,염리동제2투,1557,881,332,242,166,67,68,0,0,1,0,0,0,1,0,877,4,676
서울특별시,마포구,염리동,염리동제3투,1403,999,434,192,228,67,71,0,0,0,0,1,1,0,0,994,5,404
서울특별시,마포구,염리동,염리동제4투,1700,1316,540,302,283,93,89,6,0,2,0,0,0,0,0,1315,1,384
서울특별시,마포구,신수동,합계,15797,12450,5315,2498,2681,1018,855,21,2,9,0,4,1,5,5,12414,36,3347
서울특별시,마포구,신수동,관내사전투표,2941,2941,1378,484,579,226,248,9,0,1,0,3,0,2,1,2931,10,0
서울특별시,마포구,신수동,신수동제1투,2920,1938,840,380,431,154,124,3,0,0,0,0,0,1,1,1934,4,982
서울특별시,마포구,신수동,신수동제2투,2041,1514,581,341,337,140,100,1,2,2,0,0,0,1,1,1506,8,527
서울특별시,마포구,신수동,신수동제3투,1932,1383,559,272,326,122,100,0,0,1,0,0,1,0,0,1381,2,549
서울특별시,마포구,신수동,신수동제4투,3090,2372,931,540,524,191,169,6,0,3,0,1,0,0,1,2366,6,718
서울특별시,마포구,신수동,신수동제5투,2873,2302,1026,481,484,185,114,2,0,2,0,0,0,1,1,2296,6,571
서울특별시,마포구,서강동,합계,19400,15624,6885,2872,3154,1331,1295,23,0,4,0,3,1,1,5,15574,50,3776
서울특별시,마포구,서강동,관내사전투표,3770,3770,1875,543,693,307,333,3,0,0,0,0,0,0,1,3755,15,0
서울특별시,마포구,서강동,서강동제1투,2458,1662,716,341,313,166,116,5,0,0,0,0,0,0,0,1657,5,796
서울특별시,마포구,서강동,서강동제2투,2686,2140,847,453,509,180,144,2,0,0,0,0,0,0,1,2136,4,546
서울특별시,마포구,서강동,서강동제3투,2813,2147,929,411,430,168,196,1,0,0,0,2,1,0,0,2138,9,666
서울특별시,마포구,서강동,서강동제4투,1784,1329,626,202,251,105,138,1,0,2,0,1,0,1,1,1328,1,455
서울특별시,마포구,서강동,서강동제5투,2726,2046,902,365,392,157,216,3,0,2,0,0,0,0,1,2038,8,680
서울특별시,마포구,서강동,서강동제6투,3163,2530,990,557,566,248,152,8,0,0,0,0,0,0,1,2522,8,633
서울특별시,마포구,서교동,합계,19849,14918,6934,2726,2789,1022,1344,20,0,4,4,7,0,9,9,14868,50,4931
서울특별시,마포구,서교동,관내사전투표,3406,3406,1821,449,529,195,388,4,0,1,1,1,0,3,3,3395,11,0
서울특별시,마포구,서교동,서교동제1투,1822,1227,525,278,238,82,92,3,0,0,0,0,0,1,0,1219,8,595
서울특별시,마포구,서교동,서교동제2투,3181,2310,912,535,502,187,158,7,0,0,1,2,0,1,0,2305,5,871
서울특별시,마포구,서교동,서교동제3투,2336,1733,818,307,324,125,147,0,0,1,0,1,0,1,1,1725,8,603
서울특별시,마포구,서교동,서교동제4투,3400,2157,1045,374,403,130,193,2,0,1,0,1,0,1,0,2150,7,1243
서울특별시,마포구,서교동,서교동제5투,1597,1120,489,225,242,72,87,1,0,0,1,0,0,1,1,1119,1,477
서울특별시,마포구,서교동,서교동제6투,1771,1268,550,256,228,100,123,2,0,1,1,1,0,0,1,1263,5,503
서울특별시,마포구,서교동,서교동제7투,2336,1697,774,302,323,131,156,1,0,0,0,1,0,1,3,1692,5,639
서울특별시,마포구,합정동,합계,16283,12676,5840,2163,2506,872,1203,34,2,7,2,3,1,3,5,12641,35,3607
서울특별시,마포구,합정동,관내사전투표,4330,4330,2211,526,758,312,504,9,0,2,0,1,1,0,2,4326,4,0
서울특별시,마포구,합정동,합정동제1투,2033,1452,677,230,303,100,131,4,0,0,1,0,0,0,2,1448,4,581
서울특별시,마포구,합정동,합정동제2투,2155,1569,700,311,340,94,116,3,0,2,0,0,0,0,0,1566,3,586
서울특별시,마포구,합정동,합정동제3투,3141,1934,850,355,413,146,155,6,1,0,0,0,0,2,0,1928,6,1207
서울특별시,마포구,합정동,합정동제4투,2254,1634,652,368,345,107,139,7,1,2,0,1,0,0,1,1623,11,620
서울특별시,마포구,합정동,합정동제5투,2370,1757,750,373,347,113,158,5,0,1,1,1,0,1,0,1750,7,613
서울특별시,마포구,망원1동,관내사전투표,3740,3740,1946,501,654,199,416,2,1,3,0,2,0,1,4,3729,11,0
서울특별시,마포구,망원1동,합계,17419,13261,6137,2382,2714,738,1189,18,3,7,3,11,4,3,10,13219,42,4158
서울특별시,마포구,망원1동,망원1동제1투,2850,1753,756,357,377,111,140,1,0,1,1,2,0,0,1,1747,6,1097
서울특별시,마포구,망원1동,망원1동제2투,2943,2108,937,440,399,124,185,8,0,1,0,2,1,0,1,2098,10,835
서울특별시,마포구,망원1동,망원1동제3투,2721,1904,838,347,440,100,164,1,1,2,1,3,1,1,2,1901,3,817
서울특별시,마포구,망원1동,망원1동제4투,3256,2328,1036,458,504,115,198,4,1,0,0,1,2,0,1,2320,8,928
서울특별시,마포구,망원1동,망원1동제5투,1909,1428,624,279,340,89,86,2,0,0,1,1,0,1,1,1424,4,481
서울특별시,마포구,망원2동,관내사전투표,3047,3047,1624,400,537,176,291,3,0,4,0,2,1,1,1,3040,7,0
서울특별시,마포구,망원2동,합계,15260,12083,5649,2243,2455,697,942,14,0,17,3,8,4,4,7,12043,40,3177
서울특별시,마포구,망원2동,망원2동제1투,2601,1820,786,388,401,100,131,6,0,1,0,1,0,0,1,1815,5,781
서울특별시,마포구,망원2동,망원2동제2투,2074,1582,700,325,336,101,106,0,0,6,0,0,0,0,0,1574,8,492
서울특별시,마포구,망원2동,망원2동제3투,2767,2053,897,427,449,112,151,2,0,2,2,1,2,1,0,2046,7,714
서울특별시,마포구,망원2동,망원2동제4투,2651,1950,876,398,416,96,144,1,0,3,0,3,1,2,2,1942,8,701
서울특별시,마포구,망원2동,망원2동제5투,2120,1631,766,305,316,112,119,2,0,1,1,1,0,0,3,1626,5,489
서울특별시,마포구,연남동,합계,14164,10979,5256,1982,1996,665,1014,11,3,6,1,3,1,3,8,10949,30,3185
서울특별시,마포구,연남동,관내사전투표,3271,3271,1740,409,539,195,369,4,1,3,1,1,0,0,0,3262,9,0
서울특별시,마포구,연남동,연남동제1투,2594,1675,765,355,302,109,133,2,0,0,0,0,1,0,1,1668,7,919
서울특별시,마포구,연남동,연남동제2투,2235,1604,751,277,291,102,168,4,1,1,0,0,0,2,2,1599,5,631
서울특별시,마포구,연남동,연남동제3투,2922,2109,966,441,408,127,160,1,1,0,0,0,0,0,1,2105,4,813
서울특별시,마포구,연남동,연남동제4투,3142,2320,1034,500,456,132,184,0,0,2,0,2,0,1,4,2315,5,822
서울특별시,마포구,성산1동,합계,14950,11152,5217,1963,2286,658,952,19,0,6,2,11,1,2,5,11122,30,3798
서울특별시,마포구,성산1동,관내사전투표,2338,2338,1257,286,395,162,222,4,0,1,0,2,0,0,2,2331,7,0
서울특별시,마포구,성산1동,성산1동제1투,2384,1496,658,282,333,94,119,1,0,2,1,0,1,1,0,1492,4,888
서울특별시,마포구,성산1동,성산1동제2투,2874,2111,977,361,460,102,193,5,0,1,1,4,0,0,0,2104,7,763
서울특별시,마포구,성산1동,성산1동제3투,2206,1585,749,307,280,94,144,3,0,1,0,1,0,0,0,1579,6,621
서울특별시,마포구,성산1동,성산1동제4투,2530,1755,741,381,399,108,118,2,0,0,0,1,0,0,1,1751,4,775
서울특별시,마포구,성산1동,성산1동제5투,2618,1867,835,346,419,98,156,4,0,1,0,3,0,1,2,1865,2,751
서울특별시,마포구,성산2동,관내사전투표,4692,4692,2375,661,858,339,427,5,1,7,4,4,1,1,2,4685,7,0
서울특별시,마포구,성산2동,합계,28835,22833,10468,4106,4902,1555,1647,23,3,15,5,15,5,10,15,22769,64,6002
서울특별시,마포구,성산2동,성산2동제1투,2790,2245,907,503,512,167,140,3,1,0,0,1,0,0,4,2238,7,545
서울특별시,마포구,성산2동,성산2동제2투,3316,2209,928,424,535,127,172,2,1,0,0,3,0,4,0,2196,13,1107
서울특별시,마포구,성산2동,성산2동제3투,3380,2441,1111,433,560,138,191,1,0,0,0,1,0,1,0,2436,5,939
서울특별시,마포구,성산2동,성산2동제4투,2904,2177,1031,395,458,161,122,1,0,1,0,1,0,1,1,2172,5,727
서울특별시,마포구,성산2동,성산2동제5투,2005,1408,598,297,320,88,92,1,0,0,1,0,1,1,1,1400,8,597
서울특별시,마포구,성산2동,성산2동제6투,1632,1159,477,287,289,36,51,1,0,2,0,1,1,2,4,1151,8,473
서울특별시,마포구,성산2동,성산2동제7투,2470,2075,977,331,434,180,140,2,0,2,0,3,0,0,2,2071,4,395
서울특별시,마포구,성산2동,성산2동제8투,2921,2305,1063,400,490,171,170,5,0,2,0,0,1,0,0,2302,3,616
서울특별시,마포구,성산2동,성산2동제9투,2725,2122,1001,375,446,148,142,2,0,1,0,1,1,0,1,2118,4,603
서울특별시,마포구,상암동,합계,22522,18607,8911,3166,3823,1311,1285,26,0,7,3,11,3,4,11,18561,46,3915
서울특별시,마포구,상암동,관내사전투표,4065,4065,2254,504,635,292,362,4,0,0,0,2,1,2,2,4058,7,0
서울특별시,마포구,상암동,상암동제1투,2482,1698,754,344,354,109,119,3,0,1,0,6,0,0,1,1691,7,784
서울특별시,마포구,상암동,상암동제2투,2473,1829,777,405,416,109,107,5,0,2,0,0,0,0,2,1823,6,644
서울특별시,마포구,상암동,상암동제3투,1943,1623,760,285,364,128,80,0,0,0,0,0,0,0,0,1617,6,320
서울특별시,마포구,상암동,상암동제4투,2919,2443,1084,523,511,196,118,3,0,0,0,2,0,2,0,2439,4,476
서울특별시,마포구,상암동,상암동제5투,2717,2206,1024,385,492,154,140,3,0,1,0,0,0,0,1,2200,6,511
서울특별시,마포구,상암동,상암동제6투,2747,2157,998,333,494,151,168,5,0,0,2,0,1,0,2,2154,3,590
서울특별시,마포구,상암동,상암동제7투,3176,2586,1260,387,557,172,191,3,0,3,1,1,1,0,3,2579,7,590
서울특별시,마포구,잘못 투입·구분된 투표지,,0,1,1,0,0,0,0,0,0,0,0,0,0,0,0,1,0,-1
서울특별시,양천구,합계,,386393,310886,133853,60814,71816,22987,19309,422,32,194,60,121,61,88,183,309940,946,75507
서울특별시,양천구,거소·선상투표,,487,460,171,66,165,24,15,1,2,1,2,1,1,0,1,450,10,27
서울특별시,양천구,관외사전투표,,34400,34398,16175,5092,7533,2746,2536,38,6,18,8,8,13,10,44,34227,171,2
서울특별시,양천구,재외투표,,4288,3333,1949,241,557,162,401,10,0,1,1,0,1,0,1,3324,9,955
서울특별시,양천구,목1동,관내사전투표,4403,4403,2069,700,901,419,295,6,0,0,0,2,1,1,3,4397,6,0
서울특별시,양천구,목1동,합계,22209,18462,7714,3678,4235,1651,1084,38,0,1,1,6,2,3,9,18422,40,3747
서울특별시,양천구,목1동,목1동제1투,2866,2213,922,457,517,172,134,6,0,0,0,1,0,0,0,2209,4,653
서울특별시,양천구,목1동,목1동제2투,3085,2461,988,525,589,238,114,1,0,0,0,0,0,0,1,2456,5,624
서울특별시,양천구,목1동,목1동제3투,3348,2531,1036,516,612,194,144,7,0,1,1,2,0,2,4,2519,12,817
서울특별시,양천구,목1동,목1동제4투,2644,2196,961,424,470,189,139,9,0,0,0,1,0,0,0,2193,3,448
서울특별시,양천구,목1동,목1동제5투,3041,2471,999,478,591,229,162,5,0,0,0,0,0,0,1,2465,6,570
서울특별시,양천구,목1동,목1동제6투,2822,2187,739,578,555,210,96,4,0,0,0,0,1,0,0,2183,4,635
서울특별시,양천구,목2동,합계,23920,18961,8424,3531,4112,1465,1325,26,0,7,2,7,3,9,12,18923,38,4959
서울특별시,양천구,목2동,관내사전투표,5701,5701,2798,904,1121,414,445,7,0,0,0,0,0,3,1,5693,8,0
서울특별시,양천구,목2동,목2동제1투,2840,1863,856,344,397,120,137,1,0,0,0,1,0,0,0,1856,7,977
서울특별시,양천구,목2동,목2동제2투,2614,1913,682,453,456,186,121,4,0,2,0,0,0,1,4,1909,4,701
서울특별시,양천구,목2동,목2동제3투,2644,1952,858,393,386,147,145,5,0,2,2,2,1,2,2,1945,7,692
서울특별시,양천구,목2동,목2동제4투,2587,2011,837,383,492,185,110,1,0,0,0,0,0,0,1,2009,2,576
서울특별시,양천구,목2동,목2동제5투,2368,1773,770,328,414,134,121,1,0,3,0,0,0,0,0,1771,2,595
서울특별시,양천구,목2동,목2동제6투,2786,1964,860,398,406,158,123,6,0,0,0,2,2,1,4,1960,4,822
서울특별시,양천구,목2동,목2동제7투,2380,1784,763,328,440,121,123,1,0,0,0,2,0,2,0,1780,4,596
서울특별시,양천구,목3동,합계,16280,12321,5096,2722,2737,935,738,13,1,18,1,5,2,3,7,12278,43,3959
서울특별시,양천구,목3동,관내사전투표,3165,3165,1408,714,618,209,188,5,0,9,0,0,1,0,2,3154,11,0
서울특별시,양천구,목3동,목3동제1투,2126,1687,538,455,408,197,80,1,0,0,0,0,0,1,0,1680,7,439
서울특별시,양천구,목3동,목3동제2투,2810,1839,797,399,372,141,118,3,1,2,0,0,0,0,0,1833,6,971
서울특별시,양천구,목3동,목3동제3투,2785,1744,709,401,406,116,100,0,0,3,0,1,1,1,1,1739,5,1041
서울특별시,양천구,목3동,목3동제4투,2698,1841,797,325,440,124,142,2,0,1,0,2,0,0,3,1836,5,857
서울특별시,양천구,목3동,목3동제5투,2696,2045,847,428,493,148,110,2,0,3,1,2,0,1,1,2036,9,651
서울특별시,양천구,목4동,합계,20136,15814,6903,3001,3532,1199,1058,21,1,24,7,7,1,3,10,15767,47,4322
서울특별시,양천구,목4동,관내사전투표,4215,4215,2029,690,818,336,313,6,0,2,2,3,0,2,5,4206,9,0
서울특별시,양천구,목4동,목4동제1투,2626,1789,760,377,423,114,106,2,0,0,0,0,0,0,1,1783,6,837
서울특별시,양천구,목4동,목4동제2투,2240,1542,640,318,386,105,81,1,0,3,0,0,0,0,0,1534,8,698
서울특별시,양천구,목4동,목4동제3투,2875,2125,865,445,464,186,150,4,0,2,3,0,0,0,1,2120,5,750
서울특별시,양천구,목4동,목4동제4투,2663,1962,860,359,443,133,145,4,1,7,1,1,1,0,1,1956,6,701
서울특별시,양천구,목4동,목4동제5투,2629,1927,743,397,497,160,110,1,0,8,0,0,0,0,2,1918,9,702
서울특별시,양천구,목4동,목4동제6투,2888,2254,1006,415,501,165,153,3,0,2,1,3,0,1,0,2250,4,634
서울특별시,양천구,목5동,관내사전투표,5678,5678,2525,1076,1202,481,368,11,0,2,3,0,0,2,1,5671,7,0
서울특별시,양천구,목5동,합계,28916,24579,9721,5349,5629,2338,1430,35,1,4,7,4,2,10,6,24536,43,4337
서울특별시,양천구,목5동,목5동제1투,2351,1809,694,396,433,172,100,4,0,1,2,2,0,0,1,1805,4,542
서울특별시,양천구,목5동,목5동제2투,2987,2468,959,553,589,224,132,2,0,0,0,1,0,2,0,2462,6,519
서울특별시,양천구,목5동,목5동제3투,2881,2266,870,528,511,217,121,11,0,1,0,0,1,1,0,2261,5,615
서울특별시,양천구,목5동,목5동제4투,2476,2082,724,575,474,209,93,1,0,0,0,1,0,0,1,2078,4,394
서울특별시,양천구,목5동,목5동제5투,2658,1966,738,462,440,205,115,1,0,0,0,0,0,1,2,1964,2,692
서울특별시,양천구,목5동,목5동제6투,1999,1699,615,404,400,177,96,2,0,0,0,0,0,1,1,1696,3,300
서울특별시,양천구,목5동,목5동제7투,2658,2188,756,512,585,226,100,2,0,0,2,0,0,1,0,2184,4,470
서울특별시,양천구,목5동,목5동제8투,2291,1880,742,408,409,193,123,1,1,0,0,0,0,0,0,1877,3,411
서울특별시,양천구,목5동,목5동제9투,2937,2543,1098,435,586,234,182,0,0,0,0,0,1,2,0,2538,5,394
서울특별시,양천구,신월1동,합계,18031,12523,5137,2695,3236,672,669,13,1,26,4,5,2,5,8,12473,50,5508
서울특별시,양천구,신월1동,관내사전투표,2886,2886,1285,593,687,136,153,1,0,10,0,1,1,0,2,2869,17,0
서울특별시,양천구,신월1동,신월1동제1투,3373,2039,792,437,568,125,95,3,1,3,2,1,0,0,1,2028,11,1334
서울특별시,양천구,신월1동,신월1동제2투,3057,1916,754,437,496,100,116,1,0,4,0,2,0,0,1,1911,5,1141
서울특별시,양천구,신월1동,신월1동제3투,2445,1568,646,337,406,81,80,2,0,5,0,1,0,4,2,1564,4,877
서울특별시,양천구,신월1동,신월1동제4투,2896,1779,698,409,494,86,79,3,0,2,0,0,0,1,2,1774,5,1117
서울특별시,양천구,신월1동,신월1동제5투,3374,2335,962,482,585,144,146,3,0,2,2,0,1,0,0,2327,8,1039
서울특별시,양천구,신월2동,합계,17450,13421,5599,2866,3260,915,694,16,2,11,3,7,2,1,7,13383,38,4029
서울특별시,양천구,신월2동,관내사전투표,3179,3179,1382,667,742,197,167,5,0,3,2,5,0,1,1,3172,7,0
서울특별시,양천구,신월2동,신월2동제1투,2854,1922,781,396,475,153,107,0,0,1,0,0,1,0,0,1914,8,932
서울특별시,양천구,신월2동,신월2동제2투,1992,1422,552,335,371,88,64,0,0,3,0,0,0,0,1,1414,8,570
서울특별시,양천구,신월2동,신월2동제3투,3738,2907,1201,624,696,210,157,4,2,2,0,0,1,0,4,2901,6,831
서울특별시,양천구,신월2동,신월2동제4투,2971,2182,945,466,528,136,97,2,0,1,0,2,0,0,0,2177,5,789
서울특별시,양천구,신월2동,신월2동제5투,2716,1809,738,378,448,131,102,5,0,1,1,0,0,0,1,1805,4,907
서울특별시,양천구,신월3동,합계,13323,8916,3631,1872,2344,508,479,16,1,7,0,3,3,5,7,8876,40,4407
서울특별시,양천구,신월3동,관내사전투표,2325,2325,1009,477,569,124,122,7,0,1,0,0,0,4,0,2313,12,0
서울특별시,양천구,신월3동,신월3동제1투,2747,1479,574,312,432,68,77,5,1,2,0,0,1,0,0,1472,7,1268
서울특별시,양천구,신월3동,신월3동제2투,2652,1674,702,311,427,118,106,2,0,0,0,0,0,0,1,1667,7,978
서울특별시,양천구,신월3동,신월3동제3투,2674,1574,649,337,421,78,78,0,0,3,0,2,0,1,2,1571,3,1100
서울특별시,양천구,신월3동,신월3동제4투,2925,1864,697,435,495,120,96,2,0,1,0,1,2,0,4,1853,11,1061
서울특별시,양천구,신월4동,합계,14892,11665,5039,2331,2820,713,688,8,2,11,2,3,4,3,9,11633,32,3227
서울특별시,양천구,신월4동,관내사전투표,2920,2920,1369,564,632,182,153,1,1,2,1,0,2,1,2,2910,10,0
서울특별시,양천구,신월4동,신월4동제1투,3392,2466,1050,490,605,165,142,2,1,3,0,0,0,0,3,2461,5,926
서울특별시,양천구,신월4동,신월4동제2투,2861,2149,896,477,520,112,134,2,0,2,1,2,1,0,1,2148,1,712
서울특별시,양천구,신월4동,신월4동제3투,3388,2445,1011,508,627,136,142,3,0,3,0,1,1,1,1,2434,11,943
서울특별시,양천구,신월4동,신월4동제4투,2331,1685,713,292,436,118,117,0,0,1,0,0,0,1,2,1680,5,646
서울특별시,양천구,신월5동,합계,12684,9605,4098,1914,2256,633,612,13,3,2,2,13,5,3,9,9563,42,3079
서울특별시,양천구,신월5동,관내사전투표,3284,3284,1528,621,668,207,223,2,1,1,1,8,3,1,2,3266,18,0
서울특별시,양천구,신월5동,신월5동제1투,3049,2186,917,444,504,153,153,1,2,0,0,3,0,2,3,2182,4,863
서울특별시,양천구,신월5동,신월5동제2투,3285,2156,860,443,579,138,109,10,0,1,1,2,2,0,4,2149,7,1129
서울특별시,양천구,신월5동,신월5동제3투,3066,1979,793,406,505,135,127,0,0,0,0,0,0,0,0,1966,13,1087
서울특별시,양천구,신월6동,합계,6265,4942,2158,972,1188,277,309,7,0,1,1,2,1,2,3,4921,21,1323
서울특별시,양천구,신월6동,관내사전투표,1896,1896,934,285,417,115,134,0,0,0,1,2,0,1,1,1890,6,0
서울특별시,양천구,신월6동,신월6동제1투,1573,1171,492,228,299,70,77,2,0,0,0,0,0,0,1,1169,2,402
서울특별시,양천구,신월6동,신월6동제2투,1360,831,307,232,207,37,43,2,0,0,0,0,1,0,0,829,2,529
서울특별시,양천구,신월6동,신월6동제3투,1436,1044,425,227,265,55,55,3,0,1,0,0,0,1,1,1033,11,392
서울특별시,양천구,신월7동,합계,18383,13790,5774,2894,3366,827,828,12,1,9,2,9,5,0,10,13737,53,4593
서울특별시,양천구,신월7동,관내사전투표,3358,3358,1585,620,722,200,209,5,1,2,0,2,0,0,2,3348,10,0
서울특별시,양천구,신월7동,신월7동제1투,2828,1766,696,383,451,110,108,1,0,3,0,0,1,0,1,1754,12,1062
서울특별시,양천구,신월7동,신월7동제2투,2569,1765,703,394,449,102,109,1,0,0,0,1,1,0,1,1761,4,804
서울특별시,양천구,신월7동,신월7동제3투,2271,1502,514,379,436,80,81,1,0,0,1,1,0,0,1,1494,8,769
서울특별시,양천구,신월7동,신월7동제4투,2085,1397,530,338,345,80,93,1,0,1,0,0,1,0,1,1390,7,688
서울특별시,양천구,신월7동,신월7동제5투,2767,2095,907,407,516,123,123,0,0,2,1,3,2,0,3,2087,8,672
서울특별시,양천구,신월7동,신월7동제6투,2505,1907,839,373,447,132,105,3,0,1,0,2,0,0,1,1903,4,598
서울특별시,양천구,신정1동,관내사전투표,4231,4231,1993,783,854,313,256,11,0,2,0,3,1,3,0,4219,12,0
서울특별시,양천구,신정1동,합계,15952,13436,5562,2877,3065,1137,716,23,0,5,0,6,1,6,2,13400,36,2516
서울특별시,양천구,신정1동,신정1동제1투,2755,1950,779,429,486,156,91,0,0,2,0,1,0,1,0,1945,5,805
서울특별시,양천구,신정1동,신정1동제2투,2740,2155,870,464,526,176,108,2,0,0,0,0,0,0,1,2147,8,585
서울특별시,양천구,신정1동,신정1동제3투,2216,1858,674,480,428,178,89,3,0,0,0,1,0,0,0,1853,5,358
서울특별시,양천구,신정1동,신정1동제4투,2166,1811,678,413,438,175,100,2,0,0,0,0,0,2,1,1809,2,355
서울특별시,양천구,신정1동,신정1동제5투,1844,1431,568,308,333,139,72,5,0,1,0,1,0,0,0,1427,4,413
서울특별시,양천구,신정2동,관내사전투표,4422,4422,2186,676,863,383,294,5,0,0,1,0,0,0,1,4409,13,0
서울특별시,양천구,신정2동,합계,16377,13445,5926,2443,3050,1075,874,19,2,5,2,5,3,2,4,13410,35,2932
서울특별시,양천구,신정2동,신정2동제1투,3293,2344,981,443,580,166,156,4,2,0,0,1,2,0,1,2336,8,949
서울특별시,양천구,신정2동,신정2동제2투,2872,2204,953,448,494,151,147,3,0,1,1,1,0,1,0,2200,4,668
서울특별시,양천구,신정2동,신정2동제3투,3047,2400,1008,426,614,193,145,3,0,2,0,1,0,1,2,2395,5,647
서울특별시,양천구,신정2동,신정2동제4투,2743,2075,798,450,499,182,132,4,0,2,0,2,1,0,0,2070,5,668
서울특별시,양천구,신정3동,합계,34804,26901,11907,5194,6325,1766,1552,36,4,12,5,12,2,7,14,26836,65,7903
서울특별시,양천구,신정3동,관내사전투표,4075,4075,1966,748,843,268,219,10,0,3,2,0,1,2,4,4066,9,0
서울특별시,양천구,신정3동,신정3동제1투,2328,1702,722,343,431,106,92,1,1,1,0,3,0,1,0,1701,1,626
서울특별시,양천구,신정3동,신정3동제2투,1088,658,285,124,164,42,38,0,0,0,0,0,0,0,2,655,3,430
서울특별시,양천구,신정3동,신정3동제3투,1358,796,292,194,227,40,39,2,0,0,0,0,0,0,0,794,2,562
서울특별시,양천구,신정3동,신정3동제4투,985,542,194,154,138,23,32,0,0,0,0,0,0,0,0,541,1,443
서울특별시,양천구,신정3동,신정3동제5투,2329,1303,502,327,332,70,60,5,0,3,0,1,0,0,0,1300,3,1026
서울특별시,양천구,신정3동,신정3동제6투,2477,1766,766,376,419,92,100,1,0,1,1,2,0,0,1,1759,7,711
서울특별시,양천구,신정3동,신정3동제7투,3005,2420,1018,456,578,201,157,2,0,1,1,0,0,0,1,2415,5,585
서울특별시,양천구,신정3동,신정3동제8투,2706,2107,944,394,469,154,132,3,1,0,0,0,0,0,2,2099,8,599
서울특별시,양천구,신정3동,신정3동제9투,2642,2052,821,415,507,168,134,1,0,0,0,0,0,0,1,2047,5,590
서울특별시,양천구,신정3동,신정3동제10투,3056,2434,1061,440,601,186,133,4,0,1,0,0,1,3,2,2432,2,622
서울특별시,양천구,신정3동,신정3동제11투,2501,1937,915,364,439,103,105,4,1,1,0,1,0,0,0,1933,4,564
서울특별시,양천구,신정3동,신정3동제12투,2406,1934,902,333,465,108,116,2,0,1,0,3,0,0,0,1930,4,472
서울특별시,양천구,신정3동,신정3동제13투,1917,1586,785,270,325,105,91,1,1,0,0,1,0,0,1,1580,6,331
서울특별시,양천구,신정3동,신정3동제14투,1931,1589,734,256,387,100,104,0,0,0,1,1,0,1,0,1584,5,342
서울특별시,양천구,신정4동,합계,27350,20578,8974,4085,4873,1220,1299,28,2,14,2,6,4,7,8,20522,56,6772
서울특별시,양천구,신정4동,관내사전투표,4654,4654,2367,708,960,269,319,9,1,3,2,2,0,0,1,4641,13,0
서울특별시,양천구,신정4동,신정4동제1투,3087,2191,963,418,530,133,135,3,0,3,0,1,0,0,0,2186,5,896
서울특별시,양천구,신정4동,신정4동제2투,2537,1770,722,401,434,92,109,1,1,1,0,0,2,2,1,1766,4,767
서울특별시,양천구,신정4동,신정4동제3투,2623,1556,577,380,394,93,97,3,0,3,0,1,0,1,1,1550,6,1067
서울특별시,양천구,신정4동,신정4동제4투,2670,1974,862,365,479,125,131,2,0,1,0,0,0,1,1,1967,7,696
서울특별시,양천구,신정4동,신정4동제5투,3044,2243,937,484,556,124,126,3,0,1,0,1,0,1,1,2234,9,801
서울특별시,양천구,신정4동,신정4동제6투,2811,1938,796,402,483,110,134,0,0,1,0,0,1,1,2,1930,8,873
서울특별시,양천구,신정4동,신정4동제7투,2716,1922,794,388,490,129,116,3,0,1,0,1,0,0,0,1922,0,794
서울특별시,양천구,신정4동,신정4동제8투,3208,2330,956,539,547,145,132,4,0,0,0,0,1,1,1,2326,4,878
서울특별시,양천구,신정6동,관내사전투표,3711,3711,1763,644,734,323,237,3,0,3,0,0,0,1,0,3708,3,0
서울특별시,양천구,신정6동,합계,17855,15444,6403,3156,3478,1364,974,19,2,6,2,7,0,4,3,15418,26,2411
서울특별시,양천구,신정6동,신정6동제1투,2175,1743,602,465,400,174,94,4,2,0,1,0,0,0,1,1743,0,432
서울특별시,양천구,신정6동,신정6동제2투,1914,1516,584,397,331,112,84,3,0,0,0,0,0,0,0,1511,5,398
서울특별시,양천구,신정6동,신정6동제3투,2965,2507,943,566,604,224,154,4,0,1,0,3,0,1,1,2501,6,458
서울특별시,양천구,신정6동,신정6동제4투,2848,2424,1052,431,537,221,173,2,0,1,0,2,0,0,1,2420,4,424
서울특별시,양천구,신정6동,신정6동제5투,2522,2154,982,315,485,206,154,3,0,1,1,2,0,0,0,2149,5,368
서울특별시,양천구,신정6동,신정6동제6투,1720,1389,477,338,387,104,78,0,0,0,0,0,0,2,0,1386,3,331
서울특별시,양천구,신정7동,관내사전투표,3325,3325,1586,542,678,287,215,4,0,2,2,1,1,0,2,3320,5,0
서울특별시,양천구,신정7동,합계,22391,17892,7492,3835,4055,1360,1028,30,1,11,6,5,4,5,9,17841,51,4499
서울특별시,양천구,신정7동,신정7동제1투,2270,1596,637,352,371,139,95,0,1,0,0,0,0,0,0,1595,1,674
서울특별시,양천구,신정7동,신정7동제2투,1964,1641,722,311,361,138,98,2,0,1,2,0,0,1,1,1637,4,323
서울특별시,양천구,신정7동,신정7동제3투,3205,2304,919,525,547,168,128,2,0,1,1,0,0,2,1,2294,10,901
서울특별시,양천구,신정7동,신정7동제4투,2557,2037,943,364,447,153,121,4,0,0,0,0,1,1,0,2034,3,520
서울특별시,양천구,신정7동,신정7동제5투,2343,1656,593,489,398,87,74,2,0,4,0,2,0,0,2,1651,5,687
서울특별시,양천구,신정7동,신정7동제6투,2392,1705,616,468,424,91,78,7,0,2,0,0,1,1,1,1689,16,687
서울특별시,양천구,신정7동,신정7동제7투,2460,2092,916,404,468,164,127,6,0,0,0,1,0,0,2,2088,4,368
서울특별시,양천구,신정7동,신정7동제8투,1875,1536,560,380,361,133,92,3,0,1,1,1,1,0,0,1533,3,339
서울특별시,양천구,잘못 투입·구분된 투표지,,0,0,0,0,0,0,0,0,0,0,0,0,0,0,0,0,0,0
서울특별시,강서구,합계,,501800,397108,175882,76601,88128,27544,26001,569,56,248,77,215,60,142,284,395807,1301,104692
서울특별시,강서구,거소·선상투표,,731,685,235,139,218,50,15,0,3,0,1,1,0,2,4,668,17,46
서울특별시,강서구,관외사전투표,,44281,44261,21545,6236,9025,3407,3592,58,12,20,13,31,10,12,65,44026,235,20
서울특별시,강서구,재외투표,,4736,3693,2205,308,563,160,429,17,0,0,0,0,1,1,1,3685,8,1043
서울특별시,강서구,염창동,관내사전투표,5895,5895,3069,828,1133,427,412,9,0,0,2,3,0,2,2,5887,8,0
서울특별시,강서구,염창동,합계,28483,24012,11169,4192,5139,1900,1492,34,2,7,5,9,1,5,7,23962,50,4471
서울특별시,강서구,염창동,염창동제1투,2520,1924,777,458,423,147,106,2,0,2,0,0,0,0,2,1917,7,596
서울특별시,강서구,염창동,염창동제2투,2989,2423,996,515,547,213,142,3,0,0,0,0,1,0,2,2419,4,566
서울특별시,강서구,염창동,염창동제3투,3129,2522,1177,412,534,218,158,7,0,2,1,3,0,1,0,2513,9,607
서울특별시,강서구,염창동,염창동제4투,2768,2266,1090,364,464,194,144,2,0,0,0,1,0,0,0,2259,7,502
서울특별시,강서구,염창동,염창동제5투,2517,1853,839,315,422,144,125,4,0,1,0,1,0,0,1,1852,1,664
서울특별시,강서구,염창동,염창동제6투,3392,2775,1268,483,628,218,170,2,0,0,0,1,0,0,0,2770,5,617
서울특별시,강서구,염창동,염창동제7투,2414,2036,926,375,466,140,118,3,2,0,1,0,0,0,0,2031,5,378
서울특별시,강서구,염창동,염창동제8투,2859,2318,1027,442,522,199,117,2,0,2,1,0,0,2,0,2314,4,541
서울특별시,강서구,등촌제1동,합계,17544,13881,6203,2568,2810,1174,1059,15,1,5,2,3,0,2,1,13843,38,3663
서울특별시,강서구,등촌제1동,관내사전투표,4408,4408,2170,691,762,377,389,4,0,1,1,2,0,1,0,4398,10,0
서울특별시,강서구,등촌제1동,등촌제1동제1투,3031,2298,1025,440,490,185,142,3,1,2,1,0,0,0,0,2289,9,733
서울특별시,강서구,등촌제1동,등촌제1동제2투,3526,2443,867,672,562,188,139,3,0,0,0,0,0,1,1,2433,10,1083
서울특별시,강서구,등촌제1동,등촌제1동제3투,3519,2533,1156,406,515,232,215,3,0,1,0,0,0,0,0,2528,5,986
서울특별시,강서구,등촌제1동,등촌제1동제4투,3060,2199,985,359,481,192,174,2,0,1,0,1,0,0,0,2195,4,861
서울특별시,강서구,등촌제2동,관내사전투표,3747,3747,1798,681,701,294,253,5,0,1,1,2,0,1,4,3741,6,0
서울특별시,강서구,등촌제2동,합계,16791,13357,5526,2894,2965,1028,841,22,0,11,1,9,3,5,13,13318,39,3434
서울특별시,강서구,등촌제2동,등촌제2동제1투,3102,2207,893,472,540,158,125,3,0,5,0,2,1,0,0,2199,8,895
서울특별시,강서구,등촌제2동,등촌제2동제2투,3580,2592,1159,512,553,182,166,2,0,4,0,2,0,0,2,2582,10,988
서울특별시,강서구,등촌제2동,등촌제2동제3투,3126,2135,816,506,500,145,157,2,0,0,0,1,0,3,1,2131,4,991
서울특별시,강서구,등촌제2동,등촌제2동제4투,3236,2676,860,723,671,249,140,10,0,1,0,2,2,1,6,2665,11,560
서울특별시,강서구,등촌제3동,관내사전투표,5245,5245,2527,908,1066,374,337,7,0,2,2,3,0,3,2,5231,14,0
서울특별시,강서구,등촌제3동,합계,27588,21592,9201,4624,4816,1516,1265,31,3,15,2,13,2,14,14,21516,76,5996
서울특별시,강서구,등촌제3동,등촌제3동제1투,2810,1889,723,471,470,120,85,5,0,2,0,1,1,2,3,1883,6,921
서울특별시,강서구,등촌제3동,등촌제3동제2투,2981,2419,1029,447,574,206,154,1,1,0,0,1,0,1,0,2414,5,562
서울특별시,강서구,등촌제3동,등촌제3동제3투,2864,2279,1043,443,471,180,133,5,0,1,0,0,0,1,0,2277,2,585
서울특별시,강서구,등촌제3동,등촌제3동제4투,2272,1474,496,426,362,85,79,4,0,3,0,1,0,2,2,1460,14,798
서울특별시,강서구,등촌제3동,등촌제3동제5투,2231,1541,614,371,361,95,80,3,0,1,0,0,0,1,2,1528,13,690
서울특별시,강서구,등촌제3동,등촌제3동제6투,2559,1732,658,433,406,122,97,2,0,3,0,2,0,2,0,1725,7,827
서울특별시,강서구,등촌제3동,등촌제3동제7투,2596,2070,974,390,438,139,124,0,1,1,0,0,0,1,1,2069,1,526
서울특별시,강서구,등촌제3동,등촌제3동제8투,2284,1513,517,451,357,82,81,3,1,2,0,2,1,1,4,1502,11,771
서울특별시,강서구,등촌제3동,등촌제3동제9투,1746,1430,620,284,311,113,95,1,0,0,0,3,0,0,0,1427,3,316
서울특별시,강서구,화곡본동,합계,26429,18912,8784,3305,4263,1133,1280,31,2,10,0,16,3,4,14,18845,67,7517
서울특별시,강서구,화곡본동,관내사전투표,4550,4550,2372,709,847,268,328,7,0,1,0,2,1,3,1,4539,11,0
서울특별시,강서구,화곡본동,화곡본동제1투,3761,2275,967,455,525,144,163,1,1,1,0,5,0,1,4,2267,8,1486
서울특별시,강서구,화곡본동,화곡본동제2투,4131,2525,1140,474,582,144,162,6,0,2,0,1,0,0,3,2514,11,1606
서울특별시,강서구,화곡본동,화곡본동제3투,3437,2370,1068,444,571,136,129,7,0,3,0,2,1,0,1,2362,8,1067
서울특별시,강서구,화곡본동,화곡본동제4투,3121,2249,999,440,493,154,152,0,0,1,0,1,0,0,1,2241,8,872
서울특별시,강서구,화곡본동,화곡본동제5투,3667,2417,1096,380,617,122,187,2,1,1,0,1,0,0,1,2408,9,1250
서울특별시,강서구,화곡본동,화곡본동제6투,3762,2526,1142,403,628,165,159,8,0,1,0,4,1,0,3,2514,12,1236
서울특별시,강서구,화곡제1동,합계,41042,29356,12921,5535,6955,1828,1926,31,3,22,8,14,4,13,24,29284,72,11686
서울특별시,강서구,화곡제1동,관내사전투표,6575,6575,3181,1087,1386,401,476,10,1,3,2,7,0,0,7,6561,14,0
서울특별시,강서구,화곡제1동,화곡제1동제1투,4232,2445,1029,494,622,139,151,2,0,2,0,0,0,0,2,2441,4,1787
서울특별시,강서구,화곡제1동,화곡제1동제2투,3605,2403,1042,449,580,147,165,8,0,0,1,2,0,1,1,2396,7,1202
서울특별시,강서구,화곡제1동,화곡제1동제3투,4132,2591,1129,505,612,171,157,2,1,2,0,1,1,2,0,2583,8,1541
서울특별시,강서구,화곡제1동,화곡제1동제4투,3617,2354,932,510,593,148,151,3,0,3,0,0,0,2,2,2344,10,1263
서울특별시,강서구,화곡제1동,화곡제1동제5투,2771,2011,826,403,524,124,127,1,0,2,0,0,1,1,1,2010,1,760
서울특별시,강서구,화곡제1동,화곡제1동제6투,2950,1908,846,330,456,131,129,1,0,1,0,0,1,3,2,1900,8,1042
서울특별시,강서구,화곡제1동,화곡제1동제7투,3217,2209,943,431,570,136,116,3,0,1,3,1,0,0,0,2204,5,1008
서울특별시,강서구,화곡제1동,화곡제1동제8투,3109,2165,942,442,476,149,141,1,0,4,0,3,0,0,4,2162,3,944
서울특별시,강서구,화곡제1동,화곡제1동제9투,3283,2217,966,462,545,105,127,0,0,3,0,0,0,4,2,2214,3,1066
서울특별시,강서구,화곡제1동,화곡제1동제10투,3551,2478,1085,422,591,177,186,0,1,1,2,0,1,0,3,2469,9,1073
서울특별시,강서구,화곡제2동,합계,14997,10822,4936,1973,2526,617,676,4,1,29,3,6,3,4,6,10784,38,4175
서울특별시,강서구,화곡제2동,관내사전투표,2994,2994,1522,439,623,163,212,1,0,17,0,1,0,1,3,2982,12,0
서울특별시,강서구,화곡제2동,화곡제2동제1투,2182,1503,601,368,354,78,90,1,1,1,1,1,1,0,1,1498,5,679
서울특별시,강서구,화곡제2동,화곡제2동제2투,2889,1765,743,379,433,104,98,0,0,5,1,0,1,0,0,1764,1,1124
서울특별시,강서구,화곡제2동,화곡제2동제3투,3461,2286,1065,382,553,132,142,1,0,2,0,0,0,1,1,2279,7,1175
서울특별시,강서구,화곡제2동,화곡제2동제4투,3471,2274,1005,405,563,140,134,1,0,4,1,4,1,2,1,2261,13,1197
서울특별시,강서구,화곡제3동,관내사전투표,4628,4628,2236,759,949,300,356,7,1,3,0,1,0,1,1,4614,14,0
서울특별시,강서구,화곡제3동,합계,19182,15343,6309,3427,3503,1043,962,37,2,8,0,3,1,2,5,15302,41,3839
서울특별시,강서구,화곡제3동,화곡제3동제1투,2696,1836,751,397,449,127,100,5,0,1,0,0,0,0,0,1830,6,860
서울특별시,강서구,화곡제3동,화곡제3동제2투,2954,1831,751,387,436,118,118,6,1,1,0,0,0,1,2,1821,10,1123
서울특별시,강서구,화곡제3동,화곡제3동제3투,2915,2190,928,488,471,130,155,11,0,2,0,1,0,0,1,2187,3,725
서울특별시,강서구,화곡제3동,화곡제3동제4투,3035,2545,784,848,593,200,109,3,0,1,0,1,1,0,0,2540,5,490
서울특별시,강서구,화곡제3동,화곡제3동제5투,2954,2313,859,548,605,168,124,5,0,0,0,0,0,0,1,2310,3,641
서울특별시,강서구,화곡제4동,관내사전투표,3672,3672,1789,667,768,174,246,5,1,0,0,4,0,0,2,3656,16,0
서울특별시,강서구,화곡제4동,합계,17922,12869,5513,2732,3035,674,809,19,1,12,2,9,4,4,5,12819,50,5053
서울특별시,강서구,화곡제4동,화곡제4동제1투,2880,1848,736,456,463,86,91,1,0,3,1,1,1,1,0,1840,8,1032
서울특별시,강서구,화곡제4동,화곡제4동제2투,2823,1765,700,423,420,103,108,3,0,2,0,0,0,1,0,1760,5,1058
서울특별시,강서구,화곡제4동,화곡제4동제3투,3203,1856,781,357,466,111,127,2,0,1,1,1,2,1,1,1851,5,1347
서울특별시,강서구,화곡제4동,화곡제4동제4투,2403,1584,629,339,399,84,116,5,0,4,0,0,0,0,1,1577,7,819
서울특별시,강서구,화곡제4동,화곡제4동제5투,2941,2144,878,490,519,116,121,3,0,2,0,3,1,1,1,2135,9,797
서울특별시,강서구,화곡제6동,합계,20341,15602,6591,3356,3503,1031,990,30,1,8,4,6,0,5,13,15538,64,4739
서울특별시,강서구,화곡제6동,관내사전투표,4671,4671,2328,756,901,306,348,8,1,2,1,4,0,1,4,4660,11,0
서울특별시,강서구,화곡제6동,화곡제6동제1투,3540,2223,977,463,491,126,144,8,0,3,1,1,0,0,3,2217,6,1317
서울특별시,강서구,화곡제6동,화곡제6동제2투,2789,1854,728,416,477,108,98,4,0,0,1,0,0,0,2,1834,20,935
서울특별시,강서구,화곡제6동,화곡제6동제3투,2782,1932,719,482,460,123,127,3,0,2,0,0,0,0,2,1918,14,850
서울특별시,강서구,화곡제6동,화곡제6동제4투,4009,2807,1178,570,672,190,182,2,0,0,0,1,0,3,1,2799,8,1202
서울특별시,강서구,화곡제6동,화곡제6동제5투,2550,2115,661,669,502,178,91,5,0,1,1,0,0,1,1,2110,5,435
서울특별시,강서구,화곡제8동,합계,21335,16019,7336,2885,3767,890,1021,20,2,10,6,14,3,3,14,15971,48,5316
서울특별시,강서구,화곡제8동,관내사전투표,4837,4837,2436,750,1030,272,324,6,0,2,1,4,0,1,3,4829,8,0
서울특별시,강서구,화곡제8동,화곡제8동제1투,3746,2369,1032,466,585,132,136,4,1,2,3,0,0,0,0,2361,8,1377
서울특별시,강서구,화곡제8동,화곡제8동제2투,2948,2003,862,389,493,112,125,3,0,3,0,3,0,1,3,1994,9,945
서울특별시,강서구,화곡제8동,화곡제8동제3투,3432,2371,1037,461,593,116,142,1,0,1,1,3,1,0,7,2363,8,1061
서울특별시,강서구,화곡제8동,화곡제8동제4투,2969,2071,921,367,521,116,139,0,0,1,0,0,0,0,0,2065,6,898
서울특별시,강서구,화곡제8동,화곡제8동제5투,3403,2368,1048,452,545,142,155,6,1,1,1,4,2,1,1,2359,9,1035
서울특별시,강서구,우장산동,합계,31836,25665,11063,5156,5844,1940,1526,48,1,14,0,5,3,5,8,25613,52,6171
서울특별시,강서구,우장산동,관내사전투표,5373,5373,2605,931,1081,379,355,5,0,2,0,2,0,0,1,5361,12,0
서울특별시,강서구,우장산동,우장산동제1투,3554,2414,1066,476,545,179,142,3,0,0,0,0,0,0,1,2412,2,1140
서울특별시,강서구,우장산동,우장산동제2투,2769,1966,819,395,471,134,131,5,0,1,0,0,0,2,0,1958,8,803
서울특별시,강서구,우장산동,우장산동제3투,3327,2413,931,537,598,159,172,5,0,2,0,1,0,0,2,2407,6,914
서울특별시,강서구,우장산동,우장산동제4투,2928,2455,1066,498,538,215,121,9,0,2,0,0,0,0,1,2450,5,473
서울특별시,강서구,우장산동,우장산동제5투,3518,2703,1194,520,635,174,160,7,0,3,0,1,0,2,2,2698,5,815
서울특별시,강서구,우장산동,우장산동제6투,3517,2865,1159,631,671,243,153,4,0,0,0,1,1,0,0,2863,2,652
서울특별시,강서구,우장산동,우장산동제7투,3431,2681,1119,536,656,211,143,4,1,3,0,0,1,0,1,2675,6,750
서울특별시,강서구,우장산동,우장산동제8투,3419,2795,1104,632,649,246,149,6,0,1,0,0,1,1,0,2789,6,624
서울특별시,강서구,가양제1동,합계,20932,16227,7301,2987,3386,1354,1117,18,2,7,2,8,1,5,4,16192,35,4705
서울특별시,강서구,가양제1동,관내사전투표,3693,3693,1846,586,688,298,259,2,0,2,1,2,0,1,2,3687,6,0
서울특별시,강서구,가양제1동,가양제1동제1투,2261,1736,678,384,424,123,114,6,1,0,1,1,0,1,0,1733,3,525
서울특별시,강서구,가양제1동,가양제1동제2투,1678,1209,539,260,276,71,56,1,0,1,0,0,0,0,0,1204,5,469
서울특별시,강서구,가양제1동,가양제1동제3투,2584,1845,647,518,397,165,111,2,0,0,0,1,0,0,0,1841,4,739
서울특별시,강서구,가양제1동,가양제1동제4투,2027,1433,664,269,279,109,99,2,1,3,0,1,1,1,1,1430,3,594
서울특별시,강서구,가양제1동,가양제1동제5투,1723,1377,539,330,310,126,68,0,0,1,0,1,0,0,0,1375,2,346
서울특별시,강서구,가양제1동,가양제1동제6투,2020,1658,667,356,394,140,93,2,0,0,0,1,0,1,0,1654,4,362
서울특별시,강서구,가양제1동,가양제1동제7투,2123,1508,755,150,332,133,127,2,0,0,0,0,0,1,1,1501,7,615
서울특별시,강서구,가양제1동,가양제1동제8투,2823,1768,966,134,286,189,190,1,0,0,0,1,0,0,0,1767,1,1055
서울특별시,강서구,가양제2동,합계,14399,11011,4445,2718,2407,730,602,17,4,7,2,9,6,7,15,10969,42,3388
서울특별시,강서구,가양제2동,관내사전투표,2940,2940,1352,610,552,218,184,3,0,1,2,3,1,0,5,2931,9,0
서울특별시,강서구,가양제2동,가양제2동제1투,1985,1357,425,459,309,100,56,2,1,0,0,0,0,1,2,1355,2,628
서울특별시,강서구,가양제2동,가양제2동제2투,2090,1659,781,300,334,125,110,1,0,0,0,1,1,0,1,1654,5,431
서울특별시,강서구,가양제2동,가양제2동제3투,2598,1703,617,439,444,99,85,3,1,3,0,1,3,2,1,1698,5,895
서울특별시,강서구,가양제2동,가양제2동제4투,2058,1368,486,402,334,80,45,5,2,1,0,1,0,1,2,1359,9,690
서울특별시,강서구,가양제2동,가양제2동제5투,2728,1984,784,508,434,108,122,3,0,2,0,3,1,3,4,1972,12,744
서울특별시,강서구,가양제3동,관내사전투표,3127,3127,1540,517,623,209,209,6,0,1,0,5,0,3,1,3114,13,0
서울특별시,강서구,가양제3동,합계,14139,11040,4705,2429,2482,711,619,18,1,3,2,13,2,5,9,10999,41,3099
서울특별시,강서구,가양제3동,가양제3동제1투,2388,1708,642,447,414,92,97,5,0,0,0,1,0,1,2,1701,7,680
서울특별시,강서구,가양제3동,가양제3동제2투,2350,1539,580,401,379,95,74,2,0,0,0,1,0,0,2,1534,5,811
서울특별시,강서구,가양제3동,가양제3동제3투,2198,1651,699,380,359,118,84,2,1,0,2,1,0,0,1,1647,4,547
서울특별시,강서구,가양제3동,가양제3동제4투,1946,1238,442,335,327,62,53,2,0,1,0,3,2,1,1,1229,9,708
서울특별시,강서구,가양제3동,가양제3동제5투,2130,1777,802,349,380,135,102,1,0,1,0,2,0,0,2,1774,3,353
서울특별시,강서구,발산제1동,합계,27838,22863,10592,3809,5235,1566,1520,28,2,12,3,5,5,11,13,22801,62,4975
서울특별시,강서구,발산제1동,관내사전투표,5530,5530,2704,791,1185,389,424,10,2,3,1,1,0,3,4,5517,13,0
서울특별시,강서구,발산제1동,발산제1동제1투,2596,1973,882,355,478,118,130,3,0,0,0,0,1,0,2,1969,4,623
서울특별시,강서구,발산제1동,발산제1동제2투,2275,1536,673,285,351,109,109,0,0,0,0,0,0,0,1,1528,8,739
서울특별시,강서구,발산제1동,발산제1동제3투,2896,2167,914,447,514,144,135,3,0,1,0,0,1,2,0,2161,6,729
서울특별시,강서구,발산제1동,발산제1동제4투,3249,2596,1160,469,608,185,159,1,0,0,0,0,1,1,1,2585,11,653
서울특별시,강서구,발산제1동,발산제1동제5투,3409,2588,1079,507,634,188,156,6,0,5,0,1,1,2,1,2580,8,821
서울특별시,강서구,발산제1동,발산제1동제6투,3325,2680,1328,379,606,187,168,1,0,0,0,3,1,3,0,2676,4,645
서울특별시,강서구,발산제1동,발산제1동제7투,2443,1999,986,296,455,121,129,3,0,1,2,0,0,0,2,1995,4,444
서울특별시,강서구,발산제1동,발산제1동제8투,2115,1794,866,280,404,125,110,1,0,2,0,0,0,0,2,1790,4,321
서울특별시,강서구,공항동,합계,18075,13098,5571,2749,3021,831,824,6,2,13,5,8,2,9,15,13056,42,4977
서울특별시,강서구,공항동,관내사전투표,3509,3509,1616,667,736,232,239,2,0,7,2,0,1,1,3,3506,3,0
서울특별시,강서구,공항동,공항동제1투,2420,1730,651,436,456,94,82,0,0,1,2,0,0,1,2,1725,5,690
서울특별시,강서구,공항동,공항동제2투,2774,1764,690,406,408,129,117,1,0,0,1,2,1,2,3,1760,4,1010
서울특별시,강서구,공항동,공항동제3투,2730,1538,608,379,328,92,109,1,1,2,0,1,0,3,2,1526,12,1192
서울특별시,강서구,공항동,공항동제4투,2237,1332,529,298,339,64,85,2,1,0,0,2,0,0,3,1323,9,905
서울특별시,강서구,공항동,공항동제5투,2367,1544,623,361,372,86,92,0,0,2,0,0,0,1,1,1538,6,823
서울특별시,강서구,공항동,공항동제6투,2038,1681,854,202,382,134,100,0,0,1,0,3,0,1,1,1678,3,357
서울특별시,강서구,방화제1동,합계,33593,26766,11520,5577,5969,1908,1634,30,5,7,7,13,0,9,11,26690,76,6827
서울특별시,강서구,방화제1동,관내사전투표,6314,6314,2798,1254,1406,400,420,4,3,1,2,4,0,1,2,6295,19,0
서울특별시,강서구,방화제1동,방화제1동제1투,2304,1659,675,393,372,96,111,2,0,0,0,1,0,1,1,1652,7,645
서울특별시,강서구,방화제1동,방화제1동제2투,2786,1881,725,467,427,140,110,3,1,1,0,0,0,1,0,1875,6,905
서울특별시,강서구,방화제1동,방화제1동제3투,2263,1511,591,384,319,121,81,3,0,1,4,1,0,0,2,1507,4,752
서울특별시,강서구,방화제1동,방화제1동제4투,2311,1373,486,373,324,94,86,3,1,1,0,1,0,0,1,1370,3,938
서울특별시,강서구,방화제1동,방화제1동제5투,2600,1971,843,418,453,156,91,1,0,2,0,0,0,0,2,1966,5,629
서울특별시,강서구,방화제1동,방화제1동제6투,2985,2375,1037,487,507,178,149,5,0,0,1,0,0,1,1,2366,9,610
서울특별시,강서구,방화제1동,방화제1동제7투,2338,1749,704,421,377,130,103,5,0,0,0,1,0,0,0,1741,8,589
서울특별시,강서구,방화제1동,방화제1동제8투,2919,2299,1051,421,518,177,125,1,0,0,0,2,0,0,0,2295,4,620
서울특별시,강서구,방화제1동,방화제1동제9투,2793,2355,1110,368,542,174,147,1,0,1,0,2,0,2,1,2348,7,438
서울특별시,강서구,방화제1동,방화제1동제10투,3980,3279,1500,591,724,242,211,2,0,0,0,1,0,3,1,3275,4,701
서울특별시,강서구,방화제2동,합계,18670,13456,5269,3328,3018,871,839,27,4,14,6,6,4,7,13,13406,50,5214
서울특별시,강서구,방화제2동,관내사전투표,2493,2493,1169,507,486,149,164,3,1,2,2,1,0,0,2,2486,7,0
서울특별시,강서구,방화제2동,방화제2동제1투,2854,1862,743,419,404,154,131,0,0,1,0,1,0,1,1,1855,7,992
서울특별시,강서구,방화제2동,방화제2동제2투,2826,1597,561,440,374,114,88,1,1,4,0,3,1,0,2,1589,8,1229
서울특별시,강서구,방화제2동,방화제2동제3투,2811,1980,767,468,484,126,114,6,0,2,0,0,1,2,3,1973,7,831
서울특별시,강서구,방화제2동,방화제2동제4투,2354,1728,686,423,381,109,118,5,0,1,1,1,0,0,1,1726,2,626
서울특별시,강서구,방화제2동,방화제2동제5투,2140,1491,560,362,370,92,80,6,1,1,0,0,2,2,3,1479,12,649
서울특별시,강서구,방화제2동,방화제2동제6투,1423,1016,310,365,207,64,57,2,1,3,2,0,0,0,0,1011,5,407
서울특별시,강서구,방화제2동,방화제2동제7투,1769,1289,473,344,312,63,87,4,0,0,1,0,0,2,1,1287,2,480
서울특별시,강서구,방화제3동,합계,20916,16565,6934,3672,3677,1182,962,28,2,14,3,14,2,8,10,16508,57,4351
서울특별시,강서구,방화제3동,관내사전투표,4979,4979,2430,915,949,317,324,8,0,4,2,5,0,1,2,4957,22,0
서울특별시,강서구,방화제3동,방화제3동제1투,2809,1959,784,409,482,156,119,0,0,1,0,0,0,3,2,1956,3,850
서울특별시,강서구,방화제3동,방화제3동제2투,2023,1568,752,256,346,107,93,2,0,2,0,1,0,1,2,1562,6,455
서울특별시,강서구,방화제3동,방화제3동제3투,2154,1424,484,391,391,69,61,4,2,3,1,3,2,0,0,1411,13,730
서울특별시,강서구,방화제3동,방화제3동제4투,2571,1912,734,470,444,140,115,5,0,1,0,0,0,0,2,1911,1,659
서울특별시,강서구,방화제3동,방화제3동제5투,2062,1656,611,430,355,161,92,2,0,1,0,0,0,2,0,1654,2,406
서울특별시,강서구,방화제3동,방화제3동제6투,1926,1322,449,388,324,92,50,4,0,2,0,3,0,1,2,1315,7,604
서울특별시,강서구,방화제3동,방화제3동제7투,2392,1745,690,413,386,140,108,3,0,0,0,2,0,0,0,1742,3,647
서울특별시,강서구,잘못 투입·구분된 투표지,,0,13,8,2,1,0,1,0,0,0,0,0,0,0,0,12,1,-13
서울특별시,구로구,합계,,350524,278805,121077,59194,61734,17147,17437,373,45,141,57,165,56,98,190,277714,1091,71719
서울특별시,구로구,거소·선상투표,,524,487,165,85,154,30,15,3,3,1,1,0,3,1,0,461,26,37
서울특별시,구로구,관외사전투표,,30689,30683,14980,4508,6272,2198,2425,36,7,12,11,21,10,13,39,30532,151,6
서울특별시,구로구,재외투표,,2994,2380,1459,199,352,101,253,6,2,1,0,3,0,0,1,2377,3,614
서울특별시,구로구,신도림동,관내사전투표,5818,5818,2821,963,1208,421,372,13,0,1,1,1,0,0,4,5805,13,0
서울특별시,구로구,신도림동,합계,27264,23084,9961,4582,5246,1806,1358,37,1,7,4,5,2,4,13,23026,58,4180
서울특별시,구로구,신도림동,신도림동제1투,2499,1831,748,387,412,157,108,3,0,2,0,0,1,0,3,1821,10,668
서울특별시,구로구,신도림동,신도림동제2투,2538,2158,888,457,525,158,118,3,0,2,1,0,0,0,1,2153,5,380
서울특별시,구로구,신도림동,신도림동제3투,2285,1923,816,359,463,149,124,4,0,1,1,0,0,1,2,1920,3,362
서울특별시,구로구,신도림동,신도림동제4투,2551,1890,791,378,451,141,118,4,0,0,0,0,0,1,0,1884,6,661
서울특별시,구로구,신도림동,신도림동제5투,2867,2387,1031,474,538,195,143,0,0,1,0,1,1,0,0,2384,3,480
서울특별시,구로구,신도림동,신도림동제6투,2781,2312,985,493,506,189,128,5,1,0,0,1,0,0,2,2310,2,469
서울특별시,구로구,신도림동,신도림동제7투,3124,2440,994,491,593,213,135,1,0,0,1,2,0,1,1,2432,8,684
서울특별시,구로구,신도림동,신도림동제8투,2801,2325,887,580,550,183,112,4,0,0,0,0,0,1,0,2317,8,476
서울특별시,구로구,구로제1동,합계,15953,13433,6208,2418,2841,990,900,14,0,5,1,15,2,1,6,13401,32,2520
서울특별시,구로구,구로제1동,관내사전투표,4056,4056,2043,663,744,293,291,4,0,2,0,6,0,0,1,4047,9,0
서울특별시,구로구,구로제1동,구로제1동제1투,2439,1905,806,421,406,142,118,2,0,0,0,0,0,1,2,1898,7,534
서울특별시,구로구,구로제1동,구로제1동제2투,2287,1840,766,364,432,137,129,1,0,1,0,3,0,0,1,1834,6,447
서울특별시,구로구,구로제1동,구로제1동제3투,2276,1787,777,345,398,149,105,3,0,0,0,2,0,0,1,1780,7,489
서울특별시,구로구,구로제1동,구로제1동제4투,2016,1596,688,283,397,118,105,0,0,0,0,3,0,0,1,1595,1,420
서울특별시,구로구,구로제1동,구로제1동제5투,2879,2249,1128,342,464,151,152,4,0,2,1,1,2,0,0,2247,2,630
서울특별시,구로구,구로제2동,합계,22119,15354,6514,3633,3566,719,808,20,2,10,6,10,3,7,5,15303,51,6765
서울특별시,구로구,구로제2동,관내사전투표,3236,3236,1538,671,689,123,190,4,0,2,2,3,1,3,0,3226,10,0
서울특별시,구로구,구로제2동,구로제2동제1투,2657,1416,584,331,360,57,78,0,1,0,0,0,0,0,1,1412,4,1241
서울특별시,구로구,구로제2동,구로제2동제2투,1810,1104,453,299,244,53,44,1,0,0,3,1,0,0,1,1099,5,706
서울특별시,구로구,구로제2동,구로제2동제3투,2043,1226,460,326,323,46,57,2,1,0,1,0,0,1,1,1218,8,817
서울특별시,구로구,구로제2동,구로제2동제4투,2287,1449,613,317,364,68,76,2,0,2,0,0,2,0,0,1444,5,838
서울특별시,구로구,구로제2동,구로제2동제5투,1855,1277,535,327,287,54,67,3,0,1,0,0,0,1,0,1275,2,578
서울특별시,구로구,구로제2동,구로제2동제6투,3220,2389,1001,551,548,137,139,2,0,1,0,1,0,1,1,2382,7,831
서울특별시,구로구,구로제2동,구로제2동제7투,1837,1099,451,279,243,65,50,2,0,1,0,2,0,0,1,1094,5,738
서울특별시,구로구,구로제2동,구로제2동제8투,2343,1592,654,421,363,65,79,2,0,1,0,3,0,0,0,1588,4,751
서울특별시,구로구,구로제2동,구로제2동제9투,831,566,225,111,145,51,28,2,0,2,0,0,0,1,0,565,1,265
서울특별시,구로구,구로제3동,합계,20686,16130,8208,2327,3362,1038,1097,11,1,8,2,19,2,4,11,16090,40,4556
서울특별시,구로구,구로제3동,관내사전투표,4549,4549,2480,550,884,277,331,4,0,1,0,6,0,1,4,4538,11,0
서울특별시,구로구,구로제3동,구로제3동제1투,2080,1269,660,170,292,69,66,1,0,0,1,1,0,1,2,1263,6,811
서울특별시,구로구,구로제3동,구로제3동제2투,2220,1433,664,247,367,58,88,2,0,1,1,1,0,0,0,1429,4,787
서울특별시,구로구,구로제3동,구로제3동제3투,2447,1885,865,352,424,131,106,2,0,3,0,0,0,0,1,1884,1,562
서울특별시,구로구,구로제3동,구로제3동제4투,2405,1816,882,296,370,134,126,0,0,0,0,2,1,1,1,1813,3,589
서울특별시,구로구,구로제3동,구로제3동제5투,1832,1376,718,162,250,122,119,0,0,1,0,1,0,0,2,1375,1,456
서울특별시,구로구,구로제3동,구로제3동제6투,2222,1811,807,348,436,100,96,1,0,1,0,8,1,1,1,1800,11,411
서울특별시,구로구,구로제3동,구로제3동제7투,2931,1991,1132,202,339,147,165,1,1,1,0,0,0,0,0,1988,3,940
서울특별시,구로구,구로제4동,합계,18343,13359,5826,2625,3344,700,748,22,5,8,4,13,3,6,6,13310,49,4984
서울특별시,구로구,구로제4동,관내사전투표,2829,2829,1341,505,678,130,149,5,2,2,0,5,0,2,1,2820,9,0
서울특별시,구로구,구로제4동,구로제4동제1투,2809,1871,806,363,493,95,97,0,1,2,0,0,2,2,1,1862,9,938
서울특별시,구로구,구로제4동,구로제4동제2투,2289,1512,579,366,407,69,75,1,0,0,1,4,1,1,1,1505,7,777
서울특별시,구로구,구로제4동,구로제4동제3투,2893,2167,977,363,554,125,130,4,0,0,0,2,0,1,2,2158,9,726
서울특별시,구로구,구로제4동,구로제4동제4투,2243,1304,530,311,343,63,48,2,0,2,1,1,0,0,0,1301,3,939
서울특별시,구로구,구로제4동,구로제4동제5투,3356,2336,1058,413,530,134,181,6,1,2,1,1,0,0,0,2327,9,1020
서울특별시,구로구,구로제4동,구로제4동제6투,1924,1340,535,304,339,84,68,4,1,0,1,0,0,0,1,1337,3,584
서울특별시,구로구,구로제5동,합계,24331,19171,8633,3751,4189,1242,1214,22,2,12,4,13,6,4,8,19100,71,5160
서울특별시,구로구,구로제5동,관내사전투표,4994,4994,2482,831,992,309,339,6,1,2,2,6,3,1,4,4978,16,0
서울특별시,구로구,구로제5동,구로제5동제1투,2843,2025,841,475,467,107,118,2,1,1,1,1,2,1,0,2017,8,818
서울특별시,구로구,구로제5동,구로제5동제2투,3027,2347,971,529,535,164,135,0,0,4,0,0,0,0,0,2338,9,680
서울특별시,구로구,구로제5동,구로제5동제3투,2987,2050,899,430,460,134,117,5,0,0,0,0,0,0,1,2046,4,937
서울특별시,구로구,구로제5동,구로제5동제4투,3592,2351,1095,431,503,133,160,1,0,3,1,5,1,1,0,2334,17,1241
서울특별시,구로구,구로제5동,구로제5동제5투,3760,2807,1291,474,603,212,211,5,0,1,0,0,0,0,1,2798,9,953
서울특별시,구로구,구로제5동,구로제5동제6투,3128,2597,1054,581,629,183,134,3,0,1,0,1,0,1,2,2589,8,531
서울특별시,구로구,가리봉동,합계,8251,4942,2214,1058,1206,198,207,12,3,9,2,6,1,4,4,4924,18,3309
서울특별시,구로구,가리봉동,관내사전투표,534,534,260,101,117,20,28,1,0,0,0,4,0,0,0,531,3,0
서울특별시,구로구,가리봉동,가리봉동제1투,2375,1448,604,350,354,60,57,6,2,2,1,1,1,1,2,1441,7,927
서울특별시,구로구,가리봉동,가리봉동제2투,2841,1689,820,318,401,61,68,4,1,6,1,1,0,2,1,1684,5,1152
서울특별시,구로구,가리봉동,가리봉동제3투,2501,1271,530,289,334,57,54,1,0,1,0,0,0,1,1,1268,3,1230
서울특별시,구로구,고척제1동,합계,19318,15272,6138,3531,3541,985,944,19,2,13,1,8,4,8,8,15202,70,4046
서울특별시,구로구,고척제1동,관내사전투표,4007,4007,1797,835,835,237,267,3,0,4,0,4,0,4,3,3989,18,0
서울특별시,구로구,고척제1동,고척제1동제1투,3198,2316,834,639,544,141,141,2,0,1,0,0,1,3,3,2309,7,882
서울특별시,구로구,고척제1동,고척제1동제2투,3242,2314,913,526,587,139,129,6,0,1,0,2,1,0,1,2305,9,928
서울특별시,구로구,고척제1동,고척제1동제3투,3624,2811,1173,596,631,209,182,2,0,3,0,1,0,0,0,2797,14,813
서울특별시,구로구,고척제1동,고척제1동제4투,2364,1642,578,416,433,110,92,3,0,2,0,0,2,1,1,1638,4,722
서울특별시,구로구,고척제1동,고척제1동제5투,2883,2182,843,519,511,149,133,3,2,2,1,1,0,0,0,2164,18,701
서울특별시,구로구,고척제2동,합계,22027,16756,6768,3813,3935,1060,1038,18,1,11,1,9,2,8,8,16672,84,5271
서울특별시,구로구,고척제2동,관내사전투표,3358,3358,1529,640,712,219,235,4,0,1,1,4,0,1,0,3346,12,0
서울특별시,구로구,고척제2동,고척제2동제1투,2798,1989,770,456,514,120,109,1,0,2,0,2,1,0,2,1977,12,809
서울특별시,구로구,고척제2동,고척제2동제2투,2846,2163,838,540,484,152,134,5,0,1,0,1,0,1,0,2156,7,683
서울특별시,구로구,고척제2동,고척제2동제3투,2918,1969,761,473,484,106,127,1,1,5,0,0,0,0,1,1959,10,949
서울특별시,구로구,고척제2동,고척제2동제4투,2433,1546,594,386,375,83,82,1,0,2,0,1,0,3,3,1530,16,887
서울특별시,구로구,고척제2동,고척제2동제5투,2471,1620,593,445,411,83,72,0,0,0,0,1,1,2,0,1608,12,851
서울특별시,구로구,고척제2동,고척제2동제6투,3105,2561,1023,554,617,180,172,3,0,0,0,0,0,1,0,2550,11,544
서울특별시,구로구,고척제2동,고척제2동제7투,2098,1550,660,319,338,117,107,3,0,0,0,0,0,0,2,1546,4,548
서울특별시,구로구,개봉제1동,합계,26613,19995,7954,4881,4690,1149,1151,18,5,8,5,14,6,5,16,19902,93,6618
서울특별시,구로구,개봉제1동,관내사전투표,4304,4304,1881,934,937,242,273,5,0,2,1,4,0,0,5,4284,20,0
서울특별시,구로구,개봉제1동,개봉제1동제1투,2833,1910,718,516,451,105,99,1,0,1,1,2,2,0,1,1897,13,923
서울특별시,구로구,개봉제1동,개봉제1동제2투,2427,1763,693,455,414,83,98,3,1,1,1,3,0,0,2,1754,9,664
서울특별시,구로구,개봉제1동,개봉제1동제3투,2360,1482,528,414,340,102,85,0,0,1,1,0,3,1,0,1475,7,878
서울특별시,구로구,개봉제1동,개봉제1동제4투,2524,1783,673,468,434,91,99,2,1,0,0,1,0,1,4,1774,9,741
서울특별시,구로구,개봉제1동,개봉제1동제5투,3312,2055,816,488,475,153,113,1,1,0,0,2,0,0,1,2050,5,1257
서울특별시,구로구,개봉제1동,개봉제1동제6투,2386,1573,571,432,386,68,96,1,1,1,0,1,1,1,1,1560,13,813
서울특별시,구로구,개봉제1동,개봉제1동제7투,2366,1689,661,432,420,75,87,1,1,0,0,0,0,2,1,1680,9,677
서울특별시,구로구,개봉제1동,개봉제1동제8투,4101,3436,1413,742,833,230,201,4,0,2,1,1,0,0,1,3428,8,665
서울특별시,구로구,개봉제2동,관내사전투표,4741,4741,2308,943,919,261,280,7,1,0,1,0,0,1,2,4723,18,0
서울특별시,구로구,개봉제2동,합계,26474,21350,9087,4801,4804,1271,1233,42,2,8,4,2,1,2,12,21269,81,5124
서울특별시,구로구,개봉제2동,개봉제2동제1투,2930,2019,819,434,517,114,124,3,0,1,0,0,0,0,0,2012,7,911
서울특별시,구로구,개봉제2동,개봉제2동제2투,2751,1953,851,399,444,104,139,3,1,0,0,0,0,0,2,1943,10,798
서울특별시,구로구,개봉제2동,개봉제2동제3투,2519,2078,792,540,506,125,93,12,0,1,0,0,1,0,0,2070,8,441
서울특별시,구로구,개봉제2동,개봉제2동제4투,3007,2440,1033,537,575,161,117,4,0,0,0,0,0,0,2,2429,11,567
서울특별시,구로구,개봉제2동,개봉제2동제5투,2898,2452,948,651,558,151,129,2,0,2,0,1,0,0,2,2444,8,446
서울특별시,구로구,개봉제2동,개봉제2동제6투,2727,2155,884,523,475,145,109,7,0,1,1,1,0,0,3,2149,6,572
서울특별시,구로구,개봉제2동,개봉제2동제7투,2868,2055,872,430,483,114,139,3,0,3,1,0,0,1,1,2047,8,813
서울특별시,구로구,개봉제2동,개봉제2동제8투,2033,1457,580,344,327,96,103,1,0,0,1,0,0,0,0,1452,5,576
서울특별시,구로구,개봉제3동,합계,16682,12632,5301,2717,3084,700,729,13,1,3,3,1,2,9,12,12575,57,4050
서울특별시,구로구,개봉제3동,관내사전투표,2618,2618,1219,498,558,164,160,2,0,0,0,0,2,2,4,2609,9,0
서울특별시,구로구,개봉제3동,개봉제3동제1투,2779,1924,793,451,492,76,96,4,0,0,0,0,0,1,2,1915,9,855
서울특별시,구로구,개봉제3동,개봉제3동제2투,2959,2026,819,431,515,114,131,3,1,0,0,0,0,1,3,2018,8,933
서울특별시,구로구,개봉제3동,개봉제3동제3투,3033,1931,766,397,511,107,128,1,0,1,3,0,0,2,1,1917,14,1102
서울특별시,구로구,개봉제3동,개봉제3동제4투,2723,2281,919,577,521,130,119,1,0,1,0,0,0,1,2,2271,10,442
서울특별시,구로구,개봉제3동,개봉제3동제5투,2570,1852,785,363,487,109,95,2,0,1,0,1,0,2,0,1845,7,718
서울특별시,구로구,오류제1동,합계,17445,13521,5383,3571,2787,770,897,24,1,5,1,5,2,4,13,13463,58,3924
서울특별시,구로구,오류제1동,관내사전투표,4128,4127,1804,1014,752,232,297,7,0,0,1,1,1,1,2,4112,15,1
서울특별시,구로구,오류제1동,오류제1동제1투,4022,2605,1144,545,546,159,195,4,0,2,0,2,1,0,1,2599,6,1417
서울특별시,구로구,오류제1동,오류제1동제2투,3444,2432,931,675,501,127,170,5,1,2,0,0,0,1,3,2416,16,1012
서울특별시,구로구,오류제1동,오류제1동제3투,3142,2165,709,734,453,135,106,4,0,1,0,1,0,2,6,2151,14,977
서울특별시,구로구,오류제1동,오류제1동제4투,2709,2192,795,603,535,117,129,4,0,0,0,1,0,0,1,2185,7,517
서울특별시,구로구,오류제2동,합계,31509,25023,10565,5957,5400,1358,1548,30,3,13,5,14,5,13,18,24929,94,6486
서울특별시,구로구,오류제2동,관내사전투표,5357,5357,2405,1284,1042,256,330,3,3,2,0,3,3,2,5,5338,19,0
서울특별시,구로구,오류제2동,오류제2동제1투,3455,2478,858,798,572,118,110,1,0,4,2,1,0,3,1,2468,10,977
서울특별시,구로구,오류제2동,오류제2동제2투,3285,2153,821,620,468,119,113,1,0,0,2,0,0,1,3,2148,5,1132
서울특별시,구로구,오류제2동,오류제2동제3투,3154,2428,957,655,507,143,149,0,0,3,0,2,0,0,3,2419,9,726
서울특별시,구로구,오류제2동,오류제2동제4투,3448,2544,982,627,578,145,182,13,0,0,1,1,1,0,3,2533,11,904
서울특별시,구로구,오류제2동,오류제2동제5투,3213,2465,1065,573,529,143,135,2,0,2,0,1,0,4,1,2455,10,748
서울특별시,구로구,오류제2동,오류제2동제6투,3476,2703,1219,536,573,160,189,6,0,2,0,1,1,2,1,2690,13,773
서울특별시,구로구,오류제2동,오류제2동제7투,3441,2775,1347,476,591,151,193,2,0,0,0,2,0,1,1,2764,11,666
서울특별시,구로구,오류제2동,오류제2동제8투,2680,2120,911,388,540,123,147,2,0,0,0,3,0,0,0,2114,6,560
서울특별시,구로구,수궁동,합계,19302,15228,5712,4734,2960,832,872,26,4,7,2,7,2,5,10,15173,55,4074
서울특별시,구로구,수궁동,관내사전투표,3808,3808,1467,1315,576,203,214,9,2,2,1,4,0,1,2,3796,12,0
서울특별시,구로구,수궁동,수궁동제1투,2566,1694,401,804,304,101,79,0,0,0,0,0,0,1,0,1690,4,872
서울특별시,구로구,수궁동,수궁동제2투,2649,1918,737,539,399,116,110,1,1,1,0,1,0,0,2,1907,11,731
서울특별시,구로구,수궁동,수궁동제3투,3504,2565,920,805,520,111,182,10,0,1,0,0,0,2,3,2554,11,939
서울특별시,구로구,수궁동,수궁동제4투,2460,2036,854,488,478,115,92,0,0,1,1,0,0,0,0,2029,7,424
서울특별시,구로구,수궁동,수궁동제5투,2987,2178,887,550,469,125,132,3,0,2,0,1,2,0,1,2172,6,809
서울특별시,구로구,수궁동,수궁동제6투,1328,1029,446,233,214,61,63,3,1,0,0,1,0,1,2,1025,4,299
서울특별시,구로구,잘못 투입·구분된 투표지,,0,5,1,3,1,0,0,0,0,0,0,0,0,0,0,5,0,-5
서울특별시,금천구,합계,,204132,155010,67423,31106,36695,8835,9698,165,24,125,37,117,39,61,128,154453,557,49122
서울특별시,금천구,거소·선상투표,,321,301,128,48,86,13,10,1,2,1,0,1,1,0,2,293,8,20
서울특별시,금천구,관외사전투표,,17514,17504,8753,2354,3699,1189,1323,13,6,7,5,27,6,6,23,17411,93,10
서울특별시,금천구,재외투표,,1330,1033,632,88,148,37,122,3,0,0,0,1,0,0,0,1031,2,297
서울특별시,금천구,가산동,합계,15866,11582,5624,1954,2418,725,763,6,1,8,3,4,3,4,10,11523,59,4284
서울특별시,금천구,가산동,관내사전투표,3081,3081,1662,421,565,172,240,2,0,3,2,1,0,1,2,3071,10,0
서울특별시,금천구,가산동,가산동제1투,3052,1757,811,296,398,130,104,0,0,1,0,1,0,1,1,1743,14,1295
서울특별시,금천구,가산동,가산동제2투,2401,1576,763,239,336,114,106,1,0,2,0,2,1,2,0,1566,10,825
서울특별시,금천구,가산동,가산동제3투,2823,2229,966,442,542,141,126,2,1,0,0,0,1,0,2,2223,6,594
서울특별시,금천구,가산동,가산동제4투,2848,1846,931,313,357,105,123,1,0,2,1,0,0,0,5,1838,8,1002
서울특별시,금천구,가산동,가산동제5투,1043,694,311,172,134,33,37,0,0,0,0,0,1,0,0,688,6,349
서울특별시,금천구,가산동,가산동제6투,618,399,180,71,86,30,27,0,0,0,0,0,0,0,0,394,5,219
서울특별시,금천구,독산제1동,관내사전투표,3426,3426,1741,452,733,217,263,0,1,7,2,2,0,2,2,3422,4,0
서울특별시,금천구,독산제1동,합계,27321,20722,9175,3974,4737,1339,1336,21,1,22,3,13,10,10,12,20653,69,6599
서울특별시,금천구,독산제1동,독산제1동제1투,2734,1591,716,263,360,123,116,0,0,2,0,1,4,0,0,1585,6,1143
서울특별시,금천구,독산제1동,독산제1동제2투,2426,1511,723,279,308,94,95,3,0,1,0,0,0,1,1,1505,6,915
서울특별시,금천구,독산제1동,독산제1동제3투,4669,3148,1432,553,695,221,214,7,0,1,0,4,1,3,0,3131,17,1521
서울특별시,금천구,독산제1동,독산제1동제4투,3685,2998,1253,637,719,201,174,2,0,0,1,1,1,0,2,2991,7,687
서울특별시,금천구,독산제1동,독산제1동제5투,3262,2338,940,584,558,114,110,3,0,6,0,1,2,4,4,2326,12,924
서울특별시,금천구,독산제1동,독산제1동제6투,3817,2911,1144,712,670,181,187,3,0,4,0,0,1,0,3,2905,6,906
서울특별시,금천구,독산제1동,독산제1동제7투,3302,2799,1226,494,694,188,177,3,0,1,0,4,1,0,0,2788,11,503
서울특별시,금천구,독산제2동,합계,16217,11132,4639,2303,2842,589,664,25,0,11,6,13,2,4,6,11104,28,5085
서울특별시,금천구,독산제2동,관내사전투표,2178,2178,1029,373,501,117,139,6,0,2,2,1,0,0,1,2171,7,0
서울특별시,금천구,독산제2동,독산제2동제1투,2270,1345,516,299,368,71,80,3,0,3,0,2,0,0,1,1343,2,925
서울특별시,금천구,독산제2동,독산제2동제2투,2276,1479,575,345,387,82,76,2,0,1,1,4,0,1,1,1475,4,797
서울특별시,금천구,독산제2동,독산제2동제3투,2199,1437,586,300,360,82,100,1,0,2,0,2,0,0,0,1433,4,762
서울특별시,금천구,독산제2동,독산제2동제4투,2246,1507,596,335,401,72,89,2,0,1,1,2,0,1,1,1501,6,739
서울특별시,금천구,독산제2동,독산제2동제5투,2350,1397,585,275,389,74,64,5,0,0,2,0,0,1,0,1395,2,953
서울특별시,금천구,독산제2동,독산제2동제6투,2698,1789,752,376,436,91,116,6,0,2,0,2,2,1,2,1786,3,909
서울특별시,금천구,독산제3동,합계,21016,14851,6476,3150,3538,736,849,12,3,9,6,9,0,7,11,14806,45,6165
서울특별시,금천구,독산제3동,관내사전투표,3720,3720,1769,719,792,176,241,2,1,3,3,2,0,0,2,3710,10,0
서울특별시,금천구,독산제3동,독산제3동제1투,2946,1902,802,412,481,97,99,0,0,1,0,0,0,2,1,1895,7,1044
서울특별시,금천구,독산제3동,독산제3동제2투,3128,2141,876,464,559,113,118,3,0,0,0,0,0,2,1,2136,5,987
서울특별시,금천구,독산제3동,독산제3동제3투,3248,2137,905,449,518,105,144,2,0,2,0,5,0,1,2,2133,4,1111
서울특별시,금천구,독산제3동,독산제3동제4투,2839,1463,623,324,348,74,76,3,0,1,1,2,0,1,3,1456,7,1376
서울특별시,금천구,독산제3동,독산제3동제5투,2524,1693,748,378,410,81,68,1,0,0,1,0,0,0,1,1688,5,831
서울특별시,금천구,독산제3동,독산제3동제6투,2611,1795,753,404,430,90,103,1,2,2,1,0,0,1,1,1788,7,816
서울특별시,금천구,독산제4동,합계,14460,10459,4395,2169,2679,461,683,3,3,8,1,7,4,3,10,10426,33,4001
서울특별시,금천구,독산제4동,관내사전투표,3484,3484,1556,665,864,145,232,1,0,2,0,3,3,1,4,3476,8,0
서울특별시,금천구,독산제4동,독산제4동제1투,2892,1704,688,389,420,83,113,0,0,2,0,1,0,0,1,1697,7,1188
서울특별시,금천구,독산제4동,독산제4동제2투,2855,1845,722,418,482,79,129,2,1,2,0,3,0,2,1,1841,4,1010
서울특별시,금천구,독산제4동,독산제4동제3투,2292,1414,595,303,377,59,73,0,0,2,0,0,0,0,2,1411,3,878
서울특별시,금천구,독산제4동,독산제4동제4투,2937,2012,834,394,536,95,136,0,2,0,1,0,1,0,2,2001,11,925
서울특별시,금천구,시흥제1동,관내사전투표,5221,5221,2253,1129,1202,282,323,5,0,5,0,0,0,1,3,5203,18,0
서울특별시,금천구,시흥제1동,합계,27706,20169,8386,4412,4962,1106,1159,29,5,16,3,9,2,5,14,20108,61,7537
서울특별시,금천구,시흥제1동,시흥제1동제1투,2609,1871,763,396,470,116,110,5,1,2,0,3,0,0,0,1866,5,738
서울특별시,금천구,시흥제1동,시흥제1동제2투,3205,2276,967,468,567,128,133,4,0,2,0,1,0,0,1,2271,5,929
서울특별시,금천구,시흥제1동,시흥제1동제3투,4497,3520,1526,698,858,227,195,0,1,0,0,3,0,2,2,3512,8,977
서울특별시,금천구,시흥제1동,시흥제1동제4투,2342,1379,530,288,396,70,84,3,1,0,0,0,1,0,1,1374,5,963
서울특별시,금천구,시흥제1동,시흥제1동제5투,2584,1575,608,401,395,81,79,0,0,1,2,2,1,1,0,1571,4,1009
서울특별시,금천구,시흥제1동,시흥제1동제6투,2323,1479,631,357,340,67,69,5,0,3,1,0,0,0,3,1476,3,844
서울특별시,금천구,시흥제1동,시흥제1동제7투,2176,1399,568,335,348,60,70,5,2,1,0,0,0,1,3,1393,6,777
서울특별시,금천구,시흥제1동,시흥제1동제8투,2749,1449,540,340,386,75,96,2,0,2,0,0,0,0,1,1442,7,1300
서울특별시,금천구,시흥제2동,관내사전투표,3494,3494,1634,669,767,182,222,4,1,3,0,6,1,0,2,3491,3,0
서울특별시,금천구,시흥제2동,합계,17820,14316,5964,3117,3441,873,828,20,1,7,1,16,1,4,8,14281,35,3504
서울특별시,금천구,시흥제2동,시흥제2동제1투,2374,1437,570,329,361,81,82,0,0,1,0,3,0,0,1,1428,9,937
서울특별시,금천구,시흥제2동,시흥제2동제2투,2359,1775,692,389,477,99,109,2,0,0,0,2,0,1,0,1771,4,584
서울특별시,금천구,시흥제2동,시흥제2동제3투,2599,2146,758,605,515,140,113,6,0,0,0,1,0,1,2,2141,5,453
서울특별시,금천구,시흥제2동,시흥제2동제4투,2681,2236,886,530,548,141,122,2,0,0,0,2,0,0,0,2231,5,445
서울특별시,금천구,시흥제2동,시흥제2동제5투,2479,1993,945,320,444,159,112,5,0,2,0,1,0,1,0,1989,4,486
서울특별시,금천구,시흥제2동,시흥제2동제6투,1834,1235,479,275,329,71,68,1,0,1,1,1,0,1,3,1230,5,599
서울특별시,금천구,시흥제3동,관내사전투표,2213,2213,988,464,507,117,122,2,0,4,1,1,0,1,3,2210,3,0
서울특별시,금천구,시흥제3동,합계,9604,7437,2985,1713,1844,403,445,8,0,10,3,1,0,4,8,7424,13,2167
서울특별시,금천구,시흥제3동,시흥제3동제1투,2472,1635,640,383,419,85,97,2,0,2,0,0,0,1,2,1631,4,837
서울특별시,금천구,시흥제3동,시흥제3동제2투,1864,1315,509,288,351,77,81,2,0,1,1,0,0,1,2,1313,2,549
서울특별시,금천구,시흥제3동,시흥제3동제3투,1814,1320,504,317,329,67,94,2,0,2,1,0,0,1,0,1317,3,494
서울특별시,금천구,시흥제3동,시흥제3동제4투,1241,954,344,261,238,57,51,0,0,1,0,0,0,0,1,953,1,287
서울특별시,금천구,시흥제4동,합계,17478,12778,5251,2859,3148,662,769,5,2,13,2,6,2,5,11,12735,43,4700
서울특별시,금천구,시흥제4동,관내사전투표,3316,3316,1518,669,738,178,202,0,0,1,0,1,0,4,1,3312,4,0
서울특별시,금천구,시흥제4동,시흥제4동제1투,2389,1551,594,369,422,77,80,0,0,3,0,0,0,0,0,1545,6,838
서울특별시,금천구,시흥제4동,시흥제4동제2투,2206,1177,443,281,318,57,67,0,0,0,0,1,2,0,2,1171,6,1029
서울특별시,금천구,시흥제4동,시흥제4동제3투,2066,1406,570,353,338,50,83,1,0,2,0,1,0,0,1,1399,7,660
서울특별시,금천구,시흥제4동,시흥제4동제4투,2454,1846,757,417,437,107,115,2,0,1,2,2,0,0,0,1840,6,608
서울특별시,금천구,시흥제4동,시흥제4동제5투,2535,1712,647,384,467,91,108,0,1,3,0,0,0,0,4,1705,7,823
서울특별시,금천구,시흥제4동,시흥제4동제6투,2512,1770,722,386,428,102,114,2,1,3,0,1,0,1,3,1763,7,742
서울특별시,금천구,시흥제5동,합계,17479,12726,5015,2965,3153,702,747,19,0,13,4,10,8,9,13,12658,68,4753
서울특별시,금천구,시흥제5동,관내사전투표,3637,3637,1594,770,826,188,228,2,0,5,0,3,0,2,3,3621,16,0
서울특별시,금천구,시흥제5동,시흥제5동제1투,2444,1570,582,371,381,114,103,2,0,1,2,0,2,0,3,1561,9,874
서울특별시,금천구,시흥제5동,시흥제5동제2투,3198,2004,785,463,518,117,99,7,0,2,0,1,2,1,0,1995,9,1194
서울특별시,금천구,시흥제5동,시흥제5동제3투,3153,2226,879,487,596,118,121,3,0,0,0,1,2,1,4,2212,14,927
서울특별시,금천구,시흥제5동,시흥제5동제4투,2663,1733,626,434,465,77,104,4,0,5,1,1,0,3,2,1722,11,930
서울특별시,금천구,시흥제5동,시흥제5동제5투,2384,1556,549,440,367,88,92,1,0,0,1,4,2,2,1,1547,9,828
서울특별시,금천구,잘못 투입·구분된 투표지,,0,0,0,0,0,0,0,0,0,0,0,0,0,0,0,0,0,0
서울특별시,영등포구,합계,,316011,248833,105834,53615,53994,18122,15439,374,37,138,50,122,52,86,154,248017,816,67178
서울특별시,영등포구,거소·선상투표,,430,410,152,74,125,24,18,2,3,0,0,0,0,1,0,399,11,20
서울특별시,영등포구,관외사전투표,,29545,29516,14034,4400,5984,2457,2381,30,4,8,2,18,6,11,32,29367,149,29
서울특별시,영등포구,재외투표,,3835,2980,1672,316,481,135,341,16,2,1,0,2,0,1,0,2967,13,855
서울특별시,영등포구,영등포본동,합계,18192,14065,6020,3118,3134,881,812,21,3,7,2,9,4,2,13,14026,39,4127
서울특별시,영등포구,영등포본동,관내사전투표,3341,3341,1547,652,686,210,222,4,2,0,1,6,0,0,0,3330,11,0
서울특별시,영등포구,영등포본동,영등포본동제1투,2524,1869,772,488,385,99,109,3,0,0,0,0,1,0,5,1862,7,655
서울특별시,영등포구,영등포본동,영등포본동제2투,2110,1446,531,385,346,102,68,2,0,2,0,1,0,2,4,1443,3,664
서울특별시,영등포구,영등포본동,영등포본동제3투,1553,942,361,260,226,41,51,0,0,1,0,1,1,0,0,942,0,611
서울특별시,영등포구,영등포본동,영등포본동제4투,1908,1060,398,270,275,54,52,1,1,2,0,0,0,0,2,1055,5,848
서울특별시,영등포구,영등포본동,영등포본동제5투,1371,933,382,248,209,42,44,2,0,0,0,0,0,0,1,928,5,438
서울특별시,영등포구,영등포본동,영등포본동제6투,2532,2055,880,408,476,145,133,7,0,0,0,0,2,0,1,2052,3,477
서울특별시,영등포구,영등포본동,영등포본동제7투,2853,2419,1149,407,531,188,133,2,0,2,1,1,0,0,0,2414,5,434
서울특별시,영등포구,영등포동,합계,15509,10202,4243,2255,2213,734,664,18,2,6,4,9,1,5,5,10159,43,5307
서울특별시,영등포구,영등포동,관내사전투표,2187,2187,954,504,417,138,151,2,1,1,0,4,0,2,1,2175,12,0
서울특별시,영등포구,영등포동,영등포동제1투,2276,1258,538,251,250,101,109,3,0,0,2,1,0,0,1,1256,2,1018
서울특별시,영등포구,영등포동,영등포동제2투,2979,1481,569,337,415,82,69,0,0,1,0,1,0,1,1,1476,5,1498
서울특별시,영등포구,영등포동,영등포동제3투,2689,1909,779,488,401,112,110,4,0,4,0,0,1,0,0,1899,10,780
서울특별시,영등포구,영등포동,영등포동제4투,2424,1161,537,217,232,100,65,2,0,0,1,1,0,1,1,1157,4,1263
서울특별시,영등포구,영등포동,영등포동제5투,2954,2206,866,458,498,201,160,7,1,0,1,2,0,1,1,2196,10,748
서울특별시,영등포구,여의동,합계,25196,19908,6109,6581,4158,2081,858,47,0,7,4,6,1,8,6,19866,42,5288
서울특별시,영등포구,여의동,관내사전투표,5110,5110,1869,1470,945,536,262,7,0,3,0,2,0,1,4,5099,11,0
서울특별시,영등포구,여의동,여의동제1투,2594,1975,667,601,392,184,103,15,0,0,4,1,0,2,1,1970,5,619
서울특별시,영등포구,여의동,여의동제2투,3019,1762,488,614,390,191,76,1,0,0,0,0,0,1,0,1761,1,1257
서울특별시,영등포구,여의동,여의동제3투,2595,2072,617,682,460,231,70,3,0,1,0,0,0,1,0,2065,7,523
서울특별시,영등포구,여의동,여의동제4투,2489,1830,505,686,375,185,68,5,0,0,0,0,1,0,0,1825,5,659
서울특별시,영등포구,여의동,여의동제5투,2514,2007,575,656,462,203,94,6,0,1,0,1,0,0,1,1999,8,507
서울특별시,영등포구,여의동,여의동제6투,2733,2108,622,713,463,225,75,5,0,0,0,0,0,3,0,2106,2,625
서울특별시,영등포구,여의동,여의동제7투,2958,2204,435,968,478,237,79,3,0,0,0,1,0,0,0,2201,3,754
서울특별시,영등포구,여의동,여의동제8투,1184,840,331,191,193,89,31,2,0,2,0,1,0,0,0,840,0,344
서울특별시,영등포구,당산제1동,합계,17384,13699,5966,2850,2854,1043,895,21,2,7,4,7,2,5,5,13661,38,3685
서울특별시,영등포구,당산제1동,관내사전투표,4207,4207,2145,659,765,308,311,5,0,0,1,1,0,0,1,4196,11,0
서울특별시,영등포구,당산제1동,당산제1동제1투,1543,1040,414,255,230,69,61,1,1,0,0,3,1,1,1,1037,3,503
서울특별시,영등포구,당산제1동,당산제1동제2투,2850,2064,805,496,452,155,139,4,0,2,2,0,0,2,3,2060,4,786
서울특별시,영등포구,당산제1동,당산제1동제3투,2816,2173,891,459,505,185,121,0,0,0,1,2,0,2,0,2166,7,643
서울특별시,영등포구,당산제1동,당산제1동제4투,3639,2447,922,637,549,186,136,4,1,3,0,1,1,0,0,2440,7,1192
서울특별시,영등포구,당산제1동,당산제1동제5투,2329,1768,789,344,353,140,127,7,0,2,0,0,0,0,0,1762,6,561
서울특별시,영등포구,당산제2동,관내사전투표,5210,5210,2502,891,915,476,408,6,0,1,0,2,0,0,1,5202,8,0
서울특별시,영등포구,당산제2동,합계,26257,21349,9188,4324,4376,1919,1430,28,2,4,5,11,2,4,5,21298,51,4908
서울특별시,영등포구,당산제2동,당산제2동제1투,3372,2428,1099,444,457,221,189,4,0,1,0,3,0,1,1,2420,8,944
서울특별시,영등포구,당산제2동,당산제2동제2투,3449,2387,969,541,501,202,158,4,0,2,0,0,0,0,2,2379,8,1062
서울특별시,영등포구,당산제2동,당산제2동제3투,3623,2762,1169,522,626,239,184,6,0,0,3,4,0,1,0,2754,8,861
서울특별시,영등포구,당산제2동,당산제2동제4투,2668,2107,893,413,491,172,121,5,0,0,1,0,1,1,0,2098,9,561
서울특별시,영등포구,당산제2동,당산제2동제5투,3219,2692,817,863,648,240,116,1,0,0,1,2,0,0,0,2688,4,527
서울특별시,영등포구,당산제2동,당산제2동제6투,3102,2520,1079,522,535,234,141,2,1,0,0,0,1,1,0,2516,4,582
서울특별시,영등포구,당산제2동,당산제2동제7투,1614,1243,660,128,203,135,113,0,1,0,0,0,0,0,1,1241,2,371
서울특별시,영등포구,도림동,합계,15567,11548,5114,2361,2642,698,650,17,2,11,2,7,4,2,6,11516,32,4019
서울특별시,영등포구,도림동,관내사전투표,3029,3029,1534,454,603,186,236,1,0,3,0,1,0,0,1,3019,10,0
서울특별시,영등포구,도림동,도림동제1투,3294,2142,836,567,533,107,82,3,1,0,1,1,1,1,1,2134,8,1152
서울특별시,영등포구,도림동,도림동제2투,2968,1998,776,501,502,108,91,4,1,2,1,2,1,1,2,1992,6,970
서울특별시,영등포구,도림동,도림동제3투,3237,2136,1009,360,464,158,129,4,0,4,0,2,1,0,1,2132,4,1101
서울특별시,영등포구,도림동,도림동제4투,3039,2243,959,479,540,139,112,5,0,2,0,1,1,0,1,2239,4,796
서울특별시,영등포구,문래동,관내사전투표,4900,4899,2404,902,899,355,312,9,0,3,1,1,0,2,4,4892,7,1
서울특별시,영등포구,문래동,합계,23242,19259,8409,4099,4011,1465,1168,23,0,17,3,5,4,7,14,19225,34,3983
서울특별시,영등포구,문래동,문래동제1투,1861,912,333,255,208,60,47,0,0,2,1,0,0,1,2,909,3,949
서울특별시,영등포구,문래동,문래동제2투,2049,1702,637,431,389,149,93,1,0,0,1,0,0,1,0,1702,0,347
서울특별시,영등포구,문래동,문래동제3투,2920,2319,1055,449,479,163,159,2,0,4,0,0,0,2,2,2315,4,601
서울특별시,영등포구,문래동,문래동제4투,2495,2054,617,663,488,190,86,4,0,0,0,2,1,0,1,2052,2,441
서울특별시,영등포구,문래동,문래동제5투,3157,2460,989,601,506,176,167,2,0,2,0,1,3,0,4,2451,9,697
서울특별시,영등포구,문래동,문래동제6투,2895,2445,1249,337,519,180,155,1,0,2,0,0,0,0,0,2443,2,450
서울특별시,영등포구,문래동,문래동제7투,2965,2468,1125,461,523,192,149,4,0,4,0,1,0,1,1,2461,7,497
서울특별시,영등포구,양평제1동,관내사전투표,2935,2935,1440,483,572,213,211,2,0,0,2,1,0,2,1,2927,8,0
서울특별시,영등포구,양평제1동,합계,13152,10357,4763,2002,2120,751,658,8,0,4,3,2,2,6,10,10329,28,2795
서울특별시,영등포구,양평제1동,양평제1동제1투,2416,1530,496,472,371,78,96,1,0,0,1,1,2,1,3,1522,8,886
서울특별시,영등포구,양평제1동,양평제1동제2투,2890,2250,1144,329,446,185,138,0,0,1,0,0,0,0,2,2245,5,640
서울특별시,영등포구,양평제1동,양평제1동제3투,2326,1649,721,385,313,132,84,5,0,0,0,0,0,2,2,1644,5,677
서울특별시,영등포구,양평제1동,양평제1동제4투,2585,1993,962,333,418,143,129,0,0,3,0,0,0,1,2,1991,2,592
서울특별시,영등포구,양평제2동,관내사전투표,3045,3045,1527,486,581,201,224,1,2,0,0,2,1,1,2,3028,17,0
서울특별시,영등포구,양평제2동,합계,16032,13076,6105,2359,2636,985,907,9,3,3,2,6,2,5,5,13027,49,2956
서울특별시,영등포구,양평제2동,양평제2동제1투,2749,2251,1072,408,444,169,149,3,0,0,0,0,0,1,0,2246,5,498
서울특별시,영등포구,양평제2동,양평제2동제2투,2471,1900,812,378,415,154,127,1,1,1,1,0,0,1,0,1891,9,571
서울특별시,영등포구,양평제2동,양평제2동제3투,2383,1536,703,299,289,138,99,1,0,0,0,2,0,0,0,1531,5,847
서울특별시,영등포구,양평제2동,양평제2동제4투,2577,2174,965,436,471,155,134,3,0,1,0,1,1,2,2,2171,3,403
서울특별시,영등포구,양평제2동,양평제2동제5투,2807,2170,1026,352,436,168,174,0,0,1,1,1,0,0,1,2160,10,637
서울특별시,영등포구,신길제1동,합계,15166,10943,4594,2493,2422,672,682,13,0,8,2,3,3,5,6,10903,40,4223
서울특별시,영등포구,신길제1동,관내사전투표,2520,2520,1198,497,480,152,176,2,0,2,1,0,1,1,2,2512,8,0
서울특별시,영등포구,신길제1동,신길제1동제1투,2731,1886,821,369,426,123,129,8,0,2,0,0,0,0,0,1878,8,845
서울특별시,영등포구,신길제1동,신길제1동제2투,2208,1427,591,345,303,95,86,0,0,0,0,1,0,2,0,1423,4,781
서울특별시,영등포구,신길제1동,신길제1동제3투,2694,1607,673,389,355,88,87,0,0,1,1,0,1,1,1,1597,10,1087
서울특별시,영등포구,신길제1동,신길제1동제4투,2532,1764,659,489,401,100,97,3,0,2,0,2,0,1,3,1757,7,768
서울특별시,영등포구,신길제1동,신길제1동제5투,2481,1739,652,404,457,114,107,0,0,1,0,0,1,0,0,1736,3,742
서울특별시,영등포구,신길제3동,합계,12588,9390,3847,2327,2121,523,496,11,4,6,4,3,3,2,9,9356,34,3198
서울특별시,영등포구,신길제3동,관내사전투표,1770,1770,811,406,369,82,88,4,0,1,0,0,1,0,1,1763,7,0
서울특별시,영등포구,신길제3동,신길제3동제1투,2179,1415,511,389,371,62,66,1,1,0,2,1,0,1,5,1410,5,764
서울특별시,영등포구,신길제3동,신길제3동제2투,2570,1597,639,413,338,93,101,1,0,0,0,1,1,0,2,1589,8,973
서울특별시,영등포구,신길제3동,신길제3동제3투,2309,1893,758,462,430,120,116,0,0,0,0,0,0,1,0,1887,6,416
서울특별시,영등포구,신길제3동,신길제3동제4투,1633,1073,425,307,232,55,38,3,2,0,2,0,1,0,1,1066,7,560
서울특별시,영등포구,신길제3동,신길제3동제5투,2127,1642,703,350,381,111,87,2,1,5,0,1,0,0,0,1641,1,485
서울특별시,영등포구,신길제4동,합계,8209,5947,2410,1437,1377,336,320,18,1,4,2,7,1,6,5,5924,23,2262
서울특별시,영등포구,신길제4동,관내사전투표,1465,1465,687,298,300,84,81,1,0,1,1,3,0,1,1,1458,7,0
서울특별시,영등포구,신길제4동,신길제4동제1투,2189,1316,526,313,331,59,66,5,1,3,1,1,0,2,0,1308,8,873
서울특별시,영등포구,신길제4동,신길제4동제2투,2327,1407,524,412,310,64,80,4,0,0,0,2,0,3,3,1402,5,920
서울특별시,영등포구,신길제4동,신길제4동제3투,2228,1759,673,414,436,129,93,8,0,0,0,1,1,0,1,1756,3,469
서울특별시,영등포구,신길제5동,합계,9655,6878,2829,1641,1674,342,339,11,0,4,0,3,0,5,2,6850,28,2777
서울특별시,영등포구,신길제5동,관내사전투표,1812,1812,808,362,428,99,104,2,0,1,0,0,0,0,1,1805,7,0
서울특별시,영등포구,신길제5동,신길제5동제1투,1818,1032,421,274,237,39,52,0,0,0,0,1,0,1,1,1026,6,786
서울특별시,영등포구,신길제5동,신길제5동제2투,612,443,169,115,106,29,24,0,0,0,0,0,0,0,0,443,0,169
서울특별시,영등포구,신길제5동,신길제5동제3투,2112,1413,551,360,344,74,71,3,0,0,0,1,0,2,0,1406,7,699
서울특별시,영등포구,신길제5동,신길제5동제4투,1672,1106,444,279,281,52,39,4,0,3,0,0,0,2,0,1104,2,566
서울특별시,영등포구,신길제5동,신길제5동제5투,1629,1072,436,251,278,49,49,2,0,0,0,1,0,0,0,1066,6,557
서울특별시,영등포구,신길제6동,합계,15221,11665,4815,2606,2690,748,731,13,1,6,5,8,4,1,4,11632,33,3556
서울특별시,영등포구,신길제6동,관내사전투표,3324,3323,1475,680,734,203,207,3,0,3,1,3,1,1,1,3312,11,1
서울특별시,영등포구,신길제6동,신길제6동제1투,1971,986,365,251,248,49,68,0,0,1,0,0,0,0,0,982,4,985
서울특별시,영등포구,신길제6동,신길제6동제2투,2431,1905,741,438,446,145,122,6,1,0,1,1,0,0,0,1901,4,526
서울특별시,영등포구,신길제6동,신길제6동제3투,2522,1972,832,419,463,139,111,1,0,0,0,0,1,0,0,1966,6,550
서울특별시,영등포구,신길제6동,신길제6동제4투,2845,2019,835,440,463,137,130,0,0,1,2,2,2,0,1,2013,6,826
서울특별시,영등포구,신길제6동,신길제6동제5투,2128,1460,567,378,336,75,93,3,0,1,1,2,0,0,2,1458,2,668
서울특별시,영등포구,신길제7동,합계,8886,6954,2483,1701,1626,673,429,9,1,2,0,2,3,1,5,6935,19,1932
서울특별시,영등포구,신길제7동,관내사전투표,2300,2300,846,546,520,213,159,4,0,1,0,1,0,1,3,2294,6,0
서울특별시,영등포구,신길제7동,신길제7동제1투,538,414,103,76,150,68,15,0,0,0,0,0,0,0,0,412,2,124
서울특별시,영등포구,신길제7동,신길제7동제2투,1156,809,275,250,175,63,42,1,0,0,0,1,0,0,0,807,2,347
서울특별시,영등포구,신길제7동,신길제7동제3투,2373,1410,580,291,301,122,105,3,0,0,0,0,1,0,1,1404,6,963
서울특별시,영등포구,신길제7동,신길제7동제4투,2519,2021,679,538,480,207,108,1,1,1,0,0,2,0,1,2018,3,498
서울특별시,영등포구,대림제1동,합계,11320,8058,3312,1781,2010,417,473,16,1,11,1,7,1,3,3,8036,22,3262
서울특별시,영등포구,대림제1동,관내사전투표,2136,2136,946,432,503,110,132,4,0,1,0,0,0,1,1,2130,6,0
서울특별시,영등포구,대림제1동,대림제1동제1투,2180,1295,485,326,322,64,83,1,1,6,1,1,0,1,0,1291,4,885
서울특별시,영등포구,대림제1동,대림제1동제2투,2235,1537,613,364,382,76,91,0,0,2,0,2,1,0,2,1533,4,698
서울특별시,영등포구,대림제1동,대림제1동제3투,922,634,262,129,160,47,34,1,0,0,0,0,0,0,0,633,1,288
서울특별시,영등포구,대림제1동,대림제1동제4투,2289,1521,625,300,413,80,94,3,0,0,0,3,0,1,0,1519,2,768
서울특별시,영등포구,대림제1동,대림제1동제5투,1558,935,381,230,230,40,39,7,0,2,0,1,0,0,0,930,5,623
서울특별시,영등포구,대림제2동,합계,10978,7691,3427,1718,1725,392,363,18,2,5,2,1,3,2,4,7662,29,3287
서울특별시,영등포구,대림제2동,관내사전투표,1846,1846,955,308,396,81,87,6,0,2,0,1,1,1,0,1838,8,0
서울특별시,영등포구,대림제2동,대림제2동제1투,1341,664,281,173,150,33,22,0,0,0,0,0,0,0,1,660,4,677
서울특별시,영등포구,대림제2동,대림제2동제2투,1296,815,328,205,203,33,42,1,0,1,0,0,0,0,0,813,2,481
서울특별시,영등포구,대림제2동,대림제2동제3투,1889,1252,513,323,274,69,57,3,1,1,0,0,1,1,1,1244,8,637
서울특별시,영등포구,대림제2동,대림제2동제4투,2843,2027,866,472,450,123,102,4,1,1,1,0,1,0,0,2021,6,816
서울특별시,영등포구,대림제2동,대림제2동제5투,1763,1087,484,237,252,53,53,4,0,0,1,0,0,0,2,1086,1,676
서울특별시,영등포구,대림제3동,관내사전투표,3051,3051,1430,519,720,158,194,4,1,7,0,3,0,1,3,3040,11,0
서울특별시,영등포구,대림제3동,합계,19647,14937,6341,3172,3615,846,824,25,4,17,3,6,6,4,15,14878,59,4710
서울특별시,영등포구,대림제3동,대림제3동제1투,2685,1956,802,434,473,106,110,7,0,2,1,3,3,2,2,1945,11,729
서울특별시,영등포구,대림제3동,대림제3동제2투,2294,1529,589,368,404,94,66,0,1,0,0,0,1,0,2,1525,4,765
서울특별시,영등포구,대림제3동,대림제3동제3투,2004,1433,585,317,363,75,82,1,0,1,1,0,0,0,1,1426,7,571
서울특별시,영등포구,대림제3동,대림제3동제4투,1871,1194,500,284,285,53,66,1,1,0,1,0,0,0,1,1192,2,677
서울특별시,영등포구,대림제3동,대림제3동제5투,2396,1489,607,342,377,72,76,2,1,3,0,0,0,0,1,1481,8,907
서울특별시,영등포구,대림제3동,대림제3동제6투,2384,1861,786,388,460,102,111,2,0,2,0,0,1,0,3,1855,6,523
서울특별시,영등포구,대림제3동,대림제3동제7투,2962,2424,1042,520,533,186,119,8,0,2,0,0,1,1,2,2414,10,538
서울특별시,영등포구,잘못 투입·구분된 투표지,,0,1,1,0,0,0,0,0,0,0,0,0,0,0,0,1,0,-1
서울특별시,동작구,합계,,342434,276685,121722,54431,60305,20593,17781,384,25,145,40,133,42,81,146,275828,857,65749
서울특별시,동작구,거소·선상투표,,464,441,156,85,140,28,13,2,2,0,1,1,0,1,3,432,9,23
서울특별시,동작구,관외사전투표,,35518,35518,17239,5079,6980,2996,2930,46,6,13,9,21,3,9,31,35362,156,0
서울특별시,동작구,재외투표,,4197,3255,1896,313,543,120,357,13,0,0,0,0,0,0,0,3242,13,942
서울특별시,동작구,노량진제1동,합계,23761,18625,7827,4097,4045,1460,1073,31,0,11,2,9,2,6,8,18571,54,5136
서울특별시,동작구,노량진제1동,관내사전투표,3490,3490,1732,592,650,273,223,4,0,1,1,1,0,1,2,3480,10,0
서울특별시,동작구,노량진제1동,노량진제1동제1투,2846,2304,925,543,514,186,123,5,0,1,0,0,0,0,1,2298,6,542
서울특별시,동작구,노량진제1동,노량진제1동제2투,2611,1940,891,409,388,131,111,0,0,1,0,0,1,0,0,1932,8,671
서울특별시,동작구,노량진제1동,노량진제1동제3투,2168,1743,671,388,425,152,97,2,0,0,0,0,0,0,0,1735,8,425
서울특별시,동작구,노량진제1동,노량진제1동제4투,2670,1531,688,330,301,101,94,7,0,0,0,0,0,1,1,1523,8,1139
서울특별시,동작구,노량진제1동,노량진제1동제5투,2065,1508,547,425,353,104,70,0,0,1,0,2,0,1,0,1503,5,557
서울특별시,동작구,노량진제1동,노량진제1동제6투,2919,2099,819,463,515,152,127,5,0,3,0,4,1,3,1,2093,6,820
서울특별시,동작구,노량진제1동,노량진제1동제7투,1557,1298,506,317,275,130,61,4,0,1,1,0,0,0,1,1296,2,259
서울특별시,동작구,노량진제1동,노량진제1동제8투,1678,1288,487,296,314,105,82,1,0,2,0,1,0,0,0,1288,0,390
서울특별시,동작구,노량진제1동,노량진제1동제9투,1757,1424,561,334,310,126,85,3,0,1,0,1,0,0,2,1423,1,333
서울특별시,동작구,노량진제2동,합계,13515,10406,4542,2247,2238,685,601,20,1,10,0,8,1,9,2,10364,42,3109
서울특별시,동작구,노량진제2동,관내사전투표,4454,4454,2188,724,851,351,306,9,0,2,0,3,0,2,0,4436,18,0
서울특별시,동작구,노량진제2동,노량진제2동제1투,1435,1000,394,269,241,55,40,1,0,0,0,0,0,0,0,1000,0,435
서울특별시,동작구,노량진제2동,노량진제2동제2투,2891,1853,737,476,412,111,95,5,0,4,0,1,0,1,1,1843,10,1038
서울특별시,동작구,노량진제2동,노량진제2동제3투,2564,1691,656,412,424,95,84,2,1,2,0,2,0,4,0,1682,9,873
서울특별시,동작구,노량진제2동,노량진제2동제4투,2171,1408,567,366,310,73,76,3,0,2,0,2,1,2,1,1403,5,763
서울특별시,동작구,상도제1동,합계,34229,27329,11699,5352,5971,2381,1750,36,3,13,7,14,2,5,8,27241,88,6900
서울특별시,동작구,상도제1동,관내사전투표,7975,7975,3716,1410,1555,688,555,9,0,5,1,5,0,1,2,7947,28,0
서울특별시,동작구,상도제1동,상도제1동제1투,3845,2740,1168,569,567,229,186,4,1,3,0,2,1,1,1,2732,8,1105
서울특별시,동작구,상도제1동,상도제1동제2투,3584,2552,1016,534,551,261,175,3,0,0,0,0,0,0,2,2542,10,1032
서울특별시,동작구,상도제1동,상도제1동제3투,3127,2335,989,472,547,160,153,5,0,0,2,1,0,0,1,2330,5,792
서울특별시,동작구,상도제1동,상도제1동제4투,2938,2198,844,474,586,162,115,4,1,1,1,4,0,0,0,2192,6,740
서울특별시,동작구,상도제1동,상도제1동제5투,3371,2263,810,565,563,199,115,2,0,0,0,1,0,2,0,2257,6,1108
서울특별시,동작구,상도제1동,상도제1동제6투,2908,2166,828,502,506,178,135,3,1,1,1,0,0,0,1,2156,10,742
서울특별시,동작구,상도제1동,상도제1동제7투,2821,2010,895,337,417,189,150,6,0,3,1,1,1,0,0,2000,10,811
서울특별시,동작구,상도제1동,상도제1동제8투,3660,3090,1433,489,679,315,166,0,0,0,1,0,0,1,1,3085,5,570
서울특별시,동작구,상도제2동,합계,21026,16803,7318,3351,3842,1245,955,21,0,4,1,1,1,10,9,16758,45,4223
서울특별시,동작구,상도제2동,관내사전투표,4956,4956,2465,824,1005,343,298,8,0,1,0,0,0,3,0,4947,9,0
서울특별시,동작구,상도제2동,상도제2동제1투,3992,3014,1246,643,729,218,152,9,0,0,0,0,0,2,2,3001,13,978
서울특별시,동작구,상도제2동,상도제2동제2투,2997,1925,773,426,462,138,119,1,0,0,0,0,0,2,3,1924,1,1072
서울특별시,동작구,상도제2동,상도제2동제3투,3211,2479,1059,485,567,194,152,1,0,2,0,1,0,2,2,2465,14,732
서울특별시,동작구,상도제2동,상도제2동제4투,3049,2481,997,522,599,240,113,1,0,1,1,0,1,1,1,2477,4,568
서울특별시,동작구,상도제2동,상도제2동제5투,2821,1948,778,451,480,112,121,1,0,0,0,0,0,0,1,1944,4,873
서울특별시,동작구,상도제3동,관내사전투표,6204,6204,3032,1059,1267,363,441,6,0,4,0,4,1,1,5,6183,21,0
서울특별시,동작구,상도제3동,합계,21633,16997,7761,3158,3852,1026,1089,15,2,11,2,11,3,3,12,16945,52,4636
서울특별시,동작구,상도제3동,상도제3동제1투,3719,2665,1105,561,620,197,166,3,0,1,0,1,0,0,4,2658,7,1054
서울특별시,동작구,상도제3동,상도제3동제2투,3008,1911,823,423,415,119,116,3,0,0,0,2,1,1,1,1904,7,1097
서울특별시,동작구,상도제3동,상도제3동제3투,2578,1769,787,310,447,94,120,0,1,1,1,2,0,0,1,1764,5,809
서울특별시,동작구,상도제3동,상도제3동제4투,2386,1689,755,336,386,105,99,0,0,1,1,1,0,1,0,1685,4,697
서울특별시,동작구,상도제3동,상도제3동제5투,3738,2759,1259,469,717,148,147,3,1,4,0,1,1,0,1,2751,8,979
서울특별시,동작구,상도제4동,합계,21258,15636,6941,3138,3494,996,950,16,2,15,3,7,1,4,14,15581,55,5622
서울특별시,동작구,상도제4동,관내사전투표,2830,2830,1413,482,575,166,176,0,1,3,0,1,1,0,2,2820,10,0
서울특별시,동작구,상도제4동,상도제4동제1투,2406,1527,689,300,339,86,95,2,0,1,1,2,0,1,2,1518,9,879
서울특별시,동작구,상도제4동,상도제4동제2투,2714,1754,752,366,409,109,102,2,0,1,2,0,0,0,2,1745,9,960
서울특별시,동작구,상도제4동,상도제4동제3투,2939,1956,834,375,463,127,143,5,1,0,0,0,0,0,1,1949,7,983
서울특별시,동작구,상도제4동,상도제4동제4투,2570,1743,783,342,388,118,99,1,0,3,0,1,0,0,2,1737,6,827
서울특별시,동작구,상도제4동,상도제4동제5투,4127,3185,1274,742,743,231,174,3,0,4,0,2,0,1,3,3177,8,942
서울특별시,동작구,상도제4동,상도제4동제6투,3672,2641,1196,531,577,159,161,3,0,3,0,1,0,2,2,2635,6,1031
서울특별시,동작구,흑석동,합계,25272,19352,7703,4399,4291,1611,1215,28,0,20,1,5,3,6,6,19288,64,5920
서울특별시,동작구,흑석동,관내사전투표,5857,5857,2492,1266,1197,466,400,11,0,4,0,1,1,2,2,5842,15,0
서울특별시,동작구,흑석동,흑석동제1투,2816,2130,703,586,498,230,104,4,0,0,0,0,0,0,0,2125,5,686
서울특별시,동작구,흑석동,흑석동제2투,2672,1431,542,384,308,108,77,1,0,1,0,0,1,0,1,1423,8,1241
서울특별시,동작구,흑석동,흑석동제3투,1691,1134,433,303,260,67,65,0,0,1,0,0,1,1,2,1133,1,557
서울특별시,동작구,흑석동,흑석동제4투,2612,1668,680,375,405,90,103,3,0,4,0,1,0,0,0,1661,7,944
서울특별시,동작구,흑석동,흑석동제5투,2060,1455,576,317,315,126,108,2,0,1,0,1,0,1,0,1447,8,605
서울특별시,동작구,흑석동,흑석동제6투,2092,1426,532,324,350,114,93,1,0,2,0,1,0,1,0,1418,8,666
서울특별시,동작구,흑석동,흑석동제7투,3139,2447,1041,472,547,221,155,2,0,3,0,0,0,1,1,2443,4,692
서울특별시,동작구,흑석동,흑석동제8투,2333,1804,704,372,411,189,110,4,0,4,1,1,0,0,0,1796,8,529
서울특별시,동작구,사당제1동,합계,18164,14190,6427,2622,3134,933,975,24,1,5,5,8,5,6,5,14150,40,3974
서울특별시,동작구,사당제1동,관내사전투표,3598,3598,1784,552,719,241,271,3,1,1,2,2,4,3,2,3585,13,0
서울특별시,동작구,사당제1동,사당제1동제1투,3857,2942,1333,568,646,200,186,1,0,0,0,0,0,0,0,2934,8,915
서울특별시,동작구,사당제1동,사당제1동제2투,2895,2185,989,371,504,151,153,4,0,1,0,0,0,3,2,2178,7,710
서울특별시,동작구,사당제1동,사당제1동제3투,2450,1737,689,384,407,113,126,8,0,2,1,3,0,0,0,1733,4,713
서울특별시,동작구,사당제1동,사당제1동제4투,2455,1787,808,356,410,96,107,1,0,0,1,3,0,0,1,1783,4,668
서울특별시,동작구,사당제1동,사당제1동제5투,2909,1941,824,391,448,132,132,7,0,1,1,0,1,0,0,1937,4,968
서울특별시,동작구,사당제2동,합계,22534,17964,7378,4041,4037,1380,1022,27,1,8,2,3,5,5,7,17916,48,4570
서울특별시,동작구,사당제2동,관내사전투표,6243,6243,2841,1299,1289,403,379,5,0,4,0,1,4,2,3,6230,13,0
서울특별시,동작구,사당제2동,사당제2동제1투,3094,2360,824,599,572,219,133,4,0,1,0,0,0,0,1,2353,7,734
서울특별시,동작구,사당제2동,사당제2동제2투,2053,1321,544,303,316,74,70,3,0,1,0,1,0,0,0,1312,9,732
서울특별시,동작구,사당제2동,사당제2동제3투,2181,1518,657,295,355,107,92,1,0,2,0,1,0,1,3,1514,4,663
서울특별시,동작구,사당제2동,사당제2동제4투,2793,1756,659,440,400,155,96,2,1,0,0,0,1,0,0,1754,2,1037
서울특별시,동작구,사당제2동,사당제2동제5투,1830,1291,568,251,298,105,66,1,0,0,0,0,0,0,0,1289,2,539
서울특별시,동작구,사당제2동,사당제2동제6투,2213,1798,719,396,425,147,96,7,0,0,1,0,0,2,0,1793,5,415
서울특별시,동작구,사당제2동,사당제2동제7투,2127,1677,566,458,382,170,90,4,0,0,1,0,0,0,0,1671,6,450
서울특별시,동작구,사당제3동,합계,17935,14217,5838,3155,3283,1015,839,16,2,9,2,6,2,1,8,14176,41,3718
서울특별시,동작구,사당제3동,관내사전투표,3363,3363,1533,701,682,208,217,3,0,1,0,3,1,0,2,3351,12,0
서울특별시,동작구,사당제3동,사당제3동제1투,2781,2071,888,389,489,159,131,5,1,1,1,0,0,0,1,2065,6,710
서울특별시,동작구,사당제3동,사당제3동제2투,1984,1356,576,283,319,93,77,2,0,2,0,0,0,1,0,1353,3,628
서울특별시,동작구,사당제3동,사당제3동제3투,2489,1726,613,477,388,145,87,5,0,0,0,2,0,0,1,1718,8,763
서울특별시,동작구,사당제3동,사당제3동제4투,2097,1466,604,274,368,109,97,0,1,3,0,1,1,0,1,1459,7,631
서울특별시,동작구,사당제3동,사당제3동제5투,2559,2058,829,479,481,139,123,1,0,1,1,0,0,0,2,2056,2,501
서울특별시,동작구,사당제3동,사당제3동제6투,2662,2177,795,552,556,162,107,0,0,1,0,0,0,0,1,2174,3,485
서울특별시,동작구,사당제4동,합계,11875,9413,4257,1800,2123,570,602,9,1,5,0,6,1,1,5,9380,33,2462
서울특별시,동작구,사당제4동,관내사전투표,3093,3093,1504,539,654,166,208,6,0,4,0,1,1,0,2,3085,8,0
서울특별시,동작구,사당제4동,사당제4동제1투,2174,1537,671,297,370,82,102,1,0,0,0,1,0,0,2,1526,11,637
서울특별시,동작구,사당제4동,사당제4동제2투,2065,1551,655,334,344,117,97,2,0,1,0,0,0,0,0,1550,1,514
서울특별시,동작구,사당제4동,사당제4동제3투,2554,1822,851,313,429,111,109,0,1,0,0,1,0,1,0,1816,6,732
서울특별시,동작구,사당제4동,사당제4동제4투,1989,1410,576,317,326,94,86,0,0,0,0,3,0,0,1,1403,7,579
서울특별시,동작구,사당제5동,합계,10112,7990,3717,1463,1720,584,464,9,0,2,2,2,3,0,5,7971,19,2122
서울특별시,동작구,사당제5동,관내사전투표,2503,2503,1282,395,493,169,155,0,0,0,0,0,1,0,0,2495,8,0
서울특별시,동작구,사당제5동,사당제5동제1투,783,512,238,83,119,40,29,0,0,1,0,0,0,0,1,511,1,271
서울특별시,동작구,사당제5동,사당제5동제2투,2416,1870,811,387,412,147,106,2,0,1,0,0,0,0,0,1866,4,546
서울특별시,동작구,사당제5동,사당제5동제3투,2358,1592,690,312,346,137,95,4,0,0,1,2,1,0,1,1589,3,766
서울특별시,동작구,사당제5동,사당제5동제4투,2052,1513,696,286,350,91,79,3,0,0,1,0,1,0,3,1510,3,539
서울특별시,동작구,대방동,합계,27583,21903,9432,4483,4831,1721,1307,38,1,10,3,12,1,7,12,21858,45,5680
서울특별시,동작구,대방동,관내사전투표,5096,5096,2379,931,1025,415,318,13,1,2,1,4,0,1,1,5091,5,0
서울특별시,동작구,대방동,대방동제1투,2751,1927,802,485,410,109,108,1,0,2,1,1,1,1,1,1922,5,824
서울특별시,동작구,대방동,대방동제2투,2674,2085,798,498,473,201,102,5,0,1,0,1,0,2,0,2081,4,589
서울특별시,동작구,대방동,대방동제3투,3311,2648,1094,533,596,253,160,2,0,0,0,2,0,1,1,2642,6,663
서울특별시,동작구,대방동,대방동제4투,2829,1949,802,425,483,126,94,5,0,1,1,0,0,1,5,1943,6,880
서울특별시,동작구,대방동,대방동제5투,2712,2161,840,499,517,187,103,7,0,0,0,2,0,0,0,2155,6,551
서울특별시,동작구,대방동,대방동제6투,2155,1579,680,324,338,114,118,0,0,0,0,1,0,1,1,1577,2,576
서울특별시,동작구,대방동,대방동제7투,3009,2250,1039,388,494,161,158,1,0,3,0,1,0,0,0,2245,5,759
서울특별시,동작구,대방동,대방동제8투,3046,2208,998,400,495,155,146,4,0,1,0,0,0,0,3,2202,6,838
서울특별시,동작구,신대방제1동,합계,17924,14404,6075,3153,3225,988,876,22,1,4,0,16,5,4,8,14377,27,3520
서울특별시,동작구,신대방제1동,관내사전투표,3002,3002,1411,562,604,203,206,3,1,0,0,1,2,0,2,2995,7,0
서울특별시,동작구,신대방제1동,신대방제1동제1투,1902,1293,556,275,314,66,70,1,0,0,0,3,2,0,1,1288,5,609
서울특별시,동작구,신대방제1동,신대방제1동제2투,2429,1591,622,397,357,119,79,3,0,1,0,5,1,1,1,1586,5,838
서울특별시,동작구,신대방제1동,신대방제1동제3투,3650,3124,1377,586,693,239,215,6,0,2,0,0,0,2,1,3121,3,526
서울특별시,동작구,신대방제1동,신대방제1동제4투,3447,2461,1021,532,563,168,161,6,0,1,0,4,0,1,1,2458,3,986
서울특별시,동작구,신대방제1동,신대방제1동제5투,3494,2933,1088,801,694,193,145,3,0,0,0,3,0,0,2,2929,4,561
서울특별시,동작구,신대방제2동,관내사전투표,3196,3196,1705,504,563,194,219,5,0,1,0,0,0,0,0,3191,5,0
서울특별시,동작구,신대방제2동,합계,15434,12242,5516,2495,2556,854,763,11,2,5,0,3,4,4,3,12216,26,3192
서울특별시,동작구,신대방제2동,신대방제2동제1투,2630,2057,926,352,472,176,121,0,0,1,0,2,2,0,0,2052,5,573
서울특별시,동작구,신대방제2동,신대방제2동제2투,2978,2053,954,411,384,148,141,2,1,1,0,1,2,3,3,2051,2,925
서울특별시,동작구,신대방제2동,신대방제2동제3투,3283,2450,1085,441,573,189,154,1,0,1,0,0,0,1,0,2445,5,833
서울특별시,동작구,신대방제2동,신대방제2동제4투,3347,2486,846,787,564,147,128,3,1,1,0,0,0,0,0,2477,9,861
서울특별시,동작구,잘못 투입·구분된 투표지,,0,0,0,0,0,0,0,0,0,0,0,0,0,0,0,0,0,0
서울특별시,관악구,합계,,446035,351240,159854,59914,79495,23857,25300,549,58,197,79,293,73,113,223,350005,1235,94795
서울특별시,관악구,거소·선상투표,,601,559,199,111,175,30,22,2,2,0,2,1,0,0,1,545,14,42
서울특별시,관악구,관외사전투표,,44994,44965,23056,5121,8648,3579,4141,56,11,7,8,54,7,17,46,44751,214,29
서울특별시,관악구,재외투표,,3981,3084,1833,232,511,100,395,9,0,0,0,0,0,1,0,3081,3,897
서울특별시,관악구,보라매동,관내사전투표,3300,3300,1657,458,716,192,249,6,0,2,1,3,0,2,3,3289,11,0
서울특별시,관악구,보라매동,합계,19723,14917,6380,2933,3659,895,938,21,3,12,3,8,6,9,13,14880,37,4806
서울특별시,관악구,보라매동,보라매동제1투,3099,2402,924,593,576,172,123,9,0,3,0,0,2,0,0,2402,0,697
서울특별시,관악구,보라매동,보라매동제2투,3002,2203,874,459,585,147,119,1,0,2,0,3,0,4,3,2197,6,799
서울특별시,관악구,보라매동,보라매동제3투,3527,2541,1007,601,638,123,151,1,1,3,1,0,2,3,4,2535,6,986
서울특별시,관악구,보라매동,보라매동제4투,3293,2046,889,375,519,129,121,1,1,2,0,0,2,0,1,2040,6,1247
서울특별시,관악구,보라매동,보라매동제5투,3502,2425,1029,447,625,132,175,3,1,0,1,2,0,0,2,2417,8,1077
서울특별시,관악구,은천동,관내사전투표,5034,5034,2522,762,1063,307,341,8,1,0,0,5,3,2,3,5017,17,0
서울특별시,관악구,은천동,합계,26692,20852,9339,3746,5054,1269,1289,28,5,14,4,15,5,7,10,20785,67,5840
서울특별시,관악구,은천동,은천동제1투,2882,2067,846,429,513,139,126,7,1,2,0,1,0,0,0,2064,3,815
서울특별시,관악구,은천동,은천동제2투,3068,2220,898,486,538,137,143,6,0,2,0,1,0,0,1,2212,8,848
서울특별시,관악구,은천동,은천동제3투,3032,2239,891,448,613,153,111,1,1,4,1,1,0,2,0,2226,13,793
서울특별시,관악구,은천동,은천동제4투,3015,2530,1218,373,613,168,152,0,0,0,0,1,0,1,0,2526,4,485
서울특별시,관악구,은천동,은천동제5투,3025,2364,1075,454,558,135,126,4,0,1,1,0,2,1,2,2359,5,661
서울특별시,관악구,은천동,은천동제6투,3254,2280,1009,445,526,120,162,1,0,3,0,0,0,1,2,2269,11,974
서울특별시,관악구,은천동,은천동제7투,3382,2118,880,349,630,110,128,1,2,2,2,6,0,0,2,2112,6,1264
서울특별시,관악구,성현동,관내사전투표,3970,3970,1972,572,875,260,264,3,0,2,1,5,0,1,0,3955,15,0
서울특별시,관악구,성현동,합계,24659,19768,8497,3691,4997,1300,1159,27,1,8,10,10,4,4,7,19715,53,4891
서울특별시,관악구,성현동,성현동제1투,2949,2192,898,377,662,119,119,3,1,2,4,1,2,1,0,2189,3,757
서울특별시,관악구,성현동,성현동제2투,3580,2730,1164,475,708,183,182,5,0,0,0,2,0,0,1,2720,10,850
서울특별시,관악구,성현동,성현동제3투,2533,2185,909,437,526,173,133,2,0,1,0,0,1,1,0,2183,2,348
서울특별시,관악구,성현동,성현동제4투,2929,2429,968,536,600,169,143,1,0,1,1,1,0,1,1,2422,7,500
서울특별시,관악구,성현동,성현동제5투,2786,2283,1061,395,526,176,115,6,0,0,0,1,0,0,0,2280,3,503
서울특별시,관악구,성현동,성현동제6투,2773,1717,722,352,448,114,75,2,0,0,0,0,0,0,2,1715,2,1056
서울특별시,관악구,성현동,성현동제7투,3139,2262,803,547,652,106,128,5,0,2,4,0,1,0,3,2251,11,877
서울특별시,관악구,중앙동,합계,12014,9050,4277,1300,2160,597,642,10,2,5,0,4,3,1,6,9007,43,2964
서울특별시,관악구,중앙동,관내사전투표,2782,2782,1455,306,574,202,215,5,0,2,0,1,1,0,5,2766,16,0
서울특별시,관악구,중앙동,중앙동제1투,2833,1899,835,316,492,119,122,3,0,2,0,1,0,1,0,1891,8,934
서울특별시,관악구,중앙동,중앙동제2투,2855,2105,948,359,534,112,135,1,0,1,0,1,1,0,0,2092,13,750
서울특별시,관악구,중앙동,중앙동제3투,3544,2264,1039,319,560,164,170,1,2,0,0,1,1,0,1,2258,6,1280
서울특별시,관악구,청림동,합계,12553,10229,4554,1932,2435,681,567,15,1,4,0,7,0,4,4,10204,25,2324
서울특별시,관악구,청림동,관내사전투표,2565,2565,1248,442,548,155,156,7,0,0,0,3,0,0,2,2561,4,0
서울특별시,관악구,청림동,청림동제1투,3127,2403,965,534,594,170,128,3,0,0,0,2,0,1,1,2398,5,724
서울특별시,관악구,청림동,청림동제2투,3359,2281,881,484,649,141,103,5,1,4,0,1,0,2,1,2272,9,1078
서울특별시,관악구,청림동,청림동제3투,3502,2980,1460,472,644,215,180,0,0,0,0,1,0,1,0,2973,7,522
서울특별시,관악구,행운동,합계,23732,18799,8648,3005,4236,1335,1450,18,1,13,2,13,3,8,12,18744,55,4933
서울특별시,관악구,행운동,관내사전투표,5271,5271,2645,659,1045,404,481,3,0,4,0,9,1,1,4,5256,15,0
서울특별시,관악구,행운동,행운동제1투,2811,2118,1034,360,415,135,161,0,0,1,0,1,0,1,3,2111,7,693
서울특별시,관악구,행운동,행운동제2투,3296,2514,1201,413,519,171,196,4,1,0,0,0,0,1,0,2506,8,782
서울특별시,관악구,행운동,행운동제3투,3560,2615,1205,393,621,201,179,1,0,3,0,1,1,0,3,2608,7,945
서울특별시,관악구,행운동,행운동제4투,2958,1872,805,298,481,110,162,6,0,1,0,0,1,2,0,1866,6,1086
서울특별시,관악구,행운동,행운동제5투,2337,1638,698,275,408,126,125,1,0,0,1,0,0,1,2,1637,1,699
서울특별시,관악구,행운동,행운동제6투,3499,2771,1060,607,747,188,146,3,0,4,1,2,0,2,0,2760,11,728
서울특별시,관악구,청룡동,관내사전투표,4284,4284,2153,604,884,290,318,13,0,2,0,3,1,3,2,4273,11,0
서울특별시,관악구,청룡동,합계,21962,16835,7713,2676,3913,1131,1281,25,2,8,1,11,2,6,9,16778,57,5127
서울특별시,관악구,청룡동,청룡동제1투,3290,2235,971,430,565,119,138,1,1,0,0,1,0,0,1,2227,8,1055
서울특별시,관악구,청룡동,청룡동제2투,3283,2332,1006,433,584,130,160,1,1,1,0,3,0,0,0,2319,13,951
서울특별시,관악구,청룡동,청룡동제3투,4079,3016,1422,336,642,271,324,5,0,1,1,2,0,1,4,3009,7,1063
서울특별시,관악구,청룡동,청룡동제4투,3950,2598,1107,489,670,170,141,2,0,2,0,1,0,1,2,2585,13,1352
서울특별시,관악구,청룡동,청룡동제5투,3076,2370,1054,384,568,151,200,3,0,2,0,1,1,1,0,2365,5,706
서울특별시,관악구,낙성대동,합계,13342,10590,4997,1463,2249,838,963,22,0,6,2,6,1,2,3,10552,38,2752
서울특별시,관악구,낙성대동,관내사전투표,3449,3449,1781,389,638,261,360,2,0,3,2,2,0,0,0,3438,11,0
서울특별시,관악구,낙성대동,낙성대동제1투,3554,2610,1226,365,551,232,222,6,0,1,0,0,0,0,2,2605,5,944
서울특별시,관악구,낙성대동,낙성대동제2투,3469,2350,990,415,571,154,197,9,0,1,0,2,0,1,0,2340,10,1119
서울특별시,관악구,낙성대동,낙성대동제3투,2870,2181,1000,294,489,191,184,5,0,1,0,2,1,1,1,2169,12,689
서울특별시,관악구,인헌동,관내사전투표,6137,6137,3086,886,1255,384,490,2,2,3,1,8,2,1,2,6122,15,0
서울특별시,관악구,인헌동,합계,21896,17401,8174,2754,3874,1167,1321,24,5,9,2,13,3,3,12,17361,40,4495
서울특별시,관악구,인헌동,인헌동제1투,2774,1912,909,256,440,144,152,2,0,2,0,0,0,1,2,1908,4,862
서울특별시,관악구,인헌동,인헌동제2투,3447,2328,1097,359,502,162,184,10,1,0,1,1,0,0,5,2322,6,1119
서울특별시,관악구,인헌동,인헌동제3투,3146,2255,994,424,497,174,156,2,1,0,0,0,1,0,0,2249,6,891
서울특별시,관악구,인헌동,인헌동제4투,3248,2287,978,388,587,150,171,4,1,0,0,2,0,0,1,2282,5,961
서울특별시,관악구,인헌동,인헌동제5투,3144,2482,1110,441,593,153,168,4,0,4,0,2,0,1,2,2478,4,662
서울특별시,관악구,남현동,합계,14164,11199,4850,2216,2492,833,732,22,3,8,1,2,0,2,4,11165,34,2965
서울특별시,관악구,남현동,관내사전투표,3490,3490,1682,581,722,244,233,9,2,2,0,0,0,1,0,3476,14,0
서울특별시,관악구,남현동,남현동제1투,2707,1989,805,393,479,158,138,6,0,3,0,0,0,0,1,1983,6,718
서울특별시,관악구,남현동,남현동제2투,2582,1955,841,450,425,119,113,2,1,0,0,0,0,0,1,1952,3,627
서울특별시,관악구,남현동,남현동제3투,2714,1830,780,350,409,150,129,1,0,2,1,1,0,0,0,1823,7,884
서울특별시,관악구,남현동,남현동제4투,2671,1935,742,442,457,162,119,4,0,1,0,1,0,1,2,1931,4,736
서울특별시,관악구,신림동,합계,17813,13086,6675,1722,2367,1034,1171,15,3,3,7,10,4,2,15,13028,58,4727
서울특별시,관악구,신림동,관내사전투표,4622,4622,2559,472,737,361,462,2,0,0,2,2,1,1,3,4602,20,0
서울특별시,관악구,신림동,신림동제1투,4003,2549,1271,311,494,229,216,7,1,1,1,1,1,0,1,2534,15,1454
서울특별시,관악구,신림동,신림동제2투,3223,1977,996,270,352,152,185,1,1,2,1,1,1,0,6,1968,9,1246
서울특별시,관악구,신림동,신림동제3투,3089,1928,940,285,377,141,168,4,0,0,1,2,0,0,3,1921,7,1161
서울특별시,관악구,신림동,신림동제4투,2876,2010,909,384,407,151,140,1,1,0,2,4,1,1,2,2003,7,866
서울특별시,관악구,신사동,합계,18537,13438,6123,2502,2991,827,893,14,1,8,3,5,1,7,9,13384,54,5099
서울특별시,관악구,신사동,관내사전투표,3805,3805,1912,633,772,197,268,4,0,5,1,1,0,1,2,3796,9,0
서울특별시,관악구,신사동,신사동제1투,2588,1814,787,362,410,133,105,5,0,0,0,3,0,1,2,1808,6,774
서울특별시,관악구,신사동,신사동제2투,2958,1985,904,379,416,128,141,2,0,1,0,0,0,0,2,1973,12,973
서울특별시,관악구,신사동,신사동제3투,2941,1980,885,378,453,128,122,3,0,1,0,0,0,3,0,1973,7,961
서울특별시,관악구,신사동,신사동제4투,2961,1725,766,335,386,118,104,0,1,0,1,0,0,1,2,1714,11,1236
서울특별시,관악구,신사동,신사동제5투,3284,2129,869,415,554,123,153,0,0,1,1,1,1,1,1,2120,9,1155
서울특별시,관악구,조원동,합계,14422,10615,4606,2113,2416,691,711,19,0,6,4,9,2,1,7,10585,30,3807
서울특별시,관악구,조원동,관내사전투표,3066,3066,1477,498,629,221,212,9,0,4,0,4,0,0,3,3057,9,0
서울특별시,관악구,조원동,조원동제1투,3129,2068,876,417,494,132,137,0,0,0,2,2,1,0,2,2063,5,1061
서울특별시,관악구,조원동,조원동제2투,3323,2054,849,418,504,128,139,5,0,0,0,2,0,1,2,2048,6,1269
서울특별시,관악구,조원동,조원동제3투,2689,1864,807,386,422,113,124,2,0,0,2,1,1,0,0,1858,6,825
서울특별시,관악구,조원동,조원동제4투,2215,1563,597,394,367,97,99,3,0,2,0,0,0,0,0,1559,4,652
서울특별시,관악구,미성동,합계,25512,19370,7925,4263,4734,1157,1128,41,0,16,5,15,8,7,13,19312,58,6142
서울특별시,관악구,미성동,관내사전투표,4739,4739,2214,957,1012,235,288,12,0,4,1,4,1,0,2,4730,9,0
서울특별시,관악구,미성동,미성동제1투,2951,1830,780,341,412,132,149,5,0,1,0,2,0,0,1,1823,7,1121
서울특별시,관악구,미성동,미성동제2투,2829,1990,775,432,514,123,126,5,0,2,1,1,3,1,2,1985,5,839
서울특별시,관악구,미성동,미성동제3투,3203,2678,940,776,652,186,109,4,0,0,0,1,1,2,0,2671,7,525
서울특별시,관악구,미성동,미성동제4투,2914,1965,770,404,531,118,121,2,0,4,3,0,1,1,1,1956,9,949
서울특별시,관악구,미성동,미성동제5투,2963,2055,834,426,529,134,110,2,0,3,0,1,1,1,2,2043,12,908
서울특별시,관악구,미성동,미성동제6투,3012,1960,748,460,520,109,102,8,0,1,0,2,0,0,5,1955,5,1052
서울특별시,관악구,미성동,미성동제7투,2901,2153,864,467,564,120,123,3,0,1,0,4,1,2,0,2149,4,748
서울특별시,관악구,난곡동,합계,23080,16593,6816,3388,4252,992,971,30,4,14,8,19,10,8,7,16519,74,6487
서울특별시,관악구,난곡동,관내사전투표,3839,3839,1761,704,906,207,224,4,2,2,1,3,2,1,1,3818,21,0
서울특별시,관악구,난곡동,난곡동제1투,3493,2086,844,421,537,132,127,5,0,1,2,4,1,1,2,2077,9,1407
서울특별시,관악구,난곡동,난곡동제2투,3636,2484,967,526,663,167,140,1,1,5,2,1,1,0,1,2475,9,1152
서울특별시,관악구,난곡동,난곡동제3투,3733,2735,1141,572,679,153,167,2,0,3,0,4,2,2,1,2726,9,998
서울특별시,관악구,난곡동,난곡동제4투,2687,1731,694,368,451,99,97,4,1,1,1,2,2,3,1,1724,7,956
서울특별시,관악구,난곡동,난곡동제5투,2688,1883,715,406,519,128,98,6,0,0,2,1,0,1,0,1876,7,805
서울특별시,관악구,난곡동,난곡동제6투,3004,1835,694,391,497,106,118,8,0,2,0,4,2,0,1,1823,12,1169
서울특별시,관악구,난향동,관내사전투표,2871,2871,1390,512,586,179,186,4,0,2,3,5,0,0,1,2868,3,0
서울특별시,관악구,난향동,합계,12470,9712,4212,1899,2278,652,604,18,1,5,4,10,2,2,5,9692,20,2758
서울특별시,관악구,난향동,난향동제1투,2948,1998,889,378,469,120,127,6,0,0,0,1,0,1,1,1992,6,950
서울특별시,관악구,난향동,난향동제2투,3458,2761,1176,505,658,232,176,5,0,0,0,3,1,0,2,2758,3,697
서울특별시,관악구,난향동,난향동제3투,3193,2082,757,504,565,121,115,3,1,3,1,1,1,1,1,2074,8,1111
서울특별시,관악구,서원동,합계,18555,13736,6312,2360,3021,902,1039,16,1,9,3,15,3,4,11,13696,40,4819
서울특별시,관악구,서원동,관내사전투표,3928,3928,1961,594,754,256,340,1,1,3,1,7,0,2,3,3923,5,0
서울특별시,관악구,서원동,서원동제1투,3197,2291,1039,408,516,160,149,5,0,3,0,3,1,0,2,2286,5,906
서울특별시,관악구,서원동,서원동제2투,2706,1827,777,367,404,123,138,5,0,1,0,1,0,0,1,1817,10,879
서울특별시,관악구,서원동,서원동제3투,3094,1894,889,286,404,131,172,2,0,1,0,1,0,1,2,1889,5,1200
서울특별시,관악구,서원동,서원동제4투,2396,1539,669,273,380,98,110,0,0,0,1,1,2,0,0,1534,5,857
서울특별시,관악구,서원동,서원동제5투,3234,2257,977,432,563,134,130,3,0,1,1,2,0,1,3,2247,10,977
서울특별시,관악구,신원동,합계,15396,11353,5001,2160,2572,720,804,21,2,12,1,11,3,2,6,11315,38,4043
서울특별시,관악구,신원동,관내사전투표,3908,3908,1910,652,773,258,286,5,1,4,0,3,2,0,1,3895,13,0
서울특별시,관악구,신원동,신원동제1투,3219,1929,755,444,424,140,150,3,0,1,0,3,0,0,1,1921,8,1290
서울특별시,관악구,신원동,신원동제2투,2681,1827,741,378,452,118,119,4,0,5,1,2,0,0,0,1820,7,854
서울특별시,관악구,신원동,신원동제3투,2621,1771,770,330,428,105,124,5,0,0,0,1,1,1,2,1767,4,850
서울특별시,관악구,신원동,신원동제4투,2967,1918,825,356,495,99,125,4,1,2,0,2,0,1,2,1912,6,1049
서울특별시,관악구,서림동,관내사전투표,3045,3045,1546,394,599,244,241,8,0,1,0,2,1,0,0,3036,9,0
서울특별시,관악구,서림동,합계,18782,13918,6141,2471,3171,985,1018,35,3,8,4,15,2,1,6,13860,58,4864
서울특별시,관악구,서림동,서림동제1투,3430,2165,898,429,534,143,140,5,1,2,1,1,0,0,0,2154,11,1265
서울특별시,관악구,서림동,서림동제2투,2930,2363,917,580,550,154,137,8,0,0,1,3,0,1,1,2352,11,567
서울특별시,관악구,서림동,서림동제3투,2643,1742,747,300,429,120,127,2,2,1,0,4,0,0,1,1733,9,901
서울특별시,관악구,서림동,서림동제4투,3383,2206,1026,338,441,191,193,6,0,2,1,3,0,0,0,2201,5,1177
서울특별시,관악구,서림동,서림동제5투,3351,2397,1007,430,618,133,180,6,0,2,1,2,1,0,4,2384,13,954
서울특별시,관악구,삼성동,관내사전투표,4123,4123,1925,731,928,263,242,4,1,5,0,4,0,2,2,4107,16,0
서울특별시,관악구,삼성동,합계,21698,16481,6790,3446,4210,1003,877,28,5,17,2,21,2,7,11,16419,62,5217
서울특별시,관악구,삼성동,삼성동제1투,2818,1553,592,373,417,77,67,3,1,2,1,3,2,3,3,1544,9,1265
서울특별시,관악구,삼성동,삼성동제2투,3082,2183,827,499,592,129,110,2,1,4,0,5,0,2,3,2174,9,899
서울특별시,관악구,삼성동,삼성동제3투,3184,2334,893,483,662,158,116,6,1,2,0,4,0,0,1,2326,8,850
서울특별시,관악구,삼성동,삼성동제4투,2487,1739,654,400,478,104,89,6,0,1,0,1,0,0,1,1734,5,748
서울특별시,관악구,삼성동,삼성동제5투,2883,2019,900,403,489,99,113,3,1,2,1,1,0,0,1,2013,6,864
서울특별시,관악구,삼성동,삼성동제6투,3121,2530,999,557,644,173,140,4,0,1,0,3,0,0,0,2521,9,591
서울특별시,관악구,대학동,합계,19457,14662,6720,2407,3073,1138,1183,33,2,5,3,19,2,8,6,14599,63,4795
서울특별시,관악구,대학동,관내사전투표,5493,5493,2783,668,1049,442,495,14,0,1,2,6,1,2,3,5466,27,0
서울특별시,관악구,대학동,대학동제1투,3742,2195,933,409,450,190,199,2,0,0,0,0,0,0,0,2183,12,1547
서울특별시,관악구,대학동,대학동제2투,2963,2294,945,426,583,176,147,6,1,1,0,1,0,2,1,2289,5,669
서울특별시,관악구,대학동,대학동제3투,3969,2583,1135,485,573,166,189,6,1,3,1,9,1,4,2,2575,8,1386
서울특별시,관악구,대학동,대학동제4투,3290,2097,924,419,418,164,153,5,0,0,0,3,0,0,0,2086,11,1193
서울특별시,관악구,잘못 투입·구분된 투표지,,0,28,16,3,7,1,1,0,0,0,0,0,0,0,0,28,0,-28
서울특별시,서초구,합계,,362519,292916,106416,74891,63977,29231,16562,520,28,96,55,93,28,84,111,292092,824,69603
서울특별시,서초구,거소·선상투표,,484,457,134,96,157,25,14,5,1,1,2,2,1,1,2,441,16,27
서울특별시,서초구,관외사전투표,,36041,36036,14964,7209,7456,3510,2596,66,4,10,7,18,3,5,20,35868,168,5
서울특별시,서초구,재외투표,,7300,5739,2905,612,1130,389,644,32,2,0,1,2,0,2,0,5719,20,1561
서울특별시,서초구,서초1동,합계,15590,12178,4255,3303,2606,1294,653,23,1,3,2,3,1,3,6,12153,25,3412
서울특별시,서초구,서초1동,관내사전투표,3371,3371,1384,781,675,320,191,6,1,1,0,2,0,1,1,3363,8,0
서울특별시,서초구,서초1동,서초1동제1투,3741,2749,878,796,594,333,135,6,0,0,0,0,0,0,2,2744,5,992
서울특별시,서초구,서초1동,서초1동제2투,3139,2325,755,668,509,240,138,8,0,0,0,0,0,1,2,2321,4,814
서울특별시,서초구,서초1동,서초1동제3투,2885,2030,607,629,474,215,92,3,0,0,1,1,1,1,0,2024,6,855
서울특별시,서초구,서초1동,서초1동제4투,2454,1703,631,429,354,186,97,0,0,2,1,0,0,0,1,1701,2,751
서울특별시,서초구,서초2동,합계,14277,11131,3848,3012,2356,1218,628,25,1,0,0,2,0,3,4,11097,34,3146
서울특별시,서초구,서초2동,관내사전투표,3114,3114,1236,772,571,325,193,7,0,0,0,0,0,1,1,3106,8,0
서울특별시,서초구,서초2동,서초2동제1투,1638,1341,422,378,287,168,74,6,0,0,0,0,0,0,0,1335,6,297
서울특별시,서초구,서초2동,서초2동제2투,2497,1855,570,493,456,208,114,3,0,0,0,0,0,1,1,1846,9,642
서울특별시,서초구,서초2동,서초2동제3투,3140,2383,831,647,504,255,126,7,1,0,0,2,0,1,2,2376,7,757
서울특별시,서초구,서초2동,서초2동제4투,1854,1174,447,285,243,133,65,0,0,0,0,0,0,0,0,1173,1,680
서울특별시,서초구,서초2동,서초2동제5투,2034,1264,342,437,295,129,56,2,0,0,0,0,0,0,0,1261,3,770
서울특별시,서초구,서초3동,합계,22521,17528,5961,5123,3773,1708,857,30,1,9,3,4,1,4,4,17478,50,4993
서울특별시,서초구,서초3동,관내사전투표,4673,4673,1844,1178,883,481,268,5,0,3,1,0,1,0,0,4664,9,0
서울특별시,서초구,서초3동,서초3동제1투,3053,2079,474,842,494,193,64,4,0,0,0,0,0,2,0,2073,6,974
서울특별시,서초구,서초3동,서초3동제2투,2554,1927,675,537,403,191,106,1,0,0,1,1,0,2,3,1920,7,627
서울특별시,서초구,서초3동,서초3동제3투,2536,1865,609,552,434,180,76,4,1,1,0,1,0,0,1,1859,6,671
서울특별시,서초구,서초3동,서초3동제4투,2223,1625,591,459,344,141,76,4,0,1,0,1,0,0,0,1617,8,598
서울특별시,서초구,서초3동,서초3동제5투,2484,1719,559,515,399,153,84,2,0,2,1,0,0,0,0,1715,4,765
서울특별시,서초구,서초3동,서초3동제6투,2886,1992,741,493,428,206,110,7,0,1,0,0,0,0,0,1986,6,894
서울특별시,서초구,서초3동,서초3동제7투,2112,1648,468,547,388,163,73,3,0,1,0,1,0,0,0,1644,4,464
서울특별시,서초구,서초4동,합계,19878,15893,4612,5091,3505,1969,637,24,0,2,4,3,0,4,5,15856,37,3985
서울특별시,서초구,서초4동,관내사전투표,3185,3185,1173,820,638,374,169,3,0,1,0,0,0,1,1,3180,5,0
서울특별시,서초구,서초4동,서초4동제1투,2869,1658,542,481,346,196,78,6,0,0,0,1,0,0,0,1650,8,1211
서울특별시,서초구,서초4동,서초4동제2투,2299,1831,493,636,412,217,66,2,0,0,1,1,0,1,0,1829,2,468
서울특별시,서초구,서초4동,서초4동제3투,2984,2309,578,791,561,293,73,1,0,0,2,1,0,1,2,2303,6,675
서울특별시,서초구,서초4동,서초4동제4투,2680,2143,465,883,461,265,63,0,0,0,0,0,0,1,1,2139,4,537
서울특별시,서초구,서초4동,서초4동제5투,3273,2591,688,860,587,331,107,9,0,0,1,0,0,0,1,2584,7,682
서울특별시,서초구,서초4동,서초4동제6투,2588,2176,673,620,500,293,81,3,0,1,0,0,0,0,0,2171,5,412
서울특별시,서초구,잠원동,관내사전투표,4401,4401,1747,947,921,538,229,7,1,0,1,0,0,1,0,4392,9,0
서울특별시,서초구,잠원동,합계,25095,19739,6735,5059,4370,2438,1032,26,2,1,4,2,2,9,8,19688,51,5356
서울특별시,서초구,잠원동,잠원동제1투,3237,2075,629,583,465,276,111,1,1,0,0,2,0,3,2,2073,2,1162
서울특별시,서초구,잠원동,잠원동제2투,2324,1678,461,504,397,224,85,0,0,0,0,0,0,0,0,1671,7,646
서울특별시,서초구,잠원동,잠원동제3투,2443,1918,724,395,453,242,99,2,0,0,0,0,0,0,1,1916,2,525
서울특별시,서초구,잠원동,잠원동제4투,2449,1890,554,557,411,248,108,1,0,0,0,0,0,0,3,1882,8,559
서울특별시,서초구,잠원동,잠원동제5투,2663,1804,675,433,402,152,124,5,0,0,1,0,1,1,0,1794,10,859
서울특별시,서초구,잠원동,잠원동제6투,2403,1899,626,500,463,219,82,3,0,0,1,0,0,0,1,1895,4,504
서울특별시,서초구,잠원동,잠원동제7투,2625,2043,632,596,428,288,90,1,0,0,1,0,0,2,0,2038,5,582
서울특별시,서초구,잠원동,잠원동제8투,2550,2031,687,544,430,251,104,6,0,1,0,0,1,2,1,2027,4,519
서울특별시,서초구,반포본동,관내사전투표,1802,1802,674,459,360,188,112,3,0,2,0,1,0,0,0,1799,3,0
서울특별시,서초구,반포본동,합계,8873,7200,2259,2146,1536,834,379,15,2,5,0,1,2,2,1,7182,18,1673
서울특별시,서초구,반포본동,반포본동제1투,1985,1280,489,285,262,164,67,6,1,0,0,0,0,1,1,1276,4,705
서울특별시,서초구,반포본동,반포본동제2투,1721,1368,315,521,281,174,68,2,1,2,0,0,0,0,0,1364,4,353
서울특별시,서초구,반포본동,반포본동제3투,2019,1656,441,587,383,161,79,2,0,0,0,0,0,0,0,1653,3,363
서울특별시,서초구,반포본동,반포본동제4투,1346,1094,340,294,250,147,53,2,0,1,0,0,2,1,0,1090,4,252
서울특별시,서초구,반포1동,합계,21496,15643,5651,4131,3403,1568,792,43,1,5,2,2,1,5,4,15608,35,5853
서울특별시,서초구,반포1동,관내사전투표,3550,3550,1450,871,710,326,179,6,0,0,0,0,0,1,1,3544,6,0
서울특별시,서초구,반포1동,반포1동제1투,3273,2627,840,705,650,320,101,3,0,1,0,0,0,2,0,2622,5,646
서울특별시,서초구,반포1동,반포1동제2투,3237,2485,846,655,582,272,109,13,1,0,1,0,0,0,0,2479,6,752
서울특별시,서초구,반포1동,반포1동제3투,2901,1782,716,442,352,144,114,6,0,1,1,1,1,0,0,1778,4,1119
서울특별시,서초구,반포1동,반포1동제4투,2711,1574,647,347,320,132,111,8,0,1,0,0,0,0,1,1567,7,1137
서울특별시,서초구,반포1동,반포1동제5투,2449,1363,565,293,260,117,116,1,0,2,0,1,0,2,1,1358,5,1086
서울특별시,서초구,반포1동,반포1동제6투,3375,2262,587,818,529,257,62,6,0,0,0,0,0,0,1,2260,2,1113
서울특별시,서초구,반포2동,합계,16445,13600,3846,4110,3263,1660,636,33,0,2,1,4,0,5,2,13562,38,2845
서울특별시,서초구,반포2동,관내사전투표,3230,3230,1071,895,693,387,166,11,0,0,0,1,0,1,1,3226,4,0
서울특별시,서초구,반포2동,반포2동제1투,3408,2478,567,822,640,333,101,6,0,1,0,0,0,0,0,2470,8,930
서울특별시,서초구,반포2동,반포2동제2투,2274,1818,524,570,397,225,88,1,0,0,0,3,0,3,0,1811,7,456
서울특별시,서초구,반포2동,반포2동제3투,2196,1707,529,448,413,212,91,3,0,0,1,0,0,1,0,1698,9,489
서울특별시,서초구,반포2동,반포2동제4투,2678,2217,695,590,568,255,99,4,0,1,0,0,0,0,0,2212,5,461
서울특별시,서초구,반포2동,반포2동제5투,2659,2150,460,785,552,248,91,8,0,0,0,0,0,0,1,2145,5,509
서울특별시,서초구,반포3동,합계,13086,10524,3342,2947,2438,1243,480,27,0,4,1,0,1,6,2,10491,33,2562
서울특별시,서초구,반포3동,관내사전투표,2822,2822,1000,714,617,338,137,6,0,2,0,0,1,1,0,2816,6,0
서울특별시,서초구,반포3동,반포3동제1투,2267,1464,439,433,360,167,52,6,0,0,0,0,0,1,2,1460,4,803
서울특별시,서초구,반포3동,반포3동제2투,2068,1616,510,449,376,194,77,3,0,0,0,0,0,4,0,1613,3,452
서울특별시,서초구,반포3동,반포3동제3투,1691,1267,380,394,281,142,62,1,0,1,0,0,0,0,0,1261,6,424
서울특별시,서초구,반포3동,반포3동제4투,2188,1686,464,508,403,214,83,8,0,0,1,0,0,0,0,1681,5,502
서울특별시,서초구,반포3동,반포3동제5투,2050,1669,549,449,401,188,69,3,0,1,0,0,0,0,0,1660,9,381
서울특별시,서초구,반포4동,합계,13911,11007,3660,3098,2411,1227,562,7,1,3,3,3,0,3,2,10980,27,2904
서울특별시,서초구,반포4동,관내사전투표,2433,2433,910,604,467,286,149,3,1,1,2,2,0,0,0,2425,8,0
서울특별시,서초구,반포4동,반포4동제1투,2324,1637,561,451,356,166,95,2,0,1,0,0,0,2,0,1634,3,687
서울특별시,서초구,반포4동,반포4동제2투,2675,1879,563,618,384,203,103,1,0,1,0,0,0,1,1,1875,4,796
서울특별시,서초구,반포4동,반포4동제3투,2615,2192,715,571,549,253,99,0,0,0,0,0,0,0,1,2188,4,423
서울특별시,서초구,반포4동,반포4동제4투,1701,1356,452,369,314,165,48,1,0,0,1,1,0,0,0,1351,5,345
서울특별시,서초구,반포4동,반포4동제5투,2163,1510,459,485,341,154,68,0,0,0,0,0,0,0,0,1507,3,653
서울특별시,서초구,방배본동,관내사전투표,2830,2830,1124,660,594,251,184,6,0,0,0,1,0,0,3,2823,7,0
서울특별시,서초구,방배본동,합계,15472,12140,4064,3378,2752,1208,671,21,1,2,1,3,2,3,8,12114,26,3332
서울특별시,서초구,방배본동,방배본동제1투,3004,2112,647,621,520,213,103,1,0,0,0,1,0,0,0,2106,6,892
서울특별시,서초구,방배본동,방배본동제2투,3066,2234,518,829,496,286,91,10,0,0,0,0,0,1,0,2231,3,832
서울특별시,서초구,방배본동,방배본동제3투,3545,2673,877,720,632,277,151,3,0,2,1,0,0,2,4,2669,4,872
서울특별시,서초구,방배본동,방배본동제4투,3027,2291,898,548,510,181,142,1,1,0,0,1,2,0,1,2285,6,736
서울특별시,서초구,방배1동,관내사전투표,3051,3051,1325,617,612,284,198,6,0,0,0,1,0,1,2,3046,5,0
서울특별시,서초구,방배1동,합계,12931,10262,3848,2558,2200,988,611,20,0,3,1,4,1,2,5,10241,21,2669
서울특별시,서초구,방배1동,방배1동제1투,2498,1715,682,415,369,142,97,3,0,0,1,1,0,0,0,1710,5,783
서울특별시,서초구,방배1동,방배1동제2투,2896,2164,818,490,517,209,121,2,0,0,0,0,0,0,1,2158,6,732
서울특별시,서초구,방배1동,방배1동제3투,1994,1421,527,361,285,137,97,2,0,3,0,2,1,1,2,1418,3,573
서울특별시,서초구,방배1동,방배1동제4투,2492,1911,496,675,417,216,98,7,0,0,0,0,0,0,0,1909,2,581
서울특별시,서초구,방배2동,합계,20245,16026,6200,4032,3604,1239,850,21,4,3,3,6,2,9,10,15983,43,4219
서울특별시,서초구,방배2동,관내사전투표,3973,3973,1794,844,766,310,238,3,1,0,0,1,0,2,4,3963,10,0
서울특별시,서초구,방배2동,방배2동제1투,2617,1679,635,419,389,129,97,3,0,0,0,0,0,1,0,1673,6,938
서울특별시,서초구,방배2동,방배2동제2투,2149,1598,646,403,352,109,77,3,1,2,0,1,1,1,0,1596,2,551
서울특별시,서초구,방배2동,방배2동제3투,2113,1552,531,415,417,118,60,2,1,0,0,1,0,0,1,1546,6,561
서울특별시,서초구,방배2동,방배2동제4투,1930,1298,444,388,289,94,75,3,0,0,1,1,0,1,0,1296,2,632
서울특별시,서초구,방배2동,방배2동제5투,2503,2032,745,500,507,172,100,2,0,1,0,0,0,1,2,2030,2,471
서울특별시,서초구,방배2동,방배2동제6투,1932,1443,606,336,290,119,80,0,1,0,1,0,0,2,1,1436,7,489
서울특별시,서초구,방배2동,방배2동제7투,1903,1608,533,461,377,144,83,3,0,0,0,1,0,1,0,1603,5,295
서울특별시,서초구,방배2동,방배2동제8투,1125,843,266,266,217,44,40,2,0,0,1,1,1,0,2,840,3,282
서울특별시,서초구,방배3동,관내사전투표,2913,2913,1109,757,603,261,173,5,0,0,1,0,0,0,0,2909,4,0
서울특별시,서초구,방배3동,합계,17101,13502,4387,3842,3123,1324,736,24,0,6,8,3,6,4,5,13468,34,3599
서울특별시,서초구,방배3동,방배3동제1투,2913,2057,508,749,478,225,83,6,0,0,2,1,0,0,0,2052,5,856
서울특별시,서초구,방배3동,방배3동제2투,2164,1692,443,510,431,209,89,0,0,3,4,0,0,0,0,1689,3,472
서울특별시,서초구,방배3동,방배3동제3투,2254,1747,448,569,437,186,90,5,0,2,0,1,2,1,1,1742,5,507
서울특별시,서초구,방배3동,방배3동제4투,1998,1437,556,332,326,128,84,3,0,1,0,0,1,1,2,1434,3,561
서울특별시,서초구,방배3동,방배3동제5투,2872,2125,779,545,497,170,122,4,0,0,0,0,0,1,0,2118,7,747
서울특별시,서초구,방배3동,방배3동제6투,1987,1531,544,380,351,145,95,1,0,0,1,1,3,1,2,1524,7,456
서울특별시,서초구,방배4동,합계,18784,14944,5525,3785,3256,1407,897,14,1,9,4,6,1,2,2,14909,35,3840
서울특별시,서초구,방배4동,관내사전투표,3926,3926,1606,921,751,374,259,0,1,4,0,1,1,1,0,3919,7,0
서울특별시,서초구,방배4동,방배4동제1투,2437,1763,445,629,422,185,69,4,0,1,2,0,0,0,1,1758,5,674
서울특별시,서초구,방배4동,방배4동제2투,2375,1737,554,528,355,197,95,3,0,0,0,0,0,0,0,1732,5,638
서울특별시,서초구,방배4동,방배4동제3투,2489,1666,661,369,374,130,123,1,0,2,2,0,0,0,0,1662,4,823
서울특별시,서초구,방배4동,방배4동제4투,2605,1954,818,377,451,163,138,0,0,2,0,1,0,0,1,1951,3,651
서울특별시,서초구,방배4동,방배4동제5투,2247,1646,651,349,395,124,114,1,0,0,0,4,0,0,0,1638,8,601
서울특별시,서초구,방배4동,방배4동제6투,2705,2252,790,612,508,234,99,5,0,0,0,0,0,1,0,2249,3,453
서울특별시,서초구,양재1동,합계,31860,25204,10193,5880,5453,2074,1462,35,4,7,8,11,4,9,7,25147,57,6656
서울특별시,서초구,양재1동,관내사전투표,4213,4213,1930,853,815,363,236,6,1,0,2,2,0,0,0,4208,5,0
서울특별시,서초구,양재1동,양재1동제1투,2307,1715,678,426,341,142,116,2,0,1,0,1,0,0,2,1709,6,592
서울특별시,서초구,양재1동,양재1동제2투,2856,2157,890,490,469,157,140,2,0,2,0,0,1,0,1,2152,5,699
서울특별시,서초구,양재1동,양재1동제3투,2133,1539,504,528,298,130,69,3,0,0,1,0,0,0,0,1533,6,594
서울특별시,서초구,양재1동,양재1동제4투,2713,2156,798,551,452,217,124,4,0,1,0,1,0,0,2,2150,6,557
서울특별시,서초구,양재1동,양재1동제5투,3413,2611,994,652,591,203,153,4,0,2,2,2,1,1,2,2607,4,802
서울특별시,서초구,양재1동,양재1동제6투,2807,1917,737,496,430,134,104,3,1,0,1,2,2,2,0,1912,5,890
서울특별시,서초구,양재1동,양재1동제7투,2427,1759,553,579,369,162,82,3,1,0,0,0,0,1,0,1750,9,668
서울특별시,서초구,양재1동,양재1동제8투,2831,2267,993,442,487,179,150,7,0,1,1,0,0,1,0,2261,6,564
서울특별시,서초구,양재1동,양재1동제9투,3398,2705,1143,472,661,253,169,1,0,0,0,0,0,3,0,2702,3,693
서울특별시,서초구,양재1동,양재1동제10투,2762,2165,973,391,540,134,119,0,1,0,1,3,0,1,0,2163,2,597
서울특별시,서초구,양재2동,합계,18039,13847,6142,2757,2881,1080,904,13,1,12,0,9,0,2,8,13809,38,4192
서울특별시,서초구,양재2동,관내사전투표,3842,3842,1942,629,693,275,274,6,1,4,0,3,0,0,4,3831,11,0
서울특별시,서초구,양재2동,양재2동제1투,2830,1806,724,433,410,107,120,1,0,0,0,2,0,0,0,1797,9,1024
서울특별시,서초구,양재2동,양재2동제2투,2448,1823,780,373,379,174,108,2,0,3,0,0,0,0,1,1820,3,625
서울특별시,서초구,양재2동,양재2동제3투,3137,2283,983,493,481,169,146,1,0,0,0,1,0,1,2,2277,6,854
서울특별시,서초구,양재2동,양재2동제4투,3068,2267,935,454,503,206,154,1,0,5,0,3,0,0,0,2261,6,801
서울특별시,서초구,양재2동,양재2동제5투,2714,1826,778,375,415,149,102,2,0,0,0,0,0,1,1,1823,3,888
서울특별시,서초구,내곡동,합계,13090,10316,3885,2722,2304,828,521,16,1,9,0,5,0,1,6,10298,18,2774
서울특별시,서초구,내곡동,관내사전투표,2280,2280,970,562,435,164,137,2,0,3,0,2,0,0,1,2276,4,0
서울특별시,서초구,내곡동,내곡동제1투,1543,916,232,332,217,65,55,3,0,3,0,0,0,0,5,912,4,627
서울특별시,서초구,내곡동,내곡동제2투,2675,2151,783,590,473,221,78,3,0,0,0,1,0,0,0,2149,2,524
서울특별시,서초구,내곡동,내곡동제3투,3386,2635,1029,608,642,200,145,5,0,1,0,1,0,0,0,2631,4,751
서울특별시,서초구,내곡동,내곡동제4투,3206,2334,871,630,537,178,106,3,1,2,0,1,0,1,0,2330,4,872
서울특별시,서초구,잘못 투입·구분된 투표지,,0,0,0,0,0,0,0,0,0,0,0,0,0,0,0,0,0,0
서울특별시,강남구,합계,,467032,365642,128927,97639,80201,36176,20287,714,39,121,80,97,49,101,163,364594,1048,101390
서울특별시,강남구,거소·선상투표,,600,555,199,116,178,33,10,3,1,1,1,1,2,1,1,547,8,45
서울특별시,강남구,관외사전투표,,42653,42645,17443,8661,9066,4188,2922,74,6,7,12,22,9,10,34,42454,191,8
서울특별시,강남구,재외투표,,8908,6863,3325,867,1409,448,756,28,0,0,0,3,1,1,2,6840,23,2045
서울특별시,강남구,신사동,합계,13940,10531,3026,3618,2179,1116,538,19,0,0,2,2,0,3,6,10509,22,3409
서울특별시,강남구,신사동,관내사전투표,2548,2548,931,691,462,278,170,8,0,0,1,0,0,0,3,2544,4,0
서울특별시,강남구,신사동,신사동제1투,2329,1467,427,466,342,160,68,2,0,0,0,1,0,1,0,1467,0,862
서울특별시,강남구,신사동,신사동제2투,1831,1153,460,294,230,95,66,4,0,0,0,0,0,0,0,1149,4,678
서울특별시,강남구,신사동,신사동제3투,1963,1353,542,326,271,106,102,0,0,0,0,1,0,0,2,1350,3,610
서울특별시,강남구,신사동,신사동제4투,2815,2089,276,1099,426,220,57,1,0,0,1,0,0,2,0,2082,7,726
서울특별시,강남구,신사동,신사동제5투,2454,1921,390,742,448,257,75,4,0,0,0,0,0,0,1,1917,4,533
서울특별시,강남구,논현1동,합계,19895,12651,5032,3083,2526,1055,887,19,3,3,1,2,1,1,5,12618,33,7244
서울특별시,강남구,논현1동,관내사전투표,3093,3093,1454,598,509,248,272,2,0,0,0,0,1,1,0,3085,8,0
서울특별시,강남구,논현1동,논현1동제1투,3551,1669,679,376,358,130,117,2,1,0,0,0,0,0,1,1664,5,1882
서울특별시,강남구,논현1동,논현1동제2투,3207,1900,702,572,353,160,104,4,0,0,1,2,0,0,0,1898,2,1307
서울특별시,강남구,논현1동,논현1동제3투,3713,2438,836,694,499,251,145,6,0,2,0,0,0,0,1,2434,4,1275
서울특별시,강남구,논현1동,논현1동제4투,3351,1857,710,460,402,139,133,2,1,1,0,0,0,0,2,1850,7,1494
서울특별시,강남구,논현1동,논현1동제5투,2980,1694,651,383,405,127,116,3,1,0,0,0,0,0,1,1687,7,1286
서울특별시,강남구,논현2동,관내사전투표,2800,2800,1154,703,464,270,190,7,0,1,2,2,0,2,1,2796,4,0
서울특별시,강남구,논현2동,합계,17375,12143,4194,3500,2475,1168,721,28,1,9,5,5,0,3,7,12116,27,5232
서울특별시,강남구,논현2동,논현2동제1투,3548,1995,581,678,433,189,100,6,0,0,1,0,0,0,2,1990,5,1553
서울특별시,강남구,논현2동,논현2동제2투,2409,1686,503,531,392,153,92,4,0,2,1,2,0,1,1,1682,4,723
서울특별시,강남구,논현2동,논현2동제3투,1872,1229,455,330,249,106,87,0,0,0,0,0,0,0,0,1227,2,643
서울특별시,강남구,논현2동,논현2동제4투,3622,2480,788,757,527,263,131,4,1,2,0,1,0,0,2,2476,4,1142
서울특별시,강남구,논현2동,논현2동제5투,3124,1953,713,501,410,187,121,7,0,4,1,0,0,0,1,1945,8,1171
서울특별시,강남구,압구정동,합계,20639,15418,3234,6449,3306,1783,546,44,0,7,5,1,1,1,2,15379,39,5221
서울특별시,강남구,압구정동,관내사전투표,2899,2899,697,1108,613,350,118,9,0,1,1,0,0,0,0,2897,2,0
서울특별시,강남구,압구정동,압구정동제1투,3179,1940,288,1000,366,219,48,7,0,1,0,0,0,0,0,1929,11,1239
서울특별시,강남구,압구정동,압구정동제2투,2100,1575,304,640,393,180,44,10,0,0,1,0,0,1,0,1573,2,525
서울특별시,강남구,압구정동,압구정동제3투,2652,1978,337,906,417,252,53,8,0,0,0,0,0,0,0,1973,5,674
서울특별시,강남구,압구정동,압구정동제4투,2315,1583,471,538,334,148,78,1,0,4,1,0,0,0,1,1576,7,732
서울특별시,강남구,압구정동,압구정동제5투,3169,2444,516,977,539,301,95,4,0,1,0,1,0,0,0,2434,10,725
서울특별시,강남구,압구정동,압구정동제6투,2973,2114,419,909,444,258,75,4,0,0,2,0,1,0,0,2112,2,859
서울특별시,강남구,압구정동,압구정동제7투,1352,885,202,371,200,75,35,1,0,0,0,0,0,0,1,885,0,467
서울특별시,강남구,청담동,관내사전투표,3463,3463,1300,948,631,366,196,2,0,2,0,2,1,2,1,3451,12,0
서울특별시,강남구,청담동,합계,22476,16599,4877,5452,3601,1774,783,36,0,8,2,3,2,5,6,16549,50,5877
서울특별시,강남구,청담동,청담동제1투,3417,1988,541,676,446,224,89,6,0,2,0,0,0,0,0,1984,4,1429
서울특별시,강남구,청담동,청담동제2투,2413,1598,303,730,344,151,60,4,0,0,0,0,0,0,1,1593,5,815
서울특별시,강남구,청담동,청담동제3투,2077,1530,354,629,331,150,57,2,0,1,0,0,0,0,0,1524,6,547
서울특별시,강남구,청담동,청담동제4투,3624,2708,670,958,642,319,96,7,0,2,2,1,1,0,1,2699,9,916
서울특별시,강남구,청담동,청담동제5투,2886,2154,690,557,519,240,133,2,0,0,0,0,0,2,1,2144,10,732
서울특별시,강남구,청담동,청담동제6투,2878,2041,703,550,463,214,97,10,0,0,0,0,0,0,1,2038,3,837
서울특별시,강남구,청담동,청담동제7투,1718,1117,316,404,225,110,55,3,0,1,0,0,0,1,1,1116,1,601
서울특별시,강남구,삼성1동,합계,11463,8780,2675,2773,1978,877,414,25,1,2,1,1,1,3,6,8757,23,2683
서울특별시,강남구,삼성1동,관내사전투표,2483,2482,915,681,498,236,130,7,0,0,0,1,1,0,3,2472,10,1
서울특별시,강남구,삼성1동,삼성1동제1투,2852,1936,538,698,424,175,86,10,0,0,0,0,0,1,1,1933,3,916
서울특별시,강남구,삼성1동,삼성1동제2투,3081,2267,565,812,545,233,102,3,1,0,1,0,0,1,0,2263,4,814
서울특별시,강남구,삼성1동,삼성1동제3투,3047,2095,657,582,511,233,96,5,0,2,0,0,0,1,2,2089,6,952
서울특별시,강남구,삼성2동,합계,22884,17486,6373,4555,3738,1776,952,29,1,6,3,4,3,3,5,17448,38,5398
서울특별시,강남구,삼성2동,관내사전투표,4699,4699,2016,990,901,462,312,6,0,0,1,0,0,1,2,4691,8,0
서울특별시,강남구,삼성2동,삼성2동제1투,3770,2115,839,510,407,183,155,7,0,1,1,1,0,0,0,2104,11,1655
서울특별시,강남구,삼성2동,삼성2동제2투,4067,3271,1033,960,761,375,121,9,1,2,0,1,1,0,0,3264,7,796
서울특별시,강남구,삼성2동,삼성2동제3투,3492,2433,848,671,538,227,136,0,0,2,1,2,0,2,3,2430,3,1059
서울특별시,강남구,삼성2동,삼성2동제4투,2952,1913,716,522,397,152,117,4,0,1,0,0,1,0,0,1910,3,1039
서울특별시,강남구,삼성2동,삼성2동제5투,3904,3055,921,902,734,377,111,3,0,0,0,0,1,0,0,3049,6,849
서울특별시,강남구,대치1동,합계,16579,13868,3820,4305,3392,1713,566,21,1,5,2,1,0,0,5,13831,37,2711
서울특별시,강남구,대치1동,관내사전투표,3359,3359,1118,968,711,397,152,4,0,0,0,0,0,0,1,3351,8,0
서울특별시,강남구,대치1동,대치1동제1투,3370,2716,676,877,730,333,84,6,1,2,0,0,0,0,2,2711,5,654
서울특별시,강남구,대치1동,대치1동제2투,2148,1698,547,397,461,199,84,1,0,0,1,0,0,0,0,1690,8,450
서울특별시,강남구,대치1동,대치1동제3투,2199,1765,405,651,390,237,75,3,0,0,0,0,0,0,2,1763,2,434
서울특별시,강남구,대치1동,대치1동제4투,2257,1776,385,678,409,224,69,4,0,2,0,0,0,0,0,1771,5,481
서울특별시,강남구,대치1동,대치1동제5투,3246,2554,689,734,691,323,102,3,0,1,1,1,0,0,0,2545,9,692
서울특별시,강남구,대치2동,합계,28610,23257,7176,6829,5422,2612,1091,62,1,4,3,4,1,6,7,23218,39,5353
서울특별시,강남구,대치2동,관내사전투표,4493,4493,1775,1056,901,462,271,10,0,2,1,2,0,0,3,4483,10,0
서울특별시,강남구,대치2동,대치2동제1투,3459,2796,915,730,687,299,144,8,1,0,1,0,1,1,1,2788,8,663
서울특별시,강남구,대치2동,대치2동제2투,2697,2146,686,585,545,209,112,5,0,0,0,0,0,0,2,2144,2,551
서울특별시,강남구,대치2동,대치2동제3투,2969,2351,742,662,541,268,128,4,0,1,0,0,0,1,0,2347,4,618
서울특별시,강남구,대치2동,대치2동제4투,2651,2120,443,804,512,297,53,8,0,0,0,0,0,0,0,2117,3,531
서울특별시,강남구,대치2동,대치2동제5투,2665,2224,475,865,517,295,62,5,0,0,0,0,0,0,0,2219,5,441
서울특별시,강남구,대치2동,대치2동제6투,3127,2626,603,931,635,356,84,11,0,1,1,0,0,0,0,2622,4,501
서울특별시,강남구,대치2동,대치2동제7투,3856,2623,853,682,666,268,138,6,0,0,0,2,0,4,1,2620,3,1233
서울특별시,강남구,대치2동,대치2동제8투,2693,1878,684,514,418,158,99,5,0,0,0,0,0,0,0,1878,0,815
서울특별시,강남구,대치4동,합계,16059,11506,4637,2435,2468,1067,834,13,1,3,2,3,2,3,4,11472,34,4553
서울특별시,강남구,대치4동,관내사전투표,3644,3644,1641,660,670,370,284,6,0,2,0,2,0,1,1,3637,7,0
서울특별시,강남구,대치4동,대치4동제1투,3166,1965,738,433,487,135,158,3,1,0,1,0,0,0,1,1957,8,1201
서울특별시,강남구,대치4동,대치4동제2투,3464,2444,948,517,558,227,175,1,0,0,1,1,0,2,2,2432,12,1020
서울특별시,강남구,대치4동,대치4동제3투,2733,1704,578,469,377,173,100,0,0,1,0,0,2,0,0,1700,4,1029
서울특별시,강남구,대치4동,대치4동제4투,3052,1749,732,356,376,162,117,3,0,0,0,0,0,0,0,1746,3,1303
서울특별시,강남구,역삼1동,관내사전투표,3988,3988,1921,694,691,357,303,9,1,1,1,1,0,1,1,3981,7,0
서울특별시,강남구,역삼1동,합계,27800,17406,7210,3815,3583,1500,1195,29,1,9,1,4,1,5,8,17361,45,10394
서울특별시,강남구,역삼1동,역삼1동제1투,3158,1744,662,429,366,155,120,5,0,3,0,0,0,0,1,1741,3,1414
서울특별시,강남구,역삼1동,역삼1동제2투,2666,1520,602,338,344,133,95,3,0,0,0,0,0,1,1,1517,3,1146
서울특별시,강남구,역삼1동,역삼1동제3투,3265,1834,783,379,409,146,103,2,0,1,0,1,0,2,1,1827,7,1431
서울특별시,강남구,역삼1동,역삼1동제4투,3500,1950,747,509,391,156,139,2,0,0,0,1,0,0,3,1948,2,1550
서울특별시,강남구,역삼1동,역삼1동제5투,4126,1868,761,431,378,147,139,2,0,0,0,0,0,1,0,1859,9,2258
서울특별시,강남구,역삼1동,역삼1동제6투,3015,1912,742,450,427,156,119,3,0,3,0,1,0,0,1,1902,10,1103
서울특별시,강남구,역삼1동,역삼1동제7투,4082,2590,992,585,577,250,177,3,0,1,0,0,1,0,0,2586,4,1492
서울특별시,강남구,역삼2동,합계,26206,19891,7241,4887,4423,2169,1083,27,2,5,2,1,2,4,6,19852,39,6315
서울특별시,강남구,역삼2동,관내사전투표,5262,5262,2147,1148,1066,568,318,6,0,2,0,0,1,0,0,5256,6,0
서울특별시,강남구,역삼2동,역삼2동제1투,3799,2447,829,606,568,300,138,1,1,0,0,1,0,0,0,2444,3,1352
서울특별시,강남구,역삼2동,역삼2동제2투,3711,2797,815,837,668,332,132,4,0,0,1,0,0,1,2,2792,5,914
서울특별시,강남구,역삼2동,역삼2동제3투,3540,2127,793,501,476,219,125,4,0,1,0,0,0,1,1,2121,6,1413
서울특별시,강남구,역삼2동,역삼2동제4투,3376,2265,917,510,465,213,147,2,0,2,0,0,1,0,0,2257,8,1111
서울특별시,강남구,역삼2동,역삼2동제5투,3005,2252,873,509,539,202,113,6,1,0,1,0,0,2,2,2248,4,753
서울특별시,강남구,역삼2동,역삼2동제6투,3513,2741,867,776,641,335,110,4,0,0,0,0,0,0,1,2734,7,772
서울특별시,강남구,도곡1동,합계,16564,13463,4536,3589,2993,1522,747,26,1,7,4,4,1,3,2,13435,28,3101
서울특별시,강남구,도곡1동,관내사전투표,3698,3698,1417,880,724,425,237,8,0,0,1,1,0,0,0,3693,5,0
서울특별시,강남구,도곡1동,도곡1동제1투,1484,1156,287,389,270,150,51,3,0,0,0,0,1,1,0,1152,4,328
서울특별시,강남구,도곡1동,도곡1동제2투,3316,2481,762,656,633,282,131,5,1,3,0,1,0,0,1,2475,6,835
서울특별시,강남구,도곡1동,도곡1동제3투,2964,2352,819,591,529,291,112,3,0,1,0,0,0,1,1,2348,4,612
서울특별시,강남구,도곡1동,도곡1동제4투,3218,2339,877,565,513,215,153,5,0,2,3,1,0,1,0,2335,4,879
서울특별시,강남구,도곡1동,도곡1동제5투,1884,1437,374,508,324,159,63,2,0,1,0,1,0,0,0,1432,5,447
서울특별시,강남구,도곡2동,합계,24112,19318,4799,6966,4406,2307,727,39,2,2,2,5,1,4,6,19266,52,4794
서울특별시,강남구,도곡2동,관내사전투표,2917,2917,924,895,598,355,137,3,0,1,0,0,0,0,1,2914,3,0
서울특별시,강남구,도곡2동,도곡2동제1투,2046,1403,479,382,292,148,87,5,1,0,0,2,0,1,0,1397,6,643
서울특별시,강남구,도곡2동,도곡2동제2투,2685,2037,443,729,491,288,77,2,0,1,0,0,0,0,1,2032,5,648
서울특별시,강남구,도곡2동,도곡2동제3투,2779,2095,322,1002,494,220,40,10,0,0,0,0,0,0,0,2088,7,684
서울특별시,강남구,도곡2동,도곡2동제4투,3580,2743,386,1431,556,291,64,6,1,0,0,0,0,1,1,2737,6,837
서울특별시,강남구,도곡2동,도곡2동제5투,3385,2576,577,940,624,318,98,4,0,0,1,0,0,0,2,2564,12,809
서울특별시,강남구,도곡2동,도곡2동제6투,3465,2844,786,909,684,346,105,6,0,0,0,0,0,1,1,2838,6,621
서울특별시,강남구,도곡2동,도곡2동제7투,3255,2703,882,678,667,341,119,3,0,0,1,3,1,1,0,2696,7,552
서울특별시,강남구,개포1동,합계,16050,12713,4172,3805,2828,1209,606,39,1,1,3,6,3,2,5,12680,33,3337
서울특별시,강남구,개포1동,관내사전투표,3382,3382,1307,852,719,305,183,7,0,0,2,1,0,0,0,3376,6,0
서울특별시,강남구,개포1동,개포1동제1투,2708,1856,569,608,408,172,86,5,0,0,0,1,1,0,1,1851,5,852
서울특별시,강남구,개포1동,개포1동제2투,3149,2535,546,948,574,371,79,6,0,0,0,0,1,1,1,2527,8,614
서울특별시,강남구,개포1동,개포1동제3투,2701,1952,655,564,421,161,131,12,1,0,1,1,0,1,0,1948,4,749
서울특별시,강남구,개포1동,개포1동제4투,2839,2070,786,539,461,164,101,8,0,0,0,1,1,0,3,2064,6,769
서울특별시,강남구,개포1동,개포1동제5투,1271,918,309,294,245,36,26,1,0,1,0,2,0,0,0,914,4,353
서울특별시,강남구,개포2동,합계,14866,11801,4152,3115,2648,1182,629,25,2,6,4,2,0,3,2,11770,31,3065
서울특별시,강남구,개포2동,관내사전투표,3238,3238,1308,723,705,293,187,6,1,3,0,0,0,1,1,3228,10,0
서울특별시,강남구,개포2동,개포2동제1투,2250,1565,579,368,365,144,97,3,0,0,0,0,0,0,0,1556,9,685
서울특별시,강남구,개포2동,개포2동제2투,1741,1185,406,332,276,92,71,3,0,0,0,0,0,0,0,1180,5,556
서울특별시,강남구,개포2동,개포2동제3투,2224,1657,485,581,350,153,79,4,0,1,0,0,0,1,0,1654,3,567
서울특별시,강남구,개포2동,개포2동제4투,2650,1926,639,510,432,251,86,2,1,1,0,1,0,1,0,1924,2,724
서울특별시,강남구,개포2동,개포2동제5투,2763,2230,735,601,520,249,109,7,0,1,4,1,0,0,1,2228,2,533
서울특별시,강남구,개포4동,합계,13338,10160,4086,2352,2220,816,612,21,1,5,4,2,0,4,14,10137,23,3178
서울특별시,강남구,개포4동,관내사전투표,2352,2352,1053,492,441,178,169,4,0,1,0,2,0,0,7,2347,5,0
서울특별시,강남구,개포4동,개포4동제1투,3585,2336,991,500,524,163,131,12,0,2,2,0,0,2,3,2330,6,1249
서울특별시,강남구,개포4동,개포4동제2투,1517,1166,240,485,285,123,30,2,0,0,0,0,0,0,1,1166,0,351
서울특별시,강남구,개포4동,개포4동제3투,2201,1667,667,375,392,141,81,2,0,0,1,0,0,1,1,1661,6,534
서울특별시,강남구,개포4동,개포4동제4투,3683,2639,1135,500,578,211,201,1,1,2,1,0,0,1,2,2633,6,1044
서울특별시,강남구,일원본동,합계,17105,14127,5313,3257,3168,1514,778,15,2,10,4,6,1,7,5,14080,47,2978
서울특별시,강남구,일원본동,관내사전투표,3960,3960,1655,781,816,428,239,5,0,7,3,2,1,1,0,3938,22,0
서울특별시,강남구,일원본동,일원본동제1투,3760,2727,887,749,666,292,115,2,0,2,1,2,0,1,2,2719,8,1033
서울특별시,강남구,일원본동,일원본동제2투,2846,2315,896,530,525,223,127,5,0,1,0,1,0,2,1,2311,4,531
서울특별시,강남구,일원본동,일원본동제3투,3721,2957,968,792,669,341,174,0,2,0,0,0,0,3,2,2951,6,764
서울특별시,강남구,일원본동,일원본동제4투,2818,2168,907,405,492,230,123,3,0,0,0,1,0,0,0,2161,7,650
서울특별시,강남구,일원1동,관내사전투표,2617,2617,1125,562,545,216,145,2,0,1,1,1,3,1,2,2604,13,0
서울특별시,강남구,일원1동,합계,13151,10074,3838,2533,2288,767,555,20,4,5,2,2,4,6,5,10029,45,3077
서울특별시,강남구,일원1동,일원1동제1투,2440,1634,589,458,382,113,79,5,0,2,0,0,1,0,1,1630,4,806
서울특별시,강남구,일원1동,일원1동제2투,1981,1527,604,394,321,112,83,4,2,0,0,0,0,1,0,1521,6,454
서울특별시,강남구,일원1동,일원1동제3투,1955,1392,494,349,319,138,75,6,0,1,0,1,0,2,0,1385,7,563
서울특별시,강남구,일원1동,일원1동제4투,2011,1425,514,349,346,106,102,0,0,0,1,0,0,2,0,1420,5,586
서울특별시,강남구,일원1동,일원1동제5투,2147,1479,512,421,375,82,71,3,2,1,0,0,0,0,2,1469,10,668
서울특별시,강남구,일원2동,관내사전투표,2720,2720,1189,565,595,216,144,1,1,0,1,1,0,0,0,2713,7,0
서울특별시,강남구,일원2동,합계,12262,9903,3835,2423,2210,888,482,14,2,5,5,2,0,6,1,9873,30,2359
서울특별시,강남구,일원2동,일원2동제1투,2192,1460,576,429,338,52,43,6,1,2,0,1,0,3,1,1452,8,732
서울특별시,강남구,일원2동,일원2동제2투,2433,1852,773,417,368,164,114,3,0,2,3,0,0,0,0,1844,8,581
서울특별시,강남구,일원2동,일원2동제3투,2253,1708,607,458,387,181,71,0,0,0,1,0,0,0,0,1705,3,545
서울특별시,강남구,일원2동,일원2동제4투,2664,2163,690,554,522,275,110,4,0,1,0,0,0,3,0,2159,4,501
서울특별시,강남구,수서동,합계,14071,10996,3903,3074,2512,856,534,20,2,6,7,0,8,8,9,10939,57,3075
서울특별시,강남구,수서동,관내사전투표,2989,2989,1219,746,605,228,167,10,0,0,2,0,0,1,1,2979,10,0
서울특별시,강남구,수서동,수서동제1투,2227,1636,472,550,365,175,70,2,0,0,0,0,0,0,1,1635,1,591
서울특별시,강남구,수서동,수서동제2투,1737,1209,428,344,297,57,56,3,0,1,1,0,3,2,1,1193,16,528
서울특별시,강남구,수서동,수서동제3투,2061,1375,467,387,360,80,51,3,1,2,2,0,3,1,5,1362,13,686
서울특별시,강남구,수서동,수서동제4투,1905,1293,423,396,325,69,58,2,1,3,2,0,2,2,1,1284,9,612
서울특별시,강남구,수서동,수서동제5투,3152,2494,894,651,560,247,132,0,0,0,0,0,0,2,0,2486,8,658
서울특별시,강남구,세곡동,합계,29426,23486,9831,5178,5184,1836,1319,38,3,5,3,11,5,9,10,23432,54,5940
서울특별시,강남구,세곡동,관내사전투표,4326,4326,2047,806,865,342,242,10,0,0,0,4,0,1,1,4318,8,0
서울특별시,강남구,세곡동,세곡동제1투,2374,1612,631,374,368,141,88,2,1,0,0,0,1,2,1,1609,3,762
서울특별시,강남구,세곡동,세곡동제2투,2646,1969,786,441,471,130,122,6,0,1,0,1,0,0,4,1962,7,677
서울특별시,강남구,세곡동,세곡동제3투,3212,2489,900,687,563,202,123,5,0,0,0,1,1,1,0,2483,6,723
서울특별시,강남구,세곡동,세곡동제4투,2705,2037,843,490,440,162,96,2,0,0,0,0,0,0,2,2035,2,668
서울특별시,강남구,세곡동,세곡동제5투,2597,2111,858,463,487,162,129,2,0,0,0,2,1,1,1,2106,5,486
서울특별시,강남구,세곡동,세곡동제6투,2690,2081,912,420,439,184,114,3,1,1,0,0,0,3,0,2077,4,609
서울특별시,강남구,세곡동,세곡동제7투,2519,1873,862,343,369,174,114,1,1,0,2,1,1,0,1,1869,4,646
서울특별시,강남구,세곡동,세곡동제8투,3648,2768,1226,550,659,138,175,3,0,3,1,1,1,1,0,2758,10,880
서울특별시,강남구,세곡동,세곡동제9투,2709,2220,766,604,523,201,116,4,0,0,0,1,0,0,0,2215,5,489
서울특별시,강남구,잘못 투입·구분된 투표지,,0,2,0,2,0,0,0,0,0,0,0,0,0,0,0,2,0,-2
서울특별시,송파구,합계,,546867,441198,177328,98549,99018,37438,26064,657,32,166,68,156,79,151,221,439927,1271,105669
서울특별시,송파구,거소·선상투표,,710,674,200,138,248,49,13,3,1,2,1,1,3,1,1,661,13,36
서울특별시,송파구,관외사전투표,,45929,45920,20681,7600,9728,4136,3364,63,6,17,4,25,14,12,46,45696,224,9
서울특별시,송파구,재외투표,,7684,5993,3256,593,1088,316,689,21,0,3,0,1,1,3,4,5975,18,1691
서울특별시,송파구,풍납1동,합계,13408,10067,4041,2359,2359,621,613,12,1,8,2,4,5,5,10,10040,27,3341
서울특별시,송파구,풍납1동,관내사전투표,2938,2938,1305,603,652,163,198,0,1,2,0,2,2,1,3,2932,6,0
서울특별시,송파구,풍납1동,풍납1동제1투,2694,1619,606,426,383,98,89,4,0,2,1,0,1,2,2,1614,5,1075
서울특별시,송파구,풍납1동,풍납1동제2투,2407,1693,663,404,401,106,112,3,0,0,0,1,0,1,1,1692,1,714
서울특별시,송파구,풍납1동,풍납1동제3투,2532,1642,639,429,383,85,90,0,0,2,1,1,1,1,3,1635,7,890
서울특별시,송파구,풍납1동,풍납1동제4투,2837,2175,828,497,540,169,124,5,0,2,0,0,1,0,1,2167,8,662
서울특별시,송파구,풍납2동,관내사전투표,4045,4045,1910,731,801,319,261,2,0,0,1,3,0,3,2,4033,12,0
서울특별시,송파구,풍납2동,합계,18600,14853,6198,3192,3304,1173,897,20,1,3,4,9,2,6,4,14813,40,3747
서울특별시,송파구,풍납2동,풍납2동제1투,2318,1687,699,339,397,138,106,1,0,0,0,0,1,1,0,1682,5,631
서울특별시,송파구,풍납2동,풍납2동제2투,2029,1409,580,335,289,119,79,1,0,1,0,0,1,1,1,1407,2,620
서울특별시,송파구,풍납2동,풍납2동제3투,2571,1933,713,444,491,155,114,6,1,1,1,1,0,0,0,1927,6,638
서울특별시,송파구,풍납2동,풍납2동제4투,2861,2171,933,452,465,175,130,5,0,0,1,3,0,1,0,2165,6,690
서울특별시,송파구,풍납2동,풍납2동제5투,2079,1530,555,404,380,99,85,2,0,0,0,0,0,0,0,1525,5,549
서울특별시,송파구,풍납2동,풍납2동제6투,2697,2078,808,487,481,168,122,3,0,1,1,2,0,0,1,2074,4,619
서울특별시,송파구,거여1동,합계,10348,7873,3031,1973,1873,496,443,11,1,7,3,1,0,3,8,7850,23,2475
서울특별시,송파구,거여1동,관내사전투표,1941,1941,854,425,411,122,118,0,1,3,3,0,0,1,0,1938,3,0
서울특별시,송파구,거여1동,거여1동제1투,3359,2262,844,575,563,147,111,5,0,1,0,0,0,0,4,2250,12,1097
서울특별시,송파구,거여1동,거여1동제2투,2383,1669,631,419,415,83,106,4,0,3,0,0,0,2,2,1665,4,714
서울특별시,송파구,거여1동,거여1동제3투,2665,2001,702,554,484,144,108,2,0,0,0,1,0,0,2,1997,4,664
서울특별시,송파구,거여2동,합계,14562,11225,4596,2611,2482,765,647,11,1,9,4,6,7,6,11,11156,69,3337
서울특별시,송파구,거여2동,관내사전투표,2915,2915,1365,553,597,199,178,3,0,3,1,1,2,0,1,2903,12,0
서울특별시,송파구,거여2동,거여2동제1투,2900,1737,615,468,431,116,93,1,0,2,0,2,0,0,4,1732,5,1163
서울특별시,송파구,거여2동,거여2동제2투,2483,1733,586,448,423,108,110,3,1,0,3,1,3,1,3,1690,43,750
서울특별시,송파구,거여2동,거여2동제3투,3403,2661,1084,637,590,191,147,1,0,2,0,1,2,2,1,2658,3,742
서울특별시,송파구,거여2동,거여2동제4투,2861,2179,946,505,441,151,119,3,0,2,0,1,0,3,2,2173,6,682
서울특별시,송파구,마천1동,관내사전투표,2644,2644,1160,598,563,148,152,3,0,1,1,4,1,1,5,2637,7,0
서울특별시,송파구,마천1동,합계,17137,12400,4868,2951,3055,722,698,9,0,10,5,9,4,10,18,12359,41,4737
서울특별시,송파구,마천1동,마천1동제1투,2694,1612,621,391,428,80,75,0,0,3,0,3,1,2,2,1606,6,1082
서울특별시,송파구,마천1동,마천1동제2투,2918,1873,719,430,474,117,113,4,0,2,0,0,0,3,2,1864,9,1045
서울특별시,송파구,마천1동,마천1동제3투,3048,2073,747,548,552,109,100,0,0,2,1,0,0,1,6,2066,7,975
서울특별시,송파구,마천1동,마천1동제4투,2444,1544,521,406,433,84,88,1,0,0,0,1,0,3,1,1538,6,900
서울특별시,송파구,마천1동,마천1동제5투,3389,2654,1100,578,605,184,170,1,0,2,3,1,2,0,2,2648,6,735
서울특별시,송파구,마천2동,합계,16733,12191,4984,2765,3025,659,672,19,1,11,3,1,3,5,6,12154,37,4542
서울특별시,송파구,마천2동,관내사전투표,3056,3056,1360,659,696,147,179,3,0,1,0,0,0,1,2,3048,8,0
서울특별시,송파구,마천2동,마천2동제1투,3438,2107,841,486,532,127,106,2,0,1,2,0,1,2,2,2102,5,1331
서울특별시,송파구,마천2동,마천2동제2투,3436,2235,869,537,594,97,118,7,0,3,0,1,1,2,0,2229,6,1201
서울특별시,송파구,마천2동,마천2동제3투,3660,2579,1062,577,634,145,141,6,1,4,0,0,0,0,1,2571,8,1081
서울특별시,송파구,마천2동,마천2동제4투,3143,2214,852,506,569,143,128,1,0,2,1,0,1,0,1,2204,10,929
서울특별시,송파구,방이1동,합계,12492,10174,4055,2416,2172,883,576,20,0,5,2,2,4,5,5,10145,29,2318
서울특별시,송파구,방이1동,관내사전투표,3085,3085,1374,663,596,258,180,3,0,0,1,0,1,1,1,3078,7,0
서울특별시,송파구,방이1동,방이1동제1투,3023,2262,797,606,547,186,107,8,0,0,0,2,2,1,2,2258,4,761
서울특별시,송파구,방이1동,방이1동제2투,3379,2424,1044,518,502,189,147,7,0,3,1,0,0,0,0,2411,13,955
서울특별시,송파구,방이1동,방이1동제3투,3005,2403,840,629,527,250,142,2,0,2,0,0,1,3,2,2398,5,602
서울특별시,송파구,방이2동,합계,19603,14648,6291,3034,3171,1172,910,20,2,2,6,8,3,4,6,14629,19,4955
서울특별시,송파구,방이2동,관내사전투표,3827,3827,1878,659,744,295,237,2,1,0,0,3,2,1,0,3822,5,0
서울특별시,송파구,방이2동,방이2동제1투,3389,2207,876,499,487,200,133,4,1,1,0,3,1,0,1,2206,1,1182
서울특별시,송파구,방이2동,방이2동제2투,2998,2041,870,411,460,145,148,2,0,1,1,0,0,1,0,2039,2,957
서울특별시,송파구,방이2동,방이2동제3투,3089,1944,817,468,403,139,105,6,0,0,1,0,0,0,1,1940,4,1145
서울특별시,송파구,방이2동,방이2동제4투,3248,2392,943,527,553,209,146,5,0,0,0,2,0,2,2,2389,3,856
서울특별시,송파구,방이2동,방이2동제5투,3052,2237,907,470,524,184,141,1,0,0,4,0,0,0,2,2233,4,815
서울특별시,송파구,오륜동,관내사전투표,3180,3180,1184,788,709,318,173,3,0,0,0,1,0,1,1,3178,2,0
서울특별시,송파구,오륜동,합계,13716,11633,3679,3365,2695,1276,570,18,0,3,1,1,0,5,2,11615,18,2083
서울특별시,송파구,오륜동,오륜동제1투,2163,1665,444,540,412,189,73,1,0,1,0,0,0,0,0,1660,5,498
서울특별시,송파구,오륜동,오륜동제2투,2988,2438,742,765,551,263,110,3,0,0,0,0,0,0,1,2435,3,550
서울특별시,송파구,오륜동,오륜동제3투,2690,2238,685,681,486,260,114,6,0,1,0,0,0,1,0,2234,4,452
서울특별시,송파구,오륜동,오륜동제4투,2695,2112,624,591,537,246,100,5,0,1,1,0,0,3,0,2108,4,583
서울특별시,송파구,오금동,합계,27984,21922,8310,5285,5054,1841,1288,34,3,13,5,6,4,4,13,21860,62,6062
서울특별시,송파구,오금동,관내사전투표,5088,5088,2114,1099,1077,441,325,10,2,1,1,1,1,0,3,5075,13,0
서울특별시,송파구,오금동,오금동제1투,3373,2386,667,821,529,252,104,1,0,1,1,0,1,0,2,2379,7,987
서울특별시,송파구,오금동,오금동제2투,3478,2676,919,672,689,231,149,4,0,0,0,1,0,0,4,2669,7,802
서울특별시,송파구,오금동,오금동제3투,3327,2382,910,573,546,184,147,3,0,1,1,2,2,1,1,2371,11,945
서울특별시,송파구,오금동,오금동제4투,3274,2321,903,553,552,140,151,7,1,3,2,1,0,0,1,2314,7,953
서울특별시,송파구,오금동,오금동제5투,3516,2568,1068,565,582,192,148,5,0,2,0,1,0,2,0,2565,3,948
서울특별시,송파구,오금동,오금동제6투,2694,2111,794,479,502,232,97,1,0,2,0,0,0,0,0,2107,4,583
서울특별시,송파구,오금동,오금동제7투,3234,2390,935,523,577,169,167,3,0,3,0,0,0,1,2,2380,10,844
서울특별시,송파구,송파1동,합계,20488,16081,6943,3336,3394,1272,1046,33,1,2,4,4,2,8,6,16051,30,4407
서울특별시,송파구,송파1동,관내사전투표,4470,4470,2166,742,874,358,307,10,0,1,2,1,1,0,2,4464,6,0
서울특별시,송파구,송파1동,송파1동제1투,3077,2031,873,406,454,156,137,1,0,0,0,1,1,0,0,2029,2,1046
서울특별시,송파구,송파1동,송파1동제2투,2388,1795,703,461,392,133,93,6,0,0,1,0,0,0,0,1789,6,593
서울특별시,송파구,송파1동,송파1동제3투,2185,1586,694,328,332,133,94,2,1,0,0,0,0,1,0,1585,1,599
서울특별시,송파구,송파1동,송파1동제4투,2433,1783,756,373,364,143,135,6,0,0,0,0,0,2,1,1780,3,650
서울특별시,송파구,송파1동,송파1동제5투,2820,2074,924,410,436,140,150,1,0,0,0,2,0,1,0,2064,10,746
서울특별시,송파구,송파1동,송파1동제6투,3115,2342,827,616,542,209,130,7,0,1,1,0,0,4,3,2340,2,773
서울특별시,송파구,송파2동,합계,16184,13386,5035,3143,3186,1233,724,22,1,0,2,4,1,0,5,13356,30,2798
서울특별시,송파구,송파2동,관내사전투표,3605,3605,1517,749,781,302,240,7,0,0,0,0,1,0,2,3599,6,0
서울특별시,송파구,송파2동,송파2동제1투,2772,2014,699,525,511,166,101,4,1,0,0,0,0,0,0,2007,7,758
서울특별시,송파구,송파2동,송파2동제2투,3028,2293,935,494,561,165,126,5,0,0,1,3,0,0,1,2291,2,735
서울특별시,송파구,송파2동,송파2동제3투,3199,2577,954,621,585,293,112,2,0,0,0,1,0,0,2,2570,7,622
서울특별시,송파구,송파2동,송파2동제4투,3580,2897,930,754,748,307,145,4,0,0,1,0,0,0,0,2889,8,683
서울특별시,송파구,석촌동,합계,26195,19313,8439,3823,4310,1385,1213,35,1,10,0,6,2,9,9,19242,71,6882
서울특별시,송파구,석촌동,관내사전투표,5197,5197,2531,861,1045,385,346,9,0,1,0,0,0,1,2,5181,16,0
서울특별시,송파구,석촌동,석촌동제1투,2853,1918,800,424,405,141,135,2,1,1,0,0,0,2,2,1913,5,935
서울특별시,송파구,석촌동,석촌동제2투,2810,1855,852,331,407,131,120,6,0,2,0,1,1,0,1,1852,3,955
서울특별시,송파구,석촌동,석촌동제3투,3315,2241,943,437,520,191,138,2,0,0,0,3,0,2,0,2236,5,1074
서울특별시,송파구,석촌동,석촌동제4투,3175,2216,917,469,540,133,140,1,0,4,0,0,0,1,2,2207,9,959
서울특별시,송파구,석촌동,석촌동제5투,3195,1942,806,429,441,133,116,6,0,0,0,1,0,0,1,1933,9,1253
서울특별시,송파구,석촌동,석촌동제6투,3164,2146,835,504,524,144,113,7,0,2,0,1,0,3,0,2133,13,1018
서울특별시,송파구,석촌동,석촌동제7투,2486,1798,755,368,428,127,105,2,0,0,0,0,1,0,1,1787,11,688
서울특별시,송파구,삼전동,관내사전투표,5290,5290,2612,830,1034,387,395,4,1,2,0,4,1,0,2,5272,18,0
서울특별시,송파구,삼전동,합계,25861,19262,8483,3753,4113,1453,1341,17,1,13,4,5,2,5,12,19202,60,6599
서울특별시,송파구,삼전동,삼전동제1투,2424,1388,534,298,347,101,95,2,0,1,1,0,0,0,1,1380,8,1036
서울특별시,송파구,삼전동,삼전동제2투,2455,1635,692,355,368,112,97,0,0,2,1,0,0,1,2,1630,5,820
서울특별시,송파구,삼전동,삼전동제3투,2640,1907,769,430,401,151,140,3,0,1,0,0,0,2,1,1898,9,733
서울특별시,송파구,삼전동,삼전동제4투,2630,1805,732,391,410,151,113,0,0,3,0,1,0,1,0,1802,3,825
서울특별시,송파구,삼전동,삼전동제5투,2750,1982,855,409,418,155,133,4,0,2,0,0,0,0,2,1978,4,768
서울특별시,송파구,삼전동,삼전동제6투,2541,1649,708,340,355,114,124,1,0,0,1,0,0,1,0,1644,5,892
서울특별시,송파구,삼전동,삼전동제7투,2774,1922,831,379,417,161,126,1,0,1,1,0,0,0,1,1918,4,852
서울특별시,송파구,삼전동,삼전동제8투,2357,1684,750,321,363,121,118,2,0,1,0,0,1,0,3,1680,4,673
서울특별시,송파구,가락본동,관내사전투표,4290,4290,1921,783,895,362,306,4,0,1,2,0,0,3,0,4277,13,0
서울특별시,송파구,가락본동,합계,20953,16330,6541,3597,3763,1322,1009,35,0,4,3,3,3,8,6,16294,36,4623
서울특별시,송파구,가락본동,가락본동제1투,2607,1604,596,401,372,134,89,5,0,0,0,0,1,0,1,1599,5,1003
서울특별시,송파구,가락본동,가락본동제2투,3281,2470,941,561,607,181,164,3,0,1,0,2,1,1,2,2464,6,811
서울특별시,송파구,가락본동,가락본동제3투,3161,2221,887,527,482,171,137,9,0,2,0,0,0,2,0,2217,4,940
서울특별시,송파구,가락본동,가락본동제4투,2119,1598,660,313,373,161,88,1,0,0,0,1,0,1,0,1598,0,521
서울특별시,송파구,가락본동,가락본동제5투,2881,2122,879,430,512,142,139,7,0,0,1,0,1,1,3,2115,7,759
서울특별시,송파구,가락본동,가락본동제6투,2614,2025,657,582,522,171,86,6,0,0,0,0,0,0,0,2024,1,589
서울특별시,송파구,가락1동,관내사전투표,286,286,115,71,67,14,17,2,0,0,0,0,0,0,0,286,0,0
서울특별시,송파구,가락1동,합계,868,625,255,136,150,45,34,4,0,0,0,0,0,0,0,624,1,243
서울특별시,송파구,가락1동,가락1동투표소,582,339,140,65,83,31,17,2,0,0,0,0,0,0,0,338,1,243
서울특별시,송파구,가락2동,관내사전투표,3883,3883,1789,752,777,282,258,5,0,2,0,6,0,1,2,3874,9,0
서울특별시,송파구,가락2동,합계,24606,20099,8054,4357,4721,1724,1121,29,1,7,3,8,2,4,9,20040,59,4507
서울특별시,송파구,가락2동,가락2동제1투,3059,2114,888,426,475,180,135,1,0,1,1,0,0,0,3,2110,4,945
서울특별시,송파구,가락2동,가락2동제2투,2830,2179,867,458,535,184,123,1,0,1,0,0,0,1,1,2171,8,651
서울특별시,송파구,가락2동,가락2동제3투,3347,2901,1257,524,687,271,148,1,0,2,0,1,0,0,3,2894,7,446
서울특별시,송파구,가락2동,가락2동제4투,2813,2217,845,507,544,200,102,11,1,0,1,0,0,0,0,2211,6,596
서울특별시,송파구,가락2동,가락2동제5투,2931,2281,776,630,552,199,107,2,0,1,1,1,1,2,0,2272,9,650
서울특별시,송파구,가락2동,가락2동제6투,2950,2309,855,541,579,203,121,2,0,0,0,0,0,0,0,2301,8,641
서울특별시,송파구,가락2동,가락2동제7투,2793,2215,777,519,572,205,127,6,0,0,0,0,1,0,0,2207,8,578
서울특별시,송파구,문정1동,관내사전투표,4003,4003,1881,692,799,348,264,3,0,2,0,1,0,2,1,3993,10,0
서울특별시,송파구,문정1동,합계,17329,13855,5484,3184,3179,1134,798,16,3,6,0,4,4,8,7,13827,28,3474
서울특별시,송파구,문정1동,문정1동제1투,3536,2321,980,475,548,158,140,6,1,2,0,1,0,2,0,2313,8,1215
서울특별시,송파구,문정1동,문정1동제2투,2788,2189,823,512,534,176,133,1,2,2,0,1,1,0,2,2187,2,599
서울특별시,송파구,문정1동,문정1동제3투,3217,2238,922,475,512,174,143,1,0,0,0,1,3,1,2,2234,4,979
서울특별시,송파구,문정1동,문정1동제4투,3785,3104,878,1030,786,278,118,5,0,0,0,0,0,3,2,3100,4,681
서울특별시,송파구,문정2동,관내사전투표,2831,2831,1029,823,579,259,129,4,0,0,0,0,0,1,1,2825,6,0
서울특별시,송파구,문정2동,합계,19038,15329,5258,4141,3442,1651,773,20,0,2,1,3,1,4,3,15299,30,3709
서울특별시,송파구,문정2동,문정2동제1투,2678,2097,502,818,457,237,72,5,0,2,0,0,0,0,0,2093,4,581
서울특별시,송파구,문정2동,문정2동제2투,3437,2740,706,933,696,302,92,1,0,0,1,1,0,0,0,2732,8,697
서울특별시,송파구,문정2동,문정2동제3투,3077,2387,611,865,544,262,91,7,0,0,0,1,0,2,0,2383,4,690
서울특별시,송파구,문정2동,문정2동제4투,3287,2294,1179,236,451,237,184,2,0,0,0,1,0,0,2,2292,2,993
서울특별시,송파구,문정2동,문정2동제5투,3728,2980,1231,466,715,354,205,1,0,0,0,0,1,1,0,2974,6,748
서울특별시,송파구,장지동,합계,26190,20740,8812,4114,4785,1582,1326,22,2,8,0,14,1,3,10,20679,61,5450
서울특별시,송파구,장지동,관내사전투표,5225,5225,2413,889,1117,411,371,2,1,1,0,4,0,0,5,5214,11,0
서울특별시,송파구,장지동,장지동제1투,3221,2215,923,434,525,167,155,1,0,1,0,3,0,1,1,2211,4,1006
서울특별시,송파구,장지동,장지동제2투,2246,1619,603,368,435,101,104,4,0,0,0,0,0,0,1,1616,3,627
서울특별시,송파구,장지동,장지동제3투,3075,2200,911,483,524,138,128,1,0,2,0,1,0,1,3,2192,8,875
서울특별시,송파구,장지동,장지동제4투,2545,1927,793,371,466,148,135,6,0,2,0,2,0,0,0,1923,4,618
서울특별시,송파구,장지동,장지동제5투,3693,2723,1059,621,618,231,175,5,0,2,0,0,0,0,0,2711,12,970
서울특별시,송파구,장지동,장지동제6투,3329,2608,1108,513,603,218,145,3,1,0,0,1,1,0,0,2593,15,721
서울특별시,송파구,장지동,장지동제7투,2856,2223,1002,435,497,168,113,0,0,0,0,3,0,1,0,2219,4,633
서울특별시,송파구,잠실본동,합계,22652,16756,7322,3490,3495,1229,1111,21,0,5,2,12,3,5,4,16699,57,5896
서울특별시,송파구,잠실본동,관내사전투표,4801,4801,2307,874,905,321,358,4,0,2,0,3,1,3,1,4779,22,0
서울특별시,송파구,잠실본동,잠실본동제1투,3475,2072,904,440,448,136,136,3,0,1,0,0,0,0,1,2069,3,1403
서울특별시,송파구,잠실본동,잠실본동제2투,2679,1661,667,383,363,118,113,4,0,0,0,2,1,0,0,1651,10,1018
서울특별시,송파구,잠실본동,잠실본동제3투,2708,1865,792,404,411,143,109,1,0,0,0,2,0,0,0,1862,3,843
서울특별시,송파구,잠실본동,잠실본동제4투,2866,2019,876,427,433,162,106,5,0,0,1,0,0,1,1,2012,7,847
서울특별시,송파구,잠실본동,잠실본동제5투,3033,2187,856,500,496,178,140,2,0,2,0,3,1,1,0,2179,8,846
서울특별시,송파구,잠실본동,잠실본동제6투,3090,2151,920,462,439,171,149,2,0,0,1,2,0,0,1,2147,4,939
서울특별시,송파구,잠실2동,합계,25071,21091,8261,4514,4916,2325,982,30,0,7,1,4,0,8,1,21049,42,3980
서울특별시,송파구,잠실2동,관내사전투표,5969,5969,2646,1152,1226,610,305,11,0,2,1,1,0,1,0,5955,14,0
서울특별시,송파구,잠실2동,잠실2동제1투,2113,1679,673,353,370,197,82,3,0,0,0,0,0,0,0,1678,1,434
서울특별시,송파구,잠실2동,잠실2동제2투,2968,2442,835,561,616,311,108,5,0,1,0,0,0,1,0,2438,4,526
서울특별시,송파구,잠실2동,잠실2동제3투,3005,1966,767,383,506,206,94,1,0,1,0,1,0,1,1,1961,5,1039
서울특별시,송파구,잠실2동,잠실2동제4투,2599,2083,671,535,524,239,101,3,0,1,0,1,0,3,0,2078,5,516
서울특별시,송파구,잠실2동,잠실2동제5투,2921,2363,910,499,578,268,99,0,0,1,0,0,0,2,0,2357,6,558
서울특별시,송파구,잠실2동,잠실2동제6투,2541,2132,804,496,536,210,80,3,0,0,0,0,0,0,0,2129,3,409
서울특별시,송파구,잠실2동,잠실2동제7투,2955,2457,955,535,560,284,113,4,0,1,0,1,0,0,0,2453,4,498
서울특별시,송파구,잠실3동,합계,25674,21229,7038,6244,4795,2122,908,52,2,4,3,3,4,2,5,21182,47,4445
서울특별시,송파구,잠실3동,관내사전투표,4164,4164,1574,1144,829,392,205,8,2,0,0,2,1,0,0,4157,7,0
서울특별시,송파구,잠실3동,잠실3동제1투,2293,1824,545,543,445,204,76,5,0,1,0,1,0,0,1,1821,3,469
서울특별시,송파구,잠실3동,잠실3동제2투,2865,1981,617,617,440,188,105,9,0,0,0,0,0,0,0,1976,5,884
서울특별시,송파구,잠실3동,잠실3동제3투,2219,1784,559,545,446,154,68,4,0,2,0,0,0,1,0,1779,5,435
서울특별시,송파구,잠실3동,잠실3동제4투,1723,1322,250,578,324,125,39,3,0,0,0,0,2,0,0,1321,1,401
서울특별시,송파구,잠실3동,잠실3동제5투,3165,2594,819,785,607,270,100,4,0,1,0,0,0,0,3,2589,5,571
서울특별시,송파구,잠실3동,잠실3동제6투,2424,1988,602,663,433,198,77,4,0,0,2,0,0,1,0,1980,8,436
서울특별시,송파구,잠실3동,잠실3동제7투,3351,2694,959,694,641,291,99,4,0,0,1,0,0,0,0,2689,5,657
서울특별시,송파구,잠실3동,잠실3동제8투,3470,2878,1113,675,630,300,139,11,0,0,0,0,1,0,1,2870,8,592
서울특별시,송파구,잠실4동,합계,21584,18136,6801,4707,3933,1815,801,24,1,1,2,6,2,6,3,18102,34,3448
서울특별시,송파구,잠실4동,관내사전투표,4547,4547,1984,1062,840,422,225,4,0,1,1,0,0,1,0,4540,7,0
서울특별시,송파구,잠실4동,잠실4동제1투,2591,1867,699,468,434,186,75,2,0,0,0,2,0,0,0,1866,1,724
서울특별시,송파구,잠실4동,잠실4동제2투,3036,2491,887,628,598,264,109,3,0,0,0,0,0,0,1,2490,1,545
서울특별시,송파구,잠실4동,잠실4동제3투,3202,2581,942,647,618,252,106,5,0,0,0,2,0,2,0,2574,7,621
서울특별시,송파구,잠실4동,잠실4동제4투,3192,2558,962,634,551,273,125,2,0,0,0,2,1,1,1,2552,6,634
서울특별시,송파구,잠실4동,잠실4동제5투,2227,1845,652,467,409,209,95,2,1,0,0,0,0,2,0,1837,8,382
서울특별시,송파구,잠실4동,잠실4동제6투,2789,2247,675,801,483,209,66,6,0,0,1,0,1,0,1,2243,4,542
서울특별시,송파구,잠실6동,합계,13329,10979,3813,3165,2341,1093,520,12,0,0,1,1,1,6,2,10955,24,2350
서울특별시,송파구,잠실6동,관내사전투표,3715,3715,1445,986,722,351,194,3,0,0,1,0,0,4,0,3706,9,0
서울특별시,송파구,잠실6동,잠실6동제1투,3369,2484,815,724,553,278,104,5,0,0,0,0,0,0,0,2479,5,885
서울특별시,송파구,잠실6동,잠실6동제2투,3081,2300,724,742,509,220,94,3,0,0,0,0,0,1,1,2294,6,781
서울특별시,송파구,잠실6동,잠실6동제3투,3164,2480,829,713,557,244,128,1,0,0,0,1,1,1,1,2476,4,684
서울특별시,송파구,잠실7동,합계,8113,6781,1755,2439,1468,759,316,15,0,1,0,2,0,3,4,6762,19,1332
서울특별시,송파구,잠실7동,관내사전투표,1847,1846,587,556,388,214,91,3,0,0,0,0,0,0,1,1840,6,1
서울특별시,송파구,잠실7동,잠실7동제1투,3274,2474,475,1130,526,240,90,4,0,1,0,0,0,1,2,2469,5,800
서울특별시,송파구,잠실7동,잠실7동제2투,2992,2461,693,753,554,305,135,8,0,0,0,2,0,2,1,2453,8,531
서울특별시,송파구,위례동,합계,13826,11633,4844,2124,2773,1185,661,9,2,3,2,3,1,3,1,11611,22,2193
서울특별시,송파구,위례동,관내사전투표,3545,3545,1634,584,763,338,210,3,1,2,1,0,0,0,0,3536,9,0
서울특별시,송파구,위례동,위례동제1투,2490,1941,785,318,512,187,135,1,0,0,0,0,0,1,0,1939,2,549
서울특별시,송파구,위례동,위례동제2투,2856,2237,1097,315,498,179,136,4,0,1,1,1,1,1,0,2234,3,619
서울특별시,송파구,위례동,위례동제3투,3131,2516,948,537,641,259,127,1,0,0,0,1,0,0,0,2514,2,615
서울특별시,송파구,위례동,위례동제4투,1804,1394,380,370,359,222,53,0,1,0,0,1,0,1,1,1388,6,410
서울특별시,송파구,잘못 투입·구분된 투표지,,0,0,0,0,0,0,0,0,0,0,0,0,0,0,0,0,0,0
서울특별시,강동구,합계,,376431,297476,122511,65893,67499,21483,17965,446,29,168,54,123,56,88,196,296511,965,78955
서울특별시,강동구,거소·선상투표,,630,596,190,101,193,40,19,8,1,0,3,2,1,0,2,560,36,34
서울특별시,강동구,관외사전투표,,30867,30854,14334,4927,6550,2512,2231,37,7,12,3,20,7,9,40,30689,165,13
서울특별시,강동구,재외투표,,3856,2995,1779,269,462,124,336,8,1,3,0,1,1,1,1,2986,9,861
서울특별시,강동구,강일동,합계,22712,18068,7906,3592,4093,1240,1108,23,3,12,2,14,5,4,8,18010,58,4644
서울특별시,강동구,강일동,관내사전투표,3972,3972,1933,685,798,289,241,5,0,2,0,4,2,0,2,3961,11,0
서울특별시,강동구,강일동,강일동제1투,3164,2184,929,486,463,152,133,4,1,2,0,2,1,1,3,2177,7,980
서울특별시,강동구,강일동,강일동제2투,2789,2088,905,457,468,122,122,2,0,1,1,1,1,0,0,2080,8,701
서울특별시,강동구,강일동,강일동제3투,2813,2103,844,466,542,131,106,1,0,2,0,1,0,1,1,2095,8,710
서울특별시,강동구,강일동,강일동제4투,3114,2349,951,492,564,174,157,4,1,0,1,0,0,1,0,2345,4,765
서울특별시,강동구,강일동,강일동제5투,2521,2022,897,362,471,157,122,2,0,1,0,4,1,0,0,2017,5,499
서울특별시,강동구,강일동,강일동제6투,2070,1585,628,344,397,85,111,2,1,3,0,1,0,1,2,1575,10,485
서울특별시,강동구,강일동,강일동제7투,2269,1765,819,300,390,130,116,3,0,1,0,1,0,0,0,1760,5,504
서울특별시,강동구,상일동,합계,9373,7301,2785,1864,1620,553,413,22,1,4,2,1,1,2,6,7274,27,2072
서울특별시,강동구,상일동,관내사전투표,2122,2122,970,434,431,152,122,5,0,2,1,0,0,1,1,2119,3,0
서울특별시,강동구,상일동,상일동제1투,2604,1793,655,412,441,162,111,1,0,2,1,0,0,0,0,1785,8,811
서울특별시,강동구,상일동,상일동제2투,2417,1716,608,489,393,109,98,11,0,0,0,1,1,1,0,1711,5,701
서울특별시,강동구,상일동,상일동제3투,2230,1670,552,529,355,130,82,5,1,0,0,0,0,0,5,1659,11,560
서울특별시,강동구,명일제1동,합계,17688,14523,5449,3791,3258,1148,791,16,0,15,4,4,2,5,7,14490,33,3165
서울특별시,강동구,명일제1동,관내사전투표,4570,4569,1915,1056,931,382,251,2,0,9,1,2,0,5,3,4557,12,1
서울특별시,강동구,명일제1동,명일제1동제1투,3072,2087,714,635,464,145,114,1,0,0,2,1,0,0,2,2078,9,985
서울특별시,강동구,명일제1동,명일제1동제2투,3363,2617,869,755,633,202,145,6,0,2,0,0,0,0,0,2612,5,746
서울특별시,강동구,명일제1동,명일제1동제3투,2128,1706,572,507,391,149,81,1,0,0,1,0,1,0,1,1704,2,422
서울특별시,강동구,명일제1동,명일제1동제4투,2423,1987,785,421,477,177,117,5,0,3,0,0,0,0,1,1986,1,436
서울특별시,강동구,명일제1동,명일제1동제5투,2132,1557,594,417,362,93,83,1,0,1,0,1,1,0,0,1553,4,575
서울특별시,강동구,명일제2동,합계,13010,10895,4122,2775,2393,947,592,23,0,4,3,1,0,0,7,10867,28,2115
서울특별시,강동구,명일제2동,관내사전투표,2596,2596,1127,587,514,205,148,9,0,1,0,0,0,0,1,2592,4,0
서울특별시,강동구,명일제2동,명일제2동제1투,2477,2065,746,534,490,178,110,1,0,1,1,0,0,0,1,2062,3,412
서울특별시,강동구,명일제2동,명일제2동제2투,2616,1871,644,512,433,164,99,8,0,0,0,0,0,0,2,1862,9,745
서울특별시,강동구,명일제2동,명일제2동제3투,2671,2219,836,543,509,187,132,2,0,0,2,0,0,0,1,2212,7,452
서울특별시,강동구,명일제2동,명일제2동제4투,2650,2144,769,599,447,213,103,3,0,2,0,1,0,0,2,2139,5,506
서울특별시,강동구,고덕제1동,합계,16913,14066,6031,2892,3126,1172,778,10,0,8,4,2,0,4,5,14032,34,2847
서울특별시,강동구,고덕제1동,관내사전투표,4261,4261,1982,780,870,360,248,3,0,1,2,0,0,3,2,4251,10,0
서울특별시,강동구,고덕제1동,고덕제1동제1투,2029,1480,664,303,329,103,72,0,0,0,0,1,0,1,0,1473,7,549
서울특별시,강동구,고덕제1동,고덕제1동제2투,2090,1688,743,322,367,159,93,1,0,0,0,0,0,0,0,1685,3,402
서울특별시,강동구,고덕제1동,고덕제1동제3투,1980,1474,580,359,352,104,72,3,0,1,1,0,0,0,0,1472,2,506
서울특별시,강동구,고덕제1동,고덕제1동제4투,2357,1612,548,469,392,96,93,2,0,3,1,1,0,0,2,1607,5,745
서울특별시,강동구,고덕제1동,고덕제1동제5투,2125,1814,704,354,448,197,106,0,0,3,0,0,0,0,1,1813,1,311
서울특별시,강동구,고덕제1동,고덕제1동제6투,2071,1737,810,305,368,153,94,1,0,0,0,0,0,0,0,1731,6,334
서울특별시,강동구,고덕제2동,합계,6607,4693,1702,1309,1106,281,247,5,0,6,1,7,3,0,7,4674,19,1914
서울특별시,강동구,고덕제2동,관내사전투표,1147,1147,455,308,242,67,70,1,0,1,0,0,0,0,0,1144,3,0
서울특별시,강동구,고덕제2동,고덕제2동제1투,2853,1753,617,488,433,102,82,3,0,3,1,5,2,0,5,1741,12,1100
서울특별시,강동구,고덕제2동,고덕제2동제2투,2607,1793,630,513,431,112,95,1,0,2,0,2,1,0,2,1789,4,814
서울특별시,강동구,암사제1동,합계,27884,20221,8230,4622,4704,1316,1200,36,3,10,6,10,6,7,11,20161,60,7663
서울특별시,강동구,암사제1동,관내사전투표,4327,4327,2008,865,908,255,254,13,1,0,1,4,1,4,0,4314,13,0
서울특별시,강동구,암사제1동,암사제1동제1투,3716,2143,898,493,471,138,133,3,0,0,1,0,1,1,0,2139,4,1573
서울특별시,강동구,암사제1동,암사제1동제2투,3020,1994,784,454,509,113,121,1,0,0,2,1,0,1,2,1988,6,1026
서울특별시,강동구,암사제1동,암사제1동제3투,3050,2056,839,472,463,143,123,5,0,1,0,1,1,0,1,2049,7,994
서울특별시,강동구,암사제1동,암사제1동제4투,2794,1854,695,442,474,116,104,6,2,2,0,2,0,0,3,1846,8,940
서울특별시,강동구,암사제1동,암사제1동제5투,2463,1580,654,342,404,86,82,1,0,0,0,1,2,1,2,1575,5,883
서울특별시,강동구,암사제1동,암사제1동제6투,2782,1858,696,453,469,114,113,4,0,1,0,1,0,0,0,1851,7,924
서울특별시,강동구,암사제1동,암사제1동제7투,2734,1903,689,482,447,146,124,0,0,4,0,0,0,0,3,1895,8,831
서울특별시,강동구,암사제1동,암사제1동제8투,2998,2506,967,619,559,205,146,3,0,2,2,0,1,0,0,2504,2,492
서울특별시,강동구,암사제2동,합계,12297,10205,4476,2117,2165,747,647,13,1,5,1,1,0,3,4,10180,25,2092
서울특별시,강동구,암사제2동,관내사전투표,4263,4263,2054,765,841,291,294,2,0,3,0,0,0,1,3,4254,9,0
서울특별시,강동구,암사제2동,암사제2동제1투,2103,1592,584,390,405,116,89,3,0,1,0,0,0,2,0,1590,2,511
서울특별시,강동구,암사제2동,암사제2동제2투,2976,2040,848,453,420,165,143,2,0,1,1,0,0,0,1,2034,6,936
서울특별시,강동구,암사제2동,암사제2동제3투,2955,2310,990,509,499,175,121,6,1,0,0,1,0,0,0,2302,8,645
서울특별시,강동구,암사제3동,합계,14160,11938,4748,2759,2705,994,665,16,0,2,4,4,1,1,8,11907,31,2222
서울특별시,강동구,암사제3동,관내사전투표,3626,3626,1639,708,735,315,209,2,0,2,3,1,0,0,3,3617,9,0
서울특별시,강동구,암사제3동,암사제3동제1투,3121,2396,890,601,568,216,106,5,0,0,0,0,0,1,3,2390,6,725
서울특별시,강동구,암사제3동,암사제3동제2투,2634,2138,724,573,517,204,107,7,0,0,1,1,0,0,1,2135,3,496
서울특별시,강동구,암사제3동,암사제3동제3투,2522,1965,793,457,449,132,125,1,0,0,0,1,0,0,1,1959,6,557
서울특별시,강동구,암사제3동,암사제3동제4투,2257,1813,702,420,436,127,118,1,0,0,0,1,1,0,0,1806,7,444
서울특별시,강동구,천호제1동,합계,23117,16930,6675,4042,4048,1055,993,20,0,8,2,7,4,9,8,16871,59,6187
서울특별시,강동구,천호제1동,관내사전투표,3967,3967,1747,815,885,235,256,5,0,0,0,1,2,3,1,3950,17,0
서울특별시,강동구,천호제1동,천호제1동제1투,3520,2072,807,469,527,135,121,3,0,0,0,2,0,1,2,2067,5,1448
서울특별시,강동구,천호제1동,천호제1동제2투,3446,2445,902,653,594,153,130,1,0,1,0,1,0,2,0,2437,8,1001
서울특별시,강동구,천호제1동,천호제1동제3투,2970,1928,698,449,522,121,120,2,0,1,0,0,2,1,2,1918,10,1042
서울특별시,강동구,천호제1동,천호제1동제4투,3473,2521,992,621,590,160,138,5,0,3,0,2,0,0,2,2513,8,952
서울특별시,강동구,천호제1동,천호제1동제5투,2944,2087,793,555,474,136,116,1,0,3,2,0,0,2,1,2083,4,857
서울특별시,강동구,천호제1동,천호제1동제6투,2797,1910,736,480,456,115,112,3,0,0,0,1,0,0,0,1903,7,887
서울특별시,강동구,천호제2동,합계,27939,19773,7942,4640,4726,1188,1122,24,3,15,6,15,4,14,12,19711,62,8166
서울특별시,강동구,천호제2동,관내사전투표,4539,4539,2088,924,965,246,281,8,0,3,3,4,1,1,5,4529,10,0
서울특별시,강동구,천호제2동,천호제2동제1투,2475,1609,579,419,414,85,100,1,0,0,0,1,0,3,0,1602,7,866
서울특별시,강동구,천호제2동,천호제2동제2투,2758,1982,851,440,438,123,115,3,2,2,0,2,0,0,1,1977,5,776
서울특별시,강동구,천호제2동,천호제2동제3투,2049,1441,539,373,328,91,98,1,1,1,1,0,0,3,0,1436,5,608
서울특별시,강동구,천호제2동,천호제2동제4투,2567,1650,678,373,361,133,93,1,0,1,0,2,0,2,1,1645,5,917
서울특별시,강동구,천호제2동,천호제2동제5투,3608,2392,938,572,596,150,122,1,0,1,0,3,0,2,1,2386,6,1216
서울특별시,강동구,천호제2동,천호제2동제6투,3469,2322,854,563,621,140,126,2,0,3,0,0,0,1,2,2312,10,1147
서울특별시,강동구,천호제2동,천호제2동제7투,3723,2186,815,529,566,141,117,5,0,2,0,2,1,1,1,2180,6,1537
서울특별시,강동구,천호제2동,천호제2동제8투,2751,1652,600,447,437,79,70,2,0,2,2,1,2,1,1,1644,8,1099
서울특별시,강동구,천호제3동,합계,20106,14385,5625,3394,3507,925,819,29,0,10,5,7,4,5,7,14337,48,5721
서울특별시,강동구,천호제3동,관내사전투표,3624,3623,1574,814,765,210,241,6,0,0,1,1,1,0,2,3615,8,1
서울특별시,강동구,천호제3동,천호제3동제1투,3087,1879,640,519,473,134,95,2,0,3,2,2,0,2,1,1873,6,1208
서울특별시,강동구,천호제3동,천호제3동제2투,3308,2282,944,488,565,158,112,5,0,0,1,1,0,0,0,2274,8,1026
서울특별시,강동구,천호제3동,천호제3동제3투,2629,1593,578,382,453,84,76,5,0,1,1,1,0,2,1,1584,9,1036
서울특별시,강동구,천호제3동,천호제3동제4투,2233,1408,502,356,372,80,83,3,0,2,0,0,1,0,2,1401,7,825
서울특별시,강동구,천호제3동,천호제3동제5투,2391,1521,578,349,391,111,78,5,0,1,0,0,1,1,1,1516,5,870
서울특별시,강동구,천호제3동,천호제3동제6투,2834,2079,809,486,488,148,134,3,0,3,0,2,1,0,0,2074,5,755
서울특별시,강동구,성내제1동,관내사전투표,3687,3687,1670,705,761,278,255,5,0,2,0,0,0,0,4,3680,7,0
서울특별시,강동구,성내제1동,합계,15869,12849,5386,2786,2888,902,816,18,2,6,0,1,1,3,10,12819,30,3020
서울특별시,강동구,성내제1동,성내제1동제1투,2965,2043,802,497,504,104,126,3,0,2,0,0,0,1,0,2039,4,922
서울특별시,강동구,성내제1동,성내제1동제2투,3247,2557,1049,545,629,153,167,2,1,2,0,1,0,0,3,2552,5,690
서울특별시,강동구,성내제1동,성내제1동제3투,2722,1975,838,435,423,136,124,4,0,0,0,0,0,2,3,1965,10,747
서울특별시,강동구,성내제1동,성내제1동제4투,3248,2587,1027,604,571,231,144,4,1,0,0,0,1,0,0,2583,4,661
서울특별시,강동구,성내제2동,합계,20378,15073,6324,3322,3496,923,900,29,1,10,2,5,6,2,9,15029,44,5305
서울특별시,강동구,성내제2동,관내사전투표,4001,4001,1904,752,845,226,245,9,0,0,2,2,2,0,2,3989,12,0
서울특별시,강동구,성내제2동,성내제2동제1투,3409,2088,845,472,492,123,137,7,0,3,0,1,0,0,2,2082,6,1321
서울특별시,강동구,성내제2동,성내제2동제2투,3371,2390,941,549,556,168,161,7,0,2,0,0,0,0,2,2386,4,981
서울특별시,강동구,성내제2동,성내제2동제3투,3500,2447,1037,532,582,147,131,4,1,3,0,1,1,0,2,2441,6,1053
서울특별시,강동구,성내제2동,성내제2동제4투,3157,2257,892,515,581,149,106,1,0,1,0,1,2,1,0,2249,8,900
서울특별시,강동구,성내제2동,성내제2동제5투,2940,1890,705,502,440,110,120,1,0,1,0,0,1,1,1,1882,8,1050
서울특별시,강동구,성내제3동,합계,18750,14389,5991,3180,3180,1076,866,19,1,9,1,4,2,7,9,14345,44,4361
서울특별시,강동구,성내제3동,관내사전투표,4223,4223,1888,848,897,306,262,4,0,0,0,2,0,1,2,4210,13,0
서울특별시,강동구,성내제3동,성내제3동제1투,3219,2116,849,492,474,154,132,3,0,2,0,1,1,0,1,2109,7,1103
서울특별시,강동구,성내제3동,성내제3동제2투,3214,2278,887,497,571,180,131,2,0,0,0,1,0,0,1,2270,8,936
서울특별시,강동구,성내제3동,성내제3동제3투,3793,2784,1128,667,587,222,168,3,0,0,0,0,0,0,3,2778,6,1009
서울특별시,강동구,성내제3동,성내제3동제4투,4301,2988,1239,676,651,214,173,7,1,7,1,0,1,6,2,2978,10,1313
서울특별시,강동구,길동,합계,38797,29170,11607,6779,6804,2075,1707,49,2,18,3,11,6,3,21,29085,85,9627
서울특별시,강동구,길동,관내사전투표,6751,6751,2974,1399,1426,468,448,13,0,4,0,2,0,1,4,6739,12,0
서울특별시,강동구,길동,길동제1투,3638,2579,1042,576,642,150,152,3,0,3,0,0,0,0,3,2571,8,1059
서울특별시,강동구,길동,길동제2투,2924,2137,786,586,514,132,98,5,1,0,1,1,3,1,2,2130,7,787
서울특별시,강동구,길동,길동제3투,3314,2386,949,568,570,143,137,6,1,1,0,2,0,0,4,2381,5,928
서울특별시,강동구,길동,길동제4투,3809,2523,1054,504,555,212,181,4,0,4,1,0,1,1,0,2517,6,1286
서울특별시,강동구,길동,길동제5투,2454,1804,700,423,418,140,112,3,0,1,0,0,0,0,1,1798,6,650
서울특별시,강동구,길동,길동제6투,3450,1871,750,424,451,119,116,0,0,0,0,0,0,0,0,1860,11,1579
서울특별시,강동구,길동,길동제7투,3326,2439,855,621,639,190,118,0,0,2,0,3,0,0,2,2430,9,887
서울특별시,강동구,길동,길동제8투,3046,2289,888,564,500,192,125,7,0,1,0,1,0,0,1,2279,10,757
서울특별시,강동구,길동,길동제9투,2888,2076,788,511,476,181,107,5,0,1,0,2,2,0,1,2074,2,812
서울특별시,강동구,길동,길동제10투,3197,2315,821,603,613,148,113,3,0,1,1,0,0,0,3,2306,9,882
서울특별시,강동구,둔촌제1동,합계,13880,11466,4354,2732,2634,1006,678,25,2,5,0,3,1,4,4,11448,18,2414
서울특별시,강동구,둔촌제1동,관내사전투표,3660,3660,1618,755,752,293,226,4,0,1,0,3,0,1,2,3655,5,0
서울특별시,강동구,둔촌제1동,둔촌제1동제1투,2710,2098,696,582,494,176,140,5,0,1,0,0,0,0,0,2094,4,612
서울특별시,강동구,둔촌제1동,둔촌제1동제2투,2401,1718,598,415,434,170,90,0,1,2,0,0,1,3,1,1715,3,683
서울특별시,강동구,둔촌제1동,둔촌제1동제3투,2652,2095,743,513,525,188,111,10,1,0,0,0,0,0,0,2091,4,557
서울특별시,강동구,둔촌제1동,둔촌제1동제4투,2457,1895,699,467,429,179,111,6,0,1,0,0,0,0,1,1893,2,562
서울특별시,강동구,둔촌제2동,합계,21598,17084,6855,4000,3841,1259,1036,16,1,6,2,3,1,5,10,17035,49,4514
서울특별시,강동구,둔촌제2동,관내사전투표,4632,4632,2054,984,945,311,313,6,0,0,0,2,0,2,2,4619,13,0
서울특별시,강동구,둔촌제2동,둔촌제2동제1투,3509,2325,903,547,556,165,135,3,0,2,2,0,0,0,4,2317,8,1184
서울특별시,강동구,둔촌제2동,둔촌제2동제2투,3271,2350,935,552,551,157,141,2,0,3,0,0,0,1,0,2342,8,921
서울특별시,강동구,둔촌제2동,둔촌제2동제3투,3662,2883,1222,634,646,217,155,1,1,0,0,1,0,0,1,2878,5,779
서울특별시,강동구,둔촌제2동,둔촌제2동제4투,3206,2354,850,609,540,190,146,3,0,1,0,0,1,2,2,2344,10,852
서울특별시,강동구,둔촌제2동,둔촌제2동제5투,3318,2540,891,674,603,219,146,1,0,0,0,0,0,0,1,2535,5,778
서울특별시,강동구,잘못 투입·구분된 투표지,,0,2,0,0,0,0,1,0,0,0,0,0,0,0,0,1,1,-2
부산광역시,합계,,,2950224,2261633,872127,720484,378907,162480,109329,2651,276,1316,465,981,496,1041,2156,2252709,8924,688591
부산광역시,중구,합계,,40448,28604,9918,10684,4675,1845,1274,47,4,11,3,14,7,9,18,28509,95,11844
부산광역시,중구,거소·선상투표,,125,109,33,31,31,4,5,0,0,0,0,0,0,1,2,107,2,16
부산광역시,중구,관외사전투표,,3305,3305,1522,755,515,262,222,6,0,0,0,3,0,1,4,3290,15,0
부산광역시,중구,재외투표,,335,223,137,22,32,8,22,1,0,0,0,0,0,0,0,222,1,112
부산광역시,중구,중앙동,합계,1588,1021,343,391,164,69,48,2,0,0,0,1,1,0,2,1021,0,567
부산광역시,중구,중앙동,관내사전투표,328,328,125,121,41,23,17,1,0,0,0,0,0,0,0,328,0,0
부산광역시,중구,중앙동,중앙동제1투,534,277,82,113,44,24,12,0,0,0,0,1,0,0,1,277,0,257
부산광역시,중구,중앙동,중앙동제2투,726,416,136,157,79,22,19,1,0,0,0,0,1,0,1,416,0,310
부산광역시,중구,동광동,합계,2918,1918,660,740,315,120,65,8,0,1,0,2,0,2,1,1914,4,1000
부산광역시,중구,동광동,관내사전투표,615,615,254,210,90,31,22,4,0,1,0,1,0,0,0,613,2,0
부산광역시,중구,동광동,동광동제1투,1235,655,207,266,121,37,21,2,0,0,0,0,0,1,0,655,0,580
부산광역시,중구,동광동,동광동제2투,1068,648,199,264,104,52,22,2,0,0,0,1,0,1,1,646,2,420
부산광역시,중구,대청동,관내사전투표,949,949,356,344,162,46,37,0,0,1,0,0,0,1,1,948,1,0
부산광역시,중구,대청동,합계,5647,3909,1368,1412,665,253,181,5,0,2,1,0,2,2,3,3894,15,1738
부산광역시,중구,대청동,대청동제1투,1805,1134,403,401,187,92,42,4,0,1,0,0,1,0,1,1132,2,671
부산광역시,중구,대청동,대청동제2투,1548,936,310,321,176,58,62,0,0,0,0,0,1,0,0,928,8,612
부산광역시,중구,대청동,대청동제3투,1345,890,299,346,140,57,40,1,0,0,1,0,0,1,1,886,4,455
부산광역시,중구,보수동,합계,9027,6208,2024,2472,1004,390,274,9,2,3,1,3,0,1,2,6185,23,2819
부산광역시,중구,보수동,관내사전투표,1283,1283,522,443,157,90,67,1,0,1,0,0,0,1,0,1282,1,0
부산광역시,중구,보수동,보수동제1투,1850,1239,372,492,225,82,53,5,0,0,0,2,0,0,0,1231,8,611
부산광역시,중구,보수동,보수동제2투,2116,1287,361,530,242,89,58,0,1,0,1,0,0,0,0,1282,5,829
부산광역시,중구,보수동,보수동제3투,1328,771,240,342,119,35,27,1,0,0,0,1,0,0,1,766,5,557
부산광역시,중구,보수동,보수동제4투,2450,1628,529,665,261,94,69,2,1,2,0,0,0,0,1,1624,4,822
부산광역시,중구,부평동,관내사전투표,930,930,291,434,113,53,32,1,0,0,1,0,1,0,0,926,4,0
부산광역시,중구,부평동,합계,4564,3043,882,1464,418,176,88,2,0,0,1,1,2,1,0,3035,8,1521
부산광역시,중구,부평동,부평동제1투,1867,1032,273,521,162,51,21,0,0,0,0,0,1,1,0,1030,2,835
부산광역시,중구,부평동,부평동제2투,1767,1081,318,509,143,72,35,1,0,0,0,1,0,0,0,1079,2,686
부산광역시,중구,광복동,합계,1259,890,251,388,153,55,33,7,0,0,0,0,0,0,1,888,2,369
부산광역시,중구,광복동,관내사전투표,342,342,122,132,46,24,14,2,0,0,0,0,0,0,0,340,2,0
부산광역시,중구,광복동,광복동투표소,917,548,129,256,107,31,19,5,0,0,0,0,0,0,1,548,0,369
부산광역시,중구,남포동,관내사전투표,194,194,75,80,27,7,5,0,0,0,0,0,0,0,0,194,0,0
부산광역시,중구,남포동,합계,1090,653,195,308,92,34,20,1,0,0,0,0,0,0,1,651,2,437
부산광역시,중구,남포동,남포동투표소,896,459,120,228,65,27,15,1,0,0,0,0,0,0,1,457,2,437
부산광역시,중구,영주제1동,합계,3983,2667,946,904,494,161,148,2,2,1,0,1,0,1,0,2660,7,1316
부산광역시,중구,영주제1동,관내사전투표,546,546,243,142,94,31,33,0,0,0,0,1,0,0,0,544,2,0
부산광역시,중구,영주제1동,영주제1동제1투,1076,674,229,234,130,48,30,0,1,0,0,0,0,0,0,672,2,402
부산광역시,중구,영주제1동,영주제1동제2투,986,653,216,230,131,34,38,1,1,1,0,0,0,0,0,652,1,333
부산광역시,중구,영주제1동,영주제1동제3투,1375,794,258,298,139,48,47,1,0,0,0,0,0,1,0,792,2,581
부산광역시,중구,영주제2동,합계,6607,4658,1557,1797,792,313,168,4,0,4,0,3,2,0,2,4642,16,1949
부산광역시,중구,영주제2동,관내사전투표,787,787,339,236,127,45,36,1,0,1,0,2,0,0,0,787,0,0
부산광역시,중구,영주제2동,영주제2동제1투,1508,874,250,372,157,60,29,1,0,0,0,0,0,0,1,870,4,634
부산광역시,중구,영주제2동,영주제2동제2투,1382,845,254,346,151,65,25,1,0,0,0,0,0,0,0,842,3,537
부산광역시,중구,영주제2동,영주제2동제3투,1966,1449,494,530,249,110,56,1,0,2,0,0,0,0,1,1443,6,517
부산광역시,중구,영주제2동,영주제2동제4투,964,703,220,313,108,33,22,0,0,1,0,1,2,0,0,700,3,261
부산광역시,중구,잘못 투입·구분된 투표지,,0,0,0,0,0,0,0,0,0,0,0,0,0,0,0,0,0,0
부산광역시,서구,합계,,98536,71446,24522,26360,11868,4913,3131,77,8,70,14,32,25,51,77,71148,298,27090
부산광역시,서구,거소·선상투표,,388,359,124,73,97,19,16,2,4,4,2,3,2,0,3,349,10,29
부산광역시,서구,관외사전투표,,7769,7769,3485,1831,1242,644,486,5,1,7,3,6,0,3,15,7728,41,0
부산광역시,서구,재외투표,,669,437,241,50,64,23,54,2,0,0,0,0,0,0,0,434,3,232
부산광역시,서구,동대신제1동,합계,4066,3043,908,1309,484,212,106,2,0,3,0,1,2,2,2,3031,12,1023
부산광역시,서구,동대신제1동,관내사전투표,843,843,298,340,99,63,37,0,0,0,0,0,1,1,1,840,3,0
부산광역시,서구,동대신제1동,동대신제1동제1투,1814,1281,323,589,226,98,38,1,0,1,0,0,0,1,1,1278,3,533
부산광역시,서구,동대신제1동,동대신제1동제2투,1409,919,287,380,159,51,31,1,0,2,0,1,1,0,0,913,6,490
부산광역시,서구,동대신제2동,합계,6596,4643,1459,1914,780,301,162,9,0,2,1,2,0,1,1,4632,11,1953
부산광역시,서구,동대신제2동,관내사전투표,742,742,294,282,85,46,33,1,0,0,0,1,0,0,0,742,0,0
부산광역시,서구,동대신제2동,동대신제2동제1투,1778,1319,371,556,245,101,38,3,0,2,0,0,0,1,0,1317,2,459
부산광역시,서구,동대신제2동,동대신제2동제2투,2183,1343,406,568,239,74,46,3,0,0,0,1,0,0,1,1338,5,840
부산광역시,서구,동대신제2동,동대신제2동제3투,1893,1239,388,508,211,80,45,2,0,0,1,0,0,0,0,1235,4,654
부산광역시,서구,동대신제3동,합계,6022,4493,1531,1663,727,341,204,4,0,1,0,1,0,1,3,4476,17,1529
부산광역시,서구,동대신제3동,관내사전투표,1629,1629,639,545,223,123,89,1,0,1,0,1,0,0,0,1622,7,0
부산광역시,서구,동대신제3동,동대신제3동제1투,1960,1198,366,475,197,101,51,2,0,0,0,0,0,1,1,1194,4,762
부산광역시,서구,동대신제3동,동대신제3동제2투,2433,1666,526,643,307,117,64,1,0,0,0,0,0,0,2,1660,6,767
부산광역시,서구,서대신제1동,합계,8442,6203,2117,2299,1021,440,282,6,0,3,1,0,4,2,7,6182,21,2239
부산광역시,서구,서대신제1동,관내사전투표,1456,1456,579,478,212,100,74,1,0,1,0,0,0,2,4,1451,5,0
부산광역시,서구,서대신제1동,서대신제1동제1투,1814,1321,456,460,222,104,71,1,0,0,1,0,0,0,0,1315,6,493
부산광역시,서구,서대신제1동,서대신제1동제2투,1913,1231,361,513,222,78,48,0,0,0,0,0,3,0,2,1227,4,682
부산광역시,서구,서대신제1동,서대신제1동제3투,2159,1408,432,561,248,108,53,3,0,1,0,0,1,0,0,1407,1,751
부산광역시,서구,서대신제1동,서대신제1동제4투,1100,787,289,287,117,50,36,1,0,1,0,0,0,0,1,782,5,313
부산광역시,서구,서대신제3동,합계,6666,5142,1827,1868,832,358,233,3,0,1,0,3,3,4,4,5136,6,1524
부산광역시,서구,서대신제3동,관내사전투표,1629,1629,624,570,245,103,79,2,0,0,0,1,0,1,2,1627,2,0
부산광역시,서구,서대신제3동,서대신제3동제1투,3012,2144,745,773,371,145,100,1,0,0,0,2,2,2,0,2141,3,868
부산광역시,서구,서대신제3동,서대신제3동제2투,2025,1369,458,525,216,110,54,0,0,1,0,0,1,1,2,1368,1,656
부산광역시,서구,서대신제4동,합계,5373,4166,1485,1458,713,305,188,1,1,2,0,1,0,2,0,4156,10,1207
부산광역시,서구,서대신제4동,관내사전투표,983,983,419,311,135,72,43,1,0,0,0,0,0,0,0,981,2,0
부산광역시,서구,서대신제4동,서대신제4동제1투,1761,1238,444,403,228,98,61,0,0,0,0,0,0,2,0,1236,2,523
부산광역시,서구,서대신제4동,서대신제4동제2투,1972,1525,507,566,273,111,62,0,0,2,0,1,0,0,0,1522,3,447
부산광역시,서구,서대신제4동,서대신제4동제3투,657,420,115,178,77,24,22,0,1,0,0,0,0,0,0,417,3,237
부산광역시,서구,부민동,합계,6531,4879,1816,1589,751,443,242,5,0,5,0,4,1,4,3,4863,16,1652
부산광역시,서구,부민동,관내사전투표,1370,1370,612,331,171,146,100,0,0,0,0,2,0,2,0,1364,6,0
부산광역시,서구,부민동,부민동제1투,2837,1907,697,620,334,156,84,3,0,4,0,1,1,1,0,1901,6,930
부산광역시,서구,부민동,부민동제2투,2324,1602,507,638,246,141,58,2,0,1,0,1,0,1,3,1598,4,722
부산광역시,서구,아미동,관내사전투표,773,773,296,272,105,66,27,0,0,0,0,0,0,2,1,769,4,0
부산광역시,서구,아미동,합계,7171,4396,1294,1822,762,277,184,6,0,8,3,1,2,8,6,4373,23,2775
부산광역시,서구,아미동,아미동제1투,2042,1112,300,479,205,63,49,2,0,2,1,0,0,2,2,1105,7,930
부산광역시,서구,아미동,아미동제2투,1445,869,257,360,140,62,43,0,0,3,0,0,0,2,0,867,2,576
부산광역시,서구,아미동,아미동제3투,1603,821,219,357,153,46,31,3,0,1,1,1,1,1,1,815,6,782
부산광역시,서구,아미동,아미동제4투,1308,821,222,354,159,40,34,1,0,2,1,0,1,1,2,817,4,487
부산광역시,서구,초장동,합계,4414,2755,800,1198,462,155,98,3,1,6,1,2,2,6,5,2739,16,1659
부산광역시,서구,초장동,관내사전투표,628,628,195,250,119,22,29,2,1,2,0,1,1,4,2,628,0,0
부산광역시,서구,초장동,초장동제1투,2164,1188,350,523,187,74,37,0,0,2,1,0,0,2,2,1178,10,976
부산광역시,서구,초장동,초장동제2투,1622,939,255,425,156,59,32,1,0,2,0,1,1,0,1,933,6,683
부산광역시,서구,충무동,합계,7997,5674,1795,2369,898,347,218,5,0,7,0,2,0,1,3,5645,29,2323
부산광역시,서구,충무동,관내사전투표,1997,1997,736,746,288,114,97,3,0,1,0,0,0,0,1,1986,11,0
부산광역시,서구,충무동,충무동제1투,3391,2132,693,829,361,146,84,2,0,4,0,2,0,1,1,2123,9,1259
부산광역시,서구,충무동,충무동제2투,2609,1545,366,794,249,87,37,0,0,2,0,0,0,0,1,1536,9,1064
부산광역시,서구,남부민제1동,합계,4663,3118,901,1430,505,153,101,1,0,6,1,2,1,4,3,3108,10,1545
부산광역시,서구,남부민제1동,관내사전투표,815,815,265,356,119,43,23,0,0,3,0,1,0,2,1,813,2,0
부산광역시,서구,남부민제1동,남부민제1동제1투,2102,1236,335,570,219,59,43,0,0,0,1,1,0,1,1,1230,6,866
부산광역시,서구,남부민제1동,남부민제1동제2투,1746,1067,301,504,167,51,35,1,0,3,0,0,1,1,1,1065,2,679
부산광역시,서구,남부민제2동,관내사전투표,917,917,378,300,132,55,48,1,0,1,0,0,0,0,0,915,2,0
부산광역시,서구,남부민제2동,합계,8911,5847,1854,2419,974,345,193,9,0,10,0,2,1,6,11,5824,23,3064
부산광역시,서구,남부민제2동,남부민제2동제1투,3018,1824,584,707,335,104,74,2,0,4,0,1,0,0,5,1816,8,1194
부산광역시,서구,남부민제2동,남부민제2동제2투,1606,921,254,443,143,52,17,1,0,2,0,1,0,3,2,918,3,685
부산광역시,서구,남부민제2동,남부민제2동제3투,1579,1014,263,485,173,55,23,1,0,2,0,0,1,3,1,1007,7,565
부산광역시,서구,남부민제2동,남부민제2동제4투,1791,1171,375,484,191,79,31,4,0,1,0,0,0,0,3,1168,3,620
부산광역시,서구,암남동,합계,12858,8522,2885,3068,1556,550,364,14,1,5,2,2,7,7,11,8472,50,4336
부산광역시,서구,암남동,관내사전투표,1425,1425,610,398,239,96,69,1,1,1,0,0,2,0,1,1418,7,0
부산광역시,서구,암남동,암남동제1투,2404,1230,354,515,227,77,51,2,0,0,0,0,0,0,0,1226,4,1174
부산광역시,서구,암남동,암남동제2투,1621,1093,388,362,202,68,39,2,0,4,0,1,0,4,4,1074,19,528
부산광역시,서구,암남동,암남동제3투,1542,1041,366,380,192,56,40,2,0,0,1,0,0,1,1,1039,2,501
부산광역시,서구,암남동,암남동제4투,2979,1879,526,721,374,142,103,0,0,0,1,1,2,1,2,1873,6,1100
부산광역시,서구,암남동,암남동제5투,2887,1854,641,692,322,111,62,7,0,0,0,0,3,1,3,1842,12,1033
부산광역시,서구,잘못 투입·구분된 투표지,,0,0,0,0,0,0,0,0,0,0,0,0,0,0,0,0,0,0
부산광역시,동구,합계,,79720,58304,19606,22188,9815,3606,2589,65,14,47,19,21,19,31,62,58082,222,21416
부산광역시,동구,거소·선상투표,,225,208,69,49,62,15,8,0,0,0,0,0,2,0,0,205,3,17
부산광역시,동구,관외사전투표,,6281,6281,2774,1388,1055,523,470,5,1,6,2,6,0,5,15,6250,31,0
부산광역시,동구,재외투표,,557,381,241,45,40,16,38,0,0,0,0,0,0,0,0,380,1,176
부산광역시,동구,초량제1동,합계,4084,2771,940,1044,423,193,142,4,0,2,0,0,0,2,6,2756,15,1313
부산광역시,동구,초량제1동,관내사전투표,598,598,245,189,76,47,34,1,0,0,0,0,0,0,2,594,4,0
부산광역시,동구,초량제1동,초량제1동제1투,2161,1324,411,521,217,90,73,2,0,2,0,0,0,1,4,1321,3,837
부산광역시,동구,초량제1동,초량제1동제2투,1325,849,284,334,130,56,35,1,0,0,0,0,0,1,0,841,8,476
부산광역시,동구,초량제2동,합계,5436,3665,1064,1545,673,219,146,1,1,4,0,1,1,1,2,3658,7,1771
부산광역시,동구,초량제2동,관내사전투표,1003,1003,359,374,161,64,42,0,0,1,0,1,0,0,0,1002,1,0
부산광역시,동구,초량제2동,초량제2동제1투,2507,1428,361,665,281,74,39,1,0,3,0,0,0,0,0,1424,4,1079
부산광역시,동구,초량제2동,초량제2동제2투,1926,1234,344,506,231,81,65,0,1,0,0,0,1,1,2,1232,2,692
부산광역시,동구,초량제3동,합계,5115,3624,1278,1251,629,269,170,1,3,3,1,1,2,0,2,3610,14,1491
부산광역시,동구,초량제3동,관내사전투표,1174,1174,464,354,191,101,58,1,1,0,0,0,1,0,1,1172,2,0
부산광역시,동구,초량제3동,초량제3동제1투,1934,1179,364,480,207,76,42,0,2,2,0,1,0,0,1,1175,4,755
부산광역시,동구,초량제3동,초량제3동제2투,2007,1271,450,417,231,92,70,0,0,1,1,0,1,0,0,1263,8,736
부산광역시,동구,초량제6동,관내사전투표,1120,1120,374,452,165,58,61,0,0,2,1,0,0,2,2,1117,3,0
부산광역시,동구,초량제6동,합계,5897,4133,1270,1732,704,210,179,3,1,3,1,1,2,3,4,4113,20,1764
부산광역시,동구,초량제6동,초량제6동제1투,2288,1381,406,594,248,70,50,2,1,1,0,0,0,0,0,1372,9,907
부산광역시,동구,초량제6동,초량제6동제2투,2489,1632,490,686,291,82,68,1,0,0,0,1,2,1,2,1624,8,857
부산광역시,동구,수정제1동,관내사전투표,971,970,357,341,171,58,38,0,0,0,0,1,0,0,1,967,3,1
부산광역시,동구,수정제1동,합계,3939,2952,950,1144,509,200,126,3,0,3,2,1,1,1,4,2944,8,987
부산광역시,동구,수정제1동,수정제1동제1투,1269,776,231,309,141,48,40,1,0,1,1,0,0,1,0,773,3,493
부산광역시,동구,수정제1동,수정제1동제2투,1699,1206,362,494,197,94,48,2,0,2,1,0,1,0,3,1204,2,493
부산광역시,동구,수정제2동,관내사전투표,1161,1161,481,393,171,60,48,0,0,1,0,0,0,2,0,1156,5,0
부산광역시,동구,수정제2동,합계,7463,5326,1728,2131,919,284,219,3,1,5,1,2,2,5,3,5303,23,2137
부산광역시,동구,수정제2동,수정제2동제1투,1779,1258,374,535,227,58,55,0,0,0,0,1,1,0,1,1252,6,521
부산광역시,동구,수정제2동,수정제2동제2투,2157,1337,444,531,233,73,48,1,0,2,0,1,0,0,0,1333,4,820
부산광역시,동구,수정제2동,수정제2동제3투,2366,1570,429,672,288,93,68,2,1,2,1,0,1,3,2,1562,8,796
부산광역시,동구,수정제4동,관내사전투표,612,612,198,277,78,35,18,0,0,1,0,2,0,1,0,610,2,0
부산광역시,동구,수정제4동,합계,3945,2760,751,1281,448,158,97,2,1,3,1,2,0,2,4,2750,10,1185
부산광역시,동구,수정제4동,수정제4동제1투,1531,926,239,400,178,61,38,0,0,1,1,0,0,1,4,923,3,605
부산광역시,동구,수정제4동,수정제4동제2투,1802,1222,314,604,192,62,41,2,1,1,0,0,0,0,0,1217,5,580
부산광역시,동구,수정제5동,합계,5280,3795,1172,1607,618,207,162,9,1,1,1,0,0,3,2,3783,12,1485
부산광역시,동구,수정제5동,관내사전투표,1070,1070,376,431,154,54,43,4,0,1,0,0,0,2,1,1066,4,0
부산광역시,동구,수정제5동,수정제5동제1투,1950,1302,402,534,221,84,54,2,0,0,1,0,0,0,0,1298,4,648
부산광역시,동구,수정제5동,수정제5동제2투,2260,1423,394,642,243,69,65,3,1,0,0,0,0,1,1,1419,4,837
부산광역시,동구,좌천동,합계,9565,6942,2287,2699,1198,419,270,13,2,5,4,2,2,2,6,6909,33,2623
부산광역시,동구,좌천동,관내사전투표,1726,1726,695,569,266,105,74,0,1,2,2,0,1,0,0,1715,11,0
부산광역시,동구,좌천동,좌천동제1투,2534,1702,525,685,298,120,65,2,0,0,0,1,0,0,3,1699,3,832
부산광역시,동구,좌천동,좌천동제2투,2650,1803,557,732,324,111,62,6,1,1,1,0,1,1,1,1798,5,847
부산광역시,동구,좌천동,좌천동제3투,2655,1711,510,713,310,83,69,5,0,2,1,1,0,1,2,1697,14,944
부산광역시,동구,범일제1동,관내사전투표,1109,1109,390,434,161,63,44,5,0,3,0,0,0,1,2,1103,6,0
부산광역시,동구,범일제1동,합계,10706,7401,2301,3168,1225,388,256,13,2,5,2,1,4,4,8,7377,24,3305
부산광역시,동구,범일제1동,범일제1동제1투,2362,1661,526,684,287,93,62,1,1,0,1,0,0,0,2,1657,4,701
부산광역시,동구,범일제1동,범일제1동제2투,847,515,168,218,74,35,13,3,0,2,0,0,0,1,1,515,0,332
부산광역시,동구,범일제1동,범일제1동제3투,1964,1371,432,592,223,62,51,1,0,0,1,1,2,1,1,1367,4,593
부산광역시,동구,범일제1동,범일제1동제4투,2207,1463,426,643,256,78,51,1,1,0,0,0,0,1,1,1458,5,744
부산광역시,동구,범일제1동,범일제1동제5투,2217,1282,359,597,224,57,35,2,0,0,0,0,2,0,1,1277,5,935
부산광역시,동구,범일제2동,관내사전투표,1091,1091,443,370,176,56,41,2,0,1,0,1,0,0,0,1090,1,0
부산광역시,동구,범일제2동,합계,7578,5529,1956,2040,925,368,206,6,0,4,3,3,2,0,3,5516,13,2049
부산광역시,동구,범일제2동,범일제2동제1투,1964,1132,307,551,166,66,34,2,0,0,2,0,1,0,1,1130,2,832
부산광역시,동구,범일제2동,범일제2동제2투,2726,1940,683,676,324,154,89,1,0,2,1,1,1,0,2,1934,6,786
부산광역시,동구,범일제2동,범일제2동제3투,1797,1366,523,443,259,92,42,1,0,1,0,1,0,0,0,1362,4,431
부산광역시,동구,범일제5동,관내사전투표,471,471,190,161,69,27,21,0,0,0,0,0,1,0,1,470,1,0
부산광역시,동구,범일제5동,합계,3649,2535,825,1064,387,136,100,2,1,3,1,1,1,3,3,2527,8,1114
부산광역시,동구,범일제5동,범일제5동제1투,1510,1006,273,495,158,44,29,1,0,0,0,0,0,2,2,1004,2,504
부산광역시,동구,범일제5동,범일제5동제2투,1668,1058,362,408,160,65,50,1,1,3,1,1,0,1,0,1053,5,610
부산광역시,동구,잘못 투입·구분된 투표지,,0,1,0,0,0,1,0,0,0,0,0,0,0,0,0,1,0,-1
부산광역시,영도구,합계,,109885,78013,30094,25345,13082,5375,3416,78,9,51,21,46,15,45,82,77659,354,31872
부산광역시,영도구,거소·선상투표,,421,390,152,77,107,23,10,1,2,1,1,2,0,1,1,378,12,31
부산광역시,영도구,관외사전투표,,7605,7603,3546,1595,1202,630,533,2,2,6,2,5,3,2,15,7543,60,2
부산광역시,영도구,재외투표,,673,489,324,33,64,23,38,2,0,1,0,1,0,0,0,486,3,184
부산광역시,영도구,남항동,관내사전투표,1673,1673,671,612,251,79,52,1,0,3,0,0,0,0,1,1670,3,0
부산광역시,영도구,남항동,합계,9670,6538,2200,2662,1037,379,212,8,1,5,0,3,1,4,6,6518,20,3132
부산광역시,영도구,남항동,남항동제1투,2758,1670,517,692,278,111,55,2,1,1,0,0,0,3,3,1663,7,1088
부산광역시,영도구,남항동,남항동제2투,2349,1427,475,590,235,74,39,4,0,1,0,2,1,0,1,1422,5,922
부산광역시,영도구,남항동,남항동제3투,2890,1768,537,768,273,115,66,1,0,0,0,1,0,1,1,1763,5,1122
부산광역시,영도구,영선제1동,관내사전투표,680,680,314,153,127,51,30,0,1,0,0,0,0,1,2,679,1,0
부산광역시,영도구,영선제1동,합계,3566,2467,927,782,477,178,89,3,1,0,1,1,0,1,3,2463,4,1099
부산광역시,영도구,영선제1동,영선제1동제1투,1375,802,264,305,132,60,36,2,0,0,1,0,0,0,0,800,2,573
부산광역시,영도구,영선제1동,영선제1동제2투,1511,985,349,324,218,67,23,1,0,0,0,1,0,0,1,984,1,526
부산광역시,영도구,영선제2동,합계,8731,6400,2402,2244,1020,449,243,2,1,2,1,4,2,3,1,6374,26,2331
부산광역시,영도구,영선제2동,관내사전투표,2057,2057,920,612,294,147,70,2,1,0,0,1,2,0,0,2049,8,0
부산광역시,영도구,영선제2동,영선제2동제1투,2833,1864,677,647,301,142,88,0,0,1,1,2,0,1,0,1860,4,969
부산광역시,영도구,영선제2동,영선제2동제2투,2409,1608,534,619,280,106,57,0,0,1,0,1,0,1,1,1600,8,801
부산광역시,영도구,영선제2동,영선제2동제3투,1432,871,271,366,145,54,28,0,0,0,0,0,0,1,0,865,6,561
부산광역시,영도구,신선동,관내사전투표,738,738,318,232,99,45,33,0,0,2,1,0,1,1,2,734,4,0
부산광역시,영도구,신선동,합계,8837,5331,1911,1914,878,365,206,3,0,4,3,1,3,8,12,5308,23,3506
부산광역시,영도구,신선동,신선동제1투,2344,1200,406,441,214,85,41,1,0,0,1,1,0,3,1,1194,6,1144
부산광역시,영도구,신선동,신선동제2투,2364,1477,527,541,218,125,54,0,0,0,0,0,1,1,6,1473,4,887
부산광역시,영도구,신선동,신선동제3투,1595,941,334,352,170,44,32,1,0,1,0,0,0,0,2,936,5,654
부산광역시,영도구,신선동,신선동제4투,1796,975,326,348,177,66,46,1,0,1,1,0,1,3,1,971,4,821
부산광역시,영도구,봉래제1동,합계,6536,4686,1746,1703,749,281,168,3,0,4,1,2,0,4,3,4664,22,1850
부산광역시,영도구,봉래제1동,관내사전투표,1398,1398,576,499,170,75,65,0,0,0,1,1,0,1,1,1389,9,0
부산광역시,영도구,봉래제1동,봉래제1동제1투,2803,1864,651,687,334,122,59,1,0,1,0,1,0,2,0,1858,6,939
부산광역시,영도구,봉래제1동,봉래제1동제2투,2335,1424,519,517,245,84,44,2,0,3,0,0,0,1,2,1417,7,911
부산광역시,영도구,봉래제2동,관내사전투표,497,497,204,143,89,37,22,0,0,0,0,1,0,0,0,496,1,0
부산광역시,영도구,봉래제2동,합계,5269,3466,1236,1262,594,224,121,1,1,4,1,5,0,2,2,3453,13,1803
부산광역시,영도구,봉래제2동,봉래제2동제1투,921,451,168,157,76,32,13,0,0,0,0,1,0,0,0,447,4,470
부산광역시,영도구,봉래제2동,봉래제2동제2투,1941,1248,407,516,216,72,28,0,0,1,1,1,0,2,1,1245,3,693
부산광역시,영도구,봉래제2동,봉래제2동제3투,1910,1270,457,446,213,83,58,1,1,3,0,2,0,0,1,1265,5,640
부산광역시,영도구,청학제1동,관내사전투표,974,974,466,228,152,69,50,0,0,0,0,2,0,0,1,968,6,0
부산광역시,영도구,청학제1동,합계,6271,4091,1517,1335,737,294,174,0,0,2,0,2,2,3,6,4072,19,2180
부산광역시,영도구,청학제1동,청학제1동제1투,3046,1710,583,598,333,124,59,0,0,0,0,0,2,1,3,1703,7,1336
부산광역시,영도구,청학제1동,청학제1동제2투,2251,1407,468,509,252,101,65,0,0,2,0,0,0,2,2,1401,6,844
부산광역시,영도구,청학제2동,합계,15879,11198,4418,3563,1866,776,499,11,1,8,4,5,0,3,9,11163,35,4681
부산광역시,영도구,청학제2동,관내사전투표,2500,2500,1147,672,362,175,124,2,0,3,2,1,0,0,2,2490,10,0
부산광역시,영도구,청학제2동,청학제2동제1투,2618,1759,679,573,309,118,73,1,0,0,0,2,0,1,0,1756,3,859
부산광역시,영도구,청학제2동,청학제2동제2투,2207,1342,453,488,249,82,56,3,1,2,1,0,0,0,1,1336,6,865
부산광역시,영도구,청학제2동,청학제2동제3투,2607,1712,706,489,309,117,81,2,0,2,0,1,0,1,0,1708,4,895
부산광역시,영도구,청학제2동,청학제2동제4투,3072,2032,806,637,343,152,85,0,0,1,0,0,0,1,1,2026,6,1040
부산광역시,영도구,청학제2동,청학제2동제5투,2875,1853,627,704,294,132,80,3,0,0,1,1,0,0,5,1847,6,1022
부산광역시,영도구,동삼제1동,관내사전투표,4096,4096,1889,1053,631,291,195,3,0,5,1,6,1,5,4,4084,12,0
부산광역시,영도구,동삼제1동,합계,23233,16267,6446,5070,2747,1138,731,30,0,7,4,9,4,8,15,16209,58,6966
부산광역시,영도구,동삼제1동,동삼제1동제1투,2157,1388,522,449,242,102,61,0,0,0,0,0,0,0,2,1378,10,769
부산광역시,영도구,동삼제1동,동삼제1동제2투,2387,1462,603,434,257,87,72,0,0,0,1,1,0,2,1,1458,4,925
부산광역시,영도구,동삼제1동,동삼제1동제3투,3146,2051,727,711,354,151,89,10,0,1,0,1,1,0,2,2047,4,1095
부산광역시,영도구,동삼제1동,동삼제1동제4투,2300,1555,580,534,272,96,63,1,0,0,0,1,0,0,3,1550,5,745
부산광역시,영도구,동삼제1동,동삼제1동제5투,2886,1876,744,574,299,157,86,7,0,0,1,0,1,0,0,1869,7,1010
부산광역시,영도구,동삼제1동,동삼제1동제6투,2393,1620,603,540,285,121,63,1,0,1,0,0,0,0,0,1614,6,773
부산광역시,영도구,동삼제1동,동삼제1동제7투,1899,948,331,325,190,51,38,4,0,0,1,0,0,0,2,942,6,951
부산광역시,영도구,동삼제1동,동삼제1동제8투,1969,1271,447,450,217,82,64,4,0,0,0,0,1,1,1,1267,4,698
부산광역시,영도구,동삼제2동,합계,3210,2264,786,729,433,193,106,1,0,2,1,2,0,1,1,2255,9,946
부산광역시,영도구,동삼제2동,관내사전투표,663,663,268,181,106,52,47,1,0,2,0,1,0,0,1,659,4,0
부산광역시,영도구,동삼제2동,동삼제2동투표소,2547,1601,518,548,327,141,59,0,0,0,1,1,0,1,0,1596,5,946
부산광역시,영도구,동삼제3동,관내사전투표,1659,1659,727,474,255,101,81,6,0,1,0,0,0,1,1,1647,12,0
부산광역시,영도구,동삼제3동,합계,9984,6822,2483,2376,1170,422,286,11,0,5,2,4,0,5,8,6772,50,3162
부산광역시,영도구,동삼제3동,동삼제3동제1투,1768,1102,345,406,202,87,52,0,0,0,1,1,0,1,3,1098,4,666
부산광역시,영도구,동삼제3동,동삼제3동제2투,2123,1366,484,501,243,68,54,1,0,1,0,0,0,1,0,1353,13,757
부산광역시,영도구,동삼제3동,동삼제3동제3투,2376,1302,362,550,252,74,42,3,0,3,1,1,0,1,2,1291,11,1074
부산광역시,영도구,동삼제3동,동삼제3동제4투,2058,1393,565,445,218,92,57,1,0,0,0,2,0,1,2,1383,10,665
부산광역시,영도구,잘못 투입·구분된 투표지,,0,1,0,0,1,0,0,0,0,0,0,0,0,0,0,1,0,-1
부산광역시,부산진구,합계,,323551,246124,95042,79545,40636,16855,12045,309,25,146,45,121,49,111,224,245153,971,77427
부산광역시,부산진구,거소·선상투표,,781,722,273,146,205,45,22,4,1,0,3,1,1,1,2,704,18,59
부산광역시,부산진구,관외사전투표,,25185,25176,11719,5094,4125,2195,1747,36,6,14,5,16,6,6,47,25016,160,9
부산광역시,부산진구,재외투표,,1784,1370,842,97,199,57,166,2,0,0,1,1,0,0,1,1366,4,414
부산광역시,부산진구,부전제1동,합계,11842,7818,2580,3199,1165,430,366,9,1,9,1,3,1,4,6,7774,44,4024
부산광역시,부산진구,부전제1동,관내사전투표,2268,2268,855,913,292,91,94,4,0,1,0,2,1,1,0,2254,14,0
부산광역시,부산진구,부전제1동,부전제1동제1투,2606,1216,338,579,175,70,44,1,0,2,1,0,0,0,2,1212,4,1390
부산광역시,부산진구,부전제1동,부전제1동제2투,3202,1850,666,606,284,144,130,2,0,3,0,1,0,1,0,1837,13,1352
부산광역시,부산진구,부전제1동,부전제1동제3투,1507,1006,314,402,177,49,51,2,1,2,0,0,0,1,2,1001,5,501
부산광역시,부산진구,부전제1동,부전제1동제4투,945,627,170,308,103,21,19,0,0,1,0,0,0,1,1,624,3,318
부산광역시,부산진구,부전제1동,부전제1동제5투,1314,851,237,391,134,55,28,0,0,0,0,0,0,0,1,846,5,463
부산광역시,부산진구,부전제2동,합계,8934,6199,2371,1842,1131,457,347,12,1,2,2,1,0,5,5,6176,23,2735
부산광역시,부산진구,부전제2동,관내사전투표,1401,1401,694,266,195,117,122,1,0,0,0,0,0,1,1,1397,4,0
부산광역시,부산진구,부전제2동,부전제2동제1투,3069,1912,668,636,366,120,101,6,1,2,1,0,0,1,1,1903,9,1157
부산광역시,부산진구,부전제2동,부전제2동제2투,1684,699,216,263,136,35,37,0,0,0,1,1,0,2,0,691,8,985
부산광역시,부산진구,부전제2동,부전제2동제3투,2780,2187,793,677,434,185,87,5,0,0,0,0,0,1,3,2185,2,593
부산광역시,부산진구,연지동,합계,17792,13923,5137,4934,2236,941,580,19,1,6,2,3,2,6,8,13875,48,3869
부산광역시,부산진구,연지동,관내사전투표,3478,3478,1450,1115,490,245,155,3,0,1,0,1,1,2,0,3463,15,0
부산광역시,부산진구,연지동,연지동제1투,2939,2403,1023,713,383,186,89,1,0,1,0,0,0,0,2,2398,5,536
부산광역시,부산진구,연지동,연지동제2투,3256,2405,765,951,415,157,101,4,0,2,1,0,0,0,2,2398,7,851
부산광역시,부산진구,연지동,연지동제3투,2822,1768,536,738,306,95,69,7,1,0,0,1,1,1,3,1758,10,1054
부산광역시,부산진구,연지동,연지동제4투,2769,1953,666,716,313,149,96,2,0,1,1,1,0,2,1,1948,5,816
부산광역시,부산진구,연지동,연지동제5투,2528,1916,697,701,329,109,70,2,0,1,0,0,0,1,0,1910,6,612
부산광역시,부산진구,초읍동,합계,18190,13546,4416,5620,2051,813,549,17,0,8,1,10,1,3,11,13500,46,4644
부산광역시,부산진구,초읍동,관내사전투표,3083,3083,1216,1144,380,193,132,5,0,2,0,4,0,0,0,3076,7,0
부산광역시,부산진구,초읍동,초읍동제1투,1601,1131,283,561,180,67,33,2,0,1,0,0,0,1,1,1129,2,470
부산광역시,부산진구,초읍동,초읍동제2투,2754,2014,533,966,322,116,69,1,0,1,0,0,0,0,0,2008,6,740
부산광역시,부산진구,초읍동,초읍동제3투,2930,1804,522,836,275,90,63,1,0,0,0,2,0,1,3,1793,11,1126
부산광역시,부산진구,초읍동,초읍동제4투,2306,1598,545,610,259,103,68,0,0,4,0,2,0,1,1,1593,5,708
부산광역시,부산진구,초읍동,초읍동제5투,2919,2051,734,745,332,124,102,5,0,0,0,1,0,0,2,2045,6,868
부산광역시,부산진구,초읍동,초읍동제6투,2597,1865,583,758,303,120,82,3,0,0,1,1,1,0,4,1856,9,732
부산광역시,부산진구,양정제1동,합계,17046,13463,5120,4451,2195,926,664,16,1,10,3,4,2,6,12,13410,53,3583
부산광역시,부산진구,양정제1동,관내사전투표,3243,3243,1497,780,482,259,195,2,1,3,1,2,1,0,6,3229,14,0
부산광역시,부산진구,양정제1동,양정제1동제1투,2294,1508,479,662,219,74,66,1,0,1,0,0,0,3,1,1506,2,786
부산광역시,부산진구,양정제1동,양정제1동제2투,2867,2312,905,755,366,173,95,2,0,0,1,0,0,1,3,2301,11,555
부산광역시,부산진구,양정제1동,양정제1동제3투,3428,2822,995,936,558,195,117,7,0,3,1,0,0,1,1,2814,8,606
부산광역시,부산진구,양정제1동,양정제1동제4투,3165,2134,814,711,344,137,117,2,0,2,0,1,0,0,0,2128,6,1031
부산광역시,부산진구,양정제1동,양정제1동제5투,2049,1444,430,607,226,88,74,2,0,1,0,1,1,1,1,1432,12,605
부산광역시,부산진구,양정제2동,합계,12035,8328,3038,2964,1299,560,395,12,0,5,2,4,1,4,6,8290,38,3707
부산광역시,부산진구,양정제2동,관내사전투표,1705,1705,689,597,244,86,71,4,0,1,0,1,1,1,1,1696,9,0
부산광역시,부산진구,양정제2동,양정제2동제1투,3397,2252,896,696,342,183,119,1,0,0,0,1,0,1,2,2241,11,1145
부산광역시,부산진구,양정제2동,양정제2동제2투,3119,1987,722,659,336,136,116,3,0,1,0,1,0,1,1,1976,11,1132
부산광역시,부산진구,양정제2동,양정제2동제3투,2350,1459,462,589,236,101,59,2,0,2,1,1,0,0,0,1453,6,891
부산광역시,부산진구,양정제2동,양정제2동제4투,1464,925,269,423,141,54,30,2,0,1,1,0,0,1,2,924,1,539
부산광역시,부산진구,전포제1동,관내사전투표,2322,2322,1053,564,313,198,170,5,0,1,0,0,0,1,1,2306,16,0
부산광역시,부산진구,전포제1동,합계,14034,9469,3501,3065,1559,700,565,13,0,6,0,4,2,4,7,9426,43,4565
부산광역시,부산진구,전포제1동,전포제1동제1투,2668,1645,617,511,251,134,115,2,0,0,0,2,0,2,3,1637,8,1023
부산광역시,부산진구,전포제1동,전포제1동제2투,2619,1633,475,713,259,96,79,0,0,2,0,1,0,0,2,1627,6,986
부산광역시,부산진구,전포제1동,전포제1동제3투,3105,2057,878,434,409,181,141,4,0,0,0,0,0,1,0,2048,9,1048
부산광역시,부산진구,전포제1동,전포제1동제4투,3320,1812,478,843,327,91,60,2,0,3,0,1,2,0,1,1808,4,1508
부산광역시,부산진구,전포제2동,관내사전투표,2959,2959,1389,776,437,175,164,6,0,0,0,1,0,3,0,2951,8,0
부산광역시,부산진구,전포제2동,합계,18217,13399,5044,4602,2129,909,615,10,4,10,0,10,2,8,6,13349,50,4818
부산광역시,부산진구,전포제2동,전포제2동제1투,2559,1595,564,580,236,129,72,1,1,2,0,1,0,1,0,1587,8,964
부산광역시,부산진구,전포제2동,전포제2동제2투,3202,2196,807,803,357,142,73,0,0,2,0,3,0,1,0,2188,8,1006
부산광역시,부산진구,전포제2동,전포제2동제3투,2880,2071,693,805,334,134,83,2,3,0,0,3,0,0,2,2059,12,809
부산광역시,부산진구,전포제2동,전포제2동제4투,2643,1774,518,754,312,107,72,1,0,2,0,0,1,2,0,1769,5,869
부산광역시,부산진구,전포제2동,전포제2동제5투,3974,2804,1073,884,453,222,151,0,0,4,0,2,1,1,4,2795,9,1170
부산광역시,부산진구,부암제1동,합계,16657,12166,4723,4081,1995,796,486,18,1,3,0,5,3,9,6,12126,40,4491
부산광역시,부산진구,부암제1동,관내사전투표,2236,2236,1111,541,301,157,114,2,0,0,0,1,0,3,1,2231,5,0
부산광역시,부산진구,부암제1동,부암제1동제1투,3888,2401,869,869,416,149,81,7,0,1,0,1,0,0,0,2393,8,1487
부산광역시,부산진구,부암제1동,부암제1동제2투,3112,2103,716,799,377,126,66,3,1,0,0,3,1,2,1,2095,8,1009
부산광역시,부산진구,부암제1동,부암제1동제3투,4054,3037,1211,968,510,213,112,5,0,0,0,0,2,2,1,3024,13,1017
부산광역시,부산진구,부암제1동,부암제1동제4투,3367,2389,816,904,391,151,113,1,0,2,0,0,0,2,3,2383,6,978
부산광역시,부산진구,부암제3동,합계,16536,12631,5186,3836,2121,843,546,18,3,9,1,12,4,7,8,12594,37,3905
부산광역시,부산진구,부암제3동,관내사전투표,2662,2662,1275,686,378,171,132,4,0,1,0,4,3,3,1,2658,4,0
부산광역시,부산진구,부암제3동,부암제3동제1투,2761,1625,558,593,290,99,69,2,0,2,0,1,1,0,2,1617,8,1136
부산광역시,부산진구,부암제3동,부암제3동제2투,3274,2570,972,813,449,202,120,1,1,0,1,1,0,1,2,2563,7,704
부산광역시,부산진구,부암제3동,부암제3동제3투,3054,2172,748,843,368,128,65,4,0,4,0,4,0,1,1,2166,6,882
부산광역시,부산진구,부암제3동,부암제3동제4투,1868,1294,500,430,234,62,50,3,2,2,0,1,0,1,1,1286,8,574
부산광역시,부산진구,부암제3동,부암제3동제5투,2917,2308,1133,471,402,181,110,4,0,0,0,1,0,1,1,2304,4,609
부산광역시,부산진구,당감제1동,합계,20554,15571,6124,5123,2572,963,680,16,1,9,1,4,1,6,14,15514,57,4983
부산광역시,부산진구,당감제1동,관내사전투표,2909,2909,1376,805,413,155,142,3,0,6,0,0,0,0,3,2903,6,0
부산광역시,부산진구,당감제1동,당감제1동제1투,2950,1914,554,851,314,100,73,3,1,1,1,0,0,1,3,1902,12,1036
부산광역시,부산진구,당감제1동,당감제1동제2투,3003,2187,803,822,324,131,87,5,0,0,0,0,0,3,3,2178,9,816
부산광역시,부산진구,당감제1동,당감제1동제3투,2676,1665,512,683,306,87,69,0,0,1,0,0,0,0,0,1658,7,1011
부산광역시,부산진구,당감제1동,당감제1동제4투,3912,2802,1116,841,509,177,135,4,0,1,0,3,0,2,3,2791,11,1110
부산광역시,부산진구,당감제1동,당감제1동제5투,2389,1908,807,544,319,154,80,0,0,0,0,0,0,0,1,1905,3,481
부산광역시,부산진구,당감제1동,당감제1동제6투,2715,2186,956,577,387,159,94,1,0,0,0,1,1,0,1,2177,9,529
부산광역시,부산진구,당감제2동,합계,8645,6897,2677,2239,1182,447,305,3,0,5,1,5,2,5,7,6878,19,1748
부산광역시,부산진구,당감제2동,관내사전투표,1657,1657,737,463,271,102,73,1,0,2,0,1,0,0,3,1653,4,0
부산광역시,부산진구,당감제2동,당감제2동제1투,2412,1566,527,585,260,109,73,0,0,3,1,1,0,0,2,1561,5,846
부산광역시,부산진구,당감제2동,당감제2동제2투,2231,1730,652,564,302,119,77,2,0,0,0,3,2,3,0,1724,6,501
부산광역시,부산진구,당감제2동,당감제2동제3투,2345,1944,761,627,349,117,82,0,0,0,0,0,0,2,2,1940,4,401
부산광역시,부산진구,당감제4동,합계,10986,8353,3573,2455,1358,545,364,12,3,5,1,5,3,3,5,8332,21,2633
부산광역시,부산진구,당감제4동,관내사전투표,2650,2650,1292,640,389,171,140,1,1,1,1,0,1,2,2,2641,9,0
부산광역시,부산진구,당감제4동,당감제4동제1투,2533,1568,550,600,281,66,56,8,1,0,0,0,1,1,0,1564,4,965
부산광역시,부산진구,당감제4동,당감제4동제2투,2053,1330,466,516,203,93,45,1,0,1,0,0,1,0,1,1327,3,723
부산광역시,부산진구,당감제4동,당감제4동제3투,3750,2805,1265,699,485,215,123,2,1,3,0,5,0,0,2,2800,5,945
부산광역시,부산진구,가야제1동,합계,17653,12425,4558,4248,2104,808,590,14,1,5,3,5,4,5,17,12362,63,5228
부산광역시,부산진구,가야제1동,관내사전투표,2889,2889,1312,783,416,185,164,4,0,1,1,3,1,1,3,2874,15,0
부산광역시,부산진구,가야제1동,가야제1동제1투,2639,1736,523,722,299,108,70,2,1,1,1,0,1,1,3,1732,4,903
부산광역시,부산진구,가야제1동,가야제1동제2투,2735,1702,598,577,304,109,96,3,0,0,0,0,0,0,4,1691,11,1033
부산광역시,부산진구,가야제1동,가야제1동제3투,2761,1897,667,685,337,124,66,1,0,0,1,1,0,0,2,1884,13,864
부산광역시,부산진구,가야제1동,가야제1동제4투,2201,1330,469,458,239,87,64,2,0,1,0,1,0,2,3,1326,4,871
부산광역시,부산진구,가야제1동,가야제1동제5투,2567,1726,590,629,314,117,65,1,0,1,0,0,0,1,0,1718,8,841
부산광역시,부산진구,가야제1동,가야제1동제6투,1861,1145,399,394,195,78,65,1,0,1,0,0,2,0,2,1137,8,716
부산광역시,부산진구,가야제2동,합계,14527,11116,3987,4023,1799,754,475,5,0,10,2,9,0,8,12,11084,32,3411
부산광역시,부산진구,가야제2동,관내사전투표,2558,2558,1134,799,335,170,109,0,0,2,0,3,0,2,1,2555,3,0
부산광역시,부산진구,가야제2동,가야제2동제1투,3073,2096,708,824,335,129,86,1,0,0,1,0,0,1,3,2088,8,977
부산광역시,부산진구,가야제2동,가야제2동제2투,3067,2193,771,764,394,142,111,2,0,0,0,2,0,0,3,2189,4,874
부산광역시,부산진구,가야제2동,가야제2동제3투,2440,1691,535,666,290,102,72,0,0,7,0,3,0,2,4,1681,10,749
부산광역시,부산진구,가야제2동,가야제2동제4투,3389,2578,839,970,445,211,97,2,0,1,1,1,0,3,1,2571,7,811
부산광역시,부산진구,개금제1동,합계,12216,8977,3553,2730,1448,668,503,8,0,5,2,4,1,6,6,8934,43,3239
부산광역시,부산진구,개금제1동,관내사전투표,2439,2439,1144,578,346,188,163,2,0,0,0,0,1,2,2,2426,13,0
부산광역시,부산진구,개금제1동,개금제1동제1투,3999,2675,1052,800,452,219,137,2,0,5,1,3,0,1,0,2672,3,1324
부산광역시,부산진구,개금제1동,개금제1동제2투,3182,2156,780,729,344,151,128,4,0,0,0,1,0,0,2,2139,17,1026
부산광역시,부산진구,개금제1동,개금제1동제3투,2596,1707,577,623,306,110,75,0,0,0,1,0,0,3,2,1697,10,889
부산광역시,부산진구,개금제2동,합계,9906,7440,2698,2553,1219,523,390,8,0,1,3,2,3,5,9,7414,26,2466
부산광역시,부산진구,개금제2동,관내사전투표,1774,1774,771,501,254,137,100,2,0,0,1,0,0,0,1,1767,7,0
부산광역시,부산진구,개금제2동,개금제2동제1투,2730,1752,595,609,298,119,115,4,0,0,0,1,2,2,1,1746,6,978
부산광역시,부산진구,개금제2동,개금제2동제2투,2597,1724,531,714,286,99,77,1,0,0,1,1,0,1,5,1716,8,873
부산광역시,부산진구,개금제2동,개금제2동제3투,2805,2190,801,729,381,168,98,1,0,1,1,0,1,2,2,2185,5,615
부산광역시,부산진구,개금제3동,합계,23991,18726,7401,5913,3084,1329,864,38,0,13,7,8,4,5,13,18679,47,5265
부산광역시,부산진구,개금제3동,관내사전투표,3218,3218,1555,817,443,223,161,4,0,3,2,2,0,2,0,3212,6,0
부산광역시,부산진구,개금제3동,개금제3동제1투,2364,1536,507,602,239,101,70,4,0,4,1,1,1,1,1,1532,4,828
부산광역시,부산진구,개금제3동,개금제3동제2투,2511,1740,652,561,297,139,74,4,0,2,0,2,1,0,1,1733,7,771
부산광역시,부산진구,개금제3동,개금제3동제3투,2817,2107,865,612,370,136,108,7,0,0,0,0,1,1,3,2103,4,710
부산광역시,부산진구,개금제3동,개금제3동제4투,2952,2405,942,757,364,204,117,4,0,2,1,0,0,0,6,2397,8,547
부산광역시,부산진구,개금제3동,개금제3동제5투,2325,1635,565,626,280,98,54,3,0,1,1,0,1,0,1,1630,5,690
부산광역시,부산진구,개금제3동,개금제3동제6투,2672,1927,698,674,330,124,90,6,0,0,1,0,0,1,1,1925,2,745
부산광역시,부산진구,개금제3동,개금제3동제7투,2655,2174,808,716,369,170,98,4,0,1,0,0,0,0,0,2166,8,481
부산광역시,부산진구,개금제3동,개금제3동제8투,2477,1984,809,548,392,134,92,2,0,0,1,3,0,0,0,1981,3,493
부산광역시,부산진구,범천제1동,합계,9131,6418,2398,2213,1039,402,328,7,0,2,1,0,3,2,5,6400,18,2713
부산광역시,부산진구,범천제1동,관내사전투표,1893,1893,857,542,260,109,110,5,0,0,0,0,1,0,3,1887,6,0
부산광역시,부산진구,범천제1동,범천제1동제1투,3655,2327,761,919,386,142,108,0,0,0,1,0,1,2,2,2322,5,1328
부산광역시,부산진구,범천제1동,범천제1동제2투,3583,2198,780,752,393,151,110,2,0,2,0,0,1,0,0,2191,7,1385
부산광역시,부산진구,범천제2동,합계,16909,11989,4123,4115,2421,744,498,12,1,9,3,5,3,3,11,11948,41,4920
부산광역시,부산진구,범천제2동,관내사전투표,2302,2302,1003,647,396,131,104,4,0,4,0,2,1,2,3,2297,5,0
부산광역시,부산진구,범천제2동,범천제2동제1투,3172,2288,853,694,458,157,114,3,0,1,0,0,0,0,2,2282,6,884
부산광역시,부산진구,범천제2동,범천제2동제2투,2715,1534,453,587,325,91,66,1,1,2,1,1,0,0,1,1529,5,1181
부산광역시,부산진구,범천제2동,범천제2동제3투,1840,1087,284,500,207,54,35,0,0,1,0,1,1,0,1,1084,3,753
부산광역시,부산진구,범천제2동,범천제2동제4투,2654,1786,517,695,396,91,73,0,0,1,1,1,0,0,0,1775,11,868
부산광역시,부산진구,범천제2동,범천제2동제5투,2157,1448,391,556,361,91,39,1,0,0,1,0,1,0,1,1442,6,709
부산광역시,부산진구,범천제2동,범천제2동제6투,2069,1544,622,436,278,129,67,3,0,0,0,0,0,1,3,1539,5,525
부산광역시,부산진구,잘못 투입·구분된 투표지,,0,2,0,2,0,0,0,0,0,0,0,0,0,0,0,2,0,-2
부산광역시,동래구,합계,,229464,181098,67947,59616,30208,13211,8812,196,25,82,26,80,32,65,169,180469,629,48366
부산광역시,동래구,거소·선상투표,,579,538,188,121,151,38,23,0,0,0,0,1,1,1,0,524,14,41
부산광역시,동래구,관외사전투표,,19378,19378,8810,4076,3206,1717,1359,23,8,6,4,15,5,7,26,19262,116,0
부산광역시,동래구,재외투표,,1560,1243,767,80,193,65,129,5,0,0,0,0,0,0,1,1240,3,317
부산광역시,동래구,수민동,관내사전투표,3241,3241,1475,787,536,261,164,3,0,2,1,1,1,0,2,3233,8,0
부산광역시,동래구,수민동,합계,23242,18132,6604,6044,3178,1351,828,33,0,12,3,6,3,10,12,18084,48,5110
부산광역시,동래구,수민동,수민동제1투,2867,1932,585,793,350,112,81,1,0,0,0,2,0,3,0,1927,5,935
부산광역시,동래구,수민동,수민동제2투,3406,2689,994,853,519,199,118,2,0,0,1,0,0,0,0,2686,3,717
부산광역시,동래구,수민동,수민동제3투,2728,1900,554,800,346,118,63,7,0,2,0,0,0,0,4,1894,6,828
부산광역시,동래구,수민동,수민동제4투,3210,2237,818,743,367,171,115,6,0,1,0,1,1,6,1,2230,7,973
부산광역시,동래구,수민동,수민동제5투,2219,1714,501,716,292,118,71,5,0,1,1,1,1,1,0,1708,6,505
부산광역시,동래구,수민동,수민동제6투,2761,2207,808,636,401,219,129,3,0,2,0,0,0,0,1,2199,8,554
부산광역시,동래구,수민동,수민동제7투,2810,2212,869,716,367,153,87,6,0,4,0,1,0,0,4,2207,5,598
부산광역시,동래구,복산동,합계,10328,7837,2458,3169,1297,503,344,9,3,5,2,3,2,3,14,7812,25,2491
부산광역시,동래구,복산동,관내사전투표,2505,2505,960,870,384,158,116,3,0,0,0,2,0,0,3,2496,9,0
부산광역시,동래구,복산동,복산동제1투,3100,2214,633,904,400,155,103,2,1,2,1,1,1,1,6,2210,4,886
부산광역시,동래구,복산동,복산동제2투,2602,1762,495,804,286,102,59,3,1,3,1,0,0,0,1,1755,7,840
부산광역시,동래구,복산동,복산동제3투,2121,1356,370,591,227,88,66,1,1,0,0,0,1,2,4,1351,5,765
부산광역시,동래구,명륜동,합계,16651,13441,5515,3998,2231,1046,585,10,0,5,1,2,2,8,9,13412,29,3210
부산광역시,동래구,명륜동,관내사전투표,3213,3213,1517,788,456,256,183,1,0,0,0,0,1,3,2,3207,6,0
부산광역시,동래구,명륜동,명륜동제1투,2286,1567,501,630,244,126,56,2,0,1,0,0,0,2,0,1562,5,719
부산광역시,동래구,명륜동,명륜동제2투,2426,1921,800,517,376,139,81,1,0,0,1,0,1,0,1,1917,4,505
부산광역시,동래구,명륜동,명륜동제3투,2795,2048,713,694,386,168,81,1,0,1,0,0,0,0,1,2045,3,747
부산광역시,동래구,명륜동,명륜동제4투,2384,1670,540,699,265,98,53,2,0,3,0,2,0,1,3,1666,4,714
부산광역시,동래구,명륜동,명륜동제5투,3547,3022,1444,670,504,259,131,3,0,0,0,0,0,2,2,3015,7,525
부산광역시,동래구,온천제1동,합계,16475,11360,3852,4330,1853,751,504,12,2,8,1,3,1,3,8,11328,32,5115
부산광역시,동래구,온천제1동,관내사전투표,2340,2340,988,741,328,149,123,1,1,1,0,0,1,0,2,2335,5,0
부산광역시,동래구,온천제1동,온천제1동제1투,3456,2060,544,964,347,115,80,0,1,0,0,2,0,0,1,2054,6,1396
부산광역시,동래구,온천제1동,온천제1동제2투,3967,2590,779,1063,433,187,106,9,0,4,0,0,0,2,1,2584,6,1377
부산광역시,동래구,온천제1동,온천제1동제3투,3815,2424,843,885,410,150,115,0,0,3,1,0,0,1,3,2411,13,1391
부산광역시,동래구,온천제1동,온천제1동제4투,2897,1946,698,677,335,150,80,2,0,0,0,1,0,0,1,1944,2,951
부산광역시,동래구,온천제2동,합계,13836,10794,3549,4187,1766,755,459,13,2,5,2,6,1,5,10,10760,34,3042
부산광역시,동래구,온천제2동,관내사전투표,3001,3001,1204,973,416,228,155,4,0,1,0,4,1,1,3,2990,11,0
부산광역시,동래구,온천제2동,온천제2동제1투,1557,1098,343,455,178,62,57,1,0,0,0,0,0,0,0,1096,2,459
부산광역시,동래구,온천제2동,온천제2동제2투,2496,1882,615,710,352,134,59,0,2,3,1,0,0,0,0,1876,6,614
부산광역시,동래구,온천제2동,온천제2동제3투,2760,2088,537,964,365,143,66,5,0,1,0,0,0,0,3,2084,4,672
부산광역시,동래구,온천제2동,온천제2동제4투,1574,1057,358,394,154,91,47,0,0,0,0,2,0,4,0,1050,7,517
부산광역시,동래구,온천제2동,온천제2동제5투,730,492,149,192,85,32,30,1,0,0,1,0,0,0,1,491,1,238
부산광역시,동래구,온천제2동,온천제2동제6투,1718,1176,343,499,216,65,45,2,0,0,0,0,0,0,3,1173,3,542
부산광역시,동래구,온천제3동,관내사전투표,3548,3548,1556,1077,480,238,178,1,0,0,0,4,0,1,4,3539,9,0
부산광역시,동래구,온천제3동,합계,27037,20264,7317,7058,3318,1478,936,23,3,9,2,14,1,9,20,20188,76,6773
부산광역시,동래구,온천제3동,온천제3동제1투,3261,2461,954,744,427,209,109,5,0,2,0,0,0,0,4,2454,7,800
부산광역시,동래구,온천제3동,온천제3동제2투,3423,2350,748,911,395,160,118,1,1,3,0,0,0,1,3,2341,9,1073
부산광역시,동래구,온천제3동,온천제3동제3투,3515,2254,698,897,391,150,97,0,0,0,2,3,0,1,1,2240,14,1261
부산광역시,동래구,온천제3동,온천제3동제4투,3343,2319,739,867,391,181,116,6,0,2,0,0,0,0,1,2303,16,1024
부산광역시,동래구,온천제3동,온천제3동제5투,2736,1935,652,736,304,130,93,4,0,2,0,3,0,2,1,1927,8,801
부산광역시,동래구,온천제3동,온천제3동제6투,3165,2335,845,858,363,166,87,2,1,0,0,3,0,2,3,2330,5,830
부산광역시,동래구,온천제3동,온천제3동제7투,4046,3062,1125,968,567,244,138,4,1,0,0,1,1,2,3,3054,8,984
부산광역시,동래구,사직제1동,합계,7994,6229,2246,2213,966,459,295,8,4,2,1,3,0,1,7,6205,24,1765
부산광역시,동래구,사직제1동,관내사전투표,1683,1683,708,488,252,131,98,2,1,1,0,0,0,0,1,1682,1,0
부산광역시,동래구,사직제1동,사직제1동제1투,2765,1988,653,793,309,128,84,4,2,0,0,2,0,1,3,1979,9,777
부산광역시,동래구,사직제1동,사직제1동제2투,3546,2558,885,932,405,200,113,2,1,1,1,1,0,0,3,2544,14,988
부산광역시,동래구,사직제2동,합계,20841,17225,7494,4546,2950,1351,816,6,0,3,2,4,0,2,11,17185,40,3616
부산광역시,동래구,사직제2동,관내사전투표,4136,4136,2083,940,566,308,223,2,0,2,0,2,0,1,2,4129,7,0
부산광역시,동래구,사직제2동,사직제2동제1투,2197,1731,684,510,318,142,74,1,0,0,0,0,0,0,0,1729,2,466
부산광역시,동래구,사직제2동,사직제2동제2투,3377,2513,1114,598,469,203,113,1,0,1,0,0,0,0,6,2505,8,864
부산광역시,동래구,사직제2동,사직제2동제3투,2476,1979,821,542,373,143,93,1,0,0,1,0,0,0,1,1975,4,497
부산광역시,동래구,사직제2동,사직제2동제4투,2661,2143,899,595,358,181,104,0,0,0,0,1,0,0,1,2139,4,518
부산광역시,동래구,사직제2동,사직제2동제5투,3187,2389,869,773,440,187,108,1,0,0,0,0,0,0,0,2378,11,798
부산광역시,동래구,사직제2동,사직제2동제6투,2807,2334,1024,588,426,187,101,0,0,0,1,1,0,1,1,2330,4,473
부산광역시,동래구,사직제3동,합계,12064,9188,3316,3307,1544,580,380,8,0,1,2,6,2,3,10,9159,29,2876
부산광역시,동래구,사직제3동,관내사전투표,1974,1974,857,566,326,116,97,0,0,0,1,0,0,0,2,1965,9,0
부산광역시,동래구,사직제3동,사직제3동제1투,2282,1449,484,573,231,92,54,4,0,0,0,2,0,1,1,1442,7,833
부산광역시,동래구,사직제3동,사직제3동제2투,2456,1919,821,540,334,148,72,0,0,0,0,1,0,0,1,1917,2,537
부산광역시,동래구,사직제3동,사직제3동제3투,2557,1791,524,769,306,104,73,3,0,0,1,2,1,2,2,1787,4,766
부산광역시,동래구,사직제3동,사직제3동제4투,2795,2055,630,859,347,120,84,1,0,1,0,1,1,0,4,2048,7,740
부산광역시,동래구,안락제1동,합계,13234,10067,3397,3852,1657,655,426,11,0,8,2,6,1,3,11,10029,38,3167
부산광역시,동래구,안락제1동,관내사전투표,2391,2391,984,738,370,161,121,5,0,0,0,3,0,0,1,2383,8,0
부산광역시,동래구,안락제1동,안락제1동제1투,2934,2198,647,930,371,155,78,1,0,1,1,0,0,2,2,2188,10,736
부산광역시,동래구,안락제1동,안락제1동제2투,2687,2097,832,654,358,145,99,2,0,0,0,1,1,1,1,2094,3,590
부산광역시,동래구,안락제1동,안락제1동제3투,2628,1628,437,734,271,110,55,2,0,4,0,1,0,0,5,1619,9,1000
부산광역시,동래구,안락제1동,안락제1동제4투,2594,1753,497,796,287,84,73,1,0,3,1,1,0,0,2,1745,8,841
부산광역시,동래구,안락제2동,합계,23599,18603,6957,6066,3229,1337,903,22,1,4,0,4,6,3,8,18540,63,4996
부산광역시,동래구,안락제2동,관내사전투표,3224,3224,1441,888,492,207,181,5,0,0,0,0,1,0,0,3215,9,0
부산광역시,동래구,안락제2동,안락제2동제1투,2159,1499,435,630,259,100,62,0,0,2,0,1,0,0,3,1492,7,660
부산광역시,동래구,안락제2동,안락제2동제2투,3005,2013,637,744,377,138,99,1,1,1,0,1,0,2,0,2001,12,992
부산광역시,동래구,안락제2동,안락제2동제3투,2488,1757,505,785,288,94,76,2,0,0,0,0,1,1,1,1753,4,731
부산광역시,동래구,안락제2동,안락제2동제4투,3216,2384,912,727,445,182,104,2,0,0,0,1,1,0,2,2376,8,832
부산광역시,동래구,안락제2동,안락제2동제5투,3545,2847,998,991,510,211,119,6,0,0,0,1,1,0,1,2838,9,698
부산광역시,동래구,안락제2동,안락제2동제6투,2602,2079,796,606,374,187,105,1,0,1,0,0,1,0,1,2072,7,523
부산광역시,동래구,안락제2동,안락제2동제7투,3360,2800,1233,695,484,218,157,5,0,0,0,0,1,0,0,2793,7,560
부산광역시,동래구,명장제1동,합계,10857,7988,2560,3251,1224,508,380,9,1,9,2,4,0,5,9,7962,26,2869
부산광역시,동래구,명장제1동,관내사전투표,1564,1564,616,536,220,102,78,1,0,3,1,0,0,0,0,1557,7,0
부산광역시,동래구,명장제1동,명장제1동제1투,2879,1844,527,778,302,134,86,3,0,2,1,0,0,2,2,1837,7,1035
부산광역시,동래구,명장제1동,명장제1동제2투,2607,1887,594,815,272,110,83,2,1,1,0,2,0,2,1,1883,4,720
부산광역시,동래구,명장제1동,명장제1동제3투,2805,1968,640,786,315,112,99,3,0,1,0,2,0,0,4,1962,6,837
부산광역시,동래구,명장제1동,명장제1동제4투,1002,725,183,336,115,50,34,0,0,2,0,0,0,1,2,723,2,277
부산광역시,동래구,명장제2동,합계,11789,8811,2917,3318,1445,617,445,4,1,5,2,3,7,2,13,8779,32,2978
부산광역시,동래구,명장제2동,관내사전투표,1939,1939,775,607,305,140,100,1,0,0,0,1,2,0,3,1934,5,0
부산광역시,동래구,명장제2동,명장제2동제1투,3133,2213,732,838,367,161,95,2,0,1,1,0,2,0,1,2200,13,920
부산광역시,동래구,명장제2동,명장제2동제2투,2420,1706,556,640,279,123,97,0,0,1,0,1,0,1,4,1702,4,714
부산광역시,동래구,명장제2동,명장제2동제3투,2466,1697,498,709,265,127,82,1,1,2,0,1,2,1,4,1693,4,769
부산광역시,동래구,명장제2동,명장제2동제4투,1831,1256,356,524,229,66,71,0,0,1,1,0,1,0,1,1250,6,575
부산광역시,동래구,잘못 투입·구분된 투표지,,0,0,0,0,0,0,0,0,0,0,0,0,0,0,0,0,0,0
부산광역시,남구,합계,,233838,181922,68566,59137,30943,13029,8780,226,27,98,32,72,29,92,174,181205,717,51916
부산광역시,남구,거소·선상투표,,704,647,238,136,182,37,28,4,0,0,0,1,1,0,5,632,15,57
부산광역시,남구,관외사전투표,,18368,18355,8085,3972,3152,1689,1246,21,3,4,6,9,4,10,33,18234,121,13
부산광역시,남구,재외투표,,1565,1254,763,97,173,64,150,2,0,0,0,0,0,0,0,1249,5,311
부산광역시,남구,대연제1동,합계,16994,12318,4403,4158,2075,906,666,21,3,10,0,4,0,5,15,12266,52,4676
부산광역시,남구,대연제1동,관내사전투표,2690,2690,1213,647,442,182,182,3,1,5,0,2,0,1,3,2681,9,0
부산광역시,남구,대연제1동,대연제1동제1투,3298,2202,753,730,363,195,143,4,1,0,0,0,0,0,3,2192,10,1096
부산광역시,남구,대연제1동,대연제1동제2투,3534,2468,884,799,428,187,147,4,1,3,0,1,0,0,4,2458,10,1066
부산광역시,남구,대연제1동,대연제1동제3투,3288,2108,693,755,371,176,95,1,0,0,0,1,0,3,3,2098,10,1180
부산광역시,남구,대연제1동,대연제1동제4투,1882,1254,390,532,203,73,42,5,0,1,0,0,0,1,2,1249,5,628
부산광역시,남구,대연제1동,대연제1동제5투,2302,1596,470,695,268,93,57,4,0,1,0,0,0,0,0,1588,8,706
부산광역시,남구,대연제3동,합계,25399,19857,8398,5128,3373,1741,1089,26,1,8,3,7,1,7,13,19795,62,5542
부산광역시,남구,대연제3동,관내사전투표,4747,4747,2424,813,652,485,347,3,0,0,0,1,0,2,2,4729,18,0
부산광역시,남구,대연제3동,대연제3동제1투,2377,1723,615,481,310,188,107,4,1,2,0,1,0,0,1,1710,13,654
부산광역시,남구,대연제3동,대연제3동제2투,3216,2365,897,739,444,181,89,1,0,1,1,2,1,0,3,2359,6,851
부산광역시,남구,대연제3동,대연제3동제3투,2169,1275,511,351,202,108,89,6,0,1,0,0,0,0,2,1270,5,894
부산광역시,남구,대연제3동,대연제3동제4투,2328,1702,621,556,292,133,89,3,0,0,1,0,0,1,1,1697,5,626
부산광역시,남구,대연제3동,대연제3동제5투,2665,1938,648,649,352,170,101,3,0,1,0,3,0,2,0,1929,9,727
부산광역시,남구,대연제3동,대연제3동제6투,2929,2304,889,696,425,181,103,3,0,1,0,0,0,1,3,2302,2,625
부산광역시,남구,대연제3동,대연제3동제7투,2868,2276,1084,528,391,164,103,1,0,2,0,0,0,0,0,2273,3,592
부산광역시,남구,대연제3동,대연제3동제8투,2100,1527,709,315,305,131,61,2,0,0,1,0,0,1,1,1526,1,573
부산광역시,남구,대연제4동,관내사전투표,1652,1652,667,605,213,106,52,0,0,1,1,1,1,1,1,1649,3,0
부산광역시,남구,대연제4동,합계,8913,6635,2298,2623,1053,372,229,4,1,4,2,3,3,8,8,6608,27,2278
부산광역시,남구,대연제4동,대연제4동제1투,2375,1695,562,670,290,98,58,2,1,2,0,1,0,1,4,1689,6,680
부산광역시,남구,대연제4동,대연제4동제2투,1591,978,321,386,177,48,31,1,0,1,1,0,2,3,1,972,6,613
부산광역시,남구,대연제4동,대연제4동제3투,1751,1190,371,515,184,66,44,0,0,0,0,1,0,2,1,1184,6,561
부산광역시,남구,대연제4동,대연제4동제4투,1544,1120,377,447,189,54,44,1,0,0,0,0,0,1,1,1114,6,424
부산광역시,남구,대연제5동,합계,11297,8588,3113,3015,1425,591,380,14,1,5,2,3,1,1,9,8560,28,2709
부산광역시,남구,대연제5동,관내사전투표,2259,2259,859,786,328,143,123,4,0,1,0,3,1,0,2,2250,9,0
부산광역시,남구,대연제5동,대연제5동제1투,3190,2289,764,839,416,164,84,4,1,3,1,0,0,1,4,2281,8,901
부산광역시,남구,대연제5동,대연제5동제2투,3283,2232,750,851,383,153,80,5,0,1,1,0,0,0,2,2226,6,1051
부산광역시,남구,대연제5동,대연제5동제3투,2565,1808,740,539,298,131,93,1,0,0,0,0,0,0,1,1803,5,757
부산광역시,남구,대연제6동,합계,7444,6017,2270,2023,995,402,294,4,0,4,0,0,0,2,5,5999,18,1427
부산광역시,남구,대연제6동,관내사전투표,2629,2629,1169,734,384,184,142,1,0,1,0,0,0,0,4,2619,10,0
부산광역시,남구,대연제6동,대연제6동제1투,2647,1832,566,726,333,113,85,2,0,0,0,0,0,1,0,1826,6,815
부산광역시,남구,대연제6동,대연제6동제2투,2168,1556,535,563,278,105,67,1,0,3,0,0,0,1,1,1554,2,612
부산광역시,남구,용호제1동,합계,29484,22835,8104,7771,4204,1705,917,29,2,4,6,3,1,6,20,22772,63,6649
부산광역시,남구,용호제1동,관내사전투표,3045,3045,1194,1032,470,196,126,6,1,1,4,0,0,2,1,3033,12,0
부산광역시,남구,용호제1동,용호제1동제1투,1976,1217,357,501,218,73,53,4,0,0,0,0,0,0,2,1208,9,759
부산광역시,남구,용호제1동,용호제1동제2투,2020,1149,395,482,152,59,51,4,0,0,0,0,0,0,2,1145,4,871
부산광역시,남구,용호제1동,용호제1동제3투,2198,1435,448,611,227,80,60,0,0,0,0,0,0,1,3,1430,5,763
부산광역시,남구,용호제1동,용호제1동제4투,1670,1092,343,437,186,70,45,3,0,0,1,0,0,1,1,1087,5,578
부산광역시,남구,용호제1동,용호제1동제5투,3346,2623,1117,685,473,190,144,2,1,1,0,1,1,0,3,2618,5,723
부산광역시,남구,용호제1동,용호제1동제6투,3526,2861,1030,884,603,221,109,3,0,0,1,0,0,1,2,2854,7,665
부산광역시,남구,용호제1동,용호제1동제7투,3439,2693,931,922,521,211,101,1,0,0,0,0,0,0,1,2688,5,746
부산광역시,남구,용호제1동,용호제1동제8투,3574,2855,900,1016,582,251,97,3,0,1,0,0,0,1,1,2852,3,719
부산광역시,남구,용호제1동,용호제1동제9투,2475,1986,809,565,353,171,78,3,0,1,0,2,0,0,2,1984,2,489
부산광역시,남구,용호제1동,용호제1동제10투,2215,1879,580,636,419,183,53,0,0,0,0,0,0,0,2,1873,6,336
부산광역시,남구,용호제2동,합계,14324,10813,3749,3848,1958,743,455,11,1,3,0,3,2,5,3,10781,32,3511
부산광역시,남구,용호제2동,관내사전투표,2138,2138,788,772,342,119,101,2,0,1,0,0,0,1,2,2128,10,0
부산광역시,남구,용호제2동,용호제2동제1투,2039,1324,418,508,236,95,57,2,0,1,0,2,0,0,0,1319,5,715
부산광역시,남구,용호제2동,용호제2동제2투,1876,1211,326,545,213,59,63,0,0,1,0,0,1,0,0,1208,3,665
부산광역시,남구,용호제2동,용호제2동제3투,2885,2015,702,719,354,140,87,1,1,0,0,0,0,3,0,2007,8,870
부산광역시,남구,용호제2동,용호제2동제4투,2260,1749,655,548,334,144,62,1,0,0,0,1,1,0,1,1747,2,511
부산광역시,남구,용호제2동,용호제2동제5투,3126,2376,860,756,479,186,85,5,0,0,0,0,0,1,0,2372,4,750
부산광역시,남구,용호제3동,합계,12986,10197,3692,3578,1749,634,459,12,2,8,4,5,1,6,5,10155,42,2789
부산광역시,남구,용호제3동,관내사전투표,3594,3594,1567,1001,589,233,179,3,1,3,2,1,1,3,1,3584,10,0
부산광역시,남구,용호제3동,용호제3동제1투,2446,1734,564,655,305,117,79,1,0,1,0,1,0,1,1,1725,9,712
부산광역시,남구,용호제3동,용호제3동제2투,2151,1427,440,561,269,89,52,4,0,0,1,2,0,1,2,1421,6,724
부산광역시,남구,용호제3동,용호제3동제3투,2329,1643,508,697,266,83,73,2,1,0,1,0,0,1,1,1633,10,686
부산광역시,남구,용호제3동,용호제3동제4투,2466,1799,613,664,320,112,76,2,0,4,0,1,0,0,0,1792,7,667
부산광역시,남구,용호제4동,합계,7993,6164,2403,1976,1031,418,301,7,1,2,0,3,1,2,3,6148,16,1829
부산광역시,남구,용호제4동,관내사전투표,2211,2211,920,640,352,161,119,6,0,2,0,3,0,1,0,2204,7,0
부산광역시,남구,용호제4동,용호제4동제1투,2973,2053,824,616,372,144,89,0,0,0,0,0,0,0,2,2047,6,920
부산광역시,남구,용호제4동,용호제4동제2투,2809,1900,659,720,307,113,93,1,1,0,0,0,1,1,1,1897,3,909
부산광역시,남구,용당동,합계,6634,5102,1940,1740,808,342,236,8,1,2,0,2,2,5,1,5087,15,1532
부산광역시,남구,용당동,관내사전투표,787,787,404,180,109,45,43,2,1,0,0,0,0,1,0,785,2,0
부산광역시,남구,용당동,용당동제1투,1474,954,288,458,123,37,36,1,0,2,0,0,1,1,1,948,6,520
부산광역시,남구,용당동,용당동제2투,1775,1339,490,432,236,111,65,0,0,0,0,0,0,0,0,1334,5,436
부산광역시,남구,용당동,용당동제3투,2598,2022,758,670,340,149,92,5,0,0,0,2,1,3,0,2020,2,576
부산광역시,남구,감만제1동,관내사전투표,2111,2110,890,659,302,143,94,2,1,2,0,1,0,1,2,2097,13,1
부산광역시,남구,감만제1동,합계,12643,9302,3346,3222,1577,632,452,8,3,5,3,3,0,7,10,9268,34,3341
부산광역시,남구,감만제1동,감만제1동제1투,1631,938,290,364,166,54,55,2,1,0,1,0,0,0,2,935,3,693
부산광역시,남구,감만제1동,감만제1동제2투,2271,1552,536,493,310,112,91,1,0,0,0,0,0,1,3,1547,5,719
부산광역시,남구,감만제1동,감만제1동제3투,1776,1136,319,529,177,58,41,2,0,0,0,0,0,3,1,1130,6,640
부산광역시,남구,감만제1동,감만제1동제4투,2119,1443,485,522,268,92,69,0,0,0,2,0,0,0,0,1438,5,676
부산광역시,남구,감만제1동,감만제1동제5투,2735,2123,826,655,354,173,102,1,1,3,0,2,0,2,2,2121,2,612
부산광역시,남구,감만제2동,관내사전투표,1469,1469,633,446,208,101,70,2,0,0,0,1,1,0,1,1463,6,0
부산광역시,남구,감만제2동,합계,6491,4891,1731,1733,865,306,216,4,0,3,0,3,1,3,4,4869,22,1600
부산광역시,남구,감만제2동,감만제2동제1투,2471,1648,503,659,305,90,72,2,0,2,0,2,0,3,1,1639,9,823
부산광역시,남구,감만제2동,감만제2동제2투,2551,1774,595,628,352,115,74,0,0,1,0,0,0,0,2,1767,7,777
부산광역시,남구,문현제1동,관내사전투표,2104,2104,918,633,291,152,93,1,0,2,0,1,0,1,2,2094,10,0
부산광역시,남구,문현제1동,합계,12390,9066,3336,3149,1475,605,405,16,1,18,0,8,4,3,9,9029,37,3324
부산광역시,남구,문현제1동,문현제1동제1투,3172,2131,750,783,331,147,99,3,0,3,0,0,0,0,4,2120,11,1041
부산광역시,남구,문현제1동,문현제1동제2투,2447,1739,612,607,302,129,69,0,0,6,0,3,3,1,1,1733,6,708
부산광역시,남구,문현제1동,문현제1동제3투,2832,1951,694,656,354,126,97,8,1,5,0,2,0,1,2,1946,5,881
부산광역시,남구,문현제1동,문현제1동제4투,1835,1141,362,470,197,51,47,4,0,2,0,2,1,0,0,1136,5,694
부산광역시,남구,문현제2동,합계,7033,4818,1641,1949,744,251,189,4,2,1,0,1,1,4,6,4793,25,2215
부산광역시,남구,문현제2동,관내사전투표,1174,1174,467,435,160,58,40,0,1,0,0,0,0,0,5,1166,8,0
부산광역시,남구,문현제2동,문현제2동제1투,2067,1219,386,525,186,55,53,1,0,1,0,1,0,3,0,1211,8,848
부산광역시,남구,문현제2동,문현제2동제2투,1428,836,263,357,129,47,33,1,0,0,0,0,1,0,1,832,4,592
부산광역시,남구,문현제2동,문현제2동제3투,2364,1589,525,632,269,91,63,2,1,0,0,0,0,1,0,1584,5,775
부산광역시,남구,문현제3동,합계,10132,7839,2838,2685,1333,562,351,10,1,3,3,1,2,11,4,7804,35,2293
부산광역시,남구,문현제3동,관내사전투표,1722,1722,745,491,273,103,99,2,0,0,0,0,0,2,1,1716,6,0
부산광역시,남구,문현제3동,문현제3동제1투,2324,1594,486,658,260,94,75,3,1,0,0,1,2,5,1,1586,8,730
부산광역시,남구,문현제3동,문현제3동제2투,2521,1694,514,690,281,123,67,1,0,2,1,0,0,1,1,1681,13,827
부산광역시,남구,문현제3동,문현제3동제3투,3565,2829,1093,846,519,242,110,4,0,1,2,0,0,3,1,2821,8,736
부산광역시,남구,문현제4동,합계,8922,6679,2462,2442,1042,381,308,6,0,7,1,4,0,0,6,6659,20,2243
부산광역시,남구,문현제4동,관내사전투표,1749,1749,789,512,245,113,82,0,0,2,0,2,0,0,1,1746,3,0
부산광역시,남구,문현제4동,문현제4동제1투,2477,1773,577,772,252,82,75,2,0,2,0,0,0,0,2,1764,9,704
부산광역시,남구,문현제4동,문현제4동제2투,2853,1981,692,693,350,128,103,3,0,1,0,1,0,0,3,1974,7,872
부산광역시,남구,문현제4동,문현제4동제3투,1843,1176,404,465,195,58,48,1,0,2,1,1,0,0,0,1175,1,667
부산광역시,남구,우암동,합계,14122,10544,3756,3892,1729,648,409,15,4,7,2,8,4,7,15,10496,48,3578
부산광역시,남구,우암동,관내사전투표,1162,1162,515,350,145,79,64,1,1,1,0,0,0,1,0,1157,5,0
부산광역시,남구,우암동,우암동제1투,2156,1581,600,526,285,108,50,2,0,0,0,0,1,2,2,1576,5,575
부산광역시,남구,우암동,우암동제2투,2773,2238,860,765,367,146,80,4,0,0,1,0,1,0,3,2227,11,535
부산광역시,남구,우암동,우암동제3투,1680,972,291,448,140,46,34,1,0,1,0,1,0,0,3,965,7,708
부산광역시,남구,우암동,우암동제4투,2908,2245,786,771,411,153,102,6,0,1,1,5,0,1,1,2238,7,663
부산광역시,남구,우암동,우암동제5투,1819,1242,371,533,199,70,48,1,2,2,0,2,1,2,3,1234,8,577
부산광역시,남구,우암동,우암동제6투,1624,1104,333,499,182,46,31,0,1,2,0,0,1,1,3,1099,5,520
부산광역시,남구,잘못 투입·구분된 투표지,,0,1,0,0,0,0,0,0,0,0,0,1,0,0,0,1,0,-1
부산광역시,북구,합계,,258693,203689,83611,61175,32712,14567,9862,213,24,124,48,93,39,95,233,202796,893,55004
부산광역시,북구,거소·선상투표,,711,650,242,122,175,44,24,6,1,2,1,1,0,3,2,623,27,61
부산광역시,북구,관외사전투표,,20156,20146,9622,3975,3215,1798,1272,13,3,7,8,14,7,7,36,19977,169,10
부산광역시,북구,재외투표,,1251,941,573,71,139,46,105,2,0,1,0,0,0,0,0,937,4,310
부산광역시,북구,구포제1동,합계,13239,9349,3417,3388,1450,572,418,7,1,6,1,9,3,4,20,9296,53,3890
부산광역시,북구,구포제1동,관내사전투표,2612,2612,1102,838,382,144,116,2,1,2,0,1,1,1,3,2593,19,0
부산광역시,북구,구포제1동,구포제1동제1투,3549,2395,851,883,375,175,100,0,0,1,1,1,2,0,2,2391,4,1154
부산광역시,북구,구포제1동,구포제1동제2투,2155,1202,398,492,199,51,55,0,0,1,0,0,0,1,2,1199,3,953
부산광역시,북구,구포제1동,구포제1동제3투,2383,1507,491,651,201,83,55,1,0,1,0,4,0,1,3,1491,16,876
부산광역시,북구,구포제1동,구포제1동제4투,2540,1633,575,524,293,119,92,4,0,1,0,3,0,1,10,1622,11,907
부산광역시,북구,구포제2동,합계,21729,15711,6161,5202,2442,1022,731,11,4,11,3,3,4,10,23,15627,84,6018
부산광역시,북구,구포제2동,관내사전투표,2417,2417,1123,689,336,133,111,2,0,1,0,2,0,1,1,2399,18,0
부산광역시,북구,구포제2동,구포제2동제1투,2718,1805,604,682,293,117,88,0,1,2,1,0,0,2,5,1795,10,913
부산광역시,북구,구포제2동,구포제2동제2투,2951,1582,564,601,253,92,54,0,1,1,0,1,1,2,2,1572,10,1369
부산광역시,북구,구포제2동,구포제2동제3투,3290,2321,910,751,368,171,100,2,2,1,0,0,1,1,2,2309,12,969
부산광역시,북구,구포제2동,구포제2동제4투,3094,2097,757,756,331,131,94,4,0,1,0,0,1,2,4,2081,16,997
부산광역시,북구,구포제2동,구포제2동제5투,3436,2742,1071,910,441,172,131,1,0,1,1,0,1,1,5,2735,7,694
부산광역시,북구,구포제2동,구포제2동제6투,1458,882,294,350,141,45,38,1,0,2,1,0,0,1,3,876,6,576
부산광역시,북구,구포제2동,구포제2동제7투,2365,1865,838,463,279,161,115,1,0,2,0,0,0,0,1,1860,5,500
부산광역시,북구,구포제3동,합계,18432,12680,4884,4177,2032,803,681,15,2,7,4,5,0,6,17,12633,47,5752
부산광역시,북구,구포제3동,관내사전투표,3049,3049,1384,889,390,185,182,1,1,3,0,1,0,3,1,3040,9,0
부산광역시,북구,구포제3동,구포제3동제1투,2517,1551,538,582,254,92,73,0,0,2,1,0,0,1,2,1545,6,966
부산광역시,북구,구포제3동,구포제3동제2투,2367,1414,490,489,267,92,67,0,0,0,1,0,0,1,2,1409,5,953
부산광역시,북구,구포제3동,구포제3동제3투,2719,1640,584,558,295,117,74,1,1,1,1,2,0,0,1,1635,5,1079
부산광역시,북구,구포제3동,구포제3동제4투,2640,1831,698,574,313,116,114,6,0,0,0,2,0,0,2,1825,6,809
부산광역시,북구,구포제3동,구포제3동제5투,2300,1428,543,493,223,91,65,3,0,1,1,0,0,0,3,1423,5,872
부산광역시,북구,구포제3동,구포제3동제6투,2840,1767,647,592,290,110,106,4,0,0,0,0,0,1,6,1756,11,1073
부산광역시,북구,덕천제1동,관내사전투표,1944,1944,807,628,277,112,98,3,0,2,2,0,1,2,2,1934,10,0
부산광역시,북구,덕천제1동,합계,12997,9466,3362,3447,1535,563,457,8,1,5,4,7,1,8,14,9412,54,3531
부산광역시,북구,덕천제1동,덕천제1동제1투,3208,2428,832,886,425,153,108,1,0,1,1,2,0,1,5,2415,13,780
부산광역시,북구,덕천제1동,덕천제1동제2투,2669,1692,563,657,273,102,87,0,0,0,0,0,0,0,1,1683,9,977
부산광역시,북구,덕천제1동,덕천제1동제3투,2100,1362,484,474,232,78,74,0,0,0,0,2,0,1,4,1349,13,738
부산광역시,북구,덕천제1동,덕천제1동제4투,3076,2040,676,802,328,118,90,4,1,2,1,3,0,4,2,2031,9,1036
부산광역시,북구,덕천제2동,관내사전투표,2148,2148,995,539,274,159,161,1,0,2,1,3,0,0,1,2136,12,0
부산광역시,북구,덕천제2동,합계,11240,8080,3095,2755,1205,530,436,6,1,6,2,5,3,4,6,8054,26,3160
부산광역시,북구,덕천제2동,덕천제2동제1투,2175,1360,436,565,208,81,60,2,1,2,0,0,2,0,1,1358,2,815
부산광역시,북구,덕천제2동,덕천제2동제2투,2207,1376,499,517,217,74,63,1,0,1,0,2,0,0,1,1375,1,831
부산광역시,북구,덕천제2동,덕천제2동제3투,2505,1732,695,553,266,114,91,0,0,1,1,0,1,4,0,1726,6,773
부산광역시,북구,덕천제2동,덕천제2동제4투,2205,1464,470,581,240,102,61,2,0,0,0,0,0,0,3,1459,5,741
부산광역시,북구,덕천제3동,합계,10097,7134,2532,2497,1235,446,344,8,0,11,1,4,1,5,12,7096,38,2963
부산광역시,북구,덕천제3동,관내사전투표,1740,1740,769,500,248,115,90,2,0,2,1,1,0,1,1,1730,10,0
부산광역시,북구,덕천제3동,덕천제3동제1투,1564,1133,473,314,214,74,52,0,0,1,0,0,0,0,1,1129,4,431
부산광역시,북구,덕천제3동,덕천제3동제2투,2523,1640,517,635,289,102,80,3,0,1,0,2,0,0,5,1634,6,883
부산광역시,북구,덕천제3동,덕천제3동제3투,2229,1450,459,560,236,91,87,2,0,2,0,1,1,1,2,1442,8,779
부산광역시,북구,덕천제3동,덕천제3동제4투,2041,1171,314,488,248,64,35,1,0,5,0,0,0,3,3,1161,10,870
부산광역시,북구,만덕제1동,합계,7993,6211,2327,2259,935,411,227,5,0,3,0,3,4,4,6,6184,27,1782
부산광역시,북구,만덕제1동,관내사전투표,1622,1622,710,540,220,86,53,1,0,2,0,2,1,0,0,1615,7,0
부산광역시,북구,만덕제1동,만덕제1동제1투,1886,1281,467,478,192,84,49,1,0,0,0,0,1,1,1,1274,7,605
부산광역시,북구,만덕제1동,만덕제1동제2투,2316,1701,581,660,273,116,59,0,0,0,0,0,1,1,0,1691,10,615
부산광역시,북구,만덕제1동,만덕제1동제3투,2169,1607,569,581,250,125,66,3,0,1,0,1,1,2,5,1604,3,562
부산광역시,북구,만덕제2동,합계,22838,17742,7314,5382,2831,1242,857,21,3,11,0,3,1,3,14,17682,60,5096
부산광역시,북구,만덕제2동,관내사전투표,4438,4437,2082,1217,593,297,217,3,2,4,0,1,0,1,2,4419,18,1
부산광역시,북구,만덕제2동,만덕제2동제1투,1933,1323,424,522,236,78,53,0,0,0,0,1,0,2,2,1318,5,610
부산광역시,북구,만덕제2동,만덕제2동제2투,1832,1169,396,455,193,67,52,3,1,0,0,0,0,0,0,1167,2,663
부산광역시,북구,만덕제2동,만덕제2동제3투,2573,1738,613,691,240,105,76,0,0,1,0,0,0,0,3,1729,9,835
부산광역시,북구,만덕제2동,만덕제2동제4투,2063,1437,479,543,229,109,70,1,0,1,0,0,0,0,1,1433,4,626
부산광역시,북구,만덕제2동,만덕제2동제5투,1580,1268,606,281,213,87,69,6,0,0,0,0,0,0,0,1262,6,312
부산광역시,북구,만덕제2동,만덕제2동제6투,2666,1917,801,487,358,169,91,1,0,1,0,0,0,0,3,1911,6,749
부산광역시,북구,만덕제2동,만덕제2동제7투,3308,2588,1234,545,464,197,138,2,0,1,0,1,0,0,2,2584,4,720
부산광역시,북구,만덕제2동,만덕제2동제8투,2445,1865,679,641,305,133,91,5,0,3,0,0,1,0,1,1859,6,580
부산광역시,북구,만덕제3동,합계,16189,12876,5070,4169,2083,934,555,12,0,4,1,2,1,1,6,12838,38,3313
부산광역시,북구,만덕제3동,관내사전투표,3100,3100,1442,846,428,233,138,2,0,0,0,1,0,0,1,3091,9,0
부산광역시,북구,만덕제3동,만덕제3동제1투,2323,1703,637,585,292,125,57,2,0,0,0,0,0,0,2,1700,3,620
부산광역시,북구,만덕제3동,만덕제3동제2투,2777,2139,819,764,329,127,91,2,0,2,0,0,1,0,1,2136,3,638
부산광역시,북구,만덕제3동,만덕제3동제3투,2054,1360,527,433,211,104,77,2,0,0,0,1,0,0,0,1355,5,694
부산광역시,북구,만덕제3동,만덕제3동제4투,3066,2424,941,716,438,188,122,3,0,1,1,0,0,1,2,2413,11,642
부산광역시,북구,만덕제3동,만덕제3동제5투,2869,2150,704,825,385,157,70,1,0,1,0,0,0,0,0,2143,7,719
부산광역시,북구,금곡동,관내사전투표,3865,3865,1862,959,576,280,163,9,0,3,0,1,1,2,4,3860,5,0
부산광역시,북구,금곡동,합계,32894,25662,10220,8110,4227,1757,1084,35,4,23,8,11,9,18,42,25548,114,7232
부산광역시,북구,금곡동,금곡동제1투,2395,1805,553,778,279,106,65,4,0,0,1,0,2,3,4,1795,10,590
부산광역시,북구,금곡동,금곡동제2투,2241,1632,593,561,290,116,54,3,0,2,1,3,1,0,4,1628,4,609
부산광역시,북구,금곡동,금곡동제3투,2062,1506,532,580,239,85,52,2,0,4,1,0,1,1,0,1497,9,556
부산광역시,북구,금곡동,금곡동제4투,2150,1715,664,547,273,130,88,2,0,2,1,0,0,0,4,1711,4,435
부산광역시,북구,금곡동,금곡동제5투,1650,1137,267,553,212,46,23,4,2,2,2,2,2,1,8,1124,13,513
부산광역시,북구,금곡동,금곡동제6투,1803,1280,456,414,250,79,65,3,0,1,0,0,0,2,3,1273,7,523
부산광역시,북구,금곡동,금곡동제7투,2404,1703,684,524,280,123,85,0,1,0,0,0,0,3,0,1700,3,701
부산광역시,북구,금곡동,금곡동제8투,2353,1618,444,694,317,79,45,2,1,4,1,2,0,2,4,1595,23,735
부산광역시,북구,금곡동,금곡동제9투,3008,2346,997,661,382,185,103,1,0,0,0,1,1,0,5,2336,10,662
부산광역시,북구,금곡동,금곡동제10투,2124,1491,641,380,271,118,65,2,0,3,1,0,0,0,2,1483,8,633
부산광역시,북구,금곡동,금곡동제11투,3475,2825,1280,730,439,215,140,0,0,1,0,2,0,3,3,2813,12,650
부산광역시,북구,금곡동,금곡동제12투,3364,2739,1247,729,419,195,136,3,0,1,0,0,1,1,1,2733,6,625
부산광역시,북구,화명제1동,합계,31764,26361,11547,7135,4287,2065,1193,25,2,8,5,6,3,10,15,26301,60,5403
부산광역시,북구,화명제1동,관내사전투표,3789,3787,1973,814,449,327,203,6,0,1,1,1,0,1,2,3778,9,2
부산광역시,북구,화명제1동,화명제1동제1투,3100,2451,1118,631,385,185,119,2,0,1,1,0,0,2,3,2447,4,649
부산광역시,북구,화명제1동,화명제1동제2투,3662,2966,1314,798,471,226,141,0,0,5,1,0,0,0,2,2958,8,696
부산광역시,북구,화명제1동,화명제1동제3투,2312,1772,773,494,256,128,106,2,0,0,0,1,1,2,0,1763,9,540
부산광역시,북구,화명제1동,화명제1동제4투,2117,1683,735,432,317,129,67,0,0,0,0,1,0,0,2,1683,0,434
부산광역시,북구,화명제1동,화명제1동제5투,3768,3144,1340,854,515,275,144,3,2,1,0,1,1,2,0,3138,6,624
부산광역시,북구,화명제1동,화명제1동제6투,3311,2738,1049,873,504,201,95,4,0,0,2,0,0,1,2,2731,7,573
부산광역시,북구,화명제1동,화명제1동제7투,3214,2679,1130,753,486,208,95,1,0,0,0,0,1,1,1,2676,3,535
부산광역시,북구,화명제1동,화명제1동제8투,3262,2565,1018,824,427,190,95,2,0,0,0,0,0,1,1,2558,7,697
부산광역시,북구,화명제1동,화명제1동제9투,1983,1577,680,397,301,115,74,2,0,0,0,2,0,0,1,1572,5,406
부산광역시,북구,화명제1동,화명제1동제10투,1246,999,417,265,176,81,54,3,0,0,0,0,0,0,1,997,2,247
부산광역시,북구,화명제2동,합계,14003,10927,4421,3346,1652,822,579,20,1,12,5,11,0,7,10,10886,41,3076
부산광역시,북구,화명제2동,관내사전투표,2827,2827,1370,697,372,214,152,3,1,2,2,1,0,2,2,2818,9,0
부산광역시,북구,화명제2동,화명제2동제1투,2046,1430,456,590,215,91,55,4,0,4,3,1,0,2,1,1422,8,616
부산광역시,북구,화명제2동,화명제2동제2투,2342,1638,596,536,287,129,81,0,0,1,0,0,0,2,2,1634,4,704
부산광역시,북구,화명제2동,화명제2동제3투,2469,1808,707,539,291,141,110,6,0,3,0,4,0,0,2,1803,5,661
부산광역시,북구,화명제2동,화명제2동제4투,2147,1444,549,475,218,99,90,3,0,1,0,4,0,0,0,1439,5,703
부산광역시,북구,화명제2동,화명제2동제5투,2172,1780,743,509,269,148,91,4,0,1,0,1,0,1,3,1770,10,392
부산광역시,북구,화명제3동,관내사전투표,4251,4251,2326,763,605,336,205,2,0,1,1,3,0,0,1,4243,8,0
부산광역시,북구,화명제3동,합계,23160,19751,8824,5139,3268,1512,899,19,1,7,5,9,2,5,10,19700,51,3409
부산광역시,북구,화명제3동,화명제3동제1투,3634,3026,1251,826,570,224,133,4,0,1,1,1,0,1,1,3013,13,608
부산광역시,북구,화명제3동,화명제3동제2투,1932,1597,685,455,254,111,79,4,0,1,0,0,1,0,1,1591,6,335
부산광역시,북구,화명제3동,화명제3동제3투,2836,2203,943,605,375,163,110,2,0,0,0,0,1,0,1,2200,3,633
부산광역시,북구,화명제3동,화명제3동제4투,2425,1964,857,547,333,134,83,0,1,1,0,3,0,0,1,1960,4,461
부산광역시,북구,화명제3동,화명제3동제5투,1352,1123,464,323,188,103,39,0,0,0,0,0,0,1,0,1118,5,229
부산광역시,북구,화명제3동,화명제3동제6투,3367,2754,1168,811,424,196,140,3,0,1,2,1,0,0,2,2748,6,613
부산광역시,북구,화명제3동,화명제3동제7투,3363,2833,1130,809,519,245,110,4,0,2,1,1,0,3,3,2827,6,530
부산광역시,북구,잘못 투입·구분된 투표지,,0,2,0,1,1,0,0,0,0,0,0,0,0,0,0,2,0,-2
부산광역시,해운대구,합계,,344624,266870,102106,80904,48325,20918,12573,428,31,124,53,99,51,115,225,265952,918,77754
부산광역시,해운대구,거소·선상투표,,862,813,276,180,228,53,28,1,2,5,4,1,0,2,7,787,26,49
부산광역시,해운대구,관외사전투표,,26418,26418,11570,5575,4665,2578,1720,28,8,7,8,18,5,17,54,26253,165,0
부산광역시,해운대구,재외투표,,2674,2081,1203,187,360,95,223,7,0,0,0,0,0,1,0,2076,5,593
부산광역시,해운대구,우제1동,합계,17252,12238,4178,4390,2207,839,530,20,1,10,1,3,4,9,13,12205,33,5014
부산광역시,해운대구,우제1동,관내사전투표,2594,2594,1022,833,422,174,125,7,0,2,0,0,1,1,2,2589,5,0
부산광역시,해운대구,우제1동,우제1동제1투,2332,1386,412,548,264,99,53,0,0,1,0,0,0,1,3,1381,5,946
부산광역시,해운대구,우제1동,우제1동제2투,3382,2486,892,820,465,166,123,2,0,3,0,0,0,3,3,2477,9,896
부산광역시,해운대구,우제1동,우제1동제3투,2395,1554,414,644,303,95,73,10,0,3,0,2,1,0,2,1547,7,841
부산광역시,해운대구,우제1동,우제1동제4투,3769,2106,677,763,415,160,79,0,1,1,1,0,2,2,2,2103,3,1663
부산광역시,해운대구,우제1동,우제1동제5투,2780,2112,761,782,338,145,77,1,0,0,0,1,0,2,1,2108,4,668
부산광역시,해운대구,우제2동,합계,21711,17274,6277,5498,3255,1439,696,36,0,5,3,5,1,10,7,17232,42,4437
부산광역시,해운대구,우제2동,관내사전투표,4474,4474,1864,1272,749,359,197,12,0,2,1,1,0,2,4,4463,11,0
부산광역시,해운대구,우제2동,우제2동제1투,3409,2754,927,924,542,253,94,0,0,1,1,0,0,3,0,2745,9,655
부산광역시,해운대구,우제2동,우제2동제2투,2534,1811,702,554,321,146,75,3,0,1,1,1,0,2,0,1806,5,723
부산광역시,해운대구,우제2동,우제2동제3투,2590,1733,592,624,300,132,75,3,0,0,0,0,0,0,2,1728,5,857
부산광역시,해운대구,우제2동,우제2동제4투,3257,2465,862,788,474,206,121,6,0,0,0,2,1,1,0,2461,4,792
부산광역시,해운대구,우제2동,우제2동제5투,3088,2383,821,715,533,201,95,10,0,1,0,0,0,1,0,2377,6,705
부산광역시,해운대구,우제2동,우제2동제6투,2359,1654,509,621,336,142,39,2,0,0,0,1,0,1,1,1652,2,705
부산광역시,해운대구,중제1동,합계,17547,12885,4887,4134,2230,983,573,23,0,5,1,1,2,1,6,12846,39,4662
부산광역시,해운대구,중제1동,관내사전투표,3553,3553,1533,1003,539,286,169,9,0,1,1,0,0,0,0,3541,12,0
부산광역시,해운대구,중제1동,중제1동제1투,3607,2225,685,903,388,160,78,5,0,1,0,0,0,0,1,2221,4,1382
부산광역시,해운대구,중제1동,중제1동제2투,2868,2018,739,691,337,155,83,2,0,0,0,0,1,1,1,2010,8,850
부산광역시,해운대구,중제1동,중제1동제3투,3898,2704,1029,856,478,204,116,4,0,2,0,1,1,0,4,2695,9,1194
부산광역시,해운대구,중제1동,중제1동제4투,3621,2385,901,681,488,178,127,3,0,1,0,0,0,0,0,2379,6,1236
부산광역시,해운대구,중제2동,합계,12498,9022,3373,2815,1683,715,374,22,1,4,3,2,1,0,5,8998,24,3476
부산광역시,해운대구,중제2동,관내사전투표,2828,2828,1309,688,455,230,126,10,0,0,2,0,0,0,2,2822,6,0
부산광역시,해운대구,중제2동,중제2동제1투,1343,713,203,295,123,60,25,1,0,1,0,0,1,0,0,709,4,630
부산광역시,해운대구,중제2동,중제2동제2투,2845,1746,591,619,320,128,82,3,0,0,0,0,0,0,1,1744,2,1099
부산광역시,해운대구,중제2동,중제2동제3투,2524,1663,505,641,330,114,60,3,1,1,0,2,0,0,1,1658,5,861
부산광역시,해운대구,중제2동,중제2동제4투,2958,2072,765,572,455,183,81,5,0,2,1,0,0,0,1,2065,7,886
부산광역시,해운대구,좌제1동,합계,14614,11593,4732,3011,2066,1093,613,22,0,8,0,1,3,7,7,11563,30,3021
부산광역시,해운대구,좌제1동,관내사전투표,3366,3366,1590,696,515,325,221,5,0,1,0,0,1,1,2,3357,9,0
부산광역시,해운대구,좌제1동,좌제1동제1투,2652,1592,634,362,303,179,100,7,0,0,0,0,1,1,2,1589,3,1060
부산광역시,해운대구,좌제1동,좌제1동제2투,2545,1895,621,653,350,169,87,5,0,4,0,0,0,1,1,1891,4,650
부산광역시,해운대구,좌제1동,좌제1동제3투,2722,2100,884,530,393,190,88,1,0,3,0,1,0,0,1,2091,9,622
부산광역시,해운대구,좌제1동,좌제1동제4투,3329,2640,1003,770,505,230,117,4,0,0,0,0,1,4,1,2635,5,689
부산광역시,해운대구,좌제2동,합계,24961,19538,7955,5233,3664,1661,923,17,2,7,0,3,3,11,4,19483,55,5423
부산광역시,해운대구,좌제2동,관내사전투표,5174,5174,2515,1087,863,453,235,2,0,1,0,1,0,2,1,5160,14,0
부산광역시,해운대구,좌제2동,좌제2동제1투,3063,2019,799,568,383,151,110,1,0,0,0,0,0,1,0,2013,6,1044
부산광역시,해운대구,좌제2동,좌제2동제2투,3185,2110,820,609,380,194,99,3,0,1,0,0,1,0,1,2108,2,1075
부산광역시,해운대구,좌제2동,좌제2동제3투,2914,2151,816,628,407,181,109,1,0,1,0,0,0,1,1,2145,6,763
부산광역시,해운대구,좌제2동,좌제2동제4투,2576,1917,712,549,400,148,97,3,1,2,0,0,0,0,0,1912,5,659
부산광역시,해운대구,좌제2동,좌제2동제5투,2989,2289,868,664,455,189,97,3,1,0,0,1,1,3,1,2283,6,700
부산광역시,해운대구,좌제2동,좌제2동제6투,2540,1950,732,566,378,169,92,3,0,1,0,0,0,4,0,1945,5,590
부산광역시,해운대구,좌제2동,좌제2동제7투,2520,1928,693,562,398,176,84,1,0,1,0,1,1,0,0,1917,11,592
부산광역시,해운대구,좌제3동,합계,13222,10752,4067,3175,2093,896,429,30,1,5,2,3,0,0,6,10707,45,2470
부산광역시,해운대구,좌제3동,관내사전투표,3473,3473,1526,861,616,284,154,13,0,1,1,3,0,0,0,3459,14,0
부산광역시,해운대구,좌제3동,좌제3동제1투,2685,1952,653,577,432,169,99,6,0,3,0,0,0,0,3,1942,10,733
부산광역시,해운대구,좌제3동,좌제3동제2투,2124,1555,495,556,305,129,58,5,0,0,0,0,0,0,1,1549,6,569
부산광역시,해운대구,좌제3동,좌제3동제3투,2380,1784,664,554,326,157,66,3,1,1,0,0,0,0,1,1773,11,596
부산광역시,해운대구,좌제3동,좌제3동제4투,2560,1988,729,627,414,157,52,3,0,0,1,0,0,0,1,1984,4,572
부산광역시,해운대구,좌제4동,관내사전투표,4501,4501,2222,904,705,401,246,6,0,0,0,1,0,3,2,4490,11,0
부산광역시,해운대구,좌제4동,합계,18590,15482,6569,3938,2808,1341,745,20,1,5,1,2,0,6,10,15446,36,3108
부산광역시,해운대구,좌제4동,좌제4동제1투,2307,1702,713,417,341,144,77,3,0,1,0,0,0,1,1,1698,4,605
부산광역시,해운대구,좌제4동,좌제4동제2투,1332,1018,412,269,185,90,59,0,0,1,0,0,0,0,0,1016,2,314
부산광역시,해운대구,좌제4동,좌제4동제3투,2407,1856,759,434,372,187,93,2,1,0,0,0,0,0,3,1851,5,551
부산광역시,해운대구,좌제4동,좌제4동제4투,2899,2241,851,659,441,188,88,2,0,0,0,0,0,0,2,2231,10,658
부산광역시,해운대구,좌제4동,좌제4동제5투,2663,2152,827,675,396,149,91,6,0,3,1,0,0,1,1,2150,2,511
부산광역시,해운대구,좌제4동,좌제4동제6투,2481,2012,785,580,368,182,91,1,0,0,0,1,0,1,1,2010,2,469
부산광역시,해운대구,송정동,관내사전투표,1533,1533,604,493,245,93,82,2,0,2,0,1,0,0,5,1527,6,0
부산광역시,해운대구,송정동,합계,8448,5935,2038,2070,1110,394,267,16,0,5,1,5,2,2,7,5917,18,2513
부산광역시,해운대구,송정동,송정동제1투,2479,1425,422,544,293,90,63,1,0,0,1,2,0,2,0,1418,7,1054
부산광역시,해운대구,송정동,송정동제2투,2676,1790,585,629,366,122,73,6,0,1,0,1,1,0,2,1786,4,886
부산광역시,해운대구,송정동,송정동제3투,1760,1187,427,404,206,89,49,7,0,2,0,1,1,0,0,1186,1,573
부산광역시,해운대구,반여제1동,합계,27796,22106,9008,6390,3825,1658,1095,18,2,3,4,6,7,7,19,22042,64,5690
부산광역시,해운대구,반여제1동,관내사전투표,4314,4314,2165,917,658,316,234,2,0,2,1,1,1,1,4,4302,12,0
부산광역시,해운대구,반여제1동,반여제1동제1투,2262,1475,445,621,242,84,73,2,0,0,0,1,0,1,3,1472,3,787
부산광역시,해운대구,반여제1동,반여제1동제2투,2462,1698,538,642,314,90,97,2,1,0,1,0,2,0,2,1689,9,764
부산광역시,해운대구,반여제1동,반여제1동제3투,3223,2261,860,718,390,166,117,0,1,0,1,0,0,0,2,2255,6,962
부산광역시,해운대구,반여제1동,반여제1동제4투,3193,2259,745,816,398,170,108,4,0,1,0,2,0,3,5,2252,7,934
부산광역시,해운대구,반여제1동,반여제1동제5투,2548,2079,793,640,373,144,113,0,0,0,0,1,2,1,0,2067,12,469
부산광역시,해운대구,반여제1동,반여제1동제6투,2178,1771,753,472,312,137,91,1,0,0,1,1,0,1,0,1769,2,407
부산광역시,해운대구,반여제1동,반여제1동제7투,2174,1776,776,431,325,151,89,1,0,0,0,0,0,0,2,1775,1,398
부산광역시,해운대구,반여제1동,반여제1동제8투,2521,2062,858,588,341,178,86,2,0,0,0,0,1,0,1,2055,7,459
부산광역시,해운대구,반여제1동,반여제1동제9투,2921,2411,1075,545,472,222,87,4,0,0,0,0,1,0,0,2406,5,510
부산광역시,해운대구,반여제2동,합계,11932,7904,2707,2838,1420,501,360,14,3,0,3,6,3,8,6,7869,35,4028
부산광역시,해운대구,반여제2동,관내사전투표,1973,1973,789,609,346,118,92,1,2,0,1,3,0,3,0,1964,9,0
부산광역시,해운대구,반여제2동,반여제2동제1투,2091,1283,400,522,216,80,51,3,1,0,0,0,0,2,2,1277,6,808
부산광역시,해운대구,반여제2동,반여제2동제2투,2187,1333,467,440,252,99,69,1,0,0,0,0,1,1,1,1331,2,854
부산광역시,해운대구,반여제2동,반여제2동제3투,2056,1097,339,427,195,77,43,2,0,0,2,0,2,1,2,1090,7,959
부산광역시,해운대구,반여제2동,반여제2동제4투,2132,1352,440,519,235,77,68,4,0,0,0,2,0,1,0,1346,6,780
부산광역시,해운대구,반여제2동,반여제2동제5투,1493,866,272,321,176,50,37,3,0,0,0,1,0,0,1,861,5,627
부산광역시,해운대구,반여제3동,합계,8768,5914,2021,2209,1009,335,273,13,0,7,4,1,3,7,7,5889,25,2854
부산광역시,해운대구,반여제3동,관내사전투표,1481,1481,594,504,243,65,61,3,0,1,1,0,3,2,1,1478,3,0
부산광역시,해운대구,반여제3동,반여제3동제1투,2568,1574,498,635,278,85,61,4,0,2,1,0,0,0,1,1565,9,994
부산광역시,해운대구,반여제3동,반여제3동제2투,2169,1364,443,531,212,85,71,2,0,4,2,0,0,3,4,1357,7,805
부산광역시,해운대구,반여제3동,반여제3동제3투,2550,1495,486,539,276,100,80,4,0,0,0,1,0,2,1,1489,6,1055
부산광역시,해운대구,반여제4동,관내사전투표,1966,1966,888,553,297,126,84,2,0,2,1,1,0,0,1,1955,11,0
부산광역시,해운대구,반여제4동,합계,12046,9608,3819,2845,1649,715,499,18,1,5,1,2,2,5,13,9574,34,2438
부산광역시,해운대구,반여제4동,반여제4동제1투,1851,1264,404,436,243,92,75,1,0,2,0,0,2,0,3,1258,6,587
부산광역시,해운대구,반여제4동,반여제4동제2투,2512,1731,590,652,273,124,76,3,0,1,0,1,0,2,2,1724,7,781
부산광역시,해운대구,반여제4동,반여제4동제3투,2732,2280,963,559,423,196,125,4,0,0,0,0,0,2,5,2277,3,452
부산광역시,해운대구,반여제4동,반여제4동제4투,2985,2367,974,645,413,177,139,8,1,0,0,0,0,1,2,2360,7,618
부산광역시,해운대구,반송제1동,관내사전투표,2569,2569,979,927,399,133,105,3,2,2,0,3,0,0,4,2557,12,0
부산광역시,해운대구,반송제1동,합계,14333,9556,3166,3720,1605,521,420,23,3,9,4,5,3,6,13,9498,58,4777
부산광역시,해운대구,반송제1동,반송제1동제1투,2041,1223,395,470,214,66,53,5,0,3,1,0,1,0,1,1209,14,818
부산광역시,해운대구,반송제1동,반송제1동제2투,1829,1120,348,459,198,58,46,1,0,0,0,0,0,0,2,1112,8,709
부산광역시,해운대구,반송제1동,반송제1동제3투,1679,1052,337,409,195,55,41,4,0,0,1,0,1,1,2,1046,6,627
부산광역시,해운대구,반송제1동,반송제1동제4투,1866,1079,302,466,188,60,48,4,0,1,0,1,1,1,1,1073,6,787
부산광역시,해운대구,반송제1동,반송제1동제5투,1982,1058,344,406,183,55,55,1,1,2,1,1,0,0,2,1051,7,924
부산광역시,해운대구,반송제1동,반송제1동제6투,2018,1237,404,473,201,82,62,4,0,1,1,0,0,4,1,1233,4,781
부산광역시,해운대구,반송제1동,반송제1동제7투,349,218,57,110,27,12,10,1,0,0,0,0,0,0,0,217,1,131
부산광역시,해운대구,반송제2동,합계,22316,15679,5135,5862,2795,1033,696,19,2,20,9,10,5,5,12,15603,76,6637
부산광역시,해운대구,반송제2동,관내사전투표,4087,4087,1628,1311,634,277,181,5,1,8,5,0,2,1,4,4057,30,0
부산광역시,해운대구,반송제2동,반송제2동제1투,2332,1550,414,707,247,94,75,1,1,2,0,1,1,1,0,1544,6,782
부산광역시,해운대구,반송제2동,반송제2동제2투,3183,1946,679,680,337,135,99,1,0,1,3,3,2,0,1,1941,5,1237
부산광역시,해운대구,반송제2동,반송제2동제3투,1738,970,265,424,165,66,41,2,0,4,0,0,0,0,0,967,3,768
부산광역시,해운대구,반송제2동,반송제2동제4투,1432,909,256,389,166,58,36,0,0,0,0,1,0,0,2,908,1,523
부산광역시,해운대구,반송제2동,반송제2동제5투,2711,1782,538,660,365,120,78,4,0,1,0,3,0,0,2,1771,11,929
부산광역시,해운대구,반송제2동,반송제2동제6투,2234,1412,423,559,288,84,44,3,0,1,0,1,0,0,1,1404,8,822
부산광역시,해운대구,반송제2동,반송제2동제7투,1954,1227,295,561,254,71,31,3,0,1,0,0,0,2,1,1219,8,727
부산광역시,해운대구,반송제2동,반송제2동제8투,2645,1796,637,571,339,128,111,0,0,2,1,1,0,1,1,1792,4,849
부산광역시,해운대구,재송제1동,합계,25587,19925,8025,5659,3691,1631,815,33,3,7,0,4,3,5,8,19884,41,5662
부산광역시,해운대구,재송제1동,관내사전투표,4073,4073,1892,1003,640,320,199,6,1,0,0,1,0,1,2,4065,8,0
부산광역시,해운대구,재송제1동,재송제1동제1투,2877,1881,650,646,347,147,73,4,0,2,0,0,1,1,2,1873,8,996
부산광역시,해운대구,재송제1동,재송제1동제2투,3077,1984,631,713,375,171,78,4,0,1,0,1,0,1,1,1976,8,1093
부산광역시,해운대구,재송제1동,재송제1동제3투,2892,1936,681,639,370,138,96,3,1,2,0,1,0,0,0,1931,5,956
부산광역시,해운대구,재송제1동,재송제1동제4투,2518,1975,908,463,341,150,105,2,0,0,0,1,0,1,1,1972,3,543
부산광역시,해운대구,재송제1동,재송제1동제5투,4120,3325,1354,885,677,293,103,5,0,2,0,0,1,0,0,3320,5,795
부산광역시,해운대구,재송제1동,재송제1동제6투,3580,2758,1034,801,552,276,87,5,0,0,0,0,0,1,2,2758,0,822
부산광역시,해운대구,재송제1동,재송제1동제7투,2450,1993,875,509,389,136,74,4,1,0,0,0,1,0,0,1989,4,457
부산광역시,해운대구,재송제2동,관내사전투표,3609,3609,1607,1021,561,214,183,2,0,3,1,1,0,1,6,3600,9,0
부산광역시,해운대구,재송제2동,합계,22518,16042,6061,5176,2758,1120,821,24,1,7,1,6,4,1,17,15997,45,6476
부산광역시,해운대구,재송제2동,재송제2동제1투,2333,1439,483,537,231,108,69,2,0,2,0,1,0,0,1,1434,5,894
부산광역시,해운대구,재송제2동,재송제2동제2투,2119,1385,518,453,250,88,68,5,0,0,0,1,0,0,1,1384,1,734
부산광역시,해운대구,재송제2동,재송제2동제3투,2677,1702,652,500,304,134,96,4,1,1,0,1,1,0,0,1694,8,975
부산광역시,해운대구,재송제2동,재송제2동제4투,2489,1689,595,571,316,112,86,4,0,0,0,0,0,0,2,1686,3,800
부산광역시,해운대구,재송제2동,재송제2동제5투,2083,1375,490,431,277,96,68,4,0,0,0,1,1,0,2,1370,5,708
부산광역시,해운대구,재송제2동,재송제2동제6투,2100,1312,450,469,203,102,78,2,0,0,0,0,1,0,2,1307,5,788
부산광역시,해운대구,재송제2동,재송제2동제7투,2577,1742,627,561,310,134,102,0,0,0,0,1,0,0,1,1736,6,835
부산광역시,해운대구,재송제2동,재송제2동제8투,2531,1789,639,633,306,132,71,1,0,1,0,0,1,0,2,1786,3,742
부산광역시,해운대구,우제3동,관내사전투표,4083,4083,1561,1254,728,358,153,4,0,0,2,15,0,2,0,4077,6,0
부산광역시,해운대구,우제3동,합계,20531,16104,5039,5998,3204,1317,473,24,0,0,3,15,0,5,4,16082,22,4427
부산광역시,해운대구,우제3동,우제3동제1투,2902,2167,724,800,395,178,65,2,0,0,1,0,0,0,0,2165,2,735
부산광역시,해운대구,우제3동,우제3동제2투,3258,2549,783,989,508,180,79,4,0,0,0,0,0,1,0,2544,5,709
부산광역시,해운대구,우제3동,우제3동제3투,2440,1806,375,886,368,134,35,5,0,0,0,0,0,2,0,1805,1,634
부산광역시,해운대구,우제3동,우제3동제4투,3202,2099,604,827,434,168,57,4,0,0,0,0,0,0,1,2095,4,1103
부산광역시,해운대구,우제3동,우제3동제5투,2483,1812,520,634,448,167,36,3,0,0,0,0,0,0,2,1810,2,671
부산광역시,해운대구,우제3동,우제3동제6투,2163,1588,472,608,323,132,48,2,0,0,0,0,0,0,1,1586,2,575
부산광역시,해운대구,잘못 투입·구분된 투표지,,0,1,0,1,0,0,0,0,0,0,0,0,0,0,0,1,0,-1
부산광역시,기장군,합계,,124123,94393,39412,26556,15909,6775,4988,107,17,54,16,43,20,58,95,94050,343,29730
부산광역시,기장군,거소·선상투표,,538,502,248,88,100,16,13,3,2,0,0,0,0,0,1,471,31,36
부산광역시,기장군,관외사전투표,,11362,11360,5084,2625,1772,1009,771,12,2,2,2,1,1,6,20,11307,53,2
부산광역시,기장군,재외투표,,672,504,328,36,58,24,56,2,0,0,0,0,0,0,0,504,0,168
부산광역시,기장군,기장읍,관내사전투표,5886,5886,2673,1595,843,396,326,5,0,3,1,8,3,9,4,5866,20,0
부산광역시,기장군,기장읍,합계,41518,29183,10810,9652,5046,1949,1464,34,5,21,8,14,8,21,33,29065,118,12335
부산광역시,기장군,기장읍,기장읍제1투,2880,1804,647,623,299,108,118,0,0,1,0,0,1,0,2,1799,5,1076
부산광역시,기장군,기장읍,기장읍제2투,3810,2472,859,842,446,180,120,6,1,1,3,1,1,0,0,2460,12,1338
부산광역시,기장군,기장읍,기장읍제3투,3241,2409,947,667,451,169,147,3,2,3,0,1,0,2,5,2397,12,832
부산광역시,기장군,기장읍,기장읍제4투,3958,2510,812,895,475,174,133,2,0,3,2,0,0,0,2,2498,12,1448
부산광역시,기장군,기장읍,기장읍제5투,2770,1841,617,639,355,123,93,1,1,1,0,0,0,4,0,1834,7,929
부산광역시,기장군,기장읍,기장읍제6투,3964,2457,876,717,483,194,161,2,1,3,0,0,1,0,5,2443,14,1507
부산광역시,기장군,기장읍,기장읍제7투,3200,2190,665,849,427,146,85,4,0,0,2,0,0,2,0,2180,10,1010
부산광역시,기장군,기장읍,기장읍제8투,2171,1239,378,485,223,74,60,0,0,1,0,2,1,2,5,1231,8,932
부산광역시,기장군,기장읍,기장읍제9투,1646,965,275,459,150,45,29,3,0,1,0,1,0,0,0,963,2,681
부산광역시,기장군,기장읍,기장읍제10투,2360,1653,526,592,342,129,56,2,0,2,0,0,0,0,2,1651,2,707
부산광역시,기장군,기장읍,기장읍제11투,620,393,97,209,63,10,9,0,0,0,0,1,0,1,1,391,2,227
부산광역시,기장군,기장읍,기장읍제12투,711,689,599,77,5,4,0,0,0,0,0,0,0,0,2,687,2,22
부산광역시,기장군,기장읍,기장읍제13투,2267,1107,327,465,190,65,47,5,0,1,0,0,0,1,0,1101,6,1160
부산광역시,기장군,기장읍,기장읍제14투,2034,1568,512,538,294,132,80,1,0,1,0,0,1,0,5,1564,4,466
부산광역시,기장군,장안읍,합계,6952,4945,1491,2013,826,313,230,4,1,6,1,8,3,6,4,4906,39,2007
부산광역시,기장군,장안읍,관내사전투표,1019,1019,413,305,159,64,62,0,0,1,0,0,1,1,2,1008,11,0
부산광역시,기장군,장안읍,장안읍제1투,1360,797,199,372,145,38,37,0,0,1,1,1,1,0,0,795,2,563
부산광역시,기장군,장안읍,장안읍제2투,817,532,111,282,88,31,13,0,1,1,0,1,0,1,0,529,3,285
부산광역시,기장군,장안읍,장안읍제3투,566,372,84,188,71,17,5,0,0,3,0,0,1,1,0,370,2,194
부산광역시,기장군,장안읍,장안읍제4투,1127,714,178,347,100,44,30,2,0,0,0,1,0,2,1,705,9,413
부산광역시,기장군,장안읍,장안읍제5투,1356,919,211,453,156,47,39,0,0,0,0,2,0,1,1,910,9,437
부산광역시,기장군,장안읍,장안읍제6투,707,592,295,66,107,72,44,2,0,0,0,3,0,0,0,589,3,115
부산광역시,기장군,일광면,관내사전투표,1070,1070,467,342,142,64,46,1,0,1,0,1,0,2,1,1067,3,0
부산광역시,기장군,일광면,합계,7475,5152,1539,2289,814,285,173,3,1,6,1,2,1,7,6,5127,25,2323
부산광역시,기장군,일광면,일광면제1투,1530,915,227,448,152,51,29,0,0,1,0,0,0,1,1,910,5,615
부산광역시,기장군,일광면,일광면제2투,1615,1026,267,505,177,43,29,0,0,0,0,0,0,1,1,1023,3,589
부산광역시,기장군,일광면,일광면제3투,440,302,65,168,40,20,6,0,1,0,0,0,0,0,0,300,2,138
부산광역시,기장군,일광면,일광면제4투,653,425,87,241,61,18,11,1,0,0,1,1,0,1,0,422,3,228
부산광역시,기장군,일광면,일광면제5투,2167,1414,426,585,242,89,52,1,0,4,0,0,1,2,3,1405,9,753
부산광역시,기장군,정관읍,합계,48977,37881,18278,7911,6538,2884,2074,44,3,18,3,15,5,13,30,37816,65,11096
부산광역시,기장군,정관읍,관내사전투표,8631,8631,4717,1470,1273,645,481,6,1,6,1,3,0,7,2,8612,19,0
부산광역시,기장군,정관읍,정관읍제1투,3391,2169,918,519,392,167,156,6,0,2,0,0,1,0,2,2163,6,1222
부산광역시,기장군,정관읍,정관읍제2투,4781,3398,1524,783,622,254,192,9,0,0,0,2,1,1,6,3394,4,1383
부산광역시,기장군,정관읍,정관읍제3투,625,456,123,225,68,24,13,0,0,0,0,0,0,0,1,454,2,169
부산광역시,기장군,정관읍,정관읍제4투,3187,2389,1178,488,421,173,120,2,0,0,0,3,0,0,0,2385,4,798
부산광역시,기장군,정관읍,정관읍제5투,4034,3107,1564,542,576,250,163,0,0,2,0,3,0,0,3,3103,4,927
부산광역시,기장군,정관읍,정관읍제6투,3737,2680,1096,781,462,188,134,0,1,2,0,1,0,2,5,2672,8,1057
부산광역시,기장군,정관읍,정관읍제7투,2704,2081,1099,360,344,159,113,1,0,0,0,1,0,0,3,2080,1,623
부산광역시,기장군,정관읍,정관읍제8투,4273,3212,1592,601,583,259,170,1,0,1,0,0,1,1,1,3210,2,1061
부산광역시,기장군,정관읍,정관읍제9투,2976,2043,898,499,380,133,117,6,1,4,1,0,0,1,0,2040,3,933
부산광역시,기장군,정관읍,정관읍제10투,3461,2762,1434,466,489,227,137,1,0,1,0,1,1,0,2,2759,3,699
부산광역시,기장군,정관읍,정관읍제11투,4893,3375,1397,829,664,284,182,5,0,0,0,1,0,1,5,3368,7,1518
부산광역시,기장군,정관읍,정관읍제12투,2284,1578,738,348,264,121,96,7,0,0,1,0,1,0,0,1576,2,706
부산광역시,기장군,철마면,합계,6629,4866,1634,1942,755,295,207,5,3,1,1,3,2,5,1,4854,12,1763
부산광역시,기장군,철마면,관내사전투표,462,462,198,145,67,32,17,0,0,0,0,0,0,1,0,460,2,0
부산광역시,기장군,철마면,철마면제1투,1344,907,241,464,113,46,38,0,1,0,1,0,0,0,1,905,2,437
부산광역시,기장군,철마면,철마면제2투,939,695,206,296,117,50,22,1,0,0,0,0,1,1,0,694,1,244
부산광역시,기장군,철마면,철마면제3투,3884,2802,989,1037,458,167,130,4,2,1,0,3,1,3,0,2795,7,1082
부산광역시,기장군,잘못 투입·구분된 투표지,,0,0,0,0,0,0,0,0,0,0,0,0,0,0,0,0,0,0
부산광역시,사하구,합계,,280843,211876,82452,65252,36713,14958,10664,225,25,138,66,71,63,85,215,210927,949,68967
부산광역시,사하구,거소·선상투표,,854,800,315,146,237,47,16,4,1,3,2,0,1,0,2,774,26,54
부산광역시,사하구,관외사전투표,,20247,20244,9271,4033,3325,1868,1493,19,5,9,3,10,7,9,34,20086,158,3
부산광역시,사하구,재외투표,,1405,1056,644,74,163,50,120,2,0,0,0,0,0,0,0,1053,3,349
부산광역시,사하구,괴정제1동,합계,16918,12699,4609,4501,2123,836,547,11,0,6,1,4,3,2,9,12652,47,4219
부산광역시,사하구,괴정제1동,관내사전투표,3065,3065,1382,904,428,198,132,5,0,2,1,0,1,0,2,3055,10,0
부산광역시,사하구,괴정제1동,괴정제1동제1투,2565,1776,599,667,318,110,74,1,0,1,0,0,0,0,0,1770,6,789
부산광역시,사하구,괴정제1동,괴정제1동제2투,2799,1900,594,790,310,124,75,1,0,0,0,1,0,1,1,1897,3,899
부산광역시,사하구,괴정제1동,괴정제1동제3투,2993,2069,726,736,364,147,78,1,0,1,0,2,0,0,1,2056,13,924
부산광역시,사하구,괴정제1동,괴정제1동제4투,2654,1818,565,703,322,124,93,2,0,2,0,0,0,1,2,1814,4,836
부산광역시,사하구,괴정제1동,괴정제1동제5투,2842,2071,743,701,381,133,95,1,0,0,0,1,2,0,3,2060,11,771
부산광역시,사하구,괴정제2동,합계,11973,8610,3015,3076,1463,580,409,7,1,1,2,5,5,2,5,8571,39,3363
부산광역시,사하구,괴정제2동,관내사전투표,1762,1762,745,526,253,128,95,3,1,0,0,1,0,0,2,1754,8,0
부산광역시,사하구,괴정제2동,괴정제2동제1투,2510,1579,472,664,265,96,73,0,0,0,1,2,1,0,0,1574,5,931
부산광역시,사하구,괴정제2동,괴정제2동제2투,3244,2244,831,737,390,154,116,1,0,1,1,0,1,0,1,2233,11,1000
부산광역시,사하구,괴정제2동,괴정제2동제3투,2197,1425,444,533,282,93,60,1,0,0,0,1,2,1,1,1418,7,772
부산광역시,사하구,괴정제2동,괴정제2동제4투,2260,1600,523,616,273,109,65,2,0,0,0,1,1,1,1,1592,8,660
부산광역시,사하구,괴정제3동,합계,11629,8401,2997,3057,1339,528,379,11,2,9,5,5,3,10,10,8355,46,3228
부산광역시,사하구,괴정제3동,관내사전투표,2260,2260,959,665,340,139,118,3,1,5,1,2,3,5,3,2244,16,0
부산광역시,사하구,괴정제3동,괴정제3동제1투,2723,1786,633,648,284,117,83,3,0,3,1,1,0,1,3,1777,9,937
부산광역시,사하구,괴정제3동,괴정제3동제2투,3168,2066,624,885,323,125,89,1,1,0,0,2,0,4,3,2057,9,1102
부산광역시,사하구,괴정제3동,괴정제3동제3투,3478,2289,781,859,392,147,89,4,0,1,3,0,0,0,1,2277,12,1189
부산광역시,사하구,괴정제4동,합계,11126,8124,2816,3000,1357,517,368,14,0,7,5,1,0,4,3,8092,32,3002
부산광역시,사하구,괴정제4동,관내사전투표,2055,2055,849,668,283,135,103,6,0,1,2,0,0,1,0,2048,7,0
부산광역시,사하구,괴정제4동,괴정제4동제1투,2628,1831,603,711,314,122,63,4,0,1,2,0,0,0,1,1821,10,797
부산광역시,사하구,괴정제4동,괴정제4동제2투,2801,1869,629,669,332,114,112,1,0,3,0,1,0,0,1,1862,7,932
부산광역시,사하구,괴정제4동,괴정제4동제3투,1752,1166,349,497,190,66,49,3,0,2,1,0,0,3,1,1161,5,586
부산광역시,사하구,괴정제4동,괴정제4동제4투,1890,1203,386,455,238,80,41,0,0,0,0,0,0,0,0,1200,3,687
부산광역시,사하구,당리동,합계,22848,17564,6858,5727,2900,1122,829,28,0,12,2,5,1,5,15,17504,60,5284
부산광역시,사하구,당리동,관내사전투표,4199,4199,1980,1106,582,270,226,7,0,5,1,1,0,2,2,4182,17,0
부산광역시,사하구,당리동,당리동제1투,3464,2709,1135,776,480,178,124,3,0,0,0,1,0,1,4,2702,7,755
부산광역시,사하구,당리동,당리동제2투,3884,2686,1038,826,469,210,135,1,0,0,1,1,0,0,0,2681,5,1198
부산광역시,사하구,당리동,당리동제3투,3918,2815,913,1161,472,148,100,3,0,0,0,0,0,1,4,2802,13,1103
부산광역시,사하구,당리동,당리동제4투,2532,1653,579,578,290,111,85,3,0,1,0,0,0,0,4,1651,2,879
부산광역시,사하구,당리동,당리동제5투,2429,1704,600,637,277,88,84,3,0,5,0,1,0,1,1,1697,7,725
부산광역시,사하구,당리동,당리동제6투,2422,1798,613,643,330,117,75,8,0,1,0,1,1,0,0,1789,9,624
부산광역시,사하구,하단제1동,합계,18281,14012,5636,4195,2323,1038,716,9,1,4,6,4,3,6,11,13952,60,4269
부산광역시,사하구,하단제1동,관내사전투표,3469,3469,1695,747,504,262,234,2,1,0,1,1,1,4,3,3455,14,0
부산광역시,사하구,하단제1동,하단제1동제1투,2653,1885,673,658,318,143,78,3,0,0,0,0,1,1,1,1876,9,768
부산광역시,사하구,하단제1동,하단제1동제2투,2521,1513,549,517,268,98,70,0,0,1,1,0,0,0,1,1505,8,1008
부산광역시,사하구,하단제1동,하단제1동제3투,3584,2321,867,717,400,176,143,0,0,2,2,1,0,1,3,2312,9,1263
부산광역시,사하구,하단제1동,하단제1동제4투,3312,2607,989,882,461,174,93,2,0,0,0,2,0,0,1,2604,3,705
부산광역시,사하구,하단제1동,하단제1동제5투,2742,2217,863,674,372,185,98,2,0,1,2,0,1,0,2,2200,17,525
부산광역시,사하구,하단제2동,합계,19844,14806,6097,4247,2535,1079,752,16,1,8,2,2,2,3,10,14754,52,5038
부산광역시,사하구,하단제2동,관내사전투표,3179,3179,1614,701,466,221,157,2,0,2,0,0,0,2,1,3166,13,0
부산광역시,사하구,하단제2동,하단제2동제1투,3403,2413,948,745,423,167,112,3,0,1,2,0,1,0,0,2402,11,990
부산광역시,사하구,하단제2동,하단제2동제2투,3498,2420,896,793,419,171,124,5,0,1,0,1,0,1,2,2413,7,1078
부산광역시,사하구,하단제2동,하단제2동제3투,3107,1856,710,595,294,156,91,2,0,2,0,0,1,0,1,1852,4,1251
부산광역시,사하구,하단제2동,하단제2동제4투,3554,2523,862,816,498,190,137,4,1,2,0,0,0,0,4,2514,9,1031
부산광역시,사하구,하단제2동,하단제2동제5투,3103,2415,1067,597,435,174,131,0,0,0,0,1,0,0,2,2407,8,688
부산광역시,사하구,신평제1동,관내사전투표,2642,2642,1212,749,388,163,115,2,0,1,2,1,0,3,1,2637,5,0
부산광역시,사하구,신평제1동,합계,15216,10573,3908,3566,1845,695,473,6,1,6,8,3,2,8,17,10538,35,4643
부산광역시,사하구,신평제1동,신평제1동제1투,3600,2483,906,823,438,179,119,1,0,1,2,0,0,1,6,2476,7,1117
부산광역시,사하구,신평제1동,신평제1동제2투,2965,1821,591,648,359,125,81,2,1,2,0,0,0,2,1,1812,9,1144
부산광역시,사하구,신평제1동,신평제1동제3투,3231,1830,583,685,324,128,94,0,0,0,3,1,2,2,3,1825,5,1401
부산광역시,사하구,신평제1동,신평제1동제4투,2778,1797,616,661,336,100,64,1,0,2,1,1,0,0,6,1788,9,981
부산광역시,사하구,신평제2동,관내사전투표,1940,1940,901,465,293,158,116,0,1,0,1,0,0,0,2,1937,3,0
부산광역시,사하구,신평제2동,합계,12318,9439,3682,2874,1676,670,492,5,3,1,2,3,3,0,9,9420,19,2879
부산광역시,사하구,신평제2동,신평제2동제1투,2695,1579,545,553,278,107,84,3,1,0,0,0,1,0,3,1575,4,1116
부산광역시,사하구,신평제2동,신평제2동제2투,3357,2554,941,800,495,178,132,1,0,1,0,2,1,0,1,2552,2,803
부산광역시,사하구,신평제2동,신평제2동제3투,1888,1466,542,479,273,92,70,1,1,0,1,0,0,0,0,1459,7,422
부산광역시,사하구,신평제2동,신평제2동제4투,2438,1900,753,577,337,135,90,0,0,0,0,1,1,0,3,1897,3,538
부산광역시,사하구,장림제1동,합계,10728,7546,3030,2224,1366,469,380,11,0,7,3,2,1,4,14,7511,35,3182
부산광역시,사하구,장림제1동,관내사전투표,1917,1917,876,462,321,128,106,0,0,3,1,2,0,2,6,1907,10,0
부산광역시,사하구,장림제1동,장림제1동제1투,2713,1526,506,579,311,71,41,3,0,2,2,0,0,1,2,1518,8,1187
부산광역시,사하구,장림제1동,장림제1동제2투,2723,1606,503,674,282,68,56,6,0,2,0,0,0,1,4,1596,10,1117
부산광역시,사하구,장림제1동,장림제1동제3투,3375,2497,1145,509,452,202,177,2,0,0,0,0,1,0,2,2490,7,878
부산광역시,사하구,장림제2동,합계,21022,15173,5846,4591,2776,1073,742,24,1,10,3,4,6,1,20,15097,76,5849
부산광역시,사하구,장림제2동,관내사전투표,2643,2643,1222,648,421,177,146,10,0,1,1,1,1,0,2,2630,13,0
부산광역시,사하구,장림제2동,장림제2동제1투,2644,1479,439,595,288,81,59,1,0,3,0,1,1,0,1,1469,10,1165
부산광역시,사하구,장림제2동,장림제2동제2투,3283,2280,939,618,425,178,97,5,0,1,1,0,1,0,3,2268,12,1003
부산광역시,사하구,장림제2동,장림제2동제3투,2676,1878,671,612,361,141,74,1,0,0,0,0,1,0,5,1866,12,798
부산광역시,사하구,장림제2동,장림제2동제4투,3241,2336,774,825,429,162,127,1,0,2,0,1,1,0,3,2325,11,905
부산광역시,사하구,장림제2동,장림제2동제5투,3314,2278,848,697,426,171,117,2,0,1,1,0,1,1,3,2268,10,1036
부산광역시,사하구,장림제2동,장림제2동제6투,3221,2279,953,596,426,163,122,4,1,2,0,1,0,0,3,2271,8,942
부산광역시,사하구,다대제1동,합계,31548,23017,9077,6743,4249,1687,1072,22,3,19,6,9,8,11,19,22925,92,8531
부산광역시,사하구,다대제1동,관내사전투표,3974,3974,1885,929,611,303,213,1,0,3,2,2,0,3,6,3958,16,0
부산광역시,사하구,다대제1동,다대제1동제1투,3361,2192,829,630,433,172,108,1,0,2,2,4,0,1,2,2184,8,1169
부산광역시,사하구,다대제1동,다대제1동제2투,3069,1960,643,724,367,114,91,0,2,1,2,0,1,1,3,1949,11,1109
부산광역시,사하구,다대제1동,다대제1동제3투,1838,1117,345,425,202,84,46,2,0,4,0,1,1,0,1,1111,6,721
부산광역시,사하구,다대제1동,다대제1동제4투,2442,1804,637,646,340,100,69,1,1,2,0,0,0,0,1,1797,7,638
부산광역시,사하구,다대제1동,다대제1동제5투,2581,1705,654,488,326,136,85,1,0,2,0,1,2,2,1,1698,7,876
부산광역시,사하구,다대제1동,다대제1동제6투,2096,1367,583,327,264,102,80,2,0,3,0,0,0,1,0,1362,5,729
부산광역시,사하구,다대제1동,다대제1동제7투,2735,2078,773,672,370,154,94,5,0,0,0,0,0,1,2,2071,7,657
부산광역시,사하구,다대제1동,다대제1동제8투,1756,1074,304,475,197,57,25,3,0,0,0,0,3,0,2,1066,8,682
부산광역시,사하구,다대제1동,다대제1동제9투,1651,1083,421,315,221,71,47,0,0,0,0,0,1,1,0,1077,6,568
부산광역시,사하구,다대제1동,다대제1동제10투,3396,2593,1139,608,510,188,135,4,0,2,0,0,0,1,1,2588,5,803
부산광역시,사하구,다대제1동,다대제1동제11투,2649,2070,864,504,408,206,79,2,0,0,0,1,0,0,0,2064,6,579
부산광역시,사하구,다대제2동,관내사전투표,4093,4093,1876,1033,634,279,229,6,0,4,2,1,3,1,4,4072,21,0
부산광역시,사하구,다대제2동,합계,23507,17663,6835,5477,3099,1227,860,25,2,14,9,5,8,6,16,17583,80,5844
부산광역시,사하구,다대제2동,다대제2동제1투,2174,1671,639,478,302,143,101,0,0,2,0,0,0,0,1,1666,5,503
부산광역시,사하구,다대제2동,다대제2동제2투,2276,1773,681,584,295,137,69,1,0,0,1,1,0,0,0,1769,4,503
부산광역시,사하구,다대제2동,다대제2동제3투,2758,1824,608,690,325,105,74,1,0,2,0,0,3,2,1,1811,13,934
부산광역시,사하구,다대제2동,다대제2동제4투,2610,1710,656,501,321,135,78,6,1,1,0,0,0,0,3,1702,8,900
부산광역시,사하구,다대제2동,다대제2동제5투,3885,2795,1070,845,537,187,132,5,0,1,1,1,1,0,3,2783,12,1090
부산광역시,사하구,다대제2동,다대제2동제6투,3121,2286,860,706,425,158,123,1,0,0,3,0,1,1,1,2279,7,835
부산광역시,사하구,다대제2동,다대제2동제7투,2590,1511,445,640,260,83,54,5,1,4,2,2,0,2,3,1501,10,1079
부산광역시,사하구,구평동,합계,7372,5571,2154,1614,1060,430,285,0,1,4,2,0,2,1,5,5558,13,1801
부산광역시,사하구,구평동,관내사전투표,1076,1076,535,247,151,86,55,0,0,0,0,0,1,0,0,1075,1,0
부산광역시,사하구,구평동,구평동제1투,1804,1371,563,359,273,100,69,0,0,1,0,0,0,0,1,1366,5,433
부산광역시,사하구,구평동,구평동제2투,2254,1476,427,591,290,94,61,0,0,1,0,0,1,1,3,1469,7,778
부산광역시,사하구,구평동,구평동제3투,384,261,63,131,44,15,6,0,0,1,1,0,0,0,0,261,0,123
부산광역시,사하구,구평동,구평동제4투,1854,1387,566,286,302,135,94,0,1,1,1,0,0,0,1,1387,0,467
부산광역시,사하구,감천제1동,관내사전투표,2128,2128,887,647,360,121,97,1,0,1,0,1,1,0,2,2118,10,0
부산광역시,사하구,감천제1동,합계,17454,12479,4431,4334,2199,841,566,2,1,15,4,7,4,6,13,12423,56,4975
부산광역시,사하구,감천제1동,감천제1동제1투,3244,2103,671,822,369,127,89,0,0,6,2,0,1,1,4,2092,11,1141
부산광역시,사하구,감천제1동,감천제1동제2투,2768,1529,464,633,275,82,65,0,0,3,0,0,0,2,0,1524,5,1239
부산광역시,사하구,감천제1동,감천제1동제3투,1922,1284,388,487,242,87,65,1,0,2,2,3,1,0,0,1278,6,638
부산광역시,사하구,감천제1동,감천제1동제4투,2205,1681,683,516,275,134,62,0,1,2,0,0,1,1,3,1678,3,524
부산광역시,사하구,감천제1동,감천제1동제5투,2522,1823,674,570,340,145,80,0,0,1,0,3,0,2,2,1817,6,699
부산광역시,사하구,감천제1동,감천제1동제6투,2665,1931,664,659,338,145,108,0,0,0,0,0,0,0,2,1916,15,734
부산광역시,사하구,감천제2동,관내사전투표,889,888,313,343,148,42,31,1,0,1,1,1,1,3,0,885,3,1
부산광역시,사하구,감천제2동,합계,6553,4099,1231,1773,678,201,165,9,2,3,1,2,4,7,3,4079,20,2454
부산광역시,사하구,감천제2동,감천제2동제1투,2094,1175,338,518,199,56,49,3,2,0,0,0,0,1,2,1168,7,919
부산광역시,사하구,감천제2동,감천제2동제2투,1976,1069,307,478,183,53,40,3,0,0,0,0,1,0,0,1065,4,907
부산광역시,사하구,감천제2동,감천제2동제3투,1594,967,273,434,148,50,45,2,0,2,0,1,2,3,1,961,6,627
부산광역시,사하구,잘못 투입·구분된 투표지,,0,0,0,0,0,0,0,0,0,0,0,0,0,0,0,0,0,0
부산광역시,금정구,합계,,209881,164127,60169,54418,26729,13143,8188,190,13,99,35,103,33,91,159,163370,757,45754
부산광역시,금정구,거소·선상투표,,585,553,206,121,152,30,13,5,0,2,0,4,1,1,4,539,14,32
부산광역시,금정구,관외사전투표,,16705,16705,7365,3550,2753,1635,1179,13,4,9,7,16,4,6,28,16569,136,0
부산광역시,금정구,재외투표,,1518,1225,720,92,184,53,168,4,0,0,1,1,0,0,0,1223,2,293
부산광역시,금정구,서제1동,합계,6524,4334,1289,1798,711,298,194,1,1,4,2,2,1,5,3,4309,25,2190
부산광역시,금정구,서제1동,관내사전투표,829,829,306,279,128,56,53,0,1,1,0,0,0,1,0,825,4,0
부산광역시,금정구,서제1동,서제1동제1투,2018,1165,323,505,210,81,36,0,0,2,0,1,0,0,1,1159,6,853
부산광역시,금정구,서제1동,서제1동제2투,1755,1143,320,510,161,88,48,0,0,0,2,1,0,4,1,1135,8,612
부산광역시,금정구,서제1동,서제1동제3투,1922,1197,340,504,212,73,57,1,0,1,0,0,1,0,1,1190,7,725
부산광역시,금정구,서제2동,합계,9707,6735,2118,2696,1099,442,304,14,0,6,0,4,3,5,12,6703,32,2972
부산광역시,금정구,서제2동,관내사전투표,1377,1377,515,481,199,106,65,1,0,2,0,0,2,1,1,1373,4,0
부산광역시,금정구,서제2동,서제2동제1투,3093,2026,586,828,342,150,93,5,0,4,0,0,1,2,5,2016,10,1067
부산광역시,금정구,서제2동,서제2동제2투,2707,1698,481,750,278,94,72,7,0,0,0,3,0,0,4,1689,9,1009
부산광역시,금정구,서제2동,서제2동제3투,2530,1634,536,637,280,92,74,1,0,0,0,1,0,2,2,1625,9,896
부산광역시,금정구,서제3동,합계,10150,7207,2228,2998,1117,492,309,8,3,4,1,3,1,5,5,7174,33,2943
부산광역시,금정구,서제3동,관내사전투표,1513,1513,559,571,194,106,73,1,1,0,1,1,0,1,0,1508,5,0
부산광역시,금정구,서제3동,서제3동제1투,2085,1390,404,601,232,79,59,2,0,0,0,1,0,0,2,1380,10,695
부산광역시,금정구,서제3동,서제3동제2투,2398,1667,514,690,254,122,69,3,1,1,0,1,1,3,2,1661,6,731
부산광역시,금정구,서제3동,서제3동제3투,2269,1305,348,567,235,86,56,1,1,2,0,0,0,1,1,1298,7,964
부산광역시,금정구,서제3동,서제3동제4투,1885,1332,403,569,202,99,52,1,0,1,0,0,0,0,0,1327,5,553
부산광역시,금정구,금사동,합계,7945,5508,1720,2334,820,359,218,10,0,9,1,2,1,2,2,5478,30,2437
부산광역시,금정구,금사동,관내사전투표,1079,1079,414,411,139,54,47,1,0,3,0,1,0,1,1,1072,7,0
부산광역시,금정구,금사동,금사동제1투,2328,1528,437,684,221,123,50,2,0,1,0,0,1,1,0,1520,8,800
부산광역시,금정구,금사동,금사동제2투,2573,1571,469,649,267,102,69,4,0,1,0,0,0,0,1,1562,9,1002
부산광역시,금정구,금사동,금사동제3투,1965,1330,400,590,193,80,52,3,0,4,1,1,0,0,0,1324,6,635
부산광역시,금정구,부곡제1동,합계,8494,6192,2017,2409,1033,413,244,16,1,6,0,3,1,9,12,6164,28,2302
부산광역시,금정구,부곡제1동,관내사전투표,1949,1949,742,673,277,140,89,8,0,2,0,0,0,2,7,1940,9,0
부산광역시,금정구,부곡제1동,부곡제1동제1투,1719,1065,318,428,197,71,38,2,0,1,0,1,1,1,1,1059,6,654
부산광역시,금정구,부곡제1동,부곡제1동제2투,2992,1982,616,799,345,130,73,4,1,3,0,1,0,1,0,1973,9,1010
부산광역시,금정구,부곡제1동,부곡제1동제3투,1834,1196,341,509,214,72,44,2,0,0,0,1,0,5,4,1192,4,638
부산광역시,금정구,부곡제2동,합계,13679,10838,4018,3436,1881,904,503,11,0,7,2,12,4,7,10,10795,43,2841
부산광역시,금정구,부곡제2동,관내사전투표,2514,2514,1145,629,376,211,132,2,0,1,0,5,1,0,4,2506,8,0
부산광역시,금정구,부곡제2동,부곡제2동제1투,1862,1323,455,441,235,102,76,0,0,1,0,0,1,0,2,1313,10,539
부산광역시,금정구,부곡제2동,부곡제2동제2투,3158,2157,634,834,393,164,98,5,0,2,2,4,1,3,3,2143,14,1001
부산광역시,금정구,부곡제2동,부곡제2동제3투,2881,2125,759,654,402,208,90,4,0,1,0,0,0,1,0,2119,6,756
부산광역시,금정구,부곡제2동,부곡제2동제4투,3264,2719,1025,878,475,219,107,0,0,2,0,3,1,3,1,2714,5,545
부산광역시,금정구,부곡제3동,합계,13934,11191,4207,3522,1820,993,565,15,0,7,2,2,0,6,12,11151,40,2743
부산광역시,금정구,부곡제3동,관내사전투표,3147,3147,1394,763,477,285,201,6,0,4,0,0,0,0,3,3133,14,0
부산광역시,금정구,부곡제3동,부곡제3동제1투,2161,1451,522,535,206,108,65,2,0,2,1,0,0,1,1,1443,8,710
부산광역시,금정구,부곡제3동,부곡제3동제2투,2146,1452,465,535,247,122,74,1,0,0,0,0,0,0,1,1445,7,694
부산광역시,금정구,부곡제3동,부곡제3동제3투,3174,2457,844,847,417,228,105,4,0,0,1,1,0,2,2,2451,6,717
부산광역시,금정구,부곡제3동,부곡제3동제4투,3306,2684,982,842,473,250,120,2,0,1,0,1,0,3,5,2679,5,622
부산광역시,금정구,부곡제4동,합계,11261,8339,2830,3111,1366,601,353,9,0,5,1,5,1,3,6,8291,48,2922
부산광역시,금정구,부곡제4동,관내사전투표,2074,2074,889,652,283,130,104,2,0,0,0,0,0,2,0,2062,12,0
부산광역시,금정구,부곡제4동,부곡제4동제1투,2874,1947,654,684,358,169,68,0,0,2,0,2,0,0,3,1940,7,927
부산광역시,금정구,부곡제4동,부곡제4동제2투,2108,1537,483,627,245,93,71,3,0,1,1,3,0,0,1,1528,9,571
부산광역시,금정구,부곡제4동,부곡제4동제3투,1913,1186,298,563,190,81,40,1,0,1,0,0,1,1,1,1177,9,727
부산광역시,금정구,부곡제4동,부곡제4동제4투,2292,1595,506,585,290,128,70,3,0,1,0,0,0,0,1,1584,11,697
부산광역시,금정구,장전제1동,합계,14041,11209,4628,2962,1662,1158,716,6,0,1,0,9,2,6,12,11162,47,2832
부산광역시,금정구,장전제1동,관내사전투표,3118,3118,1512,511,400,388,279,1,0,0,0,6,0,1,5,3103,15,0
부산광역시,금정구,장전제1동,장전제1동제1투,2268,1567,587,488,226,154,98,2,0,0,0,1,1,1,0,1558,9,701
부산광역시,금정구,장전제1동,장전제1동제2투,3106,2306,868,663,352,249,155,0,0,1,0,1,0,3,5,2297,9,800
부산광역시,금정구,장전제1동,장전제1동제3투,2577,1809,604,711,292,124,63,2,0,0,0,1,1,1,2,1801,8,768
부산광역시,금정구,장전제1동,장전제1동제4투,2972,2409,1057,589,392,243,121,1,0,0,0,0,0,0,0,2403,6,563
부산광역시,금정구,장전제2동,합계,10972,8683,3505,2648,1450,670,352,11,2,4,3,4,3,4,3,8659,24,2289
부산광역시,금정구,장전제2동,관내사전투표,2372,2372,1125,582,337,184,131,1,1,2,0,2,2,0,1,2368,4,0
부산광역시,금정구,장전제2동,장전제2동제1투,2373,1536,514,605,246,98,46,6,0,1,3,0,0,3,0,1522,14,837
부산광역시,금정구,장전제2동,장전제2동제2투,3012,2218,746,811,405,174,69,4,0,1,0,1,0,1,2,2214,4,794
부산광역시,금정구,장전제2동,장전제2동제3투,3215,2557,1120,650,462,214,106,0,1,0,0,1,1,0,0,2555,2,658
부산광역시,금정구,장전제3동,관내사전투표,1060,1060,455,256,166,97,71,3,0,0,0,1,1,3,4,1057,3,0
부산광역시,금정구,장전제3동,합계,5531,3924,1395,1291,665,317,216,6,0,0,2,1,2,5,6,3906,18,1607
부산광역시,금정구,장전제3동,장전제3동제1투,2126,1325,407,498,239,103,64,1,0,0,1,0,1,1,2,1317,8,801
부산광역시,금정구,장전제3동,장전제3동제2투,2345,1539,533,537,260,117,81,2,0,0,1,0,0,1,0,1532,7,806
부산광역시,금정구,선두구동,합계,2264,1660,450,816,217,101,55,5,1,0,1,0,1,2,3,1652,8,604
부산광역시,금정구,선두구동,관내사전투표,513,513,193,200,57,31,23,4,0,0,0,0,0,0,2,510,3,0
부산광역시,금정구,선두구동,선두구동투표소,1751,1147,257,616,160,70,32,1,1,0,1,0,1,2,1,1142,5,604
부산광역시,금정구,청룡노포동,합계,8449,6477,2097,2617,1021,452,244,4,0,7,1,3,2,4,4,6456,21,1972
부산광역시,금정구,청룡노포동,관내사전투표,1935,1935,720,695,294,124,90,1,0,2,0,2,0,2,0,1930,5,0
부산광역시,금정구,청룡노포동,청룡노포동제1투,2919,1987,656,755,326,146,91,3,0,2,0,1,1,0,1,1982,5,932
부산광역시,금정구,청룡노포동,청룡노포동제2투,2927,2127,611,954,338,154,57,0,0,2,0,0,0,1,1,2118,9,800
부산광역시,금정구,청룡노포동,청룡노포동제3투,668,428,110,213,63,28,6,0,0,1,1,0,1,1,2,426,2,240
부산광역시,금정구,남산동,합계,25299,18868,6409,6837,3042,1470,933,17,0,14,8,21,2,5,14,18772,96,6431
부산광역시,금정구,남산동,관내사전투표,3960,3960,1659,1239,528,292,205,1,0,4,0,4,0,1,1,3934,26,0
부산광역시,금정구,남산동,남산동제1투,2625,1782,528,710,318,139,69,4,0,2,2,2,1,0,0,1775,7,843
부산광역시,금정구,남산동,남산동제2투,2826,1931,621,752,296,143,95,1,0,2,1,4,0,1,2,1918,13,895
부산광역시,금정구,남산동,남산동제3투,2877,2054,723,711,326,172,110,1,0,0,0,3,0,0,1,2047,7,823
부산광역시,금정구,남산동,남산동제4투,3261,2333,726,854,409,213,110,1,0,2,2,0,1,1,1,2320,13,928
부산광역시,금정구,남산동,남산동제5투,2979,2060,619,779,364,168,112,3,0,1,0,3,0,1,4,2054,6,919
부산광역시,금정구,남산동,남산동제6투,4190,2876,946,1071,481,194,154,4,0,2,2,0,0,1,4,2859,17,1314
부산광역시,금정구,남산동,남산동제7투,2581,1872,587,721,320,149,78,2,0,1,1,5,0,0,1,1865,7,709
부산광역시,금정구,구서제1동,합계,15437,12379,4775,3847,2086,1012,577,9,0,6,1,3,1,4,12,12333,46,3058
부산광역시,금정구,구서제1동,관내사전투표,3982,3982,1843,1008,586,326,193,2,0,3,0,0,0,2,2,3965,17,0
부산광역시,금정구,구서제1동,구서제1동제1투,3024,2265,763,805,375,190,117,1,0,2,1,0,0,0,3,2257,8,759
부산광역시,금정구,구서제1동,구서제1동제2투,3031,2034,640,770,338,169,101,2,0,1,0,1,0,1,1,2024,10,997
부산광역시,금정구,구서제1동,구서제1동제3투,2750,2152,805,627,439,186,88,1,0,0,0,1,1,0,0,2148,4,598
부산광역시,금정구,구서제1동,구서제1동제4투,2650,1946,724,637,348,141,78,3,0,0,0,1,0,1,6,1939,7,704
부산광역시,금정구,구서제2동,합계,26456,21359,7956,7029,3562,1677,1007,25,0,8,2,6,3,12,11,21298,61,5097
부산광역시,금정구,구서제2동,관내사전투표,4746,4746,2184,1220,695,339,270,8,0,4,0,2,2,4,3,4731,15,0
부산광역시,금정구,구서제2동,구서제2동제1투,3296,2173,762,741,390,157,108,1,0,0,0,2,0,2,1,2164,9,1123
부산광역시,금정구,구서제2동,구서제2동제2투,2634,1950,629,722,347,149,92,2,0,0,0,0,0,2,0,1943,7,684
부산광역시,금정구,구서제2동,구서제2동제3투,2971,2150,743,769,337,179,108,0,0,0,0,0,0,0,4,2140,10,821
부산광역시,금정구,구서제2동,구서제2동제4투,3049,2346,840,819,347,198,123,3,0,1,1,1,0,3,1,2337,9,703
부산광역시,금정구,구서제2동,구서제2동제5투,3090,2398,888,761,418,191,127,3,0,2,0,0,1,0,1,2392,6,692
부산광역시,금정구,구서제2동,구서제2동제6투,3179,2726,1027,880,487,225,103,1,0,1,1,0,0,0,0,2725,1,453
부산광역시,금정구,구서제2동,구서제2동제7투,3491,2870,883,1117,541,239,76,7,0,0,0,1,0,1,1,2866,4,621
부산광역시,금정구,금성동,합계,930,741,236,304,88,66,38,1,1,0,0,2,0,0,0,736,5,189
부산광역시,금정구,금성동,관내사전투표,235,235,82,86,35,14,13,1,1,0,0,0,0,0,0,232,3,0
부산광역시,금정구,금성동,금성동투표소,695,506,154,218,53,52,25,0,0,0,0,2,0,0,0,504,2,189
부산광역시,금정구,잘못 투입·구분된 투표지,,0,0,0,0,0,0,0,0,0,0,0,0,0,0,0,0,0,0
부산광역시,강서구,합계,,88518,68633,30783,18711,10629,4875,3154,64,9,34,21,20,19,39,59,68417,216,19885
부산광역시,강서구,거소·선상투표,,204,185,72,35,45,17,6,1,0,1,1,0,0,0,2,180,5,19
부산광역시,강서구,관외사전투표,,9386,9385,4538,2129,1335,746,554,12,1,3,5,4,4,4,12,9347,38,1
부산광역시,강서구,재외투표,,583,392,235,35,53,21,45,1,1,0,0,0,0,0,0,391,1,191
부산광역시,강서구,대저1동,합계,6241,4221,1419,1821,631,179,115,4,2,6,2,0,1,8,3,4191,30,2020
부산광역시,강서구,대저1동,관내사전투표,866,866,342,315,116,44,34,2,1,0,0,0,0,0,1,855,11,0
부산광역시,강서구,대저1동,대저1동제1투,1268,698,247,299,102,28,13,1,0,3,1,0,0,3,0,697,1,570
부산광역시,강서구,대저1동,대저1동제2투,1037,668,193,333,90,20,16,1,0,2,0,0,1,2,0,658,10,369
부산광역시,강서구,대저1동,대저1동제3투,1276,839,259,392,120,40,19,0,1,0,1,0,0,1,2,835,4,437
부산광역시,강서구,대저1동,대저1동제4투,967,627,192,276,103,28,22,0,0,1,0,0,0,2,0,624,3,340
부산광역시,강서구,대저1동,대저1동제5투,827,523,186,206,100,19,11,0,0,0,0,0,0,0,0,522,1,304
부산광역시,강서구,대저2동,합계,6471,4685,1685,1797,675,309,181,4,1,4,1,2,1,3,4,4667,18,1786
부산광역시,강서구,대저2동,관내사전투표,1062,1062,453,302,144,93,58,4,1,1,0,0,0,1,3,1060,2,0
부산광역시,강서구,대저2동,대저2동제1투,1529,1046,383,331,183,92,48,0,0,1,0,1,0,1,1,1041,5,483
부산광역시,강서구,대저2동,대저2동제2투,1286,846,260,385,128,42,25,0,0,1,0,0,0,0,0,841,5,440
부산광역시,강서구,대저2동,대저2동제3투,1437,970,347,432,120,42,23,0,0,0,0,1,1,0,0,966,4,467
부산광역시,강서구,대저2동,대저2동제4투,1157,761,242,347,100,40,27,0,0,1,1,0,0,1,0,759,2,396
부산광역시,강서구,강동동,합계,4586,3137,1100,1338,426,150,93,2,0,1,1,1,1,4,5,3122,15,1449
부산광역시,강서구,강동동,관내사전투표,686,686,283,251,87,39,20,0,0,1,0,0,0,1,2,684,2,0
부산광역시,강서구,강동동,강동동제1투,947,582,203,244,89,23,17,0,0,0,1,0,0,0,0,577,5,365
부산광역시,강서구,강동동,강동동제2투,1005,685,224,316,85,28,20,1,0,0,0,0,0,3,1,678,7,320
부산광역시,강서구,강동동,강동동제3투,785,503,138,249,73,30,11,0,0,0,0,1,0,0,1,503,0,282
부산광역시,강서구,강동동,강동동제4투,1163,681,252,278,92,30,25,1,0,0,0,0,1,0,1,680,1,482
부산광역시,강서구,명지동,합계,35831,29125,14276,6378,4679,2333,1344,21,1,8,5,4,6,8,13,29076,49,6706
부산광역시,강서구,명지동,관내사전투표,5134,5134,2941,875,664,379,257,1,0,1,0,1,1,1,2,5123,11,0
부산광역시,강서구,명지동,명지동제1투,2792,1696,462,844,237,81,51,3,0,4,0,0,2,2,1,1687,9,1096
부산광역시,강서구,명지동,명지동제2투,2525,1949,981,330,343,176,112,0,0,0,0,1,0,0,2,1945,4,576
부산광역시,강서구,명지동,명지동제3투,1820,1447,721,247,241,153,82,0,0,1,0,1,0,0,0,1446,1,373
부산광역시,강서구,명지동,명지동제4투,1636,1217,611,240,193,95,70,4,0,0,0,0,0,0,0,1213,4,419
부산광역시,강서구,명지동,명지동제5투,3452,2745,1374,566,466,206,125,2,0,0,1,0,2,0,0,2742,3,707
부산광역시,강서구,명지동,명지동제6투,1895,1543,808,236,280,137,78,0,1,0,1,0,0,0,1,1542,1,352
부산광역시,강서구,명지동,명지동제7투,2086,1734,799,409,300,157,64,0,0,0,0,0,0,2,1,1732,2,352
부산광역시,강서구,명지동,명지동제8투,1963,1550,543,521,299,124,56,5,0,0,0,0,0,0,0,1548,2,413
부산광역시,강서구,명지동,명지동제9투,2133,1761,739,490,303,140,83,4,0,1,0,0,0,0,0,1760,1,372
부산광역시,강서구,명지동,명지동제10투,1951,1604,799,341,272,128,59,1,0,0,1,0,0,1,1,1603,1,347
부산광역시,강서구,명지동,명지동제11투,2079,1661,840,302,292,149,73,0,0,0,0,0,0,0,2,1658,3,418
부산광역시,강서구,명지동,명지동제12투,3067,2425,1256,475,380,189,115,1,0,1,1,0,0,1,2,2421,4,642
부산광역시,강서구,명지동,명지동제13투,3298,2659,1402,502,409,219,119,0,0,0,1,1,1,1,1,2656,3,639
부산광역시,강서구,가락동,합계,2158,1531,559,650,215,64,35,2,0,2,0,0,0,0,1,1528,3,627
부산광역시,강서구,가락동,관내사전투표,378,378,184,112,61,9,11,0,0,0,0,0,0,0,0,377,1,0
부산광역시,강서구,가락동,가락동제1투,1034,654,221,315,70,34,11,1,0,2,0,0,0,0,0,654,0,380
부산광역시,강서구,가락동,가락동제2투,746,499,154,223,84,21,13,1,0,0,0,0,0,0,1,497,2,247
부산광역시,강서구,녹산동,관내사전투표,1341,1341,698,298,193,80,62,2,0,2,0,0,1,0,1,1337,4,0
부산광역시,강서구,녹산동,합계,20166,14119,6245,3697,2362,983,722,15,3,8,5,8,5,8,15,14076,43,6047
부산광역시,강서구,녹산동,녹산동제1투,761,460,124,240,64,14,9,1,0,2,0,0,0,1,2,457,3,301
부산광역시,강서구,녹산동,녹산동제2투,1556,906,278,406,130,50,30,1,0,1,1,2,0,1,1,901,5,650
부산광역시,강서구,녹산동,녹산동제3투,839,506,155,246,50,30,20,0,0,0,0,2,0,1,1,505,1,333
부산광역시,강서구,녹산동,녹산동제4투,2129,1488,690,262,287,144,97,1,0,0,0,1,1,1,1,1485,3,641
부산광역시,강서구,녹산동,녹산동제5투,2928,1859,784,510,334,120,94,3,0,0,1,0,1,3,2,1852,7,1069
부산광역시,강서구,녹산동,녹산동제6투,3840,2698,1267,598,464,208,149,0,1,0,2,0,1,1,2,2693,5,1142
부산광역시,강서구,녹산동,녹산동제7투,3921,2843,1314,637,499,209,164,4,1,0,1,2,0,0,3,2834,9,1078
부산광역시,강서구,녹산동,녹산동제8투,2851,2018,935,500,341,128,97,3,1,3,0,1,1,0,2,2012,6,833
부산광역시,강서구,가덕도동,관내사전투표,354,354,179,107,33,17,14,0,0,0,0,0,0,0,1,351,3,0
부산광역시,강서구,가덕도동,합계,2892,1853,654,831,208,73,59,2,0,1,1,1,1,4,4,1839,14,1039
부산광역시,강서구,가덕도동,가덕도동제1투,1124,645,230,271,75,33,26,0,0,1,0,1,0,3,1,641,4,479
부산광역시,강서구,가덕도동,가덕도동제2투,858,531,146,288,55,21,10,2,0,0,1,0,1,1,2,527,4,327
부산광역시,강서구,가덕도동,가덕도동제3투,556,323,99,165,45,2,9,0,0,0,0,0,0,0,0,320,3,233
부산광역시,강서구,잘못 투입·구분된 투표지,,0,0,0,0,0,0,0,0,0,0,0,0,0,0,0,0,0,0
부산광역시,연제구,합계,,175265,137602,52454,44221,23321,9900,6745,130,15,59,20,53,27,55,105,137105,497,37663
부산광역시,연제구,거소·선상투표,,417,383,136,88,117,21,9,1,1,1,0,0,0,0,1,375,8,34
부산광역시,연제구,관외사전투표,,15105,15105,6912,3178,2528,1343,996,13,4,9,1,9,2,7,22,15024,81,0
부산광역시,연제구,재외투표,,1045,825,519,41,132,41,90,0,0,2,0,0,0,0,0,825,0,220
부산광역시,연제구,거제제1동,합계,20337,16718,6698,5015,2974,1206,746,17,0,1,2,2,0,3,5,16669,49,3619
부산광역시,연제구,거제제1동,관내사전투표,2718,2718,1371,577,406,196,157,5,0,1,0,2,0,0,1,2716,2,0
부산광역시,연제구,거제제1동,거제제1동제1투,2629,2108,850,604,375,161,111,2,0,0,0,0,0,1,1,2105,3,521
부산광역시,연제구,거제제1동,거제제1동제2투,3452,2802,1048,970,446,207,117,3,0,0,1,0,0,1,0,2793,9,650
부산광역시,연제구,거제제1동,거제제1동제3투,2452,1802,614,657,348,98,70,1,0,0,0,0,0,1,0,1789,13,650
부산광역시,연제구,거제제1동,거제제1동제4투,2288,1890,799,526,357,133,66,0,0,0,0,0,0,0,1,1882,8,398
부산광역시,연제구,거제제1동,거제제1동제5투,2619,2209,947,602,389,169,89,5,0,0,0,0,0,0,1,2202,7,410
부산광역시,연제구,거제제1동,거제제1동제6투,1567,965,307,376,171,63,44,1,0,0,1,0,0,0,0,963,2,602
부산광역시,연제구,거제제1동,거제제1동제7투,2612,2224,762,703,482,179,92,0,0,0,0,0,0,0,1,2219,5,388
부산광역시,연제구,거제제2동,관내사전투표,2006,2006,842,631,298,139,87,1,0,0,1,0,0,1,0,2000,6,0
부산광역시,연제구,거제제2동,합계,9375,7557,2813,2552,1261,584,299,10,0,1,1,2,2,5,5,7535,22,1818
부산광역시,연제구,거제제2동,거제제2동제1투,2177,1504,509,582,218,121,66,2,0,0,0,0,1,2,0,1501,3,673
부산광역시,연제구,거제제2동,거제제2동제2투,1782,1390,529,412,261,137,45,0,0,0,0,0,0,1,1,1386,4,392
부산광역시,연제구,거제제2동,거제제2동제3투,1998,1539,533,560,268,100,64,7,0,0,0,1,0,0,1,1534,5,459
부산광역시,연제구,거제제2동,거제제2동제4투,1412,1118,400,367,216,87,37,0,0,1,0,1,1,1,3,1114,4,294
부산광역시,연제구,거제제3동,관내사전투표,1831,1831,753,601,270,116,78,0,0,0,0,0,1,2,2,1823,8,0
부산광역시,연제구,거제제3동,합계,8879,6854,2341,2597,1128,451,294,3,1,3,0,1,2,7,5,6833,21,2025
부산광역시,연제구,거제제3동,거제제3동제1투,2417,1775,610,623,302,142,91,0,1,0,0,1,0,1,1,1772,3,642
부산광역시,연제구,거제제3동,거제제3동제2투,2399,1595,453,704,281,88,60,0,0,2,0,0,1,4,0,1593,2,804
부산광역시,연제구,거제제3동,거제제3동제3투,2232,1653,525,669,275,105,65,3,0,1,0,0,0,0,2,1645,8,579
부산광역시,연제구,거제제4동,관내사전투표,1622,1622,725,430,242,130,86,0,0,1,0,1,0,1,0,1616,6,0
부산광역시,연제구,거제제4동,합계,8923,6937,2518,2378,1142,508,332,6,0,4,5,6,1,3,4,6907,30,1986
부산광역시,연제구,거제제4동,거제제4동제1투,3492,2556,873,921,433,197,112,3,0,2,1,3,0,2,1,2548,8,936
부산광역시,연제구,거제제4동,거제제4동제2투,1402,1008,383,304,199,61,54,1,0,0,3,0,0,0,0,1005,3,394
부산광역시,연제구,거제제4동,거제제4동제3투,2407,1751,537,723,268,120,80,2,0,1,1,2,1,0,3,1738,13,656
부산광역시,연제구,연산제1동,합계,12681,9861,3653,3372,1688,671,417,5,1,5,1,5,1,3,7,9829,32,2820
부산광역시,연제구,연산제1동,관내사전투표,2198,2198,1002,565,344,160,112,1,0,0,0,3,0,1,2,2190,8,0
부산광역시,연제구,연산제1동,연산제1동제1투,2681,2008,613,810,359,116,96,0,1,3,1,1,0,0,1,2001,7,673
부산광역시,연제구,연산제1동,연산제1동제2투,2494,1649,556,655,270,93,64,0,0,1,0,0,0,2,2,1643,6,845
부산광역시,연제구,연산제1동,연산제1동제3투,2396,1580,491,660,262,93,64,0,0,1,0,1,1,0,2,1575,5,816
부산광역시,연제구,연산제1동,연산제1동제4투,2912,2426,991,682,453,209,81,4,0,0,0,0,0,0,0,2420,6,486
부산광역시,연제구,연산제2동,관내사전투표,2539,2539,1208,597,379,187,152,2,0,0,0,0,0,1,1,2527,12,0
부산광역시,연제구,연산제2동,합계,11312,8619,3139,3055,1384,582,410,6,0,2,0,0,5,5,8,8596,23,2693
부산광역시,연제구,연산제2동,연산제2동제1투,2306,1721,587,672,285,103,68,0,0,0,0,0,2,0,2,1719,2,585
부산광역시,연제구,연산제2동,연산제2동제2투,1827,1237,334,555,205,72,62,2,0,0,0,0,2,1,1,1234,3,590
부산광역시,연제구,연산제2동,연산제2동제3투,2315,1607,490,709,250,98,51,2,0,1,0,0,0,1,2,1604,3,708
부산광역시,연제구,연산제2동,연산제2동제4투,2325,1515,520,522,265,122,77,0,0,1,0,0,1,2,2,1512,3,810
부산광역시,연제구,연산제3동,관내사전투표,1127,1127,475,322,177,78,62,1,0,0,0,0,1,1,0,1117,10,0
부산광역시,연제구,연산제3동,합계,8018,5688,1909,2145,947,361,271,6,2,4,0,0,6,3,3,5657,31,2330
부산광역시,연제구,연산제3동,연산제3동제1투,2336,1539,457,651,259,99,63,0,1,1,0,0,2,1,0,1534,5,797
부산광역시,연제구,연산제3동,연산제3동제2투,2819,1890,560,743,338,122,108,5,1,1,0,0,1,0,2,1881,9,929
부산광역시,연제구,연산제3동,연산제3동제3투,1736,1132,417,429,173,62,38,0,0,2,0,0,2,1,1,1125,7,604
부산광역시,연제구,연산제4동,합계,14414,10566,3689,3909,1772,675,457,7,1,6,0,3,1,1,7,10528,38,3848
부산광역시,연제구,연산제4동,관내사전투표,2433,2432,1023,784,338,159,118,2,1,2,0,1,0,0,0,2428,4,1
부산광역시,연제구,연산제4동,연산제4동제1투,3526,2493,879,895,424,160,125,1,0,0,0,1,0,0,3,2488,5,1033
부산광역시,연제구,연산제4동,연산제4동제2투,2724,1749,566,729,289,91,61,2,0,2,0,1,1,1,1,1744,5,975
부산광역시,연제구,연산제4동,연산제4동제3투,3159,2042,616,824,385,121,76,2,0,1,0,0,0,0,2,2027,15,1117
부산광역시,연제구,연산제4동,연산제4동제4투,2572,1850,605,677,336,144,77,0,0,1,0,0,0,0,1,1841,9,722
부산광역시,연제구,연산제5동,합계,11821,8406,3263,2616,1349,598,517,8,1,4,1,1,2,0,4,8364,42,3415
부산광역시,연제구,연산제5동,관내사전투표,2007,2007,948,507,258,143,135,1,0,2,0,1,0,0,2,1997,10,0
부산광역시,연제구,연산제5동,연산제5동제1투,3591,2337,831,763,413,187,129,3,0,0,0,0,0,0,0,2326,11,1254
부산광역시,연제구,연산제5동,연산제5동제2투,3852,2553,914,835,461,157,165,1,0,1,1,0,2,0,2,2539,14,1299
부산광역시,연제구,연산제5동,연산제5동제3투,2371,1509,570,511,217,111,88,3,1,1,0,0,0,0,0,1502,7,862
부산광역시,연제구,연산제6동,합계,12507,8891,3016,3397,1514,523,370,10,1,5,3,6,3,4,5,8857,34,3616
부산광역시,연제구,연산제6동,관내사전투표,1555,1555,683,471,236,94,61,3,0,0,1,0,0,2,0,1551,4,0
부산광역시,연제구,연산제6동,연산제6동제1투,1764,1200,378,493,207,73,40,3,0,0,1,0,0,0,0,1195,5,564
부산광역시,연제구,연산제6동,연산제6동제2투,2791,1934,560,827,320,102,102,2,1,2,0,1,2,2,3,1924,10,857
부산광역시,연제구,연산제6동,연산제6동제3투,2186,1253,406,496,225,80,41,0,0,1,1,0,0,0,1,1251,2,933
부산광역시,연제구,연산제6동,연산제6동제4투,1899,1308,419,518,244,68,46,2,0,2,0,2,0,0,0,1301,7,591
부산광역시,연제구,연산제6동,연산제6동제5투,2312,1641,570,592,282,106,80,0,0,0,0,3,1,0,1,1635,6,671
부산광역시,연제구,연산제8동,합계,11450,8701,3386,2683,1499,615,447,15,1,8,1,2,1,6,10,8674,27,2749
부산광역시,연제구,연산제8동,관내사전투표,1744,1744,937,300,242,139,113,2,0,3,0,0,0,2,3,1741,3,0
부산광역시,연제구,연산제8동,연산제8동제1투,2552,1690,513,677,312,101,73,3,0,2,0,0,0,1,1,1683,7,862
부산광역시,연제구,연산제8동,연산제8동제2투,2626,1803,577,677,326,105,105,0,0,2,1,0,0,1,4,1798,5,823
부산광역시,연제구,연산제8동,연산제8동제3투,1769,1219,361,532,201,63,50,4,1,0,0,2,0,1,0,1215,4,550
부산광역시,연제구,연산제8동,연산제8동제4투,2759,2245,998,497,418,207,106,6,0,1,0,0,1,1,2,2237,8,514
부산광역시,연제구,연산제9동,합계,28981,22491,8462,7195,3886,1721,1090,23,2,4,5,16,1,8,19,22432,59,6490
부산광역시,연제구,연산제9동,관내사전투표,3634,3634,1687,935,510,265,213,6,1,0,0,4,0,1,4,3626,8,0
부산광역시,연제구,연산제9동,연산제9동제1투,2359,1514,456,599,273,110,65,4,1,0,1,0,0,1,0,1510,4,845
부산광역시,연제구,연산제9동,연산제9동제2투,2303,1767,591,630,308,155,73,0,0,1,0,1,0,0,2,1761,6,536
부산광역시,연제구,연산제9동,연산제9동제3투,2316,1732,583,623,319,101,96,0,0,0,1,3,0,1,1,1728,4,584
부산광역시,연제구,연산제9동,연산제9동제4투,2960,2340,928,715,394,190,104,1,0,0,0,0,0,0,3,2335,5,620
부산광역시,연제구,연산제9동,연산제9동제5투,3421,2564,824,896,464,233,123,3,0,1,2,0,1,3,2,2552,12,857
부산광역시,연제구,연산제9동,연산제9동제6투,2521,1699,591,633,286,113,67,1,0,0,0,1,0,0,3,1695,4,822
부산광역시,연제구,연산제9동,연산제9동제7투,2431,1590,565,527,295,111,81,1,0,0,0,2,0,1,1,1584,6,841
부산광역시,연제구,연산제9동,연산제9동제8투,3059,2412,879,749,439,188,137,5,0,2,0,5,0,1,2,2407,5,647
부산광역시,연제구,연산제9동,연산제9동제9투,1217,1020,283,424,220,65,26,1,0,0,0,0,0,0,0,1019,1,197
부산광역시,연제구,연산제9동,연산제9동제10투,2760,2219,1075,464,378,190,105,1,0,0,1,0,0,0,1,2215,4,541
부산광역시,연제구,잘못 투입·구분된 투표지,,0,0,0,0,0,0,0,0,0,0,0,0,0,0,0,0,0,0
부산광역시,수영구,합계,,154637,119064,43702,39832,20319,8414,5952,171,10,70,18,38,22,47,91,118686,378,35573
부산광역시,수영구,거소·선상투표,,386,361,126,79,116,22,8,1,0,0,0,1,0,1,0,354,7,25
부산광역시,수영구,관외사전투표,,13409,13408,6067,2923,2150,1193,952,18,2,8,2,4,5,1,17,13342,66,1
부산광역시,수영구,재외투표,,1197,888,561,78,115,42,88,3,0,0,0,0,0,0,0,887,1,309
부산광역시,수영구,남천제1동,합계,11504,8682,3049,3018,1506,644,410,17,1,0,1,3,3,4,0,8656,26,2822
부산광역시,수영구,남천제1동,관내사전투표,1597,1597,716,424,226,127,99,1,0,0,0,1,0,0,0,1594,3,0
부산광역시,수영구,남천제1동,남천제1동제1투,2027,1336,376,565,239,84,64,3,0,0,0,0,0,1,0,1332,4,691
부산광역시,수영구,남천제1동,남천제1동제2투,2766,2074,685,749,383,177,67,6,0,0,0,1,1,1,0,2070,4,692
부산광역시,수영구,남천제1동,남천제1동제3투,2631,1936,658,658,359,138,104,4,1,0,1,0,1,1,0,1925,11,695
부산광역시,수영구,남천제1동,남천제1동제4투,2483,1739,614,622,299,118,76,3,0,0,0,1,1,1,0,1735,4,744
부산광역시,수영구,남천제2동,합계,10920,8544,2981,2983,1556,632,337,15,1,5,0,9,0,3,3,8525,19,2376
부산광역시,수영구,남천제2동,관내사전투표,2630,2630,1110,741,403,220,142,2,0,1,0,2,0,2,1,2624,6,0
부산광역시,수영구,남천제2동,남천제2동제1투,2525,1869,655,636,373,132,59,6,0,1,0,0,0,0,0,1862,7,656
부산광역시,수영구,남천제2동,남천제2동제2투,2884,2060,623,811,393,135,77,6,1,3,0,4,0,1,1,2055,5,824
부산광역시,수영구,남천제2동,남천제2동제3투,2881,1985,593,795,387,145,59,1,0,0,0,3,0,0,1,1984,1,896
부산광역시,수영구,수영동,합계,13385,10070,3349,4029,1594,638,389,19,0,9,1,3,1,5,12,10049,21,3315
부산광역시,수영구,수영동,관내사전투표,2395,2395,955,851,308,138,119,6,0,4,0,0,1,3,5,2390,5,0
부산광역시,수영구,수영동,수영동제1투,2773,1677,503,721,287,87,67,4,0,2,0,0,0,0,1,1672,5,1096
부산광역시,수영구,수영동,수영동제2투,3191,2240,700,905,383,154,83,4,0,2,1,1,0,0,3,2236,4,951
부산광역시,수영구,수영동,수영동제3투,2747,1964,585,863,314,128,65,2,0,1,0,0,0,2,1,1961,3,783
부산광역시,수영구,수영동,수영동제4투,2279,1794,606,689,302,131,55,3,0,0,0,2,0,0,2,1790,4,485
부산광역시,수영구,망미제1동,합계,21112,15913,5344,6048,2679,1055,689,16,1,7,1,6,3,4,10,15863,50,5199
부산광역시,수영구,망미제1동,관내사전투표,3371,3371,1381,1057,534,223,158,2,0,1,0,1,0,0,3,3360,11,0
부산광역시,수영구,망미제1동,망미제1동제1투,3201,2298,718,878,415,184,86,2,0,4,1,2,1,0,0,2291,7,903
부산광역시,수영구,망미제1동,망미제1동제2투,2373,1764,526,728,301,127,71,3,1,0,0,0,0,0,1,1758,6,609
부산광역시,수영구,망미제1동,망미제1동제3투,2685,1892,603,800,298,118,61,1,0,1,0,0,0,1,3,1886,6,793
부산광역시,수영구,망미제1동,망미제1동제4투,2530,1773,576,677,310,109,87,0,0,0,0,2,1,2,2,1766,7,757
부산광역시,수영구,망미제1동,망미제1동제5투,2065,1423,441,602,223,83,67,3,0,0,0,0,0,0,0,1419,4,642
부산광역시,수영구,망미제1동,망미제1동제6투,2464,1649,540,644,277,105,77,1,0,0,0,0,0,1,0,1645,4,815
부산광역시,수영구,망미제1동,망미제1동제7투,2423,1743,559,662,321,106,82,4,0,1,0,1,1,0,1,1738,5,680
부산광역시,수영구,망미제2동,합계,9755,7337,2568,2563,1325,468,345,14,1,6,0,5,2,5,12,7314,23,2418
부산광역시,수영구,망미제2동,관내사전투표,1151,1151,484,330,184,68,71,3,0,3,0,0,0,1,1,1145,6,0
부산광역시,수영구,망미제2동,망미제2동제1투,2681,1749,513,743,306,87,80,3,0,1,0,4,1,1,3,1742,7,932
부산광역시,수영구,망미제2동,망미제2동제2투,2952,2334,928,641,446,191,109,8,0,0,0,0,1,1,4,2329,5,618
부산광역시,수영구,망미제2동,망미제2동제3투,2971,2103,643,849,389,122,85,0,1,2,0,1,0,2,4,2098,5,868
부산광역시,수영구,광안제1동,합계,20272,15158,5822,4746,2601,1050,836,21,1,10,3,2,2,5,12,15111,47,5114
부산광역시,수영구,광안제1동,관내사전투표,3475,3474,1589,859,539,237,228,6,0,0,1,1,1,2,1,3464,10,1
부산광역시,수영구,광안제1동,광안제1동제1투,4077,2674,1021,859,454,183,141,2,1,5,0,0,1,1,1,2669,5,1403
부산광역시,수영구,광안제1동,광안제1동제2투,3062,2328,835,792,424,145,115,2,0,0,1,0,0,2,3,2319,9,734
부산광역시,수영구,광안제1동,광안제1동제3투,3027,2333,807,765,445,199,104,4,0,0,1,0,0,0,2,2327,6,694
부산광역시,수영구,광안제1동,광안제1동제4투,3480,2247,838,708,391,169,124,1,0,2,0,1,0,0,2,2236,11,1233
부산광역시,수영구,광안제1동,광안제1동제5투,3151,2102,732,763,348,117,124,6,0,3,0,0,0,0,3,2096,6,1049
부산광역시,수영구,광안제2동,관내사전투표,2967,2967,1286,830,463,202,164,6,1,5,1,0,0,3,1,2962,5,0
부산광역시,수영구,광안제2동,합계,14643,10843,4000,3498,1931,787,553,12,2,6,5,1,1,6,7,10809,34,3800
부산광역시,수영구,광안제2동,광안제2동제1투,3701,2502,855,839,486,203,108,1,0,0,2,0,0,1,2,2497,5,1199
부산광역시,수영구,광안제2동,광안제2동제2투,2159,1445,490,523,244,102,72,1,0,1,1,0,1,2,2,1439,6,714
부산광역시,수영구,광안제2동,광안제2동제3투,2870,1963,671,656,399,130,98,3,1,0,0,0,0,0,0,1958,5,907
부산광역시,수영구,광안제2동,광안제2동제4투,2946,1966,698,650,339,150,111,1,0,0,1,1,0,0,2,1953,13,980
부산광역시,수영구,광안제3동,합계,8599,6120,2109,2209,1021,410,324,4,1,2,3,3,2,2,4,6094,26,2479
부산광역시,수영구,광안제3동,관내사전투표,1489,1489,663,424,202,105,86,1,0,1,0,0,0,0,2,1484,5,0
부산광역시,수영구,광안제3동,광안제3동제1투,2889,1751,625,574,288,133,119,3,0,0,2,3,0,1,1,1749,2,1138
부산광역시,수영구,광안제3동,광안제3동제2투,2374,1629,484,658,309,90,76,0,0,0,1,0,2,0,1,1621,8,745
부산광역시,수영구,광안제3동,광안제3동제3투,1847,1251,337,553,222,82,43,0,1,1,0,0,0,1,0,1240,11,596
부산광역시,수영구,광안제4동,합계,10372,7775,2849,2614,1303,545,409,11,0,8,1,0,0,4,5,7749,26,2597
부산광역시,수영구,광안제4동,관내사전투표,2238,2238,911,672,357,170,120,0,0,2,0,0,0,0,0,2232,6,0
부산광역시,수영구,광안제4동,광안제4동제1투,3491,2316,821,772,380,183,138,4,0,3,1,0,0,1,3,2306,10,1175
부산광역시,수영구,광안제4동,광안제4동제2투,1982,1411,481,520,253,78,70,3,0,0,0,0,0,1,1,1407,4,571
부산광역시,수영구,광안제4동,광안제4동제3투,2661,1810,636,650,313,114,81,4,0,3,0,0,0,2,1,1804,6,851
부산광역시,수영구,민락동,합계,19083,13964,4877,5044,2421,928,612,20,0,9,1,1,3,7,9,13932,32,5119
부산광역시,수영구,민락동,관내사전투표,2956,2956,1207,1019,425,153,136,1,0,1,0,0,1,3,1,2947,9,0
부산광역시,수영구,민락동,민락동제1투,3222,1953,656,730,335,142,76,1,0,1,0,0,0,0,5,1946,7,1269
부산광역시,수영구,민락동,민락동제2투,2505,1582,509,622,278,90,74,2,0,2,0,0,0,3,0,1580,2,923
부산광역시,수영구,민락동,민락동제3투,2643,1677,553,608,295,133,80,1,0,2,0,0,1,1,1,1675,2,966
부산광역시,수영구,민락동,민락동제4투,3002,2041,655,801,359,116,92,6,0,2,1,0,1,0,1,2034,7,961
부산광역시,수영구,민락동,민락동제5투,3003,2344,802,834,435,162,101,6,0,0,0,0,0,0,1,2341,3,659
부산광역시,수영구,민락동,민락동제6투,1752,1411,495,430,294,132,53,3,0,1,0,1,0,0,0,1409,2,341
부산광역시,수영구,잘못 투입·구분된 투표지,,0,1,0,0,1,0,0,0,0,0,0,0,0,0,0,1,0,-1
부산광역시,사상구,합계,,198198,149868,61743,46540,23023,10096,7156,125,20,109,28,75,46,52,168,149181,687,48330
부산광역시,사상구,거소·선상투표,,482,453,172,84,125,27,21,0,3,2,0,1,2,1,1,439,14,29
부산광역시,사상구,관외사전투표,,14428,14421,6988,2805,2164,1329,954,12,3,5,2,10,6,3,30,14311,110,7
부산광역시,사상구,재외투표,,784,629,408,42,88,21,68,1,0,0,0,0,0,1,0,629,0,155
부산광역시,사상구,삼락동,관내사전투표,660,660,295,186,96,30,45,0,0,1,0,0,1,1,1,656,4,0
부산광역시,사상구,삼락동,합계,5648,3666,1362,1340,571,174,176,4,0,3,1,0,3,3,5,3642,24,1982
부산광역시,사상구,삼락동,삼락동제1투,839,574,162,263,93,25,24,3,0,0,1,0,0,0,1,572,2,265
부산광역시,사상구,삼락동,삼락동제2투,2142,1191,446,439,180,60,53,0,0,1,0,0,1,1,2,1183,8,951
부산광역시,사상구,삼락동,삼락동제3투,2007,1241,459,452,202,59,54,1,0,1,0,0,1,1,1,1231,10,766
부산광역시,사상구,모라제1동,합계,23193,17302,6786,5863,2565,1137,798,11,1,13,8,10,5,5,18,17220,82,5891
부산광역시,사상구,모라제1동,관내사전투표,3407,3407,1692,887,426,208,175,1,0,2,0,3,0,2,2,3398,9,0
부산광역시,사상구,모라제1동,모라제1동제1투,3057,2288,895,727,372,154,121,1,1,2,0,1,0,1,3,2278,10,769
부산광역시,사상구,모라제1동,모라제1동제2투,2991,2290,897,758,345,148,114,4,0,2,1,2,0,1,3,2275,15,701
부산광역시,사상구,모라제1동,모라제1동제3투,2615,1923,711,672,306,140,82,1,0,0,0,1,0,0,1,1914,9,692
부산광역시,사상구,모라제1동,모라제1동제4투,3061,2220,898,695,324,182,106,0,0,2,0,0,0,0,1,2208,12,841
부산광역시,사상구,모라제1동,모라제1동제5투,2666,1635,560,621,259,102,81,0,0,0,3,1,2,0,2,1631,4,1031
부산광역시,사상구,모라제1동,모라제1동제6투,1946,1255,411,521,179,78,44,2,0,4,2,1,1,0,5,1248,7,691
부산광역시,사상구,모라제1동,모라제1동제7투,1712,1165,365,489,200,59,39,2,0,0,1,1,1,1,0,1158,7,547
부산광역시,사상구,모라제1동,모라제1동제8투,1738,1119,357,493,154,66,36,0,0,1,1,0,1,0,1,1110,9,619
부산광역시,사상구,모라제3동,합계,11137,7972,2984,2884,1278,476,259,9,3,12,4,2,3,3,7,7924,48,3165
부산광역시,사상구,모라제3동,관내사전투표,1772,1771,807,536,250,107,53,1,2,4,0,1,0,2,0,1763,8,1
부산광역시,사상구,모라제3동,모라제3동제1투,2837,1942,732,691,312,105,75,2,0,2,0,0,1,1,2,1923,19,895
부산광역시,사상구,모라제3동,모라제3동제2투,2267,1487,439,650,257,82,36,4,0,3,1,0,2,0,2,1476,11,780
부산광역시,사상구,모라제3동,모라제3동제3투,2052,1237,425,469,209,76,46,0,0,2,3,1,0,0,1,1232,5,815
부산광역시,사상구,모라제3동,모라제3동제4투,2209,1535,581,538,250,106,49,2,1,1,0,0,0,0,2,1530,5,674
부산광역시,사상구,덕포제1동,합계,10075,7267,2863,2430,1201,440,279,7,0,5,1,5,0,4,7,7242,25,2808
부산광역시,사상구,덕포제1동,관내사전투표,2026,2026,850,661,296,121,86,2,0,1,0,2,0,4,1,2024,2,0
부산광역시,사상구,덕포제1동,덕포제1동제1투,2410,1499,532,562,275,74,42,1,0,2,1,3,0,0,0,1492,7,911
부산광역시,사상구,덕포제1동,덕포제1동제2투,2432,1385,464,554,237,67,52,1,0,0,0,0,0,0,1,1376,9,1047
부산광역시,사상구,덕포제1동,덕포제1동제3투,3207,2357,1017,653,393,178,99,3,0,2,0,0,0,0,5,2350,7,850
부산광역시,사상구,덕포제2동,합계,11156,8200,3315,2645,1295,533,341,7,0,10,0,1,3,6,6,8162,38,2956
부산광역시,사상구,덕포제2동,관내사전투표,1559,1559,742,410,210,112,71,2,0,1,0,0,2,1,0,1551,8,0
부산광역시,사상구,덕포제2동,덕포제2동제1투,1959,1327,479,460,219,104,51,1,0,4,0,0,0,1,1,1320,7,632
부산광역시,사상구,덕포제2동,덕포제2동제2투,2027,1415,570,471,218,87,55,0,0,3,0,0,0,2,2,1408,7,612
부산광역시,사상구,덕포제2동,덕포제2동제3투,2889,1968,766,664,334,109,80,0,0,0,0,1,0,1,2,1957,11,921
부산광역시,사상구,덕포제2동,덕포제2동제4투,2722,1931,758,640,314,121,84,4,0,2,0,0,1,1,1,1926,5,791
부산광역시,사상구,괘법동,합계,17811,12368,5074,3962,1854,819,562,8,3,6,2,7,4,4,15,12320,48,5443
부산광역시,사상구,괘법동,관내사전투표,2081,2081,1086,477,251,140,114,2,1,1,0,2,1,0,2,2077,4,0
부산광역시,사상구,괘법동,괘법동제1투,3160,1976,702,731,300,131,99,1,0,0,1,0,0,0,1,1966,10,1184
부산광역시,사상구,괘법동,괘법동제2투,2780,1562,568,578,248,93,61,0,0,1,0,1,0,3,3,1556,6,1218
부산광역시,사상구,괘법동,괘법동제3투,3762,2311,876,802,365,151,95,2,2,0,0,1,3,1,3,2301,10,1451
부산광역시,사상구,괘법동,괘법동제4투,2965,2142,877,665,353,131,98,3,0,3,0,1,0,0,4,2135,7,823
부산광역시,사상구,괘법동,괘법동제5투,3063,2296,965,709,337,173,95,0,0,1,1,2,0,0,2,2285,11,767
부산광역시,사상구,감전동,합계,12158,8181,2931,3238,1166,461,317,4,4,4,0,3,1,2,11,8142,39,3977
부산광역시,사상구,감전동,관내사전투표,1643,1643,731,503,217,94,85,1,0,0,0,0,0,1,2,1634,9,0
부산광역시,사상구,감전동,감전동제1투,2993,1866,672,729,271,125,58,1,1,1,0,1,0,0,2,1861,5,1127
부산광역시,사상구,감전동,감전동제2투,2562,1631,524,771,208,70,40,0,2,1,0,1,1,1,1,1620,11,931
부산광역시,사상구,감전동,감전동제3투,2614,1632,538,681,234,91,76,2,0,1,0,1,0,0,4,1628,4,982
부산광역시,사상구,감전동,감전동제4투,2346,1409,466,554,236,81,58,0,1,1,0,0,0,0,2,1399,10,937
부산광역시,사상구,주례제1동,합계,12168,9058,3635,3010,1334,600,414,9,1,3,0,3,4,7,11,9031,27,3110
부산광역시,사상구,주례제1동,관내사전투표,1768,1768,859,454,232,124,88,1,1,2,0,3,1,0,0,1765,3,0
부산광역시,사상구,주례제1동,주례제1동제1투,1553,884,307,356,133,47,32,2,0,1,0,0,0,1,0,879,5,669
부산광역시,사상구,주례제1동,주례제1동제2투,2744,1943,724,706,296,122,84,2,0,0,0,0,0,1,3,1938,5,801
부산광역시,사상구,주례제1동,주례제1동제3투,2994,2191,844,750,324,157,98,2,0,0,0,0,2,3,2,2182,9,803
부산광역시,사상구,주례제1동,주례제1동제4투,3109,2272,901,744,349,150,112,2,0,0,0,0,1,2,6,2267,5,837
부산광역시,사상구,주례제2동,합계,19022,14231,5866,4351,2186,987,739,11,0,9,0,8,4,3,15,14179,52,4791
부산광역시,사상구,주례제2동,관내사전투표,1665,1665,821,371,201,128,131,1,0,3,0,1,0,0,2,1659,6,0
부산광역시,사상구,주례제2동,주례제2동제1투,2173,1455,526,523,191,110,88,4,0,0,0,2,0,0,3,1447,8,718
부산광역시,사상구,주례제2동,주례제2동제2투,2713,1520,530,547,222,110,96,1,0,1,0,1,1,0,1,1510,10,1193
부산광역시,사상구,주례제2동,주례제2동제3투,2164,1481,534,549,232,76,79,0,0,0,0,1,2,1,2,1476,5,683
부산광역시,사상구,주례제2동,주례제2동제4투,1379,854,304,349,119,46,26,1,0,0,0,2,0,0,1,848,6,525
부산광역시,사상구,주례제2동,주례제2동제5투,2703,2187,906,607,384,183,100,2,0,0,0,0,0,0,1,2183,4,516
부산광역시,사상구,주례제2동,주례제2동제6투,2977,2356,1031,686,370,169,85,0,0,3,0,1,1,1,2,2349,7,621
부산광역시,사상구,주례제2동,주례제2동제7투,3248,2713,1214,719,467,165,134,2,0,2,0,0,0,1,3,2707,6,535
부산광역시,사상구,주례제3동,합계,11580,8960,3582,2867,1396,612,429,7,0,6,2,2,3,0,6,8912,48,2620
부산광역시,사상구,주례제3동,관내사전투표,1930,1930,960,424,260,151,117,0,0,1,0,0,0,0,0,1913,17,0
부산광역시,사상구,주례제3동,주례제3동제1투,2322,1524,559,562,241,93,52,2,0,1,1,0,1,0,1,1513,11,798
부산광역시,사상구,주례제3동,주례제3동제2투,3451,2702,1085,834,460,172,138,1,0,2,0,1,1,0,1,2695,7,749
부산광역시,사상구,주례제3동,주례제3동제3투,2200,1661,623,562,267,119,76,4,0,0,0,1,1,0,1,1654,7,539
부산광역시,사상구,주례제3동,주례제3동제4투,1677,1143,355,485,168,77,46,0,0,2,1,0,0,0,3,1137,6,534
부산광역시,사상구,학장동,관내사전투표,2818,2818,1452,646,376,181,145,2,0,4,0,0,0,1,2,2809,9,0
부산광역시,사상구,학장동,합계,24819,18922,7909,5812,2958,1225,862,23,0,19,5,13,3,5,20,18854,68,5897
부산광역시,사상구,학장동,학장동제1투,2647,2029,807,658,342,119,89,2,0,2,3,1,0,0,1,2024,5,618
부산광역시,사상구,학장동,학장동제2투,1881,1088,355,465,173,56,31,0,0,0,0,2,0,0,1,1083,5,793
부산광역시,사상구,학장동,학장동제3투,3830,2908,1199,924,433,185,146,2,0,1,1,2,1,0,3,2897,11,922
부산광역시,사상구,학장동,학장동제4투,2387,1678,678,550,264,94,71,6,0,1,0,0,0,1,5,1670,8,709
부산광역시,사상구,학장동,학장동제5투,2908,2236,859,742,387,149,87,2,0,2,0,0,1,1,1,2231,5,672
부산광역시,사상구,학장동,학장동제6투,2179,1470,569,504,218,91,67,1,0,4,1,3,0,2,2,1462,8,709
부산광역시,사상구,학장동,학장동제7투,2706,2007,848,607,300,145,89,5,0,3,0,2,1,0,0,2000,7,699
부산광역시,사상구,학장동,학장동제8투,3463,2688,1142,716,465,205,137,3,0,2,0,3,0,0,5,2678,10,775
부산광역시,사상구,엄궁동,합계,23737,18238,7868,5207,2842,1255,937,12,2,12,3,10,5,5,16,18174,64,5499
부산광역시,사상구,엄궁동,관내사전투표,4091,4091,2043,1004,536,274,207,2,1,3,0,1,1,0,1,4073,18,0
부산광역시,사상구,엄궁동,엄궁동제1투,2629,1825,749,538,312,107,106,1,0,3,0,0,0,1,3,1820,5,804
부산광역시,사상구,엄궁동,엄궁동제2투,2393,1419,481,539,249,73,64,1,0,0,1,1,1,0,1,1411,8,974
부산광역시,사상구,엄궁동,엄궁동제3투,2796,1942,721,659,302,140,99,0,1,3,1,1,0,0,3,1930,12,854
부산광역시,사상구,엄궁동,엄궁동제4투,2542,1642,635,550,243,116,88,3,0,0,0,2,0,0,3,1640,2,900
부산광역시,사상구,엄궁동,엄궁동제5투,3256,2586,1200,623,397,205,145,1,0,1,0,2,1,0,3,2578,8,670
부산광역시,사상구,엄궁동,엄궁동제6투,2544,1909,849,484,319,139,103,3,0,1,0,1,1,3,1,1904,5,635
부산광역시,사상구,엄궁동,엄궁동제7투,3486,2824,1190,810,484,201,125,1,0,1,1,2,1,1,1,2818,6,662
부산광역시,사상구,잘못 투입·구분된 투표지,,0,0,0,0,0,0,0,0,0,0,0,0,0,0,0,0,0,0
대구광역시,합계,,,2043276,1581347,342620,714205,235757,198459,74440,4057,259,563,324,804,401,986,1501,1574376,6971,461929
대구광역시,중구,합계,,68857,52180,11477,24698,7170,5931,2369,157,5,22,9,21,10,42,37,51948,232,16677
대구광역시,중구,거소·선상투표,,104,94,20,32,24,10,4,2,0,0,0,0,0,0,0,92,2,10
대구광역시,중구,관외사전투표,,5883,5883,1765,1913,892,837,404,16,1,2,0,5,1,5,8,5849,34,0
대구광역시,중구,재외투표,,536,340,187,42,55,18,34,1,0,0,0,0,0,1,0,338,2,196
대구광역시,중구,동인동,합계,8453,5806,1126,2922,806,641,256,16,1,3,0,0,3,5,6,5785,21,2647
대구광역시,중구,동인동,관내사전투표,1372,1372,327,619,181,163,67,5,0,1,0,0,0,3,2,1368,4,0
대구광역시,중구,동인동,동인동제1투,2267,1346,216,735,192,136,60,2,0,0,0,0,1,1,1,1344,2,921
대구광역시,중구,동인동,동인동제2투,2597,1633,366,726,250,201,75,6,0,2,0,0,0,1,0,1627,6,964
대구광역시,중구,동인동,동인동제3투,2217,1455,217,842,183,141,54,3,1,0,0,0,2,0,3,1446,9,762
대구광역시,중구,삼덕동,합계,5183,3716,992,1383,573,520,218,7,0,3,0,1,0,1,2,3700,16,1467
대구광역시,중구,삼덕동,관내사전투표,1066,1066,336,350,152,150,66,1,0,1,0,1,0,0,2,1059,7,0
대구광역시,중구,삼덕동,삼덕동제1투,2655,1784,430,705,287,262,86,4,0,2,0,0,0,1,0,1777,7,871
대구광역시,중구,삼덕동,삼덕동제2투,1462,866,226,328,134,108,66,2,0,0,0,0,0,0,0,864,2,596
대구광역시,중구,성내1동,합계,3751,2496,580,1169,318,269,128,7,0,1,0,1,0,2,2,2477,19,1255
대구광역시,중구,성내1동,관내사전투표,554,554,187,201,65,62,32,2,0,1,0,0,0,0,2,552,2,0
대구광역시,중구,성내1동,성내1동제1투,1928,1033,204,530,130,103,52,3,0,0,0,0,0,2,0,1024,9,895
대구광역시,중구,성내1동,성내1동제2투,1269,909,189,438,123,104,44,2,0,0,0,1,0,0,0,901,8,360
대구광역시,중구,성내2동,합계,4203,2950,544,1621,359,275,111,11,1,3,3,3,0,1,3,2935,15,1253
대구광역시,중구,성내2동,관내사전투표,743,743,201,313,90,88,41,2,1,1,0,2,0,1,1,741,2,0
대구광역시,중구,성내2동,성내2동제1투,1918,1215,188,686,165,118,36,8,0,2,2,0,0,0,1,1206,9,703
대구광역시,중구,성내2동,성내2동제2투,1542,992,155,622,104,69,34,1,0,0,1,1,0,0,1,988,4,550
대구광역시,중구,성내3동,합계,3010,2013,313,1211,251,172,49,10,0,0,0,0,0,3,0,2009,4,997
대구광역시,중구,성내3동,관내사전투표,422,422,91,212,56,41,16,3,0,0,0,0,0,1,0,420,2,0
대구광역시,중구,성내3동,성내3동제1투,1382,809,119,503,86,74,20,5,0,0,0,0,0,1,0,808,1,573
대구광역시,중구,성내3동,성내3동제2투,1206,782,103,496,109,57,13,2,0,0,0,0,0,1,0,781,1,424
대구광역시,중구,대신동,합계,5855,4590,1003,2274,595,528,158,7,0,0,1,0,1,6,4,4577,13,1265
대구광역시,중구,대신동,관내사전투표,1285,1285,390,515,161,165,47,2,0,0,0,0,0,2,1,1283,2,0
대구광역시,중구,대신동,대신동제1투,2725,1987,428,948,287,241,69,3,0,0,1,0,0,1,2,1980,7,738
대구광역시,중구,대신동,대신동제2투,1845,1318,185,811,147,122,42,2,0,0,0,0,1,3,1,1314,4,527
대구광역시,중구,남산1동,합계,4058,2926,595,1536,353,300,105,11,0,0,1,1,3,0,4,2909,17,1132
대구광역시,중구,남산1동,관내사전투표,591,591,171,248,77,58,28,0,0,0,0,0,3,0,0,585,6,0
대구광역시,중구,남산1동,남산1동제1투,1597,961,150,603,94,72,29,3,0,0,1,1,0,0,1,954,7,636
대구광역시,중구,남산1동,남산1동제2투,1870,1374,274,685,182,170,48,8,0,0,0,0,0,0,3,1370,4,496
대구광역시,중구,남산2동,합계,3737,2750,504,1472,358,282,104,12,0,2,0,0,0,3,0,2737,13,987
대구광역시,중구,남산2동,관내사전투표,712,712,176,325,90,79,39,2,0,1,0,0,0,0,0,712,0,0
대구광역시,중구,남산2동,남산2동제1투,1880,1243,205,641,187,147,50,4,0,0,0,0,0,2,0,1236,7,637
대구광역시,중구,남산2동,남산2동제2투,1145,795,123,506,81,56,15,6,0,1,0,0,0,1,0,789,6,350
대구광역시,중구,남산3동,합계,5461,4161,1003,1851,598,498,172,6,0,2,3,4,0,1,2,4140,21,1300
대구광역시,중구,남산3동,관내사전투표,1050,1050,316,409,139,135,44,4,0,1,0,1,0,0,0,1049,1,0
대구광역시,중구,남산3동,남산3동제1투,2540,1874,488,746,306,239,82,2,0,1,0,2,0,0,0,1866,8,666
대구광역시,중구,남산3동,남산3동제2투,1871,1237,199,696,153,124,46,0,0,0,3,1,0,1,2,1225,12,634
대구광역시,중구,남산4동,합계,9772,7687,1510,3856,1063,805,365,34,1,6,1,3,2,8,5,7659,28,2085
대구광역시,중구,남산4동,관내사전투표,1444,1444,356,673,168,154,72,10,0,2,0,0,1,0,0,1436,8,0
대구광역시,중구,남산4동,남산4동제1투,2481,1643,262,965,202,124,69,4,0,0,0,1,1,7,3,1638,5,838
대구광역시,중구,남산4동,남산4동제2투,3535,2762,558,1259,430,332,153,13,1,4,1,0,0,1,1,2753,9,773
대구광역시,중구,남산4동,남산4동제3투,2312,1838,334,959,263,195,71,7,0,0,0,2,0,0,1,1832,6,474
대구광역시,중구,대봉1동,합계,6289,4915,994,2425,678,583,201,13,1,0,0,2,0,2,0,4899,16,1374
대구광역시,중구,대봉1동,관내사전투표,1239,1239,335,543,147,151,51,5,1,0,0,0,0,1,0,1234,5,0
대구광역시,중구,대봉1동,대봉1동제1투,2338,1632,333,768,242,202,71,5,0,0,0,2,0,1,0,1624,8,706
대구광역시,중구,대봉1동,대봉1동제2투,2712,2044,326,1114,289,230,79,3,0,0,0,0,0,0,0,2041,3,668
대구광역시,중구,대봉2동,관내사전투표,396,396,111,169,50,43,17,1,0,0,0,0,0,1,1,393,3,0
대구광역시,중구,대봉2동,합계,2562,1853,341,991,247,193,60,4,0,0,0,1,0,4,1,1842,11,709
대구광역시,중구,대봉2동,대봉2동제1투,1030,658,115,350,98,67,23,2,0,0,0,0,0,0,0,655,3,372
대구광역시,중구,대봉2동,대봉2동제2투,1136,799,115,472,99,83,20,1,0,0,0,1,0,3,0,794,5,337
대구광역시,중구,잘못 투입·구분된 투표지,,0,0,0,0,0,0,0,0,0,0,0,0,0,0,0,0,0,0
대구광역시,동구,합계,,294274,226510,47350,100166,31351,35819,9509,609,40,84,41,132,61,157,185,225504,1006,67764
대구광역시,동구,거소·선상투표,,784,742,180,188,146,95,23,8,6,4,2,3,7,4,8,674,68,42
대구광역시,동구,관외사전투표,,22808,22806,6656,6881,3655,3915,1405,49,7,7,2,17,9,10,45,22658,148,2
대구광역시,동구,재외투표,,1312,971,509,84,172,76,110,10,0,1,0,2,1,0,1,966,5,341
대구광역시,동구,신암1동,합계,9264,6762,1049,3832,866,714,221,25,4,2,0,2,3,8,8,6734,28,2502
대구광역시,동구,신암1동,관내사전투표,1462,1462,305,707,192,187,56,2,1,0,0,2,1,2,1,1456,6,0
대구광역시,동구,신암1동,신암1동제1투,2189,1287,183,775,160,110,44,4,0,1,0,0,1,1,5,1284,3,902
대구광역시,동구,신암1동,신암1동제2투,2578,1900,298,1067,260,198,61,4,2,1,0,0,0,2,0,1893,7,678
대구광역시,동구,신암1동,신암1동제3투,3035,2113,263,1283,254,219,60,15,1,0,0,0,1,3,2,2101,12,922
대구광역시,동구,신암2동,관내사전투표,1848,1848,511,680,276,265,98,6,0,0,2,1,0,4,1,1844,4,0
대구광역시,동구,신암2동,합계,9403,7364,1577,3255,1150,1003,310,21,2,1,3,2,0,7,5,7336,28,2039
대구광역시,동구,신암2동,신암2동제1투,2810,2061,459,858,341,304,85,2,1,1,1,0,0,2,3,2057,4,749
대구광역시,동구,신암2동,신암2동제2투,2338,1582,287,778,232,203,66,4,1,0,0,1,0,0,0,1572,10,756
대구광역시,동구,신암2동,신암2동제3투,2407,1873,320,939,301,231,61,9,0,0,0,0,0,1,1,1863,10,534
대구광역시,동구,신암3동,합계,6409,4613,839,2424,583,561,166,9,0,2,1,3,1,1,3,4593,20,1796
대구광역시,동구,신암3동,관내사전투표,1193,1193,280,592,137,129,45,4,0,1,0,0,0,0,1,1189,4,0
대구광역시,동구,신암3동,신암3동제1투,2546,1770,280,903,255,244,76,2,0,0,0,0,0,0,0,1760,10,776
대구광역시,동구,신암3동,신암3동제2투,2670,1650,279,929,191,188,45,3,0,1,1,3,1,1,2,1644,6,1020
대구광역시,동구,신암4동,관내사전투표,1959,1959,472,886,259,232,94,3,0,1,0,0,0,0,0,1947,12,0
대구광역시,동구,신암4동,합계,13774,9541,1664,4988,1306,1114,385,25,2,6,1,2,1,4,3,9501,40,4233
대구광역시,동구,신암4동,신암4동제1투,3259,1903,322,973,292,219,80,7,0,1,0,0,0,1,1,1896,7,1356
대구광역시,동구,신암4동,신암4동제2투,2735,1808,254,1044,248,193,50,7,1,1,1,0,0,1,1,1801,7,927
대구광역시,동구,신암4동,신암4동제3투,2601,1815,280,995,220,229,78,1,0,2,0,1,0,1,1,1808,7,786
대구광역시,동구,신암4동,신암4동제4투,3220,2056,336,1090,287,241,83,7,1,1,0,1,1,1,0,2049,7,1164
대구광역시,동구,신암5동,합계,7506,5772,1085,2910,722,770,240,8,0,2,0,5,2,1,3,5748,24,1734
대구광역시,동구,신암5동,관내사전투표,2091,2091,550,821,240,345,114,4,0,0,0,3,2,1,2,2082,9,0
대구광역시,동구,신암5동,신암5동제1투,2679,1807,264,1042,233,199,59,0,0,2,0,1,0,0,0,1800,7,872
대구광역시,동구,신암5동,신암5동제2투,2736,1874,271,1047,249,226,67,4,0,0,0,1,0,0,1,1866,8,862
대구광역시,동구,신천1·2동,합계,11001,8688,1848,4081,1269,1026,393,20,3,1,1,5,0,7,2,8656,32,2313
대구광역시,동구,신천1·2동,관내사전투표,1724,1724,452,689,255,202,111,5,1,1,1,1,0,0,1,1719,5,0
대구광역시,동구,신천1·2동,신천1·2동제1투,2118,1614,313,789,254,172,68,5,1,0,0,4,0,2,0,1608,6,504
대구광역시,동구,신천1·2동,신천1·2동제2투,2169,1594,321,761,239,203,57,4,0,0,0,0,0,1,0,1586,8,575
대구광역시,동구,신천1·2동,신천1·2동제3투,2185,1499,227,884,182,136,57,2,1,0,0,0,0,3,1,1493,6,686
대구광역시,동구,신천1·2동,신천1·2동제4투,2805,2257,535,958,339,313,100,4,0,0,0,0,0,1,0,2250,7,548
대구광역시,동구,신천3동,합계,9269,7075,1388,3365,1048,916,293,21,0,2,2,3,2,7,1,7048,27,2194
대구광역시,동구,신천3동,관내사전투표,1602,1602,432,659,214,222,64,5,0,1,1,1,0,0,0,1599,3,0
대구광역시,동구,신천3동,신천3동제1투,1423,887,126,490,128,89,44,3,0,0,0,2,0,1,0,883,4,536
대구광역시,동구,신천3동,신천3동제2투,3232,2410,461,1137,361,329,96,10,0,1,0,0,1,3,0,2399,11,822
대구광역시,동구,신천3동,신천3동제3투,3012,2176,369,1079,345,276,89,3,0,0,1,0,1,3,1,2167,9,836
대구광역시,동구,신천4동,합계,7751,5529,1047,2808,753,643,233,13,0,2,2,2,1,2,4,5510,19,2222
대구광역시,동구,신천4동,관내사전투표,1479,1479,347,667,185,186,78,5,0,1,1,0,1,1,1,1473,6,0
대구광역시,동구,신천4동,신천4동제1투,1706,1156,162,640,162,145,38,2,0,1,1,1,0,0,0,1152,4,550
대구광역시,동구,신천4동,신천4동제2투,2649,1607,364,737,229,178,87,4,0,0,0,1,0,0,2,1602,5,1042
대구광역시,동구,신천4동,신천4동제3투,1917,1287,174,764,177,134,30,2,0,0,0,0,0,1,1,1283,4,630
대구광역시,동구,효목1동,합계,12032,8778,1474,4661,1195,1056,306,21,2,5,4,8,1,7,9,8749,29,3254
대구광역시,동구,효목1동,관내사전투표,1422,1422,341,664,164,181,63,3,0,0,0,1,0,0,2,1419,3,0
대구광역시,동구,효목1동,효목1동제1투,1775,1223,171,679,174,142,42,6,0,2,1,0,0,2,1,1220,3,552
대구광역시,동구,효목1동,효목1동제2투,1968,1390,215,778,191,148,43,1,1,1,2,1,0,0,1,1382,8,578
대구광역시,동구,효목1동,효목1동제3투,1978,1297,193,747,166,140,38,5,0,0,0,2,0,0,1,1292,5,681
대구광역시,동구,효목1동,효목1동제4투,2630,2024,353,980,321,278,76,4,1,2,1,0,1,2,2,2021,3,606
대구광역시,동구,효목1동,효목1동제5투,2259,1422,201,813,179,167,44,2,0,0,0,4,0,3,2,1415,7,837
대구광역시,동구,효목2동,합계,12782,9517,1884,4806,1262,1152,340,19,1,4,0,4,0,4,5,9481,36,3265
대구광역시,동구,효목2동,관내사전투표,2130,2130,539,974,258,259,84,5,0,0,0,0,0,1,0,2120,10,0
대구광역시,동구,효목2동,효목2동제1투,1613,1037,157,585,150,110,29,1,0,0,0,2,0,0,0,1034,3,576
대구광역시,동구,효목2동,효목2동제2투,2445,1620,270,860,205,204,63,4,1,1,0,1,0,0,3,1612,8,825
대구광역시,동구,효목2동,효목2동제3투,1953,1221,189,717,139,126,39,3,0,1,0,0,0,1,1,1216,5,732
대구광역시,동구,효목2동,효목2동제4투,1680,1191,203,693,136,113,37,3,0,1,0,0,0,1,0,1187,4,489
대구광역시,동구,효목2동,효목2동제5투,2961,2318,526,977,374,340,88,3,0,1,0,1,0,1,1,2312,6,643
대구광역시,동구,도평동,합계,3525,2668,398,1370,329,459,91,3,0,1,0,0,4,1,2,2658,10,857
대구광역시,동구,도평동,관내사전투표,581,581,120,250,69,108,31,1,0,0,0,0,0,0,0,579,2,0
대구광역시,동구,도평동,도평동제1투,2003,1437,164,802,173,238,45,2,0,1,0,0,3,1,2,1431,6,566
대구광역시,동구,도평동,도평동제2투,941,650,114,318,87,113,15,0,0,0,0,0,1,0,0,648,2,291
대구광역시,동구,불로·봉무동,합계,18454,14371,2886,6176,2010,2579,578,44,3,3,5,6,3,10,13,14316,55,4083
대구광역시,동구,불로·봉무동,관내사전투표,2061,2061,485,797,236,420,104,8,0,0,0,1,0,0,1,2052,9,0
대구광역시,동구,불로·봉무동,불로·봉무동제1투,2401,1618,229,831,192,261,73,13,2,2,0,1,0,0,4,1608,10,783
대구광역시,동구,불로·봉무동,불로·봉무동제2투,2632,2056,383,946,301,343,70,4,0,0,0,0,0,2,1,2050,6,576
대구광역시,동구,불로·봉무동,불로·봉무동제3투,2089,1390,198,769,142,214,49,2,1,0,2,0,0,3,1,1381,9,699
대구광역시,동구,불로·봉무동,불로·봉무동제4투,3485,2540,411,1233,350,412,106,5,0,0,3,4,2,2,4,2532,8,945
대구광역시,동구,불로·봉무동,불로·봉무동제5투,3073,2533,673,825,417,493,105,8,0,0,0,0,1,2,2,2526,7,540
대구광역시,동구,불로·봉무동,불로·봉무동제6투,2713,2173,507,775,372,436,71,4,0,1,0,0,0,1,0,2167,6,540
대구광역시,동구,지저동,관내사전투표,1594,1594,355,715,176,250,78,6,0,1,1,1,0,0,2,1585,9,0
대구광역시,동구,지저동,합계,9099,6651,1058,3468,812,989,258,23,1,2,2,4,3,3,2,6625,26,2448
대구광역시,동구,지저동,지저동제1투,2994,1977,287,1040,264,287,79,7,1,0,0,2,2,0,0,1969,8,1017
대구광역시,동구,지저동,지저동제2투,2723,1830,229,1047,209,264,63,8,0,0,1,0,0,1,0,1822,8,893
대구광역시,동구,지저동,지저동제3투,1788,1250,187,666,163,188,38,2,0,1,0,1,1,2,0,1249,1,538
대구광역시,동구,동촌동,관내사전투표,2059,2059,451,878,231,387,88,8,0,1,1,2,1,0,3,2051,8,0
대구광역시,동구,동촌동,합계,12478,8828,1473,4428,1120,1405,301,26,0,3,3,6,3,6,11,8785,43,3650
대구광역시,동구,동촌동,동촌동제1투,2272,1474,234,811,178,189,45,4,0,1,0,2,0,2,2,1468,6,798
대구광역시,동구,동촌동,동촌동제2투,2774,1756,263,927,247,252,46,8,0,0,1,1,1,1,3,1750,6,1018
대구광역시,동구,동촌동,동촌동제3투,2681,1835,274,948,247,281,68,2,0,0,0,0,0,1,2,1823,12,846
대구광역시,동구,동촌동,동촌동제4투,2692,1704,251,864,217,296,54,4,0,1,1,1,1,2,1,1693,11,988
대구광역시,동구,방촌동,합계,15864,12530,2229,5893,1525,2285,484,35,1,5,0,5,0,7,5,12474,56,3334
대구광역시,동구,방촌동,관내사전투표,2835,2835,639,1143,323,574,136,6,0,0,0,2,0,1,1,2825,10,0
대구광역시,동구,방촌동,방촌동제1투,2113,1592,250,793,192,267,71,9,1,0,0,0,0,1,0,1584,8,521
대구광역시,동구,방촌동,방촌동제2투,2186,1479,227,760,184,236,62,3,0,1,0,1,0,2,0,1476,3,707
대구광역시,동구,방촌동,방촌동제3투,2121,1423,200,709,182,259,54,3,0,0,0,1,0,2,2,1412,11,698
대구광역시,동구,방촌동,방촌동제4투,2710,2233,390,1060,296,397,71,6,0,3,0,0,0,0,1,2224,9,477
대구광역시,동구,방촌동,방촌동제5투,1984,1573,289,743,182,294,52,7,0,0,0,1,0,0,0,1568,5,411
대구광역시,동구,방촌동,방촌동제6투,1915,1395,234,685,166,258,38,1,0,1,0,0,0,1,1,1385,10,520
대구광역시,동구,해안동,합계,13551,9803,1601,4876,1286,1607,326,24,2,7,1,5,3,19,6,9763,40,3748
대구광역시,동구,해안동,관내사전투표,2410,2410,543,936,359,440,101,5,0,3,1,3,2,7,0,2400,10,0
대구광역시,동구,해안동,해안동제1투,2909,1965,268,1032,256,323,61,9,1,2,0,1,1,2,3,1959,6,944
대구광역시,동구,해안동,해안동제2투,2195,1410,198,780,159,225,39,2,0,0,0,0,0,2,0,1405,5,785
대구광역시,동구,해안동,해안동제3투,2364,1520,243,816,183,222,43,2,0,2,0,1,0,3,0,1515,5,844
대구광역시,동구,해안동,해안동제4투,1597,1082,163,535,165,178,31,0,0,0,0,0,0,4,2,1078,4,515
대구광역시,동구,해안동,해안동제5투,2076,1416,186,777,164,219,51,6,1,0,0,0,0,1,1,1406,10,660
대구광역시,동구,안심1동,합계,33673,24971,5489,10326,3522,4417,989,71,3,11,5,21,5,11,12,24882,89,8702
대구광역시,동구,안심1동,관내사전투표,3815,3814,1116,1336,441,713,181,7,0,5,2,4,1,0,2,3808,6,1
대구광역시,동구,안심1동,안심1동제1투,3266,2048,288,1078,249,341,73,6,0,0,0,1,1,2,0,2039,9,1218
대구광역시,동구,안심1동,안심1동제2투,2057,1333,224,655,162,230,54,4,0,0,0,0,0,1,1,1331,2,724
대구광역시,동구,안심1동,안심1동제3투,3068,1965,349,935,261,326,75,5,0,1,0,0,0,1,3,1956,9,1103
대구광역시,동구,안심1동,안심1동제4투,3119,2189,318,1081,307,359,95,12,0,2,0,4,0,2,0,2180,9,930
대구광역시,동구,안심1동,안심1동제5투,2869,2006,422,847,324,298,84,8,2,1,1,1,0,2,1,1991,15,863
대구광역시,동구,안심1동,안심1동제6투,2508,1683,298,797,232,283,51,8,1,2,0,0,0,1,1,1674,9,825
대구광역시,동구,안심1동,안심1동제7투,3094,2252,491,976,317,361,89,4,0,0,1,2,0,0,1,2242,10,842
대구광역시,동구,안심1동,안심1동제8투,3561,2671,655,929,415,552,101,3,0,0,0,3,1,1,2,2662,9,890
대구광역시,동구,안심1동,안심1동제9투,3221,2591,716,861,433,460,94,12,0,0,1,6,0,1,0,2584,7,630
대구광역시,동구,안심1동,안심1동제10투,3095,2419,612,831,381,494,92,2,0,0,0,0,2,0,1,2415,4,676
대구광역시,동구,안심2동,합계,9021,6705,1165,3201,841,1227,207,13,0,3,1,2,1,10,6,6677,28,2316
대구광역시,동구,안심2동,관내사전투표,1473,1473,357,531,202,322,51,3,0,0,1,0,0,3,0,1470,3,0
대구광역시,동구,안심2동,안심2동제1투,3194,2101,364,1001,269,378,70,6,0,0,0,0,0,1,2,2091,10,1093
대구광역시,동구,안심2동,안심2동제2투,2670,2081,311,1088,242,367,52,1,0,3,0,1,0,3,2,2070,11,589
대구광역시,동구,안심2동,안심2동제3투,1684,1050,133,581,128,160,34,3,0,0,0,1,1,3,2,1046,4,634
대구광역시,동구,안심3·4동,관내사전투표,5066,5066,1617,1468,657,958,282,13,3,3,1,7,1,2,3,5015,51,0
대구광역시,동구,안심3·4동,합계,42551,32835,8386,11536,4698,6326,1584,102,3,7,5,23,6,14,18,32708,127,9716
대구광역시,동구,안심3·4동,안심3·4동제1투,2313,1438,195,756,169,247,57,2,0,0,0,1,1,0,2,1430,8,875
대구광역시,동구,안심3·4동,안심3·4동제2투,3323,2334,456,1020,309,450,83,0,0,0,0,5,0,3,1,2327,7,989
대구광역시,동구,안심3·4동,안심3·4동제3투,3411,2576,552,1028,384,481,112,9,0,0,0,2,0,1,1,2570,6,835
대구광역시,동구,안심3·4동,안심3·4동제4투,3578,2627,639,918,387,566,105,3,0,0,3,0,0,1,1,2623,4,951
대구광역시,동구,안심3·4동,안심3·4동제5투,3703,2696,465,1268,339,482,122,4,0,1,1,2,0,0,1,2685,11,1007
대구광역시,동구,안심3·4동,안심3·4동제6투,3073,2305,500,886,353,456,96,6,0,0,0,1,1,2,2,2303,2,768
대구광역시,동구,안심3·4동,안심3·4동제7투,2820,2073,597,599,334,403,124,6,0,0,0,1,0,2,2,2068,5,747
대구광역시,동구,안심3·4동,안심3·4동제8투,3061,2312,706,704,321,439,110,21,0,0,0,1,0,1,1,2304,8,749
대구광역시,동구,안심3·4동,안심3·4동제9투,3613,2839,742,915,464,560,135,15,0,0,0,0,0,0,2,2833,6,774
대구광역시,동구,안심3·4동,안심3·4동제10투,3723,2881,743,924,442,613,135,8,0,1,0,3,2,2,0,2873,8,842
대구광역시,동구,안심3·4동,안심3·4동제11투,2654,2172,805,459,317,458,126,3,0,0,0,0,1,0,0,2169,3,482
대구광역시,동구,안심3·4동,안심3·4동제12투,2213,1516,369,591,222,213,97,12,0,2,0,0,0,0,2,1508,8,697
대구광역시,동구,공산동,합계,11963,8990,1465,4609,1081,1484,266,19,0,3,1,2,5,14,13,8962,28,2973
대구광역시,동구,공산동,관내사전투표,1898,1898,415,814,249,336,67,1,0,0,1,1,0,1,6,1891,7,0
대구광역시,동구,공산동,공산동제1투,2557,1659,155,980,162,291,47,6,0,0,0,1,3,6,1,1652,7,898
대구광역시,동구,공산동,공산동제2투,3054,2281,356,1187,304,350,70,6,0,2,0,0,0,0,0,2275,6,773
대구광역시,동구,공산동,공산동제3투,2912,2185,415,1009,283,389,76,2,0,1,0,0,1,5,3,2184,1,727
대구광역시,동구,공산동,공산동제4투,1542,967,124,619,83,118,6,4,0,0,0,0,1,2,3,960,7,575
대구광역시,동구,잘못 투입·구분된 투표지,,0,0,0,0,0,0,0,0,0,0,0,0,0,0,0,0,0,0
대구광역시,서구,합계,,173359,127659,22004,68782,17808,12259,5373,266,25,69,27,78,44,111,164,127010,649,45700
대구광역시,서구,거소·선상투표,,306,293,72,87,76,36,7,1,0,1,0,2,0,0,1,283,10,13
대구광역시,서구,관외사전투표,,11530,11528,3063,3986,1986,1516,781,29,3,10,1,9,5,8,30,11427,101,2
대구광역시,서구,재외투표,,596,428,230,44,81,27,42,4,0,0,0,0,0,0,0,428,0,168
대구광역시,서구,내당1동,관내사전투표,1536,1536,353,730,200,168,64,6,0,0,0,1,0,3,3,1528,8,0
대구광역시,서구,내당1동,합계,9131,6456,1085,3522,844,682,255,13,1,3,0,3,4,5,8,6425,31,2675
대구광역시,서구,내당1동,내당1동제1투,2602,1712,258,968,229,180,63,1,1,1,0,2,0,0,1,1704,8,890
대구광역시,서구,내당1동,내당1동제2투,2746,1678,281,922,212,176,72,4,0,0,0,0,2,0,3,1672,6,1068
대구광역시,서구,내당1동,내당1동제3투,2247,1530,193,902,203,158,56,2,0,2,0,0,2,2,1,1521,9,717
대구광역시,서구,내당2·3동,합계,9161,6558,1038,3758,857,593,247,12,2,5,1,0,2,5,5,6525,33,2603
대구광역시,서구,내당2·3동,관내사전투표,1191,1191,249,598,133,136,58,1,0,1,0,0,0,2,2,1180,11,0
대구광역시,서구,내당2·3동,내당2·3동제1투,2707,1735,289,1018,222,118,71,6,1,1,0,0,1,0,2,1729,6,972
대구광역시,서구,내당2·3동,내당2·3동제2투,2527,1679,225,1024,197,149,64,3,1,2,1,0,1,2,1,1670,9,848
대구광역시,서구,내당2·3동,내당2·3동제3투,2736,1953,275,1118,305,190,54,2,0,1,0,0,0,1,0,1946,7,783
대구광역시,서구,내당4동,관내사전투표,2318,2318,547,1066,316,248,121,3,0,1,1,2,1,0,1,2307,11,0
대구광역시,서구,내당4동,합계,14592,10808,2011,5638,1451,1155,467,20,0,2,3,7,3,6,10,10773,35,3784
대구광역시,서구,내당4동,내당4동제1투,2114,1448,277,758,199,146,59,1,0,1,1,3,0,1,1,1447,1,666
대구광역시,서구,내당4동,내당4동제2투,2490,1688,299,942,195,183,57,5,0,0,0,1,0,1,0,1683,5,802
대구광역시,서구,내당4동,내당4동제3투,2911,2136,373,1119,274,256,91,6,0,0,1,1,0,1,5,2127,9,775
대구광역시,서구,내당4동,내당4동제4투,2251,1545,241,850,224,146,71,3,0,0,0,0,2,2,2,1541,4,706
대구광역시,서구,내당4동,내당4동제5투,2508,1673,274,903,243,176,68,2,0,0,0,0,0,1,1,1668,5,835
대구광역시,서구,비산1동,합계,9289,6489,945,3760,947,519,229,10,2,1,2,6,2,10,13,6446,43,2800
대구광역시,서구,비산1동,관내사전투표,1580,1580,260,891,233,105,67,3,0,0,0,2,0,3,1,1565,15,0
대구광역시,서구,비산1동,비산1동제1투,2287,1397,194,811,205,116,49,3,1,0,0,0,1,0,1,1381,16,890
대구광역시,서구,비산1동,비산1동제2투,1970,1221,178,695,180,114,41,0,1,0,1,0,0,5,2,1217,4,749
대구광역시,서구,비산1동,비산1동제3투,1691,1091,154,642,164,86,33,1,0,1,0,0,1,1,3,1086,5,600
대구광역시,서구,비산1동,비산1동제4투,1761,1200,159,721,165,98,39,3,0,0,1,4,0,1,6,1197,3,561
대구광역시,서구,비산2·3동,관내사전투표,1379,1379,219,795,169,127,54,4,0,1,0,0,0,3,1,1373,6,0
대구광역시,서구,비산2·3동,합계,9071,6190,831,3757,801,501,233,17,0,3,1,1,0,11,5,6161,29,2881
대구광역시,서구,비산2·3동,비산2·3동제1투,2568,1738,239,1072,212,136,62,4,0,0,0,0,0,2,1,1728,10,830
대구광역시,서구,비산2·3동,비산2·3동제2투,2523,1618,196,983,223,133,65,6,0,2,1,0,0,3,1,1613,5,905
대구광역시,서구,비산2·3동,비산2·3동제3투,2601,1455,177,907,197,105,52,3,0,0,0,1,0,3,2,1447,8,1146
대구광역시,서구,비산4동,합계,8796,6333,948,3551,878,600,279,17,3,2,1,5,2,4,10,6300,33,2463
대구광역시,서구,비산4동,관내사전투표,1116,1116,225,563,157,108,52,3,0,0,1,1,1,1,0,1112,4,0
대구광역시,서구,비산4동,비산4동제1투,2679,1758,253,1005,233,159,85,7,1,1,0,1,0,1,2,1748,10,921
대구광역시,서구,비산4동,비산4동제2투,2359,1537,211,871,222,146,66,4,1,0,0,1,0,1,6,1529,8,822
대구광역시,서구,비산4동,비산4동제3투,2642,1922,259,1112,266,187,76,3,1,1,0,2,1,1,2,1911,11,720
대구광역시,서구,비산5동,관내사전투표,1271,1271,215,738,160,99,38,1,0,2,0,1,0,3,1,1258,13,0
대구광역시,서구,비산5동,합계,6086,4340,631,2611,544,364,136,6,2,4,2,3,1,9,2,4315,25,1746
대구광역시,서구,비산5동,비산5동제1투,2294,1474,197,898,186,130,44,4,2,2,1,2,0,3,0,1469,5,820
대구광역시,서구,비산5동,비산5동제2투,2521,1595,219,975,198,135,54,1,0,0,1,0,1,3,1,1588,7,926
대구광역시,서구,비산6동,관내사전투표,1276,1276,232,679,190,115,52,0,0,0,0,1,1,2,0,1272,4,0
대구광역시,서구,비산6동,합계,7187,5207,792,3003,742,413,214,5,1,0,0,2,1,6,10,5189,18,1980
대구광역시,서구,비산6동,비산6동제1투,2935,1912,269,1126,261,153,84,2,0,0,0,1,0,3,8,1907,5,1023
대구광역시,서구,비산6동,비산6동제2투,2976,2019,291,1198,291,145,78,3,1,0,0,0,0,1,2,2010,9,957
대구광역시,서구,비산7동,합계,10272,7078,979,4308,929,550,228,13,0,3,2,6,5,10,11,7044,34,3194
대구광역시,서구,비산7동,관내사전투표,1307,1307,218,760,153,106,51,3,0,1,0,0,1,5,4,1302,5,0
대구광역시,서구,비산7동,비산7동제1투,1937,1107,143,705,143,75,28,3,0,0,1,0,0,2,0,1100,7,830
대구광역시,서구,비산7동,비산7동제2투,2117,1484,192,903,201,114,54,4,0,0,1,2,3,2,2,1478,6,633
대구광역시,서구,비산7동,비산7동제3투,2316,1428,188,848,203,130,48,1,0,0,0,1,0,0,2,1421,7,888
대구광역시,서구,비산7동,비산7동제4투,2595,1752,238,1092,229,125,47,2,0,2,0,3,1,1,3,1743,9,843
대구광역시,서구,평리1동,합계,7379,5218,799,3024,737,430,176,10,1,1,2,1,2,3,7,5193,25,2161
대구광역시,서구,평리1동,관내사전투표,1330,1330,229,766,163,112,47,2,0,0,0,1,0,2,2,1324,6,0
대구광역시,서구,평리1동,평리1동제1투,1906,1276,205,760,167,95,33,4,0,1,0,0,1,0,0,1266,10,630
대구광역시,서구,평리1동,평리1동제2투,2038,1286,176,725,217,108,49,1,0,0,2,0,1,1,3,1283,3,752
대구광역시,서구,평리1동,평리1동제3투,2105,1326,189,773,190,115,47,3,1,0,0,0,0,0,2,1320,6,779
대구광역시,서구,평리2동,합계,7265,5491,1044,2806,797,571,227,6,2,4,1,3,1,4,3,5469,22,1774
대구광역시,서구,평리2동,관내사전투표,1453,1453,343,664,195,163,76,0,0,1,1,1,0,0,1,1445,8,0
대구광역시,서구,평리2동,평리2동제1투,3370,2434,458,1194,380,294,88,5,0,2,0,1,1,2,0,2425,9,936
대구광역시,서구,평리2동,평리2동제2투,2442,1604,243,948,222,114,63,1,2,1,0,1,0,2,2,1599,5,838
대구광역시,서구,평리3동,합계,11161,7892,1319,4344,1058,768,338,15,1,5,2,4,2,3,15,7874,18,3269
대구광역시,서구,평리3동,관내사전투표,2040,2040,500,935,264,206,116,3,1,2,0,2,0,0,5,2034,6,0
대구광역시,서구,평리3동,평리3동제1투,2378,1414,212,799,204,135,51,5,0,0,1,1,1,1,1,1411,3,964
대구광역시,서구,평리3동,평리3동제2투,2416,1556,201,944,205,131,60,4,0,3,0,0,1,1,5,1555,1,860
대구광역시,서구,평리3동,평리3동제3투,2194,1424,187,857,190,128,50,2,0,0,1,0,0,1,3,1419,5,770
대구광역시,서구,평리3동,평리3동제4투,2133,1458,219,809,195,168,61,1,0,0,0,1,0,0,1,1455,3,675
대구광역시,서구,평리4동,합계,14872,10830,1929,5652,1557,1100,479,31,1,5,1,4,3,5,5,10772,58,4042
대구광역시,서구,평리4동,관내사전투표,2021,2021,462,976,247,223,98,3,0,1,0,1,0,2,2,2015,6,0
대구광역시,서구,평리4동,평리4동제1투,3391,2354,446,1113,391,287,98,8,0,0,0,0,1,2,1,2347,7,1037
대구광역시,서구,평리4동,평리4동제2투,3056,2012,290,1170,277,170,88,6,0,0,0,0,1,0,1,2003,9,1044
대구광역시,서구,평리4동,평리4동제3투,3034,2121,319,1146,300,220,100,8,0,3,1,1,0,1,1,2100,21,913
대구광역시,서구,평리4동,평리4동제4투,3370,2322,412,1247,342,200,95,6,1,1,0,2,1,0,0,2307,15,1048
대구광역시,서구,평리5동,합계,5630,4050,592,2393,529,349,138,10,0,2,3,3,1,2,4,4026,24,1580
대구광역시,서구,평리5동,관내사전투표,1039,1039,171,591,131,87,49,1,0,0,0,0,0,0,1,1031,8,0
대구광역시,서구,평리5동,평리5동제1투,2197,1420,183,840,187,144,42,6,0,0,1,3,0,2,3,1411,9,777
대구광역시,서구,평리5동,평리5동제2투,2394,1591,238,962,211,118,47,3,0,2,2,0,1,0,0,1584,7,803
대구광역시,서구,평리6동,합계,6604,4635,651,2799,561,374,193,8,2,5,2,1,2,5,5,4608,27,1969
대구광역시,서구,평리6동,관내사전투표,901,901,168,479,116,94,34,1,0,0,0,0,1,3,1,897,4,0
대구광역시,서구,평리6동,평리6동제1투,2077,1368,175,866,162,88,61,2,1,1,1,0,1,0,1,1359,9,709
대구광역시,서구,평리6동,평리6동제2투,1878,1249,156,776,151,111,42,2,0,2,1,1,0,1,2,1245,4,629
대구광역시,서구,평리6동,평리6동제3투,1748,1117,152,678,132,81,56,3,1,2,0,0,0,1,1,1107,10,631
대구광역시,서구,상중이동,합계,16422,12350,2246,6458,1719,1263,524,30,2,9,2,15,8,5,14,12295,55,4072
대구광역시,서구,상중이동,관내사전투표,1912,1912,460,858,291,166,114,5,0,1,1,3,0,2,2,1903,9,0
대구광역시,서구,상중이동,상중이동제1투,1352,660,108,354,95,71,26,1,0,0,0,0,1,0,0,656,4,692
대구광역시,서구,상중이동,상중이동제2투,2898,2071,282,1223,259,198,83,9,0,3,0,2,0,0,4,2063,8,827
대구광역시,서구,상중이동,상중이동제3투,2852,2052,363,1108,277,210,77,5,0,2,1,1,0,0,2,2046,6,800
대구광역시,서구,상중이동,상중이동제4투,2484,1809,296,971,268,183,77,2,1,0,0,2,3,2,0,1805,4,675
대구광역시,서구,상중이동,상중이동제5투,3645,2982,627,1388,431,381,127,7,1,1,0,4,0,1,2,2970,12,663
대구광역시,서구,상중이동,상중이동제6투,613,405,54,259,52,29,8,1,0,1,0,0,0,0,0,404,1,208
대구광역시,서구,상중이동,상중이동제7투,666,459,56,297,46,25,12,0,0,1,0,3,4,0,4,448,11,207
대구광역시,서구,원대동,합계,8009,5485,799,3281,714,448,180,9,2,4,1,3,0,10,6,5457,28,2524
대구광역시,서구,원대동,관내사전투표,896,896,168,501,108,72,35,0,1,1,1,0,0,2,1,890,6,0
대구광역시,서구,원대동,원대동제1투,2370,1491,185,927,194,132,32,3,0,2,0,3,0,6,0,1484,7,879
대구광역시,서구,원대동,원대동제2투,2487,1736,262,1032,234,115,70,5,1,1,0,0,0,1,3,1724,12,751
대구광역시,서구,원대동,원대동제3투,2256,1362,184,821,178,129,43,1,0,0,0,0,0,1,2,1359,3,894
대구광역시,서구,잘못 투입·구분된 투표지,,0,0,0,0,0,0,0,0,0,0,0,0,0,0,0,0,0,0
대구광역시,남구,합계,,136206,100059,19862,50304,13978,10365,4486,284,15,36,22,43,26,78,88,99587,472,36147
대구광역시,남구,거소·선상투표,,247,231,66,66,56,20,9,3,0,0,0,0,0,1,2,223,8,16
대구광역시,남구,관외사전투표,,11118,11116,3148,3753,1782,1508,764,32,2,6,4,9,2,2,19,11031,85,2
대구광역시,남구,재외투표,,685,514,281,48,77,44,53,8,0,0,0,0,0,0,1,512,2,171
대구광역시,남구,이천동,합계,10749,7988,1566,3978,1206,870,302,14,3,1,2,4,2,4,5,7957,31,2761
대구광역시,남구,이천동,관내사전투표,1258,1258,330,542,171,149,58,2,0,0,0,0,1,1,1,1255,3,0
대구광역시,남구,이천동,이천동제1투,1569,917,146,536,112,78,37,1,0,0,0,0,1,0,0,911,6,652
대구광역시,남구,이천동,이천동제2투,2664,1921,346,985,324,192,62,3,0,0,1,2,0,1,0,1916,5,743
대구광역시,남구,이천동,이천동제3투,2895,2150,440,997,358,256,78,3,2,0,1,0,0,2,2,2139,11,745
대구광역시,남구,이천동,이천동제4투,2363,1742,304,918,241,195,67,5,1,1,0,2,0,0,2,1736,6,621
대구광역시,남구,봉덕1동,합계,7876,5504,973,2950,760,555,217,18,0,1,2,2,1,5,3,5487,17,2372
대구광역시,남구,봉덕1동,관내사전투표,1282,1282,323,603,154,135,57,4,0,0,0,0,0,1,1,1278,4,0
대구광역시,남구,봉덕1동,봉덕1동제1투,1781,1071,149,665,122,84,43,1,0,1,0,1,0,1,0,1067,4,710
대구광역시,남구,봉덕1동,봉덕1동제2투,2362,1660,247,880,272,181,67,7,0,0,1,1,0,0,1,1657,3,702
대구광역시,남구,봉덕1동,봉덕1동제3투,2451,1491,254,802,212,155,50,6,0,0,1,0,1,3,1,1485,6,960
대구광역시,남구,봉덕2동,관내사전투표,1108,1108,261,559,126,115,43,2,0,0,0,1,0,0,0,1107,1,0
대구광역시,남구,봉덕2동,합계,9068,6790,1113,3826,870,701,222,14,1,3,1,2,3,8,2,6766,24,2278
대구광역시,남구,봉덕2동,봉덕2동제1투,1660,978,129,602,119,85,35,1,0,2,0,0,1,2,0,976,2,682
대구광역시,남구,봉덕2동,봉덕2동제2투,1558,1116,145,656,153,117,38,1,0,0,0,0,0,3,0,1113,3,442
대구광역시,남구,봉덕2동,봉덕2동제3투,2343,1678,269,943,229,160,53,5,1,1,1,1,1,2,1,1667,11,665
대구광역시,남구,봉덕2동,봉덕2동제4투,2399,1910,309,1066,243,224,53,5,0,0,0,0,1,1,1,1903,7,489
대구광역시,남구,봉덕3동,관내사전투표,1959,1959,450,977,236,186,95,3,1,1,1,1,1,0,2,1954,5,0
대구광역시,남구,봉덕3동,합계,13152,9011,1591,4896,1208,880,357,23,2,3,2,5,2,10,4,8983,28,4141
대구광역시,남구,봉덕3동,봉덕3동제1투,3478,1822,283,1018,260,171,69,7,0,0,0,3,0,3,2,1816,6,1656
대구광역시,남구,봉덕3동,봉덕3동제2투,3035,1846,285,1061,243,168,72,5,1,1,0,0,0,4,0,1840,6,1189
대구광역시,남구,봉덕3동,봉덕3동제3투,2082,1395,239,756,221,111,55,1,0,1,1,1,1,2,0,1389,6,687
대구광역시,남구,봉덕3동,봉덕3동제4투,2598,1989,334,1084,248,244,66,7,0,0,0,0,0,1,0,1984,5,609
대구광역시,남구,대명1동,합계,9744,7092,1350,3599,1030,715,330,11,1,1,1,4,1,3,6,7052,40,2652
대구광역시,남구,대명1동,관내사전투표,1576,1576,383,742,197,159,83,0,0,0,1,2,1,0,0,1568,8,0
대구광역시,남구,대명1동,대명1동제1투,2880,1899,298,995,306,190,91,3,0,1,0,2,0,1,0,1887,12,981
대구광역시,남구,대명1동,대명1동제2투,2254,1481,270,807,189,139,61,2,1,0,0,0,0,1,3,1473,8,773
대구광역시,남구,대명1동,대명1동제3투,3034,2136,399,1055,338,227,95,6,0,0,0,0,0,1,3,2124,12,898
대구광역시,남구,대명2동,합계,9924,7101,1454,3527,998,727,320,22,1,1,3,2,0,2,4,7061,40,2823
대구광역시,남구,대명2동,관내사전투표,1291,1291,403,480,155,150,91,5,0,0,0,0,0,0,0,1284,7,0
대구광역시,남구,대명2동,대명2동제1투,2371,1477,315,685,205,188,70,7,0,0,1,2,0,0,0,1473,4,894
대구광역시,남구,대명2동,대명2동제2투,1732,1249,212,679,165,118,60,5,0,0,1,0,0,0,0,1240,9,483
대구광역시,남구,대명2동,대명2동제3투,2394,1652,295,886,267,145,45,1,0,1,0,0,0,0,2,1642,10,742
대구광역시,남구,대명2동,대명2동제4투,2136,1432,229,797,206,126,54,4,1,0,1,0,0,2,2,1422,10,704
대구광역시,남구,대명3동,관내사전투표,1471,1471,387,656,190,144,79,3,0,0,0,0,2,1,4,1466,5,0
대구광역시,남구,대명3동,합계,10989,7443,1384,4055,968,645,308,16,2,3,1,2,6,9,11,7410,33,3546
대구광역시,남구,대명3동,대명3동제1투,2576,1548,260,833,232,142,70,2,0,0,0,1,2,1,0,1543,5,1028
대구광역시,남구,대명3동,대명3동제2투,2421,1528,278,837,198,131,69,5,0,2,1,0,1,0,2,1524,4,893
대구광역시,남구,대명3동,대명3동제3투,2177,1394,217,854,147,120,37,1,0,0,0,1,0,3,3,1383,11,783
대구광역시,남구,대명3동,대명3동제4투,2344,1502,242,875,201,108,53,5,2,1,0,0,1,4,2,1494,8,842
대구광역시,남구,대명4동,합계,9556,6778,1179,3767,863,628,262,16,0,4,0,2,3,13,8,6745,33,2778
대구광역시,남구,대명4동,관내사전투표,1387,1387,325,662,178,136,72,4,0,0,0,0,0,2,3,1382,5,0
대구광역시,남구,대명4동,대명4동제1투,2826,1840,296,1022,240,188,71,5,0,2,0,0,1,4,1,1830,10,986
대구광역시,남구,대명4동,대명4동제2투,2205,1462,235,863,184,124,45,1,0,1,0,0,0,1,2,1456,6,743
대구광역시,남구,대명4동,대명4동제3투,1948,1337,184,829,160,106,39,3,0,1,0,1,2,4,2,1331,6,611
대구광역시,남구,대명4동,대명4동제4투,1190,752,139,391,101,74,35,3,0,0,0,1,0,2,0,746,6,438
대구광역시,남구,대명5동,합계,6866,4901,961,2426,721,516,223,15,1,3,1,2,1,2,5,4877,24,1965
대구광역시,남구,대명5동,관내사전투표,1056,1056,255,476,132,128,53,2,0,2,1,0,1,0,2,1052,4,0
대구광역시,남구,대명5동,대명5동제1투,1992,1269,247,645,193,106,62,6,1,0,0,0,0,1,1,1262,7,723
대구광역시,남구,대명5동,대명5동제2투,2269,1544,268,768,240,179,70,5,0,0,0,1,0,0,1,1532,12,725
대구광역시,남구,대명5동,대명5동제3투,1549,1032,191,537,156,103,38,2,0,1,0,1,0,1,1,1031,1,517
대구광역시,남구,대명6동,관내사전투표,1313,1313,328,585,159,148,79,7,0,0,0,0,0,3,1,1310,3,0
대구광역시,남구,대명6동,합계,8222,5873,1143,2984,788,613,278,28,0,2,1,4,0,7,4,5852,21,2349
대구광역시,남구,대명6동,대명6동제1투,2128,1307,239,708,165,122,62,6,0,1,1,0,0,0,0,1304,3,821
대구광역시,남구,대명6동,대명6동제2투,2586,1797,314,943,257,195,67,6,0,1,0,1,0,2,1,1787,10,789
대구광역시,남구,대명6동,대명6동제3투,2195,1456,262,748,207,148,70,9,0,0,0,3,0,2,2,1451,5,739
대구광역시,남구,대명9동,관내사전투표,2521,2521,623,1110,345,289,129,11,0,2,0,1,0,1,2,2513,8,0
대구광역시,남구,대명9동,합계,12681,8850,1830,4350,1245,947,401,27,1,4,1,2,2,4,7,8821,29,3831
대구광역시,남구,대명9동,대명9동제1투,2813,1685,278,904,247,170,71,4,1,1,0,1,1,1,0,1679,6,1128
대구광역시,남구,대명9동,대명9동제2투,2214,1526,280,833,196,153,50,5,0,0,1,0,1,1,2,1522,4,688
대구광역시,남구,대명9동,대명9동제3투,2622,1614,348,756,236,187,78,3,0,0,0,0,0,1,2,1611,3,1008
대구광역시,남구,대명9동,대명9동제4투,2511,1504,301,747,221,148,73,4,0,1,0,0,0,0,1,1496,8,1007
대구광역시,남구,대명10동,합계,7758,5550,969,2986,762,533,236,22,0,2,2,2,3,2,5,5524,26,2208
대구광역시,남구,대명10동,관내사전투표,1147,1147,267,538,151,114,61,6,0,0,0,2,0,0,0,1139,8,0
대구광역시,남구,대명10동,대명10동제1투,2424,1565,280,793,243,178,57,3,0,0,1,0,2,1,1,1559,6,859
대구광역시,남구,대명10동,대명10동제2투,1996,1398,189,838,165,127,57,10,0,0,1,0,0,1,2,1390,8,598
대구광역시,남구,대명10동,대명10동제3투,2191,1440,233,817,203,114,61,3,0,2,0,0,1,0,2,1436,4,751
대구광역시,남구,대명11동,관내사전투표,1141,1141,232,593,142,108,52,3,1,0,0,0,0,3,0,1134,7,0
대구광역시,남구,대명11동,합계,7571,5317,854,3093,644,463,204,15,1,2,1,1,0,6,2,5286,31,2254
대구광역시,남구,대명11동,대명11동제1투,2371,1497,234,893,174,122,53,4,0,1,0,0,0,1,1,1483,14,874
대구광역시,남구,대명11동,대명11동제2투,1990,1289,185,799,148,101,42,4,0,0,1,0,0,1,1,1282,7,701
대구광역시,남구,대명11동,대명11동제3투,2069,1390,203,808,180,132,57,4,0,1,0,1,0,1,0,1387,3,679
대구광역시,남구,잘못 투입·구분된 투표지,,0,0,0,0,0,0,0,0,0,0,0,0,0,0,0,0,0,0
대구광역시,북구,합계,,355739,276725,62526,121368,42369,33915,13833,626,48,85,55,128,81,165,293,275492,1233,79014
대구광역시,북구,거소·선상투표,,872,836,219,209,217,104,15,8,3,4,2,3,1,4,10,799,37,36
대구광역시,북구,관외사전투표,,25746,25740,7702,7565,4452,3816,1819,56,10,6,11,10,13,7,62,25529,211,6
대구광역시,북구,재외투표,,1376,1022,510,96,173,82,149,4,0,0,0,1,0,1,0,1016,6,354
대구광역시,북구,고성동,관내사전투표,1032,1032,291,435,116,115,57,5,1,1,0,1,0,2,1,1025,7,0
대구광역시,북구,고성동,합계,4945,3670,691,1998,461,321,150,9,3,2,1,2,0,4,4,3646,24,1275
대구광역시,북구,고성동,고성동제1투,1494,960,154,551,133,81,30,2,0,0,1,0,0,1,1,954,6,534
대구광역시,북구,고성동,고성동제2투,2419,1678,246,1012,212,125,63,2,2,1,0,1,0,1,2,1667,11,741
대구광역시,북구,칠성동,관내사전투표,1989,1989,523,904,228,233,84,7,0,0,0,3,1,1,3,1987,2,0
대구광역시,북구,칠성동,합계,15897,12108,2593,5723,1707,1488,482,38,2,5,2,7,3,11,9,12070,38,3789
대구광역시,북구,칠성동,칠성동제1투,2530,1632,183,1087,173,117,50,6,0,1,1,0,1,3,1,1623,9,898
대구광역시,북구,칠성동,칠성동제2투,2676,2044,574,769,336,255,93,7,0,1,0,1,0,0,1,2037,7,632
대구광역시,북구,칠성동,칠성동제3투,2445,1639,289,849,245,186,52,4,0,1,0,0,1,5,0,1632,7,806
대구광역시,북구,칠성동,칠성동제4투,3347,2598,512,1222,381,365,91,8,1,1,1,3,0,0,3,2588,10,749
대구광역시,북구,칠성동,칠성동제5투,2910,2206,512,892,344,332,112,6,1,1,0,0,0,2,1,2203,3,704
대구광역시,북구,침산1동,합계,4238,3096,503,1815,358,273,112,3,1,1,1,1,3,3,6,3080,16,1142
대구광역시,북구,침산1동,관내사전투표,883,883,194,451,99,90,38,1,0,1,0,0,1,1,2,878,5,0
대구광역시,북구,침산1동,침산1동제1투,1732,1172,150,727,133,102,46,2,1,0,1,0,1,1,1,1165,7,560
대구광역시,북구,침산1동,침산1동제2투,1623,1041,159,637,126,81,28,0,0,0,0,1,1,1,3,1037,4,582
대구광역시,북구,침산2동,관내사전투표,2289,2289,699,823,315,313,112,8,1,0,1,1,1,2,4,2280,9,0
대구광역시,북구,침산2동,합계,12005,9699,2275,4107,1529,1239,474,20,1,1,2,4,4,4,10,9670,29,2306
대구광역시,북구,침산2동,침산2동제1투,2629,2024,374,979,291,255,107,1,0,1,0,0,2,1,1,2012,12,605
대구광역시,북구,침산2동,침산2동제2투,3327,2357,497,1099,382,273,89,9,0,0,0,1,1,0,1,2352,5,970
대구광역시,북구,침산2동,침산2동제3투,3760,3029,705,1206,541,398,166,2,0,0,1,2,0,1,4,3026,3,731
대구광역시,북구,침산3동,합계,15874,12677,2715,5797,1926,1537,579,33,4,2,3,4,5,6,9,12620,57,3197
대구광역시,북구,침산3동,관내사전투표,2723,2723,789,996,395,363,147,10,0,0,3,0,2,1,2,2708,15,0
대구광역시,북구,침산3동,침산3동제1투,3081,2200,395,1072,347,280,82,5,2,0,0,1,2,2,2,2190,10,881
대구광역시,북구,침산3동,침산3동제2투,3159,2337,409,1252,335,237,84,5,0,2,0,0,0,1,0,2325,12,822
대구광역시,북구,침산3동,침산3동제3투,3227,2466,501,1152,380,285,128,8,0,0,0,1,1,1,3,2460,6,761
대구광역시,북구,침산3동,침산3동제4투,3684,2951,621,1325,469,372,138,5,2,0,0,2,0,1,2,2937,14,733
대구광역시,북구,노원동,합계,9246,6680,917,4166,786,543,203,16,2,4,1,2,1,2,7,6650,30,2566
대구광역시,북구,노원동,관내사전투표,1476,1476,284,837,175,121,49,0,0,0,0,2,0,1,1,1470,6,0
대구광역시,북구,노원동,노원동제1투,1626,1138,159,693,134,98,41,7,0,2,0,0,0,0,1,1135,3,488
대구광역시,북구,노원동,노원동제2투,2683,1773,236,1133,200,142,42,4,0,2,0,0,1,1,3,1764,9,910
대구광역시,북구,노원동,노원동제3투,2108,1496,169,942,190,130,51,3,1,0,1,0,0,0,1,1488,8,612
대구광역시,북구,노원동,노원동제4투,1353,797,69,561,87,52,20,2,1,0,0,0,0,0,1,793,4,556
대구광역시,북구,산격1동,합계,9194,6538,976,3850,839,589,191,30,2,3,3,4,2,10,6,6505,33,2656
대구광역시,북구,산격1동,관내사전투표,1230,1230,225,699,154,89,44,7,0,0,0,1,1,1,1,1222,8,0
대구광역시,북구,산격1동,산격1동제1투,2647,1832,243,1113,223,181,46,6,1,0,2,3,1,2,2,1823,9,815
대구광역시,북구,산격1동,산격1동제2투,2729,1949,309,1124,251,186,56,7,0,0,1,0,0,4,2,1940,9,780
대구광역시,북구,산격1동,산격1동제3투,2588,1527,199,914,211,133,45,10,1,3,0,0,0,3,1,1520,7,1061
대구광역시,북구,산격2동,합계,9834,7770,1476,3799,1198,932,311,18,1,0,2,6,0,5,3,7751,19,2064
대구광역시,북구,산격2동,관내사전투표,2298,2298,525,988,346,312,110,9,0,0,0,1,0,1,0,2292,6,0
대구광역시,북구,산격2동,산격2동제1투,2323,1695,294,880,241,212,55,1,0,0,1,4,0,2,2,1692,3,628
대구광역시,북구,산격2동,산격2동제2투,2283,1518,244,803,245,150,62,3,1,0,0,1,0,2,0,1511,7,765
대구광역시,북구,산격2동,산격2동제3투,2930,2259,413,1128,366,258,84,5,0,0,1,0,0,0,1,2256,3,671
대구광역시,북구,산격3동,합계,7628,5501,1267,2412,769,683,298,16,2,3,1,3,2,3,6,5465,36,2127
대구광역시,북구,산격3동,관내사전투표,1494,1494,515,379,194,266,121,3,1,0,0,0,0,0,4,1483,11,0
대구광역시,북구,산격3동,산격3동제1투,2770,1752,406,777,246,213,87,3,1,1,0,2,2,2,1,1741,11,1018
대구광역시,북구,산격3동,산격3동제2투,3364,2255,346,1256,329,204,90,10,0,2,1,1,0,1,1,2241,14,1109
대구광역시,북구,산격4동,합계,7951,5857,1011,3138,807,620,241,12,0,2,0,5,1,3,3,5843,14,2094
대구광역시,북구,산격4동,관내사전투표,1427,1427,342,626,209,178,64,3,0,1,0,0,0,1,0,1424,3,0
대구광역시,북구,산격4동,산격4동제1투,2137,1397,244,760,176,132,73,3,0,1,0,1,0,0,2,1392,5,740
대구광역시,북구,산격4동,산격4동제2투,2187,1483,201,855,216,141,60,3,0,0,0,2,1,1,0,1480,3,704
대구광역시,북구,산격4동,산격4동제3투,2200,1550,224,897,206,169,44,3,0,0,0,2,0,1,1,1547,3,650
대구광역시,북구,복현1동,합계,6192,4446,1080,1863,642,568,245,8,0,3,2,3,0,6,6,4426,20,1746
대구광역시,북구,복현1동,관내사전투표,1472,1472,454,480,220,214,87,1,0,1,1,2,0,1,4,1465,7,0
대구광역시,북구,복현1동,복현1동제1투,2295,1446,275,725,190,161,75,0,0,2,0,1,0,4,2,1435,11,849
대구광역시,북구,복현1동,복현1동제2투,2425,1528,351,658,232,193,83,7,0,0,1,0,0,1,0,1526,2,897
대구광역시,북구,복현2동,합계,22383,17157,4014,7402,2572,2224,782,31,3,3,3,14,4,10,15,17077,80,5226
대구광역시,북구,복현2동,관내사전투표,3069,3069,967,1030,431,448,160,9,0,0,1,2,1,1,0,3050,19,0
대구광역시,북구,복현2동,복현2동제1투,3457,2342,487,999,420,312,104,6,0,0,0,2,0,0,1,2331,11,1115
대구광역시,북구,복현2동,복현2동제2투,2736,1812,356,920,246,204,75,1,0,0,0,1,0,1,1,1805,7,924
대구광역시,북구,복현2동,복현2동제3투,3110,2381,663,921,382,287,115,3,2,0,0,1,1,1,1,2377,4,729
대구광역시,북구,복현2동,복현2동제4투,3556,2807,577,1373,398,322,113,3,1,2,2,6,0,1,3,2801,6,749
대구광역시,북구,복현2동,복현2동제5투,3605,2702,562,1181,423,392,118,5,0,1,0,1,1,1,2,2687,15,903
대구광역시,북구,복현2동,복현2동제6투,2850,2044,402,978,272,259,97,4,0,0,0,1,1,5,7,2026,18,806
대구광역시,북구,대현동,합계,15396,11439,2471,5403,1624,1339,491,20,1,6,5,3,5,6,9,11383,56,3957
대구광역시,북구,대현동,관내사전투표,2975,2975,787,1331,353,335,139,7,0,0,2,0,2,2,4,2962,13,0
대구광역시,북구,대현동,대현동제1투,2337,1369,236,719,185,158,54,2,1,0,1,0,0,3,1,1360,9,968
대구광역시,북구,대현동,대현동제2투,2339,1529,305,763,217,152,75,3,0,2,0,2,0,0,1,1520,9,810
대구광역시,북구,대현동,대현동제3투,2827,1839,334,893,307,205,81,3,0,3,0,0,2,1,0,1829,10,988
대구광역시,북구,대현동,대현동제4투,2857,2133,412,1087,293,261,65,2,0,0,1,1,1,0,2,2125,8,724
대구광역시,북구,대현동,대현동제5투,2061,1594,397,610,269,228,77,3,0,1,1,0,0,0,1,1587,7,467
대구광역시,북구,검단동,합계,6368,4766,853,2508,686,470,199,5,1,2,0,0,1,8,7,4740,26,1602
대구광역시,북구,검단동,관내사전투표,916,916,234,415,119,100,40,0,0,0,0,0,1,0,0,909,7,0
대구광역시,북구,검단동,검단동제1투,2666,1770,255,1056,225,153,61,4,1,1,0,0,0,5,3,1764,6,896
대구광역시,북구,검단동,검단동제2투,2786,2080,364,1037,342,217,98,1,0,1,0,0,0,3,4,2067,13,706
대구광역시,북구,무태조야동,합계,21156,16106,3696,7041,2457,2060,757,29,0,4,1,3,7,10,10,16075,31,5050
대구광역시,북구,무태조야동,관내사전투표,3481,3481,1070,1284,439,472,198,6,0,1,0,1,2,0,1,3474,7,0
대구광역시,북구,무태조야동,무태조야동제1투,3337,2282,488,976,400,294,110,3,0,1,1,0,1,1,2,2277,5,1055
대구광역시,북구,무태조야동,무태조야동제2투,2545,1822,358,872,279,222,73,7,0,1,0,1,0,2,3,1818,4,723
대구광역시,북구,무태조야동,무태조야동제3투,2914,2044,457,891,335,257,95,6,0,0,0,0,0,0,0,2041,3,870
대구광역시,북구,무태조야동,무태조야동제4투,1992,1161,223,566,190,124,51,2,0,0,0,0,3,0,0,1159,2,831
대구광역시,북구,무태조야동,무태조야동제5투,2095,1586,361,670,261,217,71,0,0,0,0,0,1,3,0,1584,2,509
대구광역시,북구,무태조야동,무태조야동제6투,3428,2760,627,1174,427,400,122,4,0,1,0,1,0,0,2,2758,2,668
대구광역시,북구,무태조야동,무태조야동제7투,1364,970,112,608,126,74,37,1,0,0,0,0,0,4,2,964,6,394
대구광역시,북구,관문동,합계,20555,15662,3379,7218,2402,1842,681,37,3,4,0,6,7,10,11,15600,62,4893
대구광역시,북구,관문동,관내사전투표,2036,2036,529,880,292,218,100,2,1,2,0,1,0,2,0,2027,9,0
대구광역시,북구,관문동,관문동제1투,1904,1120,152,656,148,108,39,6,0,0,0,0,3,3,0,1115,5,784
대구광역시,북구,관문동,관문동제2투,2839,2233,509,905,372,311,109,9,1,0,0,2,1,0,2,2221,12,606
대구광역시,북구,관문동,관문동제3투,2518,1919,321,982,302,226,74,1,0,1,0,1,1,1,2,1912,7,599
대구광역시,북구,관문동,관문동제4투,2533,1957,311,1090,269,207,63,6,1,1,0,1,0,1,1,1951,6,576
대구광역시,북구,관문동,관문동제5투,834,595,70,382,66,52,17,1,0,0,0,0,1,2,0,591,4,239
대구광역시,북구,관문동,관문동제6투,2690,1928,561,704,319,228,103,4,0,0,0,0,0,0,2,1921,7,762
대구광역시,북구,관문동,관문동제7투,2366,1744,398,776,270,206,79,8,0,0,0,0,1,1,0,1739,5,622
대구광역시,북구,관문동,관문동제8투,2835,2130,528,843,364,286,97,0,0,0,0,1,0,0,4,2123,7,705
대구광역시,북구,태전1동,합계,17893,13277,2679,6224,1987,1567,701,35,0,1,0,8,3,7,16,13228,49,4616
대구광역시,북구,태전1동,관내사전투표,2060,2060,573,711,312,287,155,6,0,1,0,4,0,1,3,2053,7,0
대구광역시,북구,태전1동,태전1동제1투,3506,2440,476,1187,370,263,130,4,0,0,0,0,0,2,1,2433,7,1066
대구광역시,북구,태전1동,태전1동제2투,2528,1813,374,848,277,221,82,1,0,0,0,1,0,0,2,1806,7,715
대구광역시,북구,태전1동,태전1동제3투,2016,1284,217,662,171,148,70,3,0,0,0,0,1,0,3,1275,9,732
대구광역시,북구,태전1동,태전1동제4투,2602,1706,299,863,238,198,86,10,0,0,0,2,0,0,3,1699,7,896
대구광역시,북구,태전1동,태전1동제5투,2905,2159,387,1075,345,243,94,4,0,0,0,0,1,1,1,2151,8,746
대구광역시,북구,태전1동,태전1동제6투,2276,1815,353,878,274,207,84,7,0,0,0,1,1,3,3,1811,4,461
대구광역시,북구,태전2동,합계,18789,14177,2963,6759,2043,1588,698,36,2,1,0,9,5,7,13,14124,53,4612
대구광역시,북구,태전2동,관내사전투표,3252,3252,871,1341,439,398,180,6,0,0,0,3,0,1,3,3242,10,0
대구광역시,북구,태전2동,태전2동제1투,3101,2286,427,1176,310,253,101,1,0,0,0,1,1,0,4,2274,12,815
대구광역시,북구,태전2동,태전2동제2투,3069,2054,373,1090,285,198,93,2,1,1,0,1,0,1,1,2046,8,1015
대구광역시,북구,태전2동,태전2동제3투,2806,1818,309,888,288,229,84,3,0,0,0,1,1,1,2,1806,12,988
대구광역시,북구,태전2동,태전2동제4투,3076,2305,442,1168,332,227,109,16,0,0,0,2,1,3,0,2300,5,771
대구광역시,북구,태전2동,태전2동제5투,3485,2462,541,1096,389,283,131,8,1,0,0,1,2,1,3,2456,6,1023
대구광역시,북구,구암동,합계,27101,21049,5154,8290,3576,2720,1135,40,3,6,2,12,2,10,16,20966,83,6052
대구광역시,북구,구암동,관내사전투표,3927,3926,1402,1140,611,491,240,9,0,1,0,6,0,3,4,3907,19,1
대구광역시,북구,구암동,구암동제1투,2442,1671,288,873,260,166,68,3,0,1,0,1,0,0,4,1664,7,771
대구광역시,북구,구암동,구암동제2투,3039,2373,491,1039,384,331,111,6,0,0,0,0,1,2,2,2367,6,666
대구광역시,북구,구암동,구암동제3투,2758,2058,460,882,353,257,88,3,0,2,2,1,1,1,0,2050,8,700
대구광역시,북구,구암동,구암동제4투,2736,2099,447,938,333,261,109,0,1,0,0,0,0,0,2,2091,8,637
대구광역시,북구,구암동,구암동제5투,2957,2166,478,841,415,278,135,4,1,0,0,0,0,0,0,2152,14,791
대구광역시,북구,구암동,구암동제6투,3036,2198,474,863,397,319,128,4,0,1,0,1,0,1,1,2189,9,838
대구광역시,북구,구암동,구암동제7투,2922,2106,531,769,375,300,117,3,1,1,0,0,0,0,3,2100,6,816
대구광역시,북구,구암동,구암동제8투,3284,2452,583,945,448,317,139,8,0,0,0,3,0,3,0,2446,6,832
대구광역시,북구,관음동,합계,15045,11246,2166,5499,1701,1236,533,28,2,4,3,1,6,7,10,11196,50,3799
대구광역시,북구,관음동,관내사전투표,2497,2497,673,1015,341,292,155,2,0,1,1,0,1,3,1,2485,12,0
대구광역시,북구,관음동,관음동제1투,3420,2178,327,1241,312,193,80,4,0,2,1,0,3,0,4,2167,11,1242
대구광역시,북구,관음동,관음동제2투,3649,2560,447,1256,415,273,144,6,1,0,1,0,0,2,1,2546,14,1089
대구광역시,북구,관음동,관음동제3투,2452,1650,285,864,242,175,64,10,1,1,0,0,1,1,2,1646,4,802
대구광역시,북구,관음동,관음동제4투,3027,2361,434,1123,391,303,90,6,0,0,0,1,1,1,2,2352,9,666
대구광역시,북구,읍내동,합계,20429,15046,3107,7095,2255,1744,717,28,1,4,3,6,4,11,12,14987,59,5383
대구광역시,북구,읍내동,관내사전투표,2652,2652,697,1110,348,325,150,8,0,2,1,0,0,0,2,2643,9,0
대구광역시,북구,읍내동,읍내동제1투,3407,2196,386,1076,354,245,115,2,0,1,0,1,0,2,2,2184,12,1211
대구광역시,북구,읍내동,읍내동제2투,3582,2656,538,1257,409,331,106,2,0,1,0,2,2,3,0,2651,5,926
대구광역시,북구,읍내동,읍내동제3투,3729,2477,506,1151,392,279,126,4,1,0,2,1,0,0,4,2466,11,1252
대구광역시,북구,읍내동,읍내동제4투,3572,2507,448,1278,375,263,113,6,0,0,0,1,1,4,2,2491,16,1065
대구광역시,북구,읍내동,읍내동제5투,3487,2558,532,1223,377,301,107,6,0,0,0,1,1,2,2,2552,6,929
대구광역시,북구,동천동,합계,22100,17727,4639,6350,2982,2514,1094,39,0,9,5,4,0,1,20,17657,70,4373
대구광역시,북구,동천동,관내사전투표,4423,4423,1397,1326,711,634,318,7,0,5,0,0,0,1,4,4403,20,0
대구광역시,북구,동천동,동천동제1투,2962,1999,459,893,272,237,116,9,0,0,1,0,0,0,4,1991,8,963
대구광역시,북구,동천동,동천동제2투,2309,1692,367,743,257,216,89,9,0,0,0,2,0,0,1,1684,8,617
대구광역시,북구,동천동,동천동제3투,2644,2162,531,743,420,323,129,4,0,2,0,0,0,0,4,2156,6,482
대구광역시,북구,동천동,동천동제4투,2811,2109,488,758,389,323,130,3,0,1,3,0,0,0,6,2101,8,702
대구광역시,북구,동천동,동천동제5투,3601,2880,768,980,518,440,160,3,0,0,1,1,0,0,0,2871,9,721
대구광역시,북구,동천동,동천동제6투,3350,2462,629,907,415,341,152,4,0,1,0,1,0,0,1,2451,11,888
대구광역시,북구,국우동,합계,17526,13432,3470,5040,2220,1816,776,27,1,5,2,7,2,9,13,13388,44,4094
대구광역시,북구,국우동,관내사전투표,2252,2252,738,641,376,309,163,6,0,1,0,2,0,2,4,2242,10,0
대구광역시,북구,국우동,국우동제1투,3701,2647,582,1159,416,325,140,5,0,1,0,1,0,4,3,2636,11,1054
대구광역시,북구,국우동,국우동제2투,2617,1753,356,821,259,198,95,6,1,1,1,1,0,2,1,1742,11,864
대구광역시,북구,국우동,국우동제3투,3024,2285,601,811,406,327,125,6,0,0,1,0,1,0,3,2281,4,739
대구광역시,북구,국우동,국우동제4투,2727,2090,517,752,379,307,129,1,0,1,0,0,0,1,1,2088,2,637
대구광역시,북구,국우동,국우동제5투,3205,2405,676,856,384,350,124,3,0,1,0,3,1,0,1,2399,6,800
대구광역시,북구,잘못 투입·구분된 투표지,,0,1,0,1,0,0,0,0,0,0,0,0,0,0,0,1,0,-1
대구광역시,수성구,합계,,356388,285528,64922,123074,43698,38613,12778,718,30,81,58,127,43,121,194,284457,1071,70860
대구광역시,수성구,거소·선상투표,,603,570,135,172,161,58,17,5,1,0,1,1,1,2,2,556,14,33
대구광역시,수성구,관외사전투표,,30992,30985,8676,9572,5269,5016,2063,67,8,8,7,25,7,17,44,30779,206,7
대구광역시,수성구,재외투표,,2426,1911,906,218,314,185,265,12,0,0,0,0,0,2,0,1902,9,515
대구광역시,수성구,범어1동,합계,13214,10769,2396,4910,1514,1465,414,31,0,1,1,7,0,1,3,10743,26,2445
대구광역시,수성구,범어1동,관내사전투표,2748,2748,756,1097,342,401,132,8,0,1,0,2,0,0,1,2740,8,0
대구광역시,수성구,범어1동,범어1동제1투,3795,2760,619,1216,428,386,99,3,0,0,0,1,0,0,1,2753,7,1035
대구광역시,수성구,범어1동,범어1동제2투,2852,2276,405,1195,325,279,64,5,0,0,0,1,0,0,0,2274,2,576
대구광역시,수성구,범어1동,범어1동제3투,3819,2985,616,1402,419,399,119,15,0,0,1,3,0,1,1,2976,9,834
대구광역시,수성구,범어2동,관내사전투표,1988,1988,534,813,242,286,98,1,0,0,0,0,0,1,3,1978,10,0
대구광역시,수성구,범어2동,합계,11081,8634,1769,4051,1300,1132,324,14,0,1,2,3,0,1,5,8602,32,2447
대구광역시,수성구,범어2동,범어2동제1투,1971,1288,249,624,210,150,48,1,0,1,0,0,0,0,0,1283,5,683
대구광역시,수성구,범어2동,범어2동제2투,2189,1616,406,686,257,199,54,4,0,0,2,1,0,0,0,1609,7,573
대구광역시,수성구,범어2동,범어2동제3투,2101,1441,256,736,205,155,76,6,0,0,0,2,0,0,0,1436,5,660
대구광역시,수성구,범어2동,범어2동제4투,2832,2301,324,1192,386,342,48,2,0,0,0,0,0,0,2,2296,5,531
대구광역시,수성구,범어3동,합계,9821,7763,1896,3041,1249,1173,345,23,1,2,0,1,0,2,6,7739,24,2058
대구광역시,수성구,범어3동,관내사전투표,1523,1523,461,551,200,219,81,4,0,0,0,0,0,0,2,1518,5,0
대구광역시,수성구,범어3동,범어3동제1투,3023,2278,595,805,417,360,81,9,1,0,0,0,0,1,3,2272,6,745
대구광역시,수성구,범어3동,범어3동제2투,2786,2100,446,908,318,308,105,2,0,1,0,1,0,1,1,2091,9,686
대구광역시,수성구,범어3동,범어3동제3투,2489,1862,394,777,314,286,78,8,0,1,0,0,0,0,0,1858,4,627
대구광역시,수성구,범어4동,합계,11415,9216,2182,3812,1503,1253,391,27,0,4,2,2,1,5,5,9187,29,2199
대구광역시,수성구,범어4동,관내사전투표,2186,2186,585,923,273,290,96,6,0,1,0,1,0,3,2,2180,6,0
대구광역시,수성구,범어4동,범어4동제1투,2075,1420,287,658,215,182,65,2,0,1,0,0,0,0,1,1411,9,655
대구광역시,수성구,범어4동,범어4동제2투,2441,1956,490,677,386,307,86,4,0,1,0,1,0,1,0,1953,3,485
대구광역시,수성구,범어4동,범어4동제3투,2047,1489,278,744,222,173,55,7,0,0,2,0,1,1,1,1484,5,558
대구광역시,수성구,범어4동,범어4동제4투,2666,2165,542,810,407,301,89,8,0,1,0,0,0,0,1,2159,6,501
대구광역시,수성구,만촌1동,관내사전투표,3853,3853,1038,1563,529,509,175,10,0,0,1,4,1,5,0,3835,18,0
대구광역시,수성구,만촌1동,합계,18385,14691,3142,6732,2186,1909,606,36,0,5,4,9,3,8,5,14645,46,3694
대구광역시,수성구,만촌1동,만촌1동제1투,2677,1865,324,973,251,244,58,7,0,0,1,2,0,0,0,1860,5,812
대구광역시,수성구,만촌1동,만촌1동제2투,2880,2356,531,988,391,344,92,3,0,2,0,0,0,0,2,2353,3,524
대구광역시,수성구,만촌1동,만촌1동제3투,2350,1744,347,846,265,190,80,5,0,0,1,2,0,1,0,1737,7,606
대구광역시,수성구,만촌1동,만촌1동제4투,3191,2232,404,1067,366,269,105,5,0,2,0,0,2,2,1,2223,9,959
대구광역시,수성구,만촌1동,만촌1동제5투,3434,2641,498,1295,384,353,96,6,0,1,1,1,0,0,2,2637,4,793
대구광역시,수성구,만촌2동,관내사전투표,1695,1695,465,640,242,240,92,6,0,1,0,1,0,0,1,1688,7,0
대구광역시,수성구,만촌2동,합계,9508,7230,1483,3351,1091,938,307,19,0,1,0,5,0,1,5,7201,29,2278
대구광역시,수성구,만촌2동,만촌2동제1투,3226,2264,483,996,384,291,94,4,0,0,0,2,0,0,2,2256,8,962
대구광역시,수성구,만촌2동,만촌2동제2투,2329,1621,265,830,237,219,61,4,0,0,0,2,0,0,0,1618,3,708
대구광역시,수성구,만촌2동,만촌2동제3투,2258,1650,270,885,228,188,60,5,0,0,0,0,0,1,2,1639,11,608
대구광역시,수성구,만촌3동,합계,13401,10775,2500,4462,1701,1585,466,13,0,4,1,4,0,1,0,10737,38,2626
대구광역시,수성구,만촌3동,관내사전투표,2533,2533,727,866,403,395,128,3,0,1,1,1,0,1,0,2526,7,0
대구광역시,수성구,만촌3동,만촌3동제1투,3014,2141,390,1026,339,301,76,2,0,0,0,0,0,0,0,2134,7,873
대구광역시,수성구,만촌3동,만촌3동제2투,1829,1330,256,663,178,162,54,4,0,1,0,2,0,0,0,1320,10,499
대구광역시,수성구,만촌3동,만촌3동제3투,2663,2078,492,845,356,289,91,2,0,1,0,0,0,0,0,2076,2,585
대구광역시,수성구,만촌3동,만촌3동제4투,3362,2693,635,1062,425,438,117,2,0,1,0,1,0,0,0,2681,12,669
대구광역시,수성구,수성1가동,합계,14596,11640,2505,5519,1598,1473,447,32,0,4,1,9,5,5,10,11608,32,2956
대구광역시,수성구,수성1가동,관내사전투표,3035,3035,835,1253,388,405,131,3,0,2,0,2,1,2,6,3028,7,0
대구광역시,수성구,수성1가동,수성1가동제1투,2519,2012,487,790,334,291,93,6,0,1,0,1,2,0,0,2005,7,507
대구광역시,수성구,수성1가동,수성1가동제2투,3288,2409,505,1114,358,324,88,4,0,0,1,3,0,1,2,2400,9,879
대구광역시,수성구,수성1가동,수성1가동제3투,2826,2198,359,1194,282,286,59,12,0,0,0,1,0,0,1,2194,4,628
대구광역시,수성구,수성1가동,수성1가동제4투,2928,1986,319,1168,236,167,76,7,0,1,0,2,2,2,1,1981,5,942
대구광역시,수성구,수성2·3가동,합계,9283,7393,1460,3603,1114,912,264,14,1,0,2,1,0,6,5,7382,11,1890
대구광역시,수성구,수성2·3가동,관내사전투표,2127,2127,500,1016,279,243,75,5,0,0,0,0,0,1,4,2123,4,0
대구광역시,수성구,수성2·3가동,수성2·3가동제1투,2622,2058,400,916,376,283,79,2,0,0,0,0,0,0,0,2056,2,564
대구광역시,수성구,수성2·3가동,수성2·3가동제2투,2150,1633,300,794,258,218,51,4,0,0,1,0,0,3,1,1630,3,517
대구광역시,수성구,수성2·3가동,수성2·3가동제3투,2384,1575,260,877,201,168,59,3,1,0,1,1,0,2,0,1573,2,809
대구광역시,수성구,수성4가동,합계,12420,9946,2046,4681,1453,1318,375,23,1,4,0,1,0,3,3,9908,38,2474
대구광역시,수성구,수성4가동,관내사전투표,2640,2640,686,1085,370,375,106,4,1,3,0,0,0,0,1,2631,9,0
대구광역시,수성구,수성4가동,수성4가동제1투,2855,2073,414,992,310,242,96,9,0,0,0,0,0,1,1,2065,8,782
대구광역시,수성구,수성4가동,수성4가동제2투,2740,1963,374,977,267,259,72,3,0,0,0,1,0,1,0,1954,9,777
대구광역시,수성구,수성4가동,수성4가동제3투,1921,1467,228,801,218,168,42,4,0,1,0,0,0,1,0,1463,4,454
대구광역시,수성구,수성4가동,수성4가동제4투,2264,1803,344,826,288,274,59,3,0,0,0,0,0,0,1,1795,8,461
대구광역시,수성구,황금1동,합계,15711,12948,3106,5223,2149,1869,513,29,1,2,1,3,2,6,5,12909,39,2763
대구광역시,수성구,황금1동,관내사전투표,2970,2969,901,1059,417,437,138,5,0,1,0,0,1,1,0,2960,9,1
대구광역시,수성구,황금1동,황금1동제1투,3053,2346,422,1095,400,334,87,4,0,0,1,1,0,1,0,2345,1,707
대구광역시,수성구,황금1동,황금1동제2투,1859,1268,227,662,205,121,33,6,1,1,0,0,1,0,1,1258,10,591
대구광역시,수성구,황금1동,황금1동제3투,2426,1919,401,830,316,294,71,4,0,0,0,0,0,0,1,1917,2,507
대구광역시,수성구,황금1동,황금1동제4투,3014,2463,651,873,427,392,96,7,0,0,0,2,0,3,1,2452,11,551
대구광역시,수성구,황금1동,황금1동제5투,2389,1983,504,704,384,291,88,3,0,0,0,0,0,1,2,1977,6,406
대구광역시,수성구,황금2동,합계,9676,6692,1210,3463,940,724,297,20,1,0,3,1,0,0,6,6665,27,2984
대구광역시,수성구,황금2동,관내사전투표,1420,1420,343,586,209,194,79,3,0,0,1,0,0,0,2,1417,3,0
대구광역시,수성구,황금2동,황금2동제1투,2793,1812,285,999,247,191,71,8,0,0,1,0,0,0,1,1803,9,981
대구광역시,수성구,황금2동,황금2동제2투,2833,1802,317,923,274,190,82,4,1,0,1,1,0,0,2,1795,7,1031
대구광역시,수성구,황금2동,황금2동제3투,2630,1658,265,955,210,149,65,5,0,0,0,0,0,0,1,1650,8,972
대구광역시,수성구,중동,합계,10301,7288,1314,3953,934,724,281,31,1,1,1,4,3,6,4,7257,31,3013
대구광역시,수성구,중동,관내사전투표,1897,1897,446,900,229,200,98,9,0,1,0,3,1,1,1,1889,8,0
대구광역시,수성구,중동,중동제1투,2303,1346,211,780,166,140,38,5,1,0,0,0,0,0,1,1342,4,957
대구광역시,수성구,중동,중동제2투,1827,1251,191,763,144,99,40,4,0,0,0,1,1,2,1,1246,5,576
대구광역시,수성구,중동,중동제3투,2162,1338,249,680,171,157,61,7,0,0,1,0,1,2,0,1329,9,824
대구광역시,수성구,중동,중동제4투,2112,1456,217,830,224,128,44,6,0,0,0,0,0,1,1,1451,5,656
대구광역시,수성구,상동,합계,13931,10155,1979,5238,1341,1180,329,26,2,2,6,2,2,5,5,10117,38,3776
대구광역시,수성구,상동,관내사전투표,1965,1965,514,890,239,231,72,6,1,1,1,2,0,1,1,1959,6,0
대구광역시,수성구,상동,상동제1투,2811,1623,317,793,235,194,70,6,1,0,0,0,1,0,1,1618,5,1188
대구광역시,수성구,상동,상동제2투,4012,2946,514,1578,410,354,70,6,0,0,3,0,0,1,0,2936,10,1066
대구광역시,수성구,상동,상동제3투,2753,2038,328,1147,258,226,60,5,0,0,0,0,1,3,1,2029,9,715
대구광역시,수성구,상동,상동제4투,2390,1583,306,830,199,175,57,3,0,1,2,0,0,0,2,1575,8,807
대구광역시,수성구,파동,합계,11765,8937,1633,4638,1211,1034,330,29,1,3,2,3,4,8,5,8901,36,2828
대구광역시,수성구,파동,관내사전투표,2062,2062,439,1028,248,244,87,7,0,1,1,0,2,1,1,2059,3,0
대구광역시,수성구,파동,파동제1투,3111,2027,331,1136,270,198,68,11,0,0,0,0,0,0,1,2015,12,1084
대구광역시,수성구,파동,파동제2투,3166,2387,454,1145,372,316,72,5,1,2,1,3,1,5,1,2378,9,779
대구광역시,수성구,파동,파동제3투,3426,2461,409,1329,321,276,103,6,0,0,0,0,1,2,2,2449,12,965
대구광역시,수성구,두산동,관내사전투표,2105,2105,493,942,271,288,97,2,1,0,0,0,0,1,1,2096,9,0
대구광역시,수성구,두산동,합계,11476,8147,1586,3835,1223,1146,305,19,1,0,1,1,1,1,3,8122,25,3329
대구광역시,수성구,두산동,두산동제1투,2512,1493,248,766,221,193,57,3,0,0,0,0,1,0,1,1490,3,1019
대구광역시,수성구,두산동,두산동제2투,2925,1637,316,792,230,215,68,9,0,0,0,0,0,0,0,1630,7,1288
대구광역시,수성구,두산동,두산동제3투,3934,2912,529,1335,501,450,83,5,0,0,1,1,0,0,1,2906,6,1022
대구광역시,수성구,지산1동,합계,19264,14386,2856,6880,2079,1834,597,33,2,5,5,5,5,5,19,14325,61,4878
대구광역시,수성구,지산1동,관내사전투표,3588,3588,899,1459,501,532,167,4,2,0,4,0,0,2,3,3573,15,0
대구광역시,수성구,지산1동,지산1동제1투,2565,1824,332,902,259,247,66,2,0,1,0,1,0,1,5,1816,8,741
대구광역시,수성구,지산1동,지산1동제2투,1940,1317,242,673,196,151,42,1,0,1,0,0,0,1,3,1310,7,623
대구광역시,수성구,지산1동,지산1동제3투,2166,1449,272,784,207,122,48,4,0,0,0,0,2,1,2,1442,7,717
대구광역시,수성구,지산1동,지산1동제4투,2902,2078,372,993,309,278,100,12,0,0,0,1,1,0,3,2069,9,824
대구광역시,수성구,지산1동,지산1동제5투,3057,2105,363,1048,318,273,84,8,0,1,0,2,1,0,0,2098,7,952
대구광역시,수성구,지산1동,지산1동제6투,3046,2025,376,1021,289,231,90,2,0,2,1,1,1,0,3,2017,8,1021
대구광역시,수성구,지산2동,합계,16063,12117,2443,5661,1784,1615,516,36,1,6,2,8,2,3,7,12084,33,3946
대구광역시,수성구,지산2동,관내사전투표,2626,2626,663,1114,349,357,119,5,0,2,1,4,1,0,0,2615,11,0
대구광역시,수성구,지산2동,지산2동제1투,2907,1832,352,923,261,200,85,4,0,0,1,0,0,1,1,1828,4,1075
대구광역시,수성구,지산2동,지산2동제2투,3001,2354,432,1064,399,349,95,8,0,0,0,0,0,0,1,2348,6,647
대구광역시,수성구,지산2동,지산2동제3투,2631,1849,351,871,285,245,78,7,0,3,0,3,0,0,0,1843,6,782
대구광역시,수성구,지산2동,지산2동제4투,2414,1647,293,857,240,185,57,6,0,1,0,1,1,1,2,1644,3,767
대구광역시,수성구,지산2동,지산2동제5투,2484,1809,352,832,250,279,82,6,1,0,0,0,0,1,3,1806,3,675
대구광역시,수성구,범물1동,합계,10741,8088,1462,4178,1128,947,280,26,3,4,0,4,3,7,7,8049,39,2653
대구광역시,수성구,범물1동,관내사전투표,1994,1994,430,959,269,229,83,4,1,1,0,1,1,3,3,1984,10,0
대구광역시,수성구,범물1동,범물1동제1투,2260,1405,205,817,186,126,54,5,1,1,0,3,2,1,0,1401,4,855
대구광역시,수성구,범물1동,범물1동제2투,1704,1099,171,646,139,96,24,8,0,1,0,0,0,0,3,1088,11,605
대구광역시,수성구,범물1동,범물1동제3투,2380,1831,361,867,262,269,58,8,1,0,0,0,0,1,1,1828,3,549
대구광역시,수성구,범물1동,범물1동제4투,2403,1759,295,889,272,227,61,1,0,1,0,0,0,2,0,1748,11,644
대구광역시,수성구,범물2동,합계,12139,9602,2081,4190,1559,1308,396,19,1,7,2,0,2,5,4,9574,28,2537
대구광역시,수성구,범물2동,관내사전투표,2202,2202,555,922,326,279,103,4,0,2,0,0,0,3,1,2195,7,0
대구광역시,수성구,범물2동,범물2동제1투,2282,1593,280,769,285,215,34,4,0,0,0,0,0,0,0,1587,6,689
대구광역시,수성구,범물2동,범물2동제2투,2270,1646,379,697,276,213,69,2,0,0,1,0,0,1,2,1640,6,624
대구광역시,수성구,범물2동,범물2동제3투,2675,2080,447,876,352,302,92,3,0,4,0,0,0,0,0,2076,4,595
대구광역시,수성구,범물2동,범물2동제4투,2710,2081,420,926,320,299,98,6,1,1,1,0,2,1,1,2076,5,629
대구광역시,수성구,고산1동,합계,23569,19425,5124,7231,3197,2731,987,58,2,6,6,5,0,7,10,19364,61,4144
대구광역시,수성구,고산1동,관내사전투표,4443,4443,1450,1340,686,657,283,10,0,3,2,1,0,0,1,4433,10,0
대구광역시,수성구,고산1동,고산1동제1투,2263,1743,489,583,318,238,98,6,0,1,0,1,0,1,1,1736,7,520
대구광역시,수성구,고산1동,고산1동제2투,2624,1929,406,882,296,241,88,6,0,0,0,0,0,1,1,1921,8,695
대구광역시,수성구,고산1동,고산1동제3투,2619,1962,445,867,311,235,86,8,1,1,0,0,0,0,1,1955,7,657
대구광역시,수성구,고산1동,고산1동제4투,2288,1729,382,691,286,250,104,4,0,0,2,0,0,1,2,1722,7,559
대구광역시,수성구,고산1동,고산1동제5투,2686,2211,471,965,363,307,90,3,0,0,0,1,0,2,2,2204,7,475
대구광역시,수성구,고산1동,고산1동제6투,3664,2905,732,1117,486,402,139,17,0,0,0,1,0,2,2,2898,7,759
대구광역시,수성구,고산1동,고산1동제7투,2982,2503,749,786,451,401,99,4,1,1,2,1,0,0,0,2495,8,479
대구광역시,수성구,고산2동,합계,19579,15817,3897,6584,2384,2150,682,28,1,2,3,12,2,4,11,15760,57,3762
대구광역시,수성구,고산2동,관내사전투표,3997,3997,1190,1476,558,528,211,5,1,1,2,3,0,1,4,3980,17,0
대구광역시,수성구,고산2동,고산2동제1투,2684,1941,434,863,283,274,79,1,0,0,0,2,0,0,1,1937,4,743
대구광역시,수성구,고산2동,고산2동제2투,2929,2241,532,974,320,292,107,3,0,0,1,1,1,1,1,2233,8,688
대구광역시,수성구,고산2동,고산2동제3투,2730,1981,435,900,292,265,73,3,0,0,0,0,0,0,3,1971,10,749
대구광역시,수성구,고산2동,고산2동제4투,3491,2811,684,1148,458,376,114,14,0,0,0,2,0,0,2,2798,13,680
대구광역시,수성구,고산2동,고산2동제5투,3748,2846,622,1223,473,415,98,2,0,1,0,4,1,2,0,2841,5,902
대구광역시,수성구,고산3동,합계,25028,20402,5135,7876,3315,2934,981,48,1,9,5,11,0,10,15,20340,62,4626
대구광역시,수성구,고산3동,관내사전투표,4834,4834,1469,1610,749,702,266,12,0,3,0,1,0,3,3,4818,16,0
대구광역시,수성구,고산3동,고산3동제1투,3077,2255,448,1045,345,289,104,5,0,3,2,4,0,1,1,2247,8,822
대구광역시,수성구,고산3동,고산3동제2투,2778,1958,391,919,283,246,99,7,0,2,0,2,0,1,2,1952,6,820
대구광역시,수성구,고산3동,고산3동제3투,2551,1917,477,716,324,305,87,1,0,0,0,0,0,1,3,1914,3,634
대구광역시,수성구,고산3동,고산3동제4투,2048,1607,401,604,274,225,84,8,1,1,0,2,0,0,2,1602,5,441
대구광역시,수성구,고산3동,고산3동제5투,3197,2612,610,1095,414,367,105,5,0,0,2,0,0,2,2,2602,10,585
대구광역시,수성구,고산3동,고산3동제6투,3357,2640,628,1014,435,429,118,4,0,0,1,1,0,2,0,2632,8,717
대구광역시,수성구,고산3동,고산3동제7투,3186,2579,711,873,491,371,118,6,0,0,0,1,0,0,2,2573,6,607
대구광역시,수성구,잘못 투입·구분된 투표지,,0,1,0,0,1,0,0,0,0,0,0,0,0,0,0,1,0,-1
대구광역시,달서구,합계,,479081,374766,82726,165781,57956,45593,18805,1155,62,138,72,195,90,194,346,373113,1653,104315
대구광역시,달서구,거소·선상투표,,888,831,198,237,251,93,19,7,2,2,0,0,2,0,3,814,17,57
대구광역시,달서구,관외사전투표,,36257,36256,10362,11151,6304,5257,2563,109,15,18,19,31,15,17,84,35945,311,1
대구광역시,달서구,재외투표,,2039,1558,863,122,222,132,201,10,0,1,0,0,0,0,1,1552,6,481
대구광역시,달서구,성당동,합계,19230,13920,2622,7137,1927,1444,633,75,3,3,0,2,4,7,8,13865,55,5310
대구광역시,달서구,성당동,관내사전투표,2632,2632,583,1260,331,285,138,15,2,1,0,2,1,0,1,2619,13,0
대구광역시,달서구,성당동,성당동제1투,3471,2169,301,1229,318,193,99,12,0,1,0,0,1,2,3,2159,10,1302
대구광역시,달서구,성당동,성당동제2투,2607,1733,285,1035,201,140,54,6,1,1,0,0,1,0,0,1724,9,874
대구광역시,달서구,성당동,성당동제3투,3174,2069,291,1208,258,189,98,13,0,0,0,0,0,1,0,2058,11,1105
대구광역시,달서구,성당동,성당동제4투,3600,2733,683,1117,426,355,126,15,0,0,0,0,0,2,2,2726,7,867
대구광역시,달서구,성당동,성당동제5투,3746,2584,479,1288,393,282,118,14,0,0,0,0,1,2,2,2579,5,1162
대구광역시,달서구,두류1·2동,합계,13973,9478,1622,5248,1209,869,397,40,2,4,2,5,5,8,4,9415,63,4495
대구광역시,달서구,두류1·2동,관내사전투표,1473,1473,328,732,177,134,84,8,1,0,0,2,0,0,0,1466,7,0
대구광역시,달서구,두류1·2동,두류1·2동제1투,2089,1244,181,727,159,104,54,5,0,0,0,0,1,2,1,1234,10,845
대구광역시,달서구,두류1·2동,두류1·2동제2투,2304,1511,235,882,184,127,59,11,0,1,1,0,1,2,1,1504,7,793
대구광역시,달서구,두류1·2동,두류1·2동제3투,2416,1561,200,959,207,129,47,4,0,0,0,2,0,0,0,1548,13,855
대구광역시,달서구,두류1·2동,두류1·2동제4투,2487,1663,286,934,214,144,59,4,1,1,0,0,2,3,1,1649,14,824
대구광역시,달서구,두류1·2동,두류1·2동제5투,3204,2026,392,1014,268,231,94,8,0,2,1,1,1,1,1,2014,12,1178
대구광역시,달서구,두류3동,합계,8579,6556,1260,3292,886,733,313,24,0,1,1,2,0,5,8,6525,31,2023
대구광역시,달서구,두류3동,관내사전투표,1955,1955,465,871,253,225,116,9,0,0,0,0,0,2,3,1944,11,0
대구광역시,달서구,두류3동,두류3동제1투,2733,2033,369,1042,283,240,78,8,0,0,1,1,0,0,3,2025,8,700
대구광역시,달서구,두류3동,두류3동제2투,2192,1389,229,727,200,150,67,6,0,1,0,0,0,2,1,1383,6,803
대구광역시,달서구,두류3동,두류3동제3투,1699,1179,197,652,150,118,52,1,0,0,0,1,0,1,1,1173,6,520
대구광역시,달서구,본리동,합계,17949,13501,3137,5849,2069,1672,631,73,1,7,1,9,3,5,7,13464,37,4448
대구광역시,달서구,본리동,관내사전투표,3577,3577,1024,1336,501,491,193,18,0,1,0,4,0,1,0,3569,8,0
대구광역시,달서구,본리동,본리동제1투,2614,2057,524,797,322,305,83,12,0,1,0,1,0,0,1,2046,11,557
대구광역시,달서구,본리동,본리동제2투,2107,1224,230,576,210,120,75,5,0,1,0,0,0,0,2,1219,5,883
대구광역시,달서구,본리동,본리동제3투,2138,1400,245,718,187,173,63,7,0,1,0,2,2,0,0,1398,2,738
대구광역시,달서구,본리동,본리동제4투,2155,1660,385,727,282,192,58,9,0,1,1,2,0,1,0,1658,2,495
대구광역시,달서구,본리동,본리동제5투,3051,1914,351,938,316,198,91,11,1,1,0,0,0,1,1,1909,5,1137
대구광역시,달서구,본리동,본리동제6투,2307,1669,378,757,251,193,68,11,0,1,0,0,1,2,3,1665,4,638
대구광역시,달서구,감삼동,합계,20913,15740,3032,7634,2404,1791,700,78,1,5,1,10,1,8,11,15676,64,5173
대구광역시,달서구,감삼동,관내사전투표,2024,2023,530,837,282,239,111,7,0,0,0,1,0,4,2,2013,10,1
대구광역시,달서구,감삼동,감삼동제1투,2634,1670,292,877,226,166,81,12,1,1,0,1,0,1,2,1660,10,964
대구광역시,달서구,감삼동,감삼동제2투,3006,1981,276,1140,295,161,80,17,0,0,0,1,0,1,1,1972,9,1025
대구광역시,달서구,감삼동,감삼동제3투,2363,1576,257,836,242,150,63,10,0,1,0,4,0,1,0,1564,12,787
대구광역시,달서구,감삼동,감삼동제4투,3198,2462,498,1162,405,267,103,15,0,1,0,1,1,0,1,2454,8,736
대구광역시,달서구,감삼동,감삼동제5투,4265,3467,729,1564,539,451,159,11,0,0,1,2,0,0,3,3459,8,798
대구광역시,달서구,감삼동,감삼동제6투,3423,2561,450,1218,415,357,103,6,0,2,0,0,0,1,2,2554,7,862
대구광역시,달서구,죽전동,합계,12435,8918,1531,4592,1293,977,429,19,1,5,0,7,3,3,8,8868,50,3517
대구광역시,달서구,죽전동,관내사전투표,1290,1290,274,576,192,160,73,1,0,3,0,0,0,1,0,1280,10,0
대구광역시,달서구,죽전동,죽전동제1투,2087,1341,198,750,182,123,71,2,0,0,0,4,0,0,2,1332,9,746
대구광역시,달서구,죽전동,죽전동제2투,2392,1678,281,868,243,186,79,4,1,0,0,2,0,2,2,1668,10,714
대구광역시,달서구,죽전동,죽전동제3투,3344,2312,401,1169,358,256,108,2,0,1,0,0,0,0,2,2297,15,1032
대구광역시,달서구,죽전동,죽전동제4투,3322,2297,377,1229,318,252,98,10,0,1,0,1,3,0,2,2291,6,1025
대구광역시,달서구,장기동,관내사전투표,3230,3230,940,1166,442,452,198,9,0,2,0,2,1,0,1,3213,17,0
대구광역시,달서구,장기동,합계,14200,11138,2476,4901,1634,1474,538,38,0,5,1,5,2,4,9,11087,51,3062
대구광역시,달서구,장기동,장기동제1투,3170,2317,437,1066,341,350,98,10,0,0,0,2,0,1,2,2307,10,853
대구광역시,달서구,장기동,장기동제2투,1846,1213,202,680,145,121,46,2,0,2,0,0,0,3,3,1204,9,633
대구광역시,달서구,장기동,장기동제3투,3384,2621,561,1168,410,340,118,9,0,1,0,0,1,0,2,2610,11,763
대구광역시,달서구,장기동,장기동제4투,2570,1757,336,821,296,211,78,8,0,0,1,1,0,0,1,1753,4,813
대구광역시,달서구,용산1동,합계,25036,19866,4082,8831,3088,2615,1078,40,3,8,1,5,6,8,22,19787,79,5170
대구광역시,달서구,용산1동,관내사전투표,4045,4045,1061,1523,581,546,297,10,2,3,0,1,2,1,3,4030,15,0
대구광역시,달서구,용산1동,용산1동제1투,2867,1954,378,920,288,234,116,3,0,1,0,0,0,1,5,1946,8,913
대구광역시,달서구,용산1동,용산1동제2투,3150,2419,499,1062,383,309,148,6,0,1,1,2,0,0,3,2414,5,731
대구광역시,달서구,용산1동,용산1동제3투,2499,1787,318,843,273,243,94,1,0,0,0,0,0,3,1,1776,11,712
대구광역시,달서구,용산1동,용산1동제4투,2810,2217,443,943,402,310,97,4,1,1,0,0,1,1,4,2207,10,593
대구광역시,달서구,용산1동,용산1동제5투,2978,2134,397,974,353,285,106,4,0,0,0,1,0,0,1,2121,13,844
대구광역시,달서구,용산1동,용산1동제6투,3076,2348,389,1189,341,301,100,6,0,2,0,1,1,1,4,2335,13,728
대구광역시,달서구,용산1동,용산1동제7투,3611,2962,597,1377,467,387,120,6,0,0,0,0,2,1,1,2958,4,649
대구광역시,달서구,용산2동,합계,23359,18225,3953,7848,2937,2348,978,39,4,4,7,12,3,5,23,18161,64,5134
대구광역시,달서구,용산2동,관내사전투표,3164,3164,876,1167,489,402,202,3,1,1,0,7,1,1,4,3154,10,0
대구광역시,달서구,용산2동,용산2동제1투,2576,1722,327,814,270,208,89,4,0,0,3,1,0,1,2,1719,3,854
대구광역시,달서구,용산2동,용산2동제2투,3219,2022,425,911,304,250,113,7,0,1,1,0,0,0,1,2013,9,1197
대구광역시,달서구,용산2동,용산2동제3투,1940,1554,310,666,271,207,89,1,0,0,0,1,0,0,4,1549,5,386
대구광역시,달서구,용산2동,용산2동제4투,3192,2655,567,1116,429,393,130,5,1,0,1,2,0,0,1,2645,10,537
대구광역시,달서구,용산2동,용산2동제5투,3648,2790,598,1189,473,375,132,9,1,0,0,1,0,1,4,2783,7,858
대구광역시,달서구,용산2동,용산2동제6투,2628,2031,407,907,334,246,115,6,0,1,1,0,1,1,3,2022,9,597
대구광역시,달서구,용산2동,용산2동제7투,2992,2287,443,1078,367,267,108,4,1,1,1,0,1,1,4,2276,11,705
대구광역시,달서구,이곡1동,합계,19080,14757,3180,6388,2447,1867,765,27,2,4,1,7,1,7,12,14708,49,4323
대구광역시,달서구,이곡1동,관내사전투표,2852,2852,802,1033,446,388,160,3,2,1,1,1,1,1,3,2842,10,0
대구광역시,달서구,이곡1동,이곡1동제1투,2443,1493,294,759,223,133,77,3,0,0,0,0,0,0,2,1491,2,950
대구광역시,달서구,이곡1동,이곡1동제2투,1776,1368,246,666,241,167,41,1,0,0,0,1,0,1,1,1365,3,408
대구광역시,달서구,이곡1동,이곡1동제3투,3053,2427,556,962,413,354,119,7,0,1,0,3,0,1,1,2417,10,626
대구광역시,달서구,이곡1동,이곡1동제4투,2551,1843,347,826,323,228,105,4,0,0,0,2,0,0,0,1835,8,708
대구광역시,달서구,이곡1동,이곡1동제5투,2664,2037,431,840,346,281,125,4,0,0,0,0,0,3,0,2030,7,627
대구광역시,달서구,이곡1동,이곡1동제6투,3741,2737,504,1302,455,316,138,5,0,2,0,0,0,1,5,2728,9,1004
대구광역시,달서구,이곡2동,관내사전투표,3993,3993,1027,1591,586,492,251,13,1,2,0,4,1,4,5,3977,16,0
대구광역시,달서구,이곡2동,합계,15227,12233,2552,5561,1874,1474,655,34,2,5,0,9,3,8,12,12189,44,2994
대구광역시,달서구,이곡2동,이곡2동제1투,2492,1782,361,821,278,214,88,7,0,1,0,1,2,0,2,1775,7,710
대구광역시,달서구,이곡2동,이곡2동제2투,2960,1959,398,861,346,228,105,2,1,1,0,4,0,3,1,1950,9,1001
대구광역시,달서구,이곡2동,이곡2동제3투,2856,2247,397,1135,315,290,98,6,0,0,0,0,0,1,1,2243,4,609
대구광역시,달서구,이곡2동,이곡2동제4투,2926,2252,369,1153,349,250,113,6,0,1,0,0,0,0,3,2244,8,674
대구광역시,달서구,신당동,합계,25863,18355,3803,8308,2919,2186,929,38,2,8,4,11,10,13,15,18246,109,7508
대구광역시,달서구,신당동,관내사전투표,2074,2074,627,730,308,261,126,2,0,1,0,1,1,2,0,2059,15,0
대구광역시,달서구,신당동,신당동제1투,3089,1724,289,880,283,157,90,2,0,3,0,1,3,0,6,1714,10,1365
대구광역시,달서구,신당동,신당동제2투,1781,1071,211,498,170,114,58,2,0,0,2,2,1,2,1,1061,10,710
대구광역시,달서구,신당동,신당동제3투,1476,859,183,386,123,98,58,3,0,0,1,0,0,0,1,853,6,617
대구광역시,달서구,신당동,신당동제4투,2574,1591,277,847,241,131,70,7,0,1,0,1,3,5,0,1583,8,983
대구광역시,달서구,신당동,신당동제5투,2795,1809,319,933,308,148,75,6,0,2,0,0,1,0,2,1794,15,986
대구광역시,달서구,신당동,신당동제6투,3291,2726,591,1196,440,361,120,3,1,0,0,0,0,0,1,2713,13,565
대구광역시,달서구,신당동,신당동제7투,3198,1915,374,823,289,300,112,5,1,0,0,0,0,1,0,1905,10,1283
대구광역시,달서구,신당동,신당동제8투,3919,3176,659,1400,525,422,138,7,0,1,1,4,1,1,3,3162,14,743
대구광역시,달서구,신당동,신당동제9투,1666,1410,273,615,232,194,82,1,0,0,0,2,0,2,1,1402,8,256
대구광역시,달서구,월성1동,합계,28067,22993,6406,8183,3923,3235,1114,41,2,5,1,15,4,7,7,22943,50,5074
대구광역시,달서구,월성1동,관내사전투표,3949,3949,1361,1122,610,607,224,6,0,0,0,2,1,3,1,3937,12,0
대구광역시,달서구,월성1동,월성1동제1투,3724,2780,778,945,520,372,147,7,0,0,1,3,0,0,2,2775,5,944
대구광역시,달서구,월성1동,월성1동제2투,3761,2891,817,972,477,450,154,5,1,0,0,7,1,1,1,2886,5,870
대구광역시,달서구,월성1동,월성1동제3투,2981,2465,651,899,425,373,104,3,0,2,0,1,0,0,1,2459,6,516
대구광역시,달서구,월성1동,월성1동제4투,2209,1838,498,640,365,257,71,6,0,0,0,0,0,0,0,1837,1,371
대구광역시,달서구,월성1동,월성1동제5투,3087,2425,497,1201,335,272,104,4,0,1,0,1,2,1,0,2418,7,662
대구광역시,달서구,월성1동,월성1동제6투,2252,1804,349,875,275,214,79,4,0,0,0,1,0,0,1,1798,6,448
대구광역시,달서구,월성1동,월성1동제7투,3183,2555,722,848,492,355,126,4,0,2,0,0,0,2,1,2552,3,628
대구광역시,달서구,월성1동,월성1동제8투,2921,2286,733,681,424,335,105,2,1,0,0,0,0,0,0,2281,5,635
대구광역시,달서구,월성2동,합계,16028,12059,2276,6125,1793,1240,461,41,2,6,5,2,3,12,22,11988,71,3969
대구광역시,달서구,월성2동,관내사전투표,3166,3166,838,1308,446,376,153,11,0,2,2,2,0,5,4,3147,19,0
대구광역시,달서구,월성2동,월성2동제1투,1843,1071,151,649,152,80,22,3,0,0,0,0,2,2,1,1062,9,772
대구광역시,달서구,월성2동,월성2동제2투,2158,1508,248,794,232,164,59,3,1,0,0,0,0,2,1,1504,4,650
대구광역시,달서구,월성2동,월성2동제3투,2123,1434,220,780,225,140,45,5,1,1,0,0,0,0,5,1422,12,689
대구광역시,달서구,월성2동,월성2동제4투,2608,1980,347,1074,264,210,64,8,0,1,2,0,0,0,1,1971,9,628
대구광역시,달서구,월성2동,월성2동제5투,1919,1297,185,746,210,94,34,5,0,2,0,0,1,2,7,1286,11,622
대구광역시,달서구,월성2동,월성2동제6투,2211,1603,287,774,264,176,84,6,0,0,1,0,0,1,3,1596,7,608
대구광역시,달서구,진천동,합계,47229,37071,9049,15336,5914,4705,1746,88,7,20,6,11,10,24,32,36948,123,10158
대구광역시,달서구,진천동,관내사전투표,6375,6375,1903,2341,894,811,368,16,2,3,0,2,3,5,5,6353,22,0
대구광역시,달서구,진천동,진천동제1투,3294,2339,429,1143,352,270,107,10,0,4,0,3,0,1,4,2323,16,955
대구광역시,달서구,진천동,진천동제2투,3108,2186,371,1177,297,237,86,4,0,3,0,1,0,2,3,2181,5,922
대구광역시,달서구,진천동,진천동제3투,3126,2083,323,1164,292,200,82,2,1,1,0,0,0,3,3,2071,12,1043
대구광역시,달서구,진천동,진천동제4투,3009,2095,444,993,316,209,104,3,0,3,1,0,1,2,6,2082,13,914
대구광역시,달서구,진천동,진천동제5투,2939,2365,500,1008,400,315,115,11,0,3,1,1,0,4,2,2360,5,574
대구광역시,달서구,진천동,진천동제6투,2560,1939,337,994,304,211,75,3,0,2,0,1,0,2,2,1931,8,621
대구광역시,달서구,진천동,진천동제7투,3099,2270,517,1022,359,276,86,3,1,0,2,0,1,0,1,2268,2,829
대구광역시,달서구,진천동,진천동제8투,2723,2035,471,898,317,238,100,2,0,0,0,0,0,0,0,2026,9,688
대구광역시,달서구,진천동,진천동제9투,3007,2469,588,979,433,336,117,8,0,0,0,1,1,0,1,2464,5,538
대구광역시,달서구,진천동,진천동제10투,3390,2436,546,1051,410,285,119,7,2,0,0,0,1,2,1,2424,12,954
대구광역시,달서구,진천동,진천동제11투,1539,1139,260,504,167,154,47,3,0,0,0,0,1,0,0,1136,3,400
대구광역시,달서구,진천동,진천동제12투,2810,2314,698,728,406,338,130,7,0,1,1,0,0,1,0,2310,4,496
대구광역시,달서구,진천동,진천동제13투,2981,2372,783,663,448,356,109,5,0,0,1,2,2,1,1,2371,1,609
대구광역시,달서구,진천동,진천동제14투,3269,2654,879,671,519,469,101,4,1,0,0,0,0,1,3,2648,6,615
대구광역시,달서구,상인1동,합계,29943,24825,5396,10973,3846,3253,1189,67,1,2,0,13,2,10,8,24760,65,5118
대구광역시,달서구,상인1동,관내사전투표,4426,4426,1226,1727,569,631,237,16,1,0,0,2,1,1,2,4413,13,0
대구광역시,달서구,상인1동,상인1동제1투,2896,2223,388,1124,303,294,98,6,0,1,0,4,0,2,0,2220,3,673
대구광역시,달서구,상인1동,상인1동제2투,1970,1588,280,786,238,211,61,3,0,0,0,0,0,1,1,1581,7,382
대구광역시,달서구,상인1동,상인1동제3투,2760,2136,400,1023,330,266,96,9,0,0,0,2,0,0,0,2126,10,624
대구광역시,달서구,상인1동,상인1동제4투,1925,1421,258,722,211,149,65,6,0,0,0,0,1,1,1,1414,7,504
대구광역시,달서구,상인1동,상인1동제5투,1887,1533,256,735,244,202,85,4,0,0,0,1,0,1,0,1528,5,354
대구광역시,달서구,상인1동,상인1동제6투,3111,2459,468,1194,405,267,110,3,0,0,0,3,0,2,3,2455,4,652
대구광역시,달서구,상인1동,상인1동제7투,3219,2626,623,1024,464,356,148,4,0,0,0,1,0,1,0,2621,5,593
대구광역시,달서구,상인1동,상인1동제8투,3135,2593,567,1084,435,362,127,9,0,1,0,0,0,0,0,2585,8,542
대구광역시,달서구,상인1동,상인1동제9투,2205,1796,354,798,316,239,82,4,0,0,0,0,0,1,1,1795,1,409
대구광역시,달서구,상인1동,상인1동제10투,2409,2024,576,756,331,276,80,3,0,0,0,0,0,0,0,2022,2,385
대구광역시,달서구,상인2동,합계,16906,12458,2396,6205,1828,1348,568,18,2,6,2,11,3,3,12,12402,56,4448
대구광역시,달서구,상인2동,관내사전투표,2951,2951,668,1333,426,339,160,3,1,2,1,3,1,1,1,2939,12,0
대구광역시,달서구,상인2동,상인2동제1투,2485,1552,227,869,222,156,67,1,0,0,1,2,0,0,1,1546,6,933
대구광역시,달서구,상인2동,상인2동제2투,2393,1567,280,811,229,165,67,5,0,0,0,0,1,0,2,1560,7,826
대구광역시,달서구,상인2동,상인2동제3투,2283,1548,275,808,216,157,70,2,0,1,0,1,0,0,3,1533,15,735
대구광역시,달서구,상인2동,상인2동제4투,2817,2019,420,962,324,216,81,3,1,1,0,1,1,1,3,2014,5,798
대구광역시,달서구,상인2동,상인2동제5투,2178,1563,302,751,241,192,64,3,0,1,0,1,0,1,2,1558,5,615
대구광역시,달서구,상인2동,상인2동제6투,1799,1258,224,671,170,123,59,1,0,1,0,3,0,0,0,1252,6,541
대구광역시,달서구,상인3동,합계,10913,7919,1352,4425,1058,692,296,26,2,5,8,5,1,10,3,7883,36,2994
대구광역시,달서구,상인3동,관내사전투표,1682,1682,335,901,213,140,76,4,1,1,1,2,1,3,0,1678,4,0
대구광역시,달서구,상인3동,상인3동제1투,2160,1435,213,823,196,141,52,2,0,0,1,1,0,0,0,1429,6,725
대구광역시,달서구,상인3동,상인3동제2투,2448,1734,315,912,221,196,78,4,0,0,2,0,0,0,2,1730,4,714
대구광역시,달서구,상인3동,상인3동제3투,2597,1714,248,1022,244,114,50,10,0,1,3,2,0,4,0,1698,16,883
대구광역시,달서구,상인3동,상인3동제4투,2026,1354,241,767,184,101,40,6,1,3,1,0,0,3,1,1348,6,672
대구광역시,달서구,도원동,합계,29858,24203,5307,10912,3578,2975,1251,51,3,5,5,7,2,8,14,24118,85,5655
대구광역시,달서구,도원동,관내사전투표,5429,5429,1488,2096,747,722,331,14,0,2,1,1,0,1,1,5404,25,0
대구광역시,달서구,도원동,도원동제1투,2592,1844,334,862,301,220,107,8,0,0,0,0,0,1,2,1835,9,748
대구광역시,달서구,도원동,도원동제2투,2356,1701,347,845,241,178,78,3,0,0,0,1,0,0,0,1693,8,655
대구광역시,달서구,도원동,도원동제3투,2523,1825,377,857,280,202,96,1,1,0,0,1,1,0,2,1818,7,698
대구광역시,달서구,도원동,도원동제4투,2248,1714,354,854,236,164,86,5,1,2,1,1,1,1,2,1708,6,534
대구광역시,달서구,도원동,도원동제5투,1877,1463,320,615,239,170,112,3,0,0,0,0,0,1,0,1460,3,414
대구광역시,달서구,도원동,도원동제6투,2166,1620,363,695,263,200,87,4,1,0,0,0,0,0,2,1615,5,546
대구광역시,달서구,도원동,도원동제7투,2557,2101,401,1015,301,286,82,4,0,0,0,1,0,2,2,2094,7,456
대구광역시,달서구,도원동,도원동제8투,2964,2472,471,1205,372,307,106,6,0,0,1,2,0,0,1,2471,1,492
대구광역시,달서구,도원동,도원동제9투,3027,2336,484,1105,356,299,78,1,0,0,1,0,0,1,2,2327,9,691
대구광역시,달서구,도원동,도원동제10투,2119,1698,368,763,242,227,88,2,0,1,1,0,0,1,0,1693,5,421
대구광역시,달서구,송현1동,합계,16973,11862,2186,6134,1693,1182,525,58,2,3,1,6,4,7,5,11806,56,5111
대구광역시,달서구,송현1동,관내사전투표,2509,2509,606,1189,301,268,110,15,0,0,0,3,1,2,2,2497,12,0
대구광역시,달서구,송현1동,송현1동제1투,2649,1713,260,938,277,145,80,4,0,0,1,0,1,0,0,1706,7,936
대구광역시,달서구,송현1동,송현1동제2투,2681,1658,276,897,233,176,62,5,0,1,0,0,1,3,0,1654,4,1023
대구광역시,달서구,송현1동,송현1동제3투,2799,1819,324,933,270,181,83,17,1,0,0,0,1,1,1,1812,7,980
대구광역시,달서구,송현1동,송현1동제4투,3440,2222,382,1154,337,224,100,9,0,1,0,0,0,1,2,2210,12,1218
대구광역시,달서구,송현1동,송현1동제5투,2895,1941,338,1023,275,188,90,8,1,1,0,3,0,0,0,1927,14,954
대구광역시,달서구,송현2동,합계,16693,11758,2080,6279,1618,1162,478,56,1,3,5,6,1,11,10,11710,48,4935
대구광역시,달서구,송현2동,관내사전투표,1901,1901,440,874,238,213,113,9,0,0,2,1,1,3,0,1894,7,0
대구광역시,달서구,송현2동,송현2동제1투,2731,1666,288,945,222,124,55,14,0,0,1,1,0,0,5,1655,11,1065
대구광역시,달서구,송현2동,송현2동제2투,2096,1460,261,764,217,137,53,10,0,1,0,1,0,4,1,1449,11,636
대구광역시,달서구,송현2동,송현2동제3투,2666,1644,269,896,236,155,75,5,0,0,0,1,0,2,1,1640,4,1022
대구광역시,달서구,송현2동,송현2동제4투,2474,1785,328,882,275,214,71,4,0,0,1,1,0,1,0,1777,8,689
대구광역시,달서구,송현2동,송현2동제5투,2303,1716,292,930,243,181,59,5,0,1,1,0,0,0,2,1714,2,587
대구광역시,달서구,송현2동,송현2동제6투,2522,1586,202,988,187,138,52,9,1,1,0,1,0,1,1,1581,5,936
대구광역시,달서구,본동,합계,11443,8282,1605,4108,1240,869,347,58,2,3,1,4,2,4,6,8249,33,3161
대구광역시,달서구,본동,관내사전투표,1560,1560,423,659,214,179,70,10,0,0,0,1,0,0,0,1556,4,0
대구광역시,달서구,본동,본동제1투,2026,1273,219,690,181,105,57,7,1,1,0,0,1,1,1,1264,9,753
대구광역시,달서구,본동,본동제2투,2605,1967,377,1001,300,219,54,10,1,0,0,0,0,0,0,1962,5,638
대구광역시,달서구,본동,본동제3투,2282,1632,322,762,259,179,76,14,0,1,1,3,1,2,3,1623,9,650
대구광역시,달서구,본동,본동제4투,2970,1850,264,996,286,187,90,17,0,1,0,0,0,1,2,1844,6,1120
대구광역시,달서구,잘못 투입·구분된 투표지,,0,4,0,2,1,0,1,0,0,0,0,0,0,0,0,4,0,-4
대구광역시,달성군,합계,,179372,137920,31753,60032,21427,15964,7287,242,34,48,40,80,46,118,194,137265,655,41452
대구광역시,달성군,거소·선상투표,,553,525,146,131,125,45,15,6,4,5,2,1,2,3,6,491,34,28
대구광역시,달성군,관외사전투표,,15746,15740,4509,5205,2550,2225,1052,24,5,3,5,16,2,7,39,15642,98,6
대구광역시,달성군,재외투표,,740,479,247,44,88,43,52,1,0,0,0,0,0,0,0,475,4,261
대구광역시,달성군,화원읍,합계,36987,27478,5487,13182,4087,3079,1378,57,3,12,9,12,6,15,28,27355,123,9509
대구광역시,달성군,화원읍,관내사전투표,4961,4961,1262,2040,714,586,312,9,0,2,0,3,2,1,6,4937,24,0
대구광역시,달성군,화원읍,화원읍제1투,3137,1902,317,1051,242,202,71,7,0,0,0,1,2,2,3,1898,4,1235
대구광역시,달성군,화원읍,화원읍제2투,3073,2165,342,1121,347,235,89,7,0,1,4,0,1,1,2,2150,15,908
대구광역시,달성군,화원읍,화원읍제3투,2555,1721,236,975,248,165,68,5,0,1,2,0,0,1,4,1705,16,834
대구광역시,달성군,화원읍,화원읍제4투,2982,1478,278,731,228,168,65,3,0,1,0,0,0,1,0,1475,3,1504
대구광역시,달성군,화원읍,화원읍제5투,2995,2219,505,1031,315,226,124,3,1,0,0,2,0,2,4,2213,6,776
대구광역시,달성군,화원읍,화원읍제6투,3209,2326,426,1155,373,251,106,3,1,1,0,1,0,0,2,2319,7,883
대구광역시,달성군,화원읍,화원읍제7투,1131,875,145,471,109,97,46,0,0,2,0,0,1,0,0,871,4,256
대구광역시,달성군,화원읍,화원읍제8투,2225,1453,177,857,201,144,57,2,1,2,0,0,0,3,0,1444,9,772
대구광역시,달성군,화원읍,화원읍제9투,3651,2746,519,1316,417,311,151,9,0,0,2,2,0,1,2,2730,16,905
대구광역시,달성군,화원읍,화원읍제10투,2636,2000,406,894,348,212,123,2,0,0,0,0,0,1,3,1989,11,636
대구광역시,달성군,화원읍,화원읍제11투,1677,1271,283,558,179,171,70,2,0,1,1,0,0,0,1,1266,5,406
대구광역시,달성군,화원읍,화원읍제12투,2755,2361,591,982,366,311,96,5,0,1,0,3,0,2,1,2358,3,394
대구광역시,달성군,논공읍,합계,14547,9975,1961,4826,1494,938,607,18,3,4,3,19,4,18,23,9918,57,4572
대구광역시,달성군,논공읍,관내사전투표,1477,1477,376,628,176,179,97,3,0,0,0,2,1,6,3,1471,6,0
대구광역시,달성군,논공읍,논공읍제1투,1465,951,109,635,114,58,24,2,1,0,0,0,0,3,0,946,5,514
대구광역시,달성군,논공읍,논공읍제2투,945,620,62,430,65,36,16,1,0,0,0,0,0,3,1,614,6,325
대구광역시,달성군,논공읍,논공읍제3투,2098,1307,266,607,232,103,77,2,0,0,2,5,2,1,3,1300,7,791
대구광역시,달성군,논공읍,논공읍제4투,1604,1081,233,488,172,100,75,1,0,3,0,3,0,1,3,1079,2,523
대구광역시,달성군,논공읍,논공읍제5투,2520,1714,361,706,285,202,139,1,0,0,0,5,0,1,1,1701,13,806
대구광역시,달성군,논공읍,논공읍제6투,2488,1458,265,733,229,125,78,6,1,1,1,2,1,3,6,1451,7,1030
대구광역시,달성군,논공읍,논공읍제7투,1950,1367,289,599,221,135,101,2,1,0,0,2,0,0,6,1356,11,583
대구광역시,달성군,다사읍,합계,51232,39631,9561,15964,6662,5046,2113,65,7,7,8,12,7,15,39,39506,125,11601
대구광역시,달성군,다사읍,관내사전투표,4993,4993,1595,1680,732,626,312,7,1,1,2,3,2,2,5,4968,25,0
대구광역시,달성군,다사읍,다사읍제1투,2286,1602,308,728,268,199,85,5,0,0,0,0,0,1,0,1594,8,684
대구광역시,달성군,다사읍,다사읍제2투,2744,1993,413,972,309,193,90,7,0,0,0,0,0,1,1,1986,7,751
대구광역시,달성군,다사읍,다사읍제3투,2299,1576,321,790,247,147,61,1,0,0,0,1,0,1,3,1572,4,723
대구광역시,달성군,다사읍,다사읍제4투,595,433,41,282,67,34,7,0,0,0,0,0,0,1,0,432,1,162
대구광역시,달성군,다사읍,다사읍제5투,2327,1696,324,785,285,198,96,1,0,0,0,0,0,0,1,1690,6,631
대구광역시,달성군,다사읍,다사읍제6투,2627,2019,391,928,341,237,98,4,1,2,0,1,0,1,6,2010,9,608
대구광역시,달성군,다사읍,다사읍제7투,2774,2053,429,891,351,248,111,1,1,0,1,0,1,2,6,2042,11,721
대구광역시,달성군,다사읍,다사읍제8투,2869,2079,425,942,345,238,111,5,0,1,0,2,0,2,5,2076,3,790
대구광역시,달성군,다사읍,다사읍제9투,2613,1968,421,867,361,213,91,4,0,0,0,2,0,1,2,1962,6,645
대구광역시,달성군,다사읍,다사읍제10투,3183,2488,544,1102,397,306,130,2,1,0,0,0,1,0,1,2484,4,695
대구광역시,달성군,다사읍,다사읍제11투,3651,2883,732,1042,502,415,177,6,0,0,0,0,0,1,3,2878,5,768
대구광역시,달성군,다사읍,다사읍제12투,2859,2088,448,906,389,234,101,5,0,0,1,0,0,0,1,2085,3,771
대구광역시,달성군,다사읍,다사읍제13투,2666,2113,622,780,329,281,87,5,0,0,1,0,1,0,1,2107,6,553
대구광역시,달성군,다사읍,다사읍제14투,1956,1369,294,588,228,171,77,0,0,2,1,1,0,0,1,1363,6,587
대구광역시,달성군,다사읍,다사읍제15투,3022,2160,622,718,380,317,110,6,0,0,1,1,1,1,0,2157,3,862
대구광역시,달성군,다사읍,다사읍제16투,2530,1876,483,586,341,320,139,2,2,0,0,0,0,0,0,1873,3,654
대구광역시,달성군,다사읍,다사읍제17투,2866,2385,626,851,439,334,125,1,1,1,1,0,0,0,2,2381,4,481
대구광역시,달성군,다사읍,다사읍제18투,2372,1857,522,526,351,335,105,3,0,0,0,1,1,1,1,1846,11,515
대구광역시,달성군,가창면,합계,6446,4755,809,2670,651,418,153,8,2,3,0,1,6,8,5,4734,21,1691
대구광역시,달성군,가창면,관내사전투표,1089,1089,231,551,150,94,49,2,0,0,0,0,2,3,1,1083,6,0
대구광역시,달성군,가창면,가창면제1투,1412,912,187,450,131,97,40,2,1,0,0,0,0,0,1,909,3,500
대구광역시,달성군,가창면,가창면제2투,1233,843,136,439,137,87,36,0,0,2,0,0,0,1,0,838,5,390
대구광역시,달성군,가창면,가창면제3투,1699,1215,179,761,155,91,18,2,1,1,0,0,3,2,1,1214,1,484
대구광역시,달성군,가창면,가창면제4투,1013,696,76,469,78,49,10,2,0,0,0,1,1,2,2,690,6,317
대구광역시,달성군,하빈면,합계,3500,2463,318,1606,290,147,66,5,2,0,1,0,1,9,2,2447,16,1037
대구광역시,달성군,하빈면,관내사전투표,559,559,105,321,72,41,16,2,0,0,0,0,0,1,0,558,1,0
대구광역시,달성군,하빈면,하빈면제1투,1566,1002,127,663,117,48,26,1,2,0,0,0,0,5,2,991,11,564
대구광역시,달성군,하빈면,하빈면제2투,1375,902,86,622,101,58,24,2,0,0,1,0,1,3,0,898,4,473
대구광역시,달성군,옥포면,합계,14211,10554,2010,5480,1477,1071,397,27,1,3,3,2,6,8,14,10499,55,3657
대구광역시,달성군,옥포면,관내사전투표,2069,2068,522,908,280,242,100,2,0,0,0,0,0,1,5,2060,8,1
대구광역시,달성군,옥포면,옥포면제1투,2480,1631,270,928,200,150,61,6,0,0,1,0,2,2,2,1622,9,849
대구광역시,달성군,옥포면,옥포면제2투,1654,1166,135,794,125,74,23,6,1,0,0,0,1,2,1,1162,4,488
대구광역시,달성군,옥포면,옥포면제3투,1703,1205,161,709,171,102,41,6,0,0,2,0,2,2,1,1197,8,498
대구광역시,달성군,옥포면,옥포면제4투,3418,2315,419,1235,353,206,74,6,0,1,0,1,1,0,3,2299,16,1103
대구광역시,달성군,옥포면,옥포면제5투,2887,2169,503,906,348,297,98,1,0,2,0,1,0,1,2,2159,10,718
대구광역시,달성군,현풍면,관내사전투표,2068,2068,605,841,271,191,131,2,0,1,2,1,3,3,2,2053,15,0
대구광역시,달성군,현풍면,합계,13647,9728,2123,4618,1385,946,529,10,2,4,6,4,8,14,19,9668,60,3919
대구광역시,달성군,현풍면,현풍면제1투,2093,1302,222,745,157,98,60,2,0,0,0,0,0,3,4,1291,11,791
대구광역시,달성군,현풍면,현풍면제2투,1922,1204,185,688,147,90,73,1,0,0,1,0,2,3,5,1195,9,718
대구광역시,달성군,현풍면,현풍면제3투,1344,867,115,570,89,55,27,1,0,1,0,0,0,1,1,860,7,477
대구광역시,달성군,현풍면,현풍면제4투,780,549,63,386,55,15,11,0,0,0,1,1,3,3,4,542,7,231
대구광역시,달성군,현풍면,현풍면제5투,2510,1698,429,570,313,259,114,2,1,1,1,2,0,0,2,1694,4,812
대구광역시,달성군,현풍면,현풍면제6투,2930,2040,504,818,353,238,113,2,1,1,1,0,0,1,1,2033,7,890
대구광역시,달성군,유가면,합계,16210,12648,3807,4181,2119,1674,764,14,3,5,1,12,0,9,14,12603,45,3562
대구광역시,달성군,유가면,관내사전투표,3653,3653,1354,960,563,506,237,5,0,2,0,7,0,0,4,3638,15,0
대구광역시,달성군,유가면,유가면제1투,1745,1192,239,553,191,141,57,1,1,0,0,1,0,2,1,1187,5,553
대구광역시,달성군,유가면,유가면제2투,1052,682,74,496,53,34,17,0,0,0,0,1,0,3,0,678,4,370
대구광역시,달성군,유가면,유가면제3투,3227,2298,641,764,423,316,134,5,0,0,1,2,0,0,2,2288,10,929
대구광역시,달성군,유가면,유가면제4투,3236,2343,700,711,434,327,153,2,1,2,0,1,0,2,3,2336,7,893
대구광역시,달성군,유가면,유가면제5투,3297,2480,799,697,455,350,166,1,1,1,0,0,0,2,4,2476,4,817
대구광역시,달성군,구지면,합계,5553,3944,775,2125,499,332,161,7,2,2,2,1,4,12,5,3927,17,1609
대구광역시,달성군,구지면,관내사전투표,1087,1087,291,492,128,106,57,1,1,0,1,0,1,5,1,1084,3,0
대구광역시,달성군,구지면,구지면제1투,1000,634,50,477,50,30,13,3,0,1,0,0,0,3,2,629,5,366
대구광역시,달성군,구지면,구지면제2투,614,444,42,312,45,18,14,1,0,1,1,0,3,2,2,441,3,170
대구광역시,달성군,구지면,구지면제3투,1063,638,150,257,114,78,35,1,0,0,0,0,0,2,0,637,1,425
대구광역시,달성군,구지면,구지면제4투,1789,1141,242,587,162,100,42,1,1,0,0,1,0,0,0,1136,5,648
대구광역시,달성군,잘못 투입·구분된 투표지,,0,0,0,0,0,0,0,0,0,0,0,0,0,0,0,0,0,0
인천광역시,합계,,,2409031,1820091,747090,379191,428888,118691,129925,2646,374,1618,410,1230,594,625,1681,1812963,7128,588940
인천광역시,중구,합계,,94392,69220,28030,16139,15405,4196,4837,122,14,59,22,54,19,27,64,68988,232,25172
인천광역시,중구,거소·선상투표,,210,200,83,32,58,9,6,3,0,3,1,0,0,0,1,196,4,10
인천광역시,중구,관외사전투표,,8556,8556,3743,1588,1788,631,697,18,3,6,1,9,3,2,11,8500,56,0
인천광역시,중구,재외투표,,719,542,338,51,66,23,58,3,0,0,0,0,0,0,1,540,2,177
인천광역시,중구,신포동,관내사전투표,707,707,272,218,134,41,39,3,0,0,0,0,0,0,0,707,0,0
인천광역시,중구,신포동,합계,4523,3065,1088,966,660,160,166,5,0,7,3,2,0,0,1,3058,7,1458
인천광역시,중구,신포동,신포동제1투,1997,1372,520,382,310,74,76,1,0,4,1,0,0,0,1,1369,3,625
인천광역시,중구,신포동,신포동제2투,1819,986,296,366,216,45,51,1,0,3,2,2,0,0,0,982,4,833
인천광역시,중구,연안동,합계,5890,3873,1304,1192,977,204,176,1,0,2,0,0,0,0,2,3858,15,2017
인천광역시,중구,연안동,관내사전투표,972,972,377,285,216,52,38,0,0,0,0,0,0,0,0,968,4,0
인천광역시,중구,연안동,연안동제1투,843,521,178,155,125,23,37,1,0,1,0,0,0,0,0,520,1,322
인천광역시,중구,연안동,연안동제2투,2095,1140,366,359,312,52,44,0,0,0,0,0,0,0,1,1134,6,955
인천광역시,중구,연안동,연안동제3투,1980,1240,383,393,324,77,57,0,0,1,0,0,0,0,1,1236,4,740
인천광역시,중구,신흥동,합계,10795,7612,2762,2077,1765,422,518,7,1,7,1,6,2,6,11,7585,27,3183
인천광역시,중구,신흥동,관내사전투표,1556,1556,576,418,345,86,119,0,0,2,0,1,0,1,0,1548,8,0
인천광역시,중구,신흥동,신흥동제1투,1977,1186,405,367,269,65,63,1,0,1,0,3,1,4,2,1181,5,791
인천광역시,중구,신흥동,신흥동제2투,2641,1811,665,507,402,90,134,3,0,1,1,1,0,0,5,1809,2,830
인천광역시,중구,신흥동,신흥동제3투,534,337,93,90,106,23,23,1,0,0,0,0,0,0,0,336,1,197
인천광역시,중구,신흥동,신흥동제4투,2569,1807,733,399,415,114,135,1,1,2,0,0,1,0,2,1803,4,762
인천광역시,중구,신흥동,신흥동제5투,1518,915,290,296,228,44,44,1,0,1,0,1,0,1,2,908,7,603
인천광역시,중구,도원동,합계,3840,2675,894,839,626,134,157,2,1,3,2,1,1,2,2,2664,11,1165
인천광역시,중구,도원동,관내사전투표,774,774,267,243,173,34,50,2,1,1,1,0,0,0,0,772,2,0
인천광역시,중구,도원동,도원동제1투,1692,1017,353,307,244,46,58,0,0,1,1,0,0,1,1,1012,5,675
인천광역시,중구,도원동,도원동제2투,1374,884,274,289,209,54,49,0,0,1,0,1,1,1,1,880,4,490
인천광역시,중구,율목동,합계,3387,2170,659,710,521,116,146,2,0,0,2,2,2,1,1,2162,8,1217
인천광역시,중구,율목동,관내사전투표,663,663,219,202,156,33,47,1,0,0,0,1,1,0,1,661,2,0
인천광역시,중구,율목동,율목동투표소,2724,1507,440,508,365,83,99,1,0,0,2,1,1,1,0,1501,6,1217
인천광역시,중구,동인천동,합계,5130,3331,1090,1028,797,176,202,4,1,4,4,3,5,2,5,3321,10,1799
인천광역시,중구,동인천동,관내사전투표,907,907,333,272,186,47,59,0,1,0,2,1,0,0,0,901,6,0
인천광역시,중구,동인천동,동인천동제1투,1416,756,205,268,187,45,42,0,0,1,1,1,2,1,1,754,2,660
인천광역시,중구,동인천동,동인천동제2투,2807,1668,552,488,424,84,101,4,0,3,1,1,3,1,4,1666,2,1139
인천광역시,중구,북성동,합계,2756,1855,610,590,429,112,99,3,0,2,1,0,1,1,3,1851,4,901
인천광역시,중구,북성동,관내사전투표,364,364,151,81,80,29,20,0,0,0,0,0,0,1,2,364,0,0
인천광역시,중구,북성동,북성동제1투,1671,981,310,311,234,64,55,2,0,0,1,0,1,0,1,979,2,690
인천광역시,중구,북성동,북성동제2투,721,510,149,198,115,19,24,1,0,2,0,0,0,0,0,508,2,211
인천광역시,중구,송월동,합계,4023,2797,970,777,657,167,196,5,1,3,1,1,0,1,5,2784,13,1226
인천광역시,중구,송월동,관내사전투표,729,729,282,195,156,36,52,2,0,0,0,0,0,0,1,724,5,0
인천광역시,중구,송월동,송월동제1투,2189,1428,495,386,341,92,99,3,1,2,1,0,0,0,3,1423,5,761
인천광역시,중구,송월동,송월동제2투,1105,640,193,196,160,39,45,0,0,1,0,1,0,1,1,637,3,465
인천광역시,중구,영종동,합계,23473,16911,7395,3458,3749,1018,1168,34,5,10,3,15,3,7,9,16874,37,6562
인천광역시,중구,영종동,관내사전투표,3542,3542,1743,623,699,202,247,14,1,2,0,5,0,1,1,3538,4,0
인천광역시,중구,영종동,영종동제1투,1692,1022,304,381,223,47,65,0,0,0,1,0,0,0,0,1021,1,670
인천광역시,중구,영종동,영종동제2투,1939,1263,502,286,293,86,86,3,0,3,0,0,0,1,1,1261,2,676
인천광역시,중구,영종동,영종동제3투,1524,897,268,324,199,42,45,3,3,0,0,3,1,0,1,889,8,627
인천광역시,중구,영종동,영종동제4투,1941,1099,291,423,277,46,48,0,0,3,0,4,0,0,0,1092,7,842
인천광역시,중구,영종동,영종동제5투,4724,3221,1491,536,735,191,247,7,1,2,0,1,1,3,2,3217,4,1503
인천광역시,중구,영종동,영종동제6투,3995,2793,1345,346,646,218,220,1,0,0,2,0,1,1,4,2784,9,1202
인천광역시,중구,영종동,영종동제7투,4116,3074,1451,539,677,186,210,6,0,0,0,2,0,1,0,3072,2,1042
인천광역시,중구,용유동,합계,3604,2222,524,930,535,104,101,3,1,5,0,2,0,1,4,2210,12,1382
인천광역시,중구,용유동,관내사전투표,402,402,116,145,87,26,26,0,0,0,0,1,0,0,0,401,1,0
인천광역시,중구,용유동,용유동제1투,1445,777,200,303,186,38,36,1,1,3,0,1,0,0,1,770,7,668
인천광역시,중구,용유동,용유동제2투,1159,644,160,257,159,28,31,1,0,2,0,0,0,1,2,641,3,515
인천광역시,중구,용유동,용유동제3투,532,348,42,206,81,10,6,1,0,0,0,0,0,0,1,347,1,184
인천광역시,중구,용유동,용유동제4투,66,51,6,19,22,2,2,0,0,0,0,0,0,0,0,51,0,15
인천광역시,중구,운서동,관내사전투표,4906,4906,2604,574,887,332,479,12,0,0,1,3,1,1,4,4898,8,0
인천광역시,중구,운서동,합계,17486,13411,6570,1901,2777,920,1147,32,1,7,3,13,2,4,8,13385,26,4075
인천광역시,중구,운서동,운서동제1투,2422,1764,874,268,380,105,122,6,1,2,0,1,1,0,0,1760,4,658
인천광역시,중구,운서동,운서동제2투,1945,1201,554,199,247,90,99,1,0,4,0,3,0,0,2,1199,2,744
인천광역시,중구,운서동,운서동제3투,2304,1703,791,271,402,93,140,0,0,1,0,2,0,0,0,1700,3,601
인천광역시,중구,운서동,운서동제4투,3746,2249,1003,374,491,186,177,7,0,0,1,2,0,3,0,2244,5,1497
인천광역시,중구,운서동,운서동제5투,2163,1588,744,215,370,114,130,6,0,0,1,2,0,0,2,1584,4,575
인천광역시,중구,잘못 투입·구분된 투표지,,0,0,0,0,0,0,0,0,0,0,0,0,0,0,0,0,0,0
인천광역시,동구,합계,,59362,44672,16501,11446,10479,2484,3296,64,21,42,10,42,19,28,43,44475,197,14690
인천광역시,동구,거소·선상투표,,101,98,36,14,34,7,5,0,0,0,0,0,0,0,2,98,0,3
인천광역시,동구,관외사전투표,,3961,3961,1771,653,851,278,365,5,1,2,0,6,3,1,5,3941,20,0
인천광역시,동구,재외투표,,310,223,138,18,34,7,24,0,0,0,0,1,0,0,0,222,1,87
인천광역시,동구,만석동,합계,6122,4479,1620,1076,1145,226,359,5,2,7,0,2,3,4,4,4453,26,1643
인천광역시,동구,만석동,관내사전투표,1237,1237,496,262,293,66,109,1,0,1,0,0,2,2,0,1232,5,0
인천광역시,동구,만석동,만석동제1투,2155,1302,412,354,360,65,89,3,1,3,0,0,1,1,2,1291,11,853
인천광역시,동구,만석동,만석동제2투,2730,1940,712,460,492,95,161,1,1,3,0,2,0,1,2,1930,10,790
인천광역시,동구,화수1·화평동,합계,5409,3829,1252,1178,883,197,290,2,0,2,1,3,2,1,1,3812,17,1580
인천광역시,동구,화수1·화평동,관내사전투표,868,868,309,257,176,44,75,0,0,1,0,0,0,0,0,862,6,0
인천광역시,동구,화수1·화평동,화수1·화평동제1투,2166,1297,409,424,314,50,88,1,0,0,1,2,1,0,1,1291,6,869
인천광역시,동구,화수1·화평동,화수1·화평동제2투,2375,1664,534,497,393,103,127,1,0,1,0,1,1,1,0,1659,5,711
인천광역시,동구,화수2동,합계,6742,5006,1698,1381,1207,282,386,5,6,5,3,4,1,1,5,4984,22,1736
인천광역시,동구,화수2동,관내사전투표,792,792,305,205,163,39,68,0,4,1,0,1,0,0,1,787,5,0
인천광역시,동구,화수2동,화수2동제1투,1790,1115,329,316,320,60,76,3,0,1,3,0,0,0,2,1110,5,675
인천광역시,동구,화수2동,화수2동제2투,2135,1496,501,427,350,83,122,0,1,3,0,1,1,1,1,1491,5,639
인천광역시,동구,화수2동,화수2동제3투,2025,1603,563,433,374,100,120,2,1,0,0,2,0,0,1,1596,7,422
인천광역시,동구,송현1·2동,관내사전투표,1877,1877,760,474,381,99,146,5,0,1,0,2,0,0,2,1870,7,0
인천광역시,동구,송현1·2동,합계,8847,6882,2738,1634,1511,423,532,9,1,5,0,5,1,1,7,6867,15,1965
인천광역시,동구,송현1·2동,송현1·2동제1투,2074,1460,500,415,354,84,100,2,0,1,0,2,0,0,1,1459,1,614
인천광역시,동구,송현1·2동,송현1·2동제2투,2287,1695,670,389,386,111,130,1,0,2,0,0,1,0,4,1694,1,592
인천광역시,동구,송현1·2동,송현1·2동제3투,2609,1850,808,356,390,129,156,1,1,1,0,1,0,1,0,1844,6,759
인천광역시,동구,송현3동,합계,3462,2485,829,666,642,144,165,6,1,4,1,2,0,2,2,2464,21,977
인천광역시,동구,송현3동,관내사전투표,650,650,260,141,140,41,61,3,0,0,0,0,0,0,0,646,4,0
인천광역시,동구,송현3동,송현3동제1투,1459,996,296,300,279,52,51,3,0,2,0,2,0,2,1,988,8,463
인천광역시,동구,송현3동,송현3동제2투,1353,839,273,225,223,51,53,0,1,2,1,0,0,0,1,830,9,514
인천광역시,동구,송림1동,관내사전투표,370,370,138,95,91,23,17,1,1,0,0,1,0,1,0,368,2,0
인천광역시,동구,송림1동,합계,2290,1593,503,522,355,97,87,6,1,2,0,4,2,4,3,1586,7,697
인천광역시,동구,송림1동,송림1동제1투,1158,722,229,229,158,55,38,2,0,1,0,3,2,1,2,720,2,436
인천광역시,동구,송림1동,송림1동제2투,762,501,136,198,106,19,32,3,0,1,0,0,0,2,1,498,3,261
인천광역시,동구,송림2동,합계,3028,2109,643,712,526,82,119,7,1,2,0,0,2,2,1,2097,12,919
인천광역시,동구,송림2동,관내사전투표,604,604,210,174,137,36,40,2,0,0,0,0,0,0,0,599,5,0
인천광역시,동구,송림2동,송림2동제1투,1128,650,172,248,163,24,37,1,0,0,0,0,1,0,0,646,4,478
인천광역시,동구,송림2동,송림2동제2투,1296,855,261,290,226,22,42,4,1,2,0,0,1,2,1,852,3,441
인천광역시,동구,송림3·5동,관내사전투표,1336,1336,580,287,279,75,102,1,0,0,0,5,4,0,0,1333,3,0
인천광역시,동구,송림3·5동,합계,6995,5095,1918,1283,1217,262,356,5,2,6,0,9,4,4,5,5071,24,1900
인천광역시,동구,송림3·5동,송림3·5동제1투,2645,1672,482,580,432,72,77,2,1,3,0,3,0,3,3,1658,14,973
인천광역시,동구,송림3·5동,송림3·5동제2투,3014,2087,856,416,506,115,177,2,1,3,0,1,0,1,2,2080,7,927
인천광역시,동구,송림4동,합계,3535,2671,1031,621,645,165,176,8,3,1,2,2,0,3,4,2661,10,864
인천광역시,동구,송림4동,관내사전투표,716,716,285,181,156,40,44,4,0,0,0,0,0,0,1,711,5,0
인천광역시,동구,송림4동,송림4동제1투,653,333,86,114,88,24,17,1,0,0,1,0,0,1,1,333,0,320
인천광역시,동구,송림4동,송림4동제2투,2166,1622,660,326,401,101,115,3,3,1,1,2,0,2,2,1617,5,544
인천광역시,동구,송림6동,관내사전투표,872,872,375,184,182,45,78,1,0,1,0,0,0,1,2,869,3,0
인천광역시,동구,송림6동,합계,5617,4181,1654,996,958,229,311,5,1,1,1,2,1,3,4,4166,15,1436
인천광역시,동구,송림6동,송림6동제1투,1593,992,305,343,246,33,51,3,0,0,0,2,1,1,2,987,5,601
인천광역시,동구,송림6동,송림6동제2투,3152,2317,974,469,530,151,182,1,1,0,1,0,0,1,0,2310,7,835
인천광역시,동구,금창동,합계,2943,2060,670,692,471,85,121,1,2,5,2,2,0,2,0,2053,7,883
인천광역시,동구,금창동,관내사전투표,650,650,240,204,131,24,45,0,1,1,1,2,0,0,0,649,1,0
인천광역시,동구,금창동,금창동제1투,1122,646,208,218,164,26,20,1,0,3,0,0,0,1,0,641,5,476
인천광역시,동구,금창동,금창동제2투,1171,764,222,270,176,35,56,0,1,1,1,0,0,1,0,763,1,407
인천광역시,동구,잘못 투입·구분된 투표지,,0,0,0,0,0,0,0,0,0,0,0,0,0,0,0,0,0,0
인천광역시,남구,합계,,352503,254020,96338,60603,61034,15593,18179,373,57,254,44,142,82,93,221,253013,1007,98483
인천광역시,남구,거소·선상투표,,679,626,232,110,196,34,26,3,3,0,0,0,5,2,1,612,14,53
인천광역시,남구,관외사전투표,,25549,25547,11537,4003,5650,1848,2177,35,10,26,8,17,15,9,34,25369,178,2
인천광역시,남구,재외투표,,1791,1340,808,102,222,55,144,6,0,0,0,0,0,0,1,1338,2,451
인천광역시,남구,숭의1·3동,관내사전투표,1652,1652,600,471,322,94,146,4,1,0,1,4,0,3,0,1646,6,0
인천광역시,남구,숭의1·3동,합계,9711,6332,2257,1756,1453,360,448,12,2,3,1,5,2,6,2,6307,25,3379
인천광역시,남구,숭의1·3동,숭의1·3동제1투,2579,1456,523,405,365,69,80,1,0,2,0,1,1,0,1,1448,8,1123
인천광역시,남구,숭의1·3동,숭의1·3동제2투,3084,1827,635,506,424,115,131,6,0,0,0,0,1,2,1,1821,6,1257
인천광역시,남구,숭의1·3동,숭의1·3동제3투,2396,1397,499,374,342,82,91,1,1,1,0,0,0,1,0,1392,5,999
인천광역시,남구,숭의2동,관내사전투표,2596,2596,1009,646,579,126,216,6,0,1,0,1,0,0,1,2585,11,0
인천광역시,남구,숭의2동,합계,11141,7499,2586,2051,1854,384,565,13,1,5,1,3,2,1,4,7470,29,3642
인천광역시,남구,숭의2동,숭의2동제1투,3120,1737,570,497,427,107,125,1,1,2,1,0,0,0,1,1732,5,1383
인천광역시,남구,숭의2동,숭의2동제2투,2809,1700,580,468,427,81,126,4,0,2,0,0,2,1,0,1691,9,1109
인천광역시,남구,숭의2동,숭의2동제3투,2616,1466,427,440,421,70,98,2,0,0,0,2,0,0,2,1462,4,1150
인천광역시,남구,숭의4동,관내사전투표,2217,2217,853,577,477,139,150,2,0,1,0,1,1,1,4,2206,11,0
인천광역시,남구,숭의4동,합계,12878,8768,3016,2430,2155,491,599,13,1,6,0,8,3,4,10,8736,32,4110
인천광역시,남구,숭의4동,숭의4동제1투,4436,2713,926,688,728,149,201,5,1,1,0,5,0,2,0,2706,7,1723
인천광역시,남구,숭의4동,숭의4동제2투,2937,1732,541,562,416,92,100,4,0,2,0,2,1,0,2,1722,10,1205
인천광역시,남구,숭의4동,숭의4동제3투,3288,2106,696,603,534,111,148,2,0,2,0,0,1,1,4,2102,4,1182
인천광역시,남구,용현1·4동,관내사전투표,1609,1609,595,394,361,118,130,1,0,1,0,1,0,0,1,1602,7,0
인천광역시,남구,용현1·4동,합계,14167,9541,3157,2690,2343,606,648,13,3,11,1,5,3,5,9,9494,47,4626
인천광역시,남구,용현1·4동,용현1·4동제1투,2537,1355,391,400,390,67,83,0,1,5,0,1,3,2,0,1343,12,1182
인천광역시,남구,용현1·4동,용현1·4동제2투,2502,1527,460,496,385,71,97,3,1,2,1,2,0,1,3,1522,5,975
인천광역시,남구,용현1·4동,용현1·4동제3투,3316,2183,747,632,511,134,139,4,0,1,0,0,0,1,4,2173,10,1133
인천광역시,남구,용현1·4동,용현1·4동제4투,1722,1220,398,331,285,106,91,1,0,1,0,0,0,1,1,1215,5,502
인천광역시,남구,용현1·4동,용현1·4동제5투,2481,1647,566,437,411,110,108,4,1,1,0,1,0,0,0,1639,8,834
인천광역시,남구,용현2동,합계,10829,8028,2935,1987,1924,510,616,9,0,8,0,3,1,1,6,8000,28,2801
인천광역시,남구,용현2동,관내사전투표,2032,2032,821,520,412,115,155,0,0,2,0,0,0,0,1,2026,6,0
인천광역시,남구,용현2동,용현2동제1투,1987,1327,481,292,354,87,104,1,0,1,0,1,0,0,1,1322,5,660
인천광역시,남구,용현2동,용현2동제2투,3182,2021,705,522,491,136,151,1,0,3,0,0,0,1,3,2013,8,1161
인천광역시,남구,용현2동,용현2동제3투,3628,2648,928,653,667,172,206,7,0,2,0,2,1,0,1,2639,9,980
인천광역시,남구,용현3동,합계,7393,4923,1501,1576,1241,238,316,10,0,8,0,2,1,6,7,4906,17,2470
인천광역시,남구,용현3동,관내사전투표,1680,1680,581,510,390,73,109,5,0,1,0,0,0,4,2,1675,5,0
인천광역시,남구,용현3동,용현3동제1투,2985,1588,436,534,415,81,106,2,0,2,0,1,1,1,4,1583,5,1397
인천광역시,남구,용현3동,용현3동제2투,2728,1655,484,532,436,84,101,3,0,5,0,1,0,1,1,1648,7,1073
인천광역시,남구,용현5동,합계,34788,25618,10028,5512,6272,1723,1913,37,0,15,3,10,5,7,15,25540,78,9170
인천광역시,남구,용현5동,관내사전투표,6079,6079,2661,1205,1369,372,433,7,0,2,0,1,0,2,5,6057,22,0
인천광역시,남구,용현5동,용현5동제1투,3160,2012,744,490,474,126,167,2,0,2,1,0,0,1,1,2008,4,1148
인천광역시,남구,용현5동,용현5동제2투,3480,2047,681,516,550,126,153,3,0,0,0,1,0,0,1,2031,16,1433
인천광역시,남구,용현5동,용현5동제3투,3033,2000,737,464,480,158,144,3,0,6,0,1,0,0,1,1994,6,1033
인천광역시,남구,용현5동,용현5동제4투,3474,1941,664,469,530,116,143,4,0,4,0,2,1,0,1,1934,7,1533
인천광역시,남구,용현5동,용현5동제5투,3429,2420,932,582,562,157,177,5,0,0,0,0,0,0,1,2416,4,1009
인천광역시,남구,용현5동,용현5동제6투,3323,2429,824,621,584,170,214,7,0,0,0,1,1,0,0,2422,7,894
인천광역시,남구,용현5동,용현5동제7투,2751,2033,819,400,507,136,161,1,0,0,0,4,0,0,0,2028,5,718
인천광역시,남구,용현5동,용현5동제8투,3123,2431,1025,403,645,176,171,4,0,1,1,0,2,1,1,2430,1,692
인천광역시,남구,용현5동,용현5동제9투,2936,2226,941,362,571,186,150,1,0,0,1,0,1,3,4,2220,6,710
인천광역시,남구,학익1동,합계,25490,19434,7491,4562,4667,1212,1363,28,3,19,5,9,4,7,9,19379,55,6056
인천광역시,남구,학익1동,관내사전투표,4124,4124,1801,849,862,253,330,7,0,7,0,1,1,1,1,4113,11,0
인천광역시,남구,학익1동,학익1동제1투,3734,2570,839,725,706,145,142,2,0,3,1,0,1,0,0,2564,6,1164
인천광역시,남구,학익1동,학익1동제2투,2558,1523,538,364,383,104,113,3,1,1,1,0,0,1,1,1510,13,1035
인천광역시,남구,학익1동,학익1동제3투,2948,2321,813,625,565,157,154,1,1,1,0,0,0,0,1,2318,3,627
인천광역시,남구,학익1동,학익1동제4투,3205,2247,874,524,552,131,143,6,1,2,1,2,0,3,1,2240,7,958
인천광역시,남구,학익1동,학익1동제5투,2577,1715,624,429,414,100,133,3,0,3,0,3,1,1,1,1712,3,862
인천광역시,남구,학익1동,학익1동제6투,2457,1694,632,398,435,98,114,5,0,1,1,2,1,1,2,1690,4,763
인천광역시,남구,학익1동,학익1동제7투,3887,3240,1370,648,750,224,234,1,0,1,1,1,0,0,2,3232,8,647
인천광역시,남구,학익2동,합계,16483,12379,4513,3047,3032,822,867,18,4,16,2,4,2,1,7,12335,44,4104
인천광역시,남구,학익2동,관내사전투표,3235,3235,1312,742,697,209,251,8,1,5,0,2,0,0,1,3228,7,0
인천광역시,남구,학익2동,학익2동제1투,2487,1440,469,364,400,99,88,6,0,5,1,0,0,0,1,1433,7,1047
인천광역시,남구,학익2동,학익2동제2투,2352,1321,423,313,383,80,104,1,2,2,0,1,1,0,1,1311,10,1031
인천광역시,남구,학익2동,학익2동제3투,2656,1863,708,457,441,120,126,2,1,2,0,0,0,0,0,1857,6,793
인천광역시,남구,학익2동,학익2동제4투,2858,2270,778,614,565,163,136,0,0,2,1,0,1,1,4,2265,5,588
인천광역시,남구,학익2동,학익2동제5투,2895,2250,823,557,546,151,162,1,0,0,0,1,0,0,0,2241,9,645
인천광역시,남구,도화1동,합계,17215,11419,4261,2960,2643,639,830,12,6,17,1,4,4,5,5,11387,32,5796
인천광역시,남구,도화1동,관내사전투표,2686,2685,1081,703,543,148,185,2,0,9,1,0,1,1,1,2675,10,1
인천광역시,남구,도화1동,도화1동제1투,4026,2244,795,607,539,127,161,2,5,2,0,0,0,1,1,2240,4,1782
인천광역시,남구,도화1동,도화1동제2투,3724,2172,809,508,524,117,196,4,0,3,0,1,3,0,1,2166,6,1552
인천광역시,남구,도화1동,도화1동제3투,3301,2241,830,590,558,128,120,3,1,1,0,1,0,2,2,2236,5,1060
인천광역시,남구,도화1동,도화1동제4투,3478,2077,746,552,479,119,168,1,0,2,0,2,0,1,0,2070,7,1401
인천광역시,남구,도화2·3동,합계,15662,10510,3742,2794,2566,585,732,13,1,11,5,6,3,6,8,10472,38,5152
인천광역시,남구,도화2·3동,관내사전투표,2418,2418,970,602,540,122,168,6,0,1,0,1,0,1,3,2414,4,0
인천광역시,남구,도화2·3동,도화2·3동제1투,1962,880,296,239,217,42,76,0,1,2,2,0,0,0,1,876,4,1082
인천광역시,남구,도화2·3동,도화2·3동제2투,3212,2012,687,531,510,122,146,2,0,4,2,1,0,0,2,2007,5,1200
인천광역시,남구,도화2·3동,도화2·3동제3투,3051,2103,744,522,554,104,155,2,0,0,0,2,1,3,2,2089,14,948
인천광역시,남구,도화2·3동,도화2·3동제4투,3038,1924,708,534,434,121,110,2,0,3,0,1,2,1,0,1916,8,1114
인천광역시,남구,도화2·3동,도화2·3동제5투,1981,1173,337,366,311,74,77,1,0,1,1,1,0,1,0,1170,3,808
인천광역시,남구,주안1동,합계,15072,9201,3895,1682,2170,593,781,15,2,11,2,5,1,0,8,9165,36,5871
인천광역시,남구,주안1동,관내사전투표,2417,2417,1165,320,496,185,239,0,1,1,1,0,0,0,1,2409,8,0
인천광역시,남구,주안1동,주안1동제1투,4034,2109,884,389,521,129,162,7,1,2,0,2,0,0,3,2100,9,1925
인천광역시,남구,주안1동,주안1동제2투,4483,2464,935,543,605,145,213,0,0,4,1,2,0,0,3,2451,13,2019
인천광역시,남구,주안1동,주안1동제3투,4138,2211,911,430,548,134,167,8,0,4,0,1,1,0,1,2205,6,1927
인천광역시,남구,주안2동,합계,17829,11756,4037,3372,2904,644,688,23,4,15,5,2,6,4,9,11713,43,6073
인천광역시,남구,주안2동,관내사전투표,2600,2600,975,729,554,148,173,5,1,1,1,0,1,2,1,2591,9,0
인천광역시,남구,주안2동,주안2동제1투,3265,1822,622,557,457,83,84,3,0,4,1,0,1,0,3,1815,7,1443
인천광역시,남구,주안2동,주안2동제2투,3239,1985,626,581,519,108,131,2,0,3,1,0,2,0,3,1976,9,1254
인천광역시,남구,주안2동,주안2동제3투,2521,1594,546,430,425,88,94,2,1,2,0,0,1,1,1,1591,3,927
인천광역시,남구,주안2동,주안2동제4투,3033,1834,598,558,456,101,100,8,2,1,1,0,0,1,0,1826,8,1199
인천광역시,남구,주안2동,주안2동제5투,3171,1921,670,517,493,116,106,3,0,4,1,2,1,0,1,1914,7,1250
인천광역시,남구,주안3동,합계,9006,6069,2056,1693,1528,333,391,10,1,11,0,1,1,4,10,6039,30,2937
인천광역시,남구,주안3동,관내사전투표,1221,1221,484,278,290,66,92,0,0,1,0,0,0,1,2,1214,7,0
인천광역시,남구,주안3동,주안3동제1투,2407,1372,445,389,341,86,89,1,0,2,0,0,1,3,4,1361,11,1035
인천광역시,남구,주안3동,주안3동제2투,2953,1907,612,553,492,104,123,6,0,7,0,1,0,0,1,1899,8,1046
인천광역시,남구,주안3동,주안3동제3투,2425,1569,515,473,405,77,87,3,1,1,0,0,0,0,3,1565,4,856
인천광역시,남구,주안4동,합계,16294,10931,3624,3275,2685,578,661,13,4,6,4,14,4,5,18,10891,40,5363
인천광역시,남구,주안4동,관내사전투표,2136,2136,853,538,462,120,136,1,2,3,1,3,1,0,6,2126,10,0
인천광역시,남구,주안4동,주안4동제1투,3180,1871,615,506,492,103,138,5,1,0,0,1,2,2,3,1868,3,1309
인천광역시,남구,주안4동,주안4동제2투,2986,1873,611,576,458,102,108,4,0,1,0,1,0,1,5,1867,6,1113
인천광역시,남구,주안4동,주안4동제3투,2497,1598,472,539,402,85,83,1,1,0,3,5,0,0,1,1592,6,899
인천광역시,남구,주안4동,주안4동제4투,2649,1689,507,569,421,82,94,1,0,2,0,1,1,2,2,1682,7,960
인천광역시,남구,주안4동,주안4동제5투,2846,1764,566,547,450,86,102,1,0,0,0,3,0,0,1,1756,8,1082
인천광역시,남구,주안5동,합계,17381,12248,4788,2744,3040,739,817,16,4,9,4,7,7,5,17,12197,51,5133
인천광역시,남구,주안5동,관내사전투표,2986,2986,1340,561,666,176,212,3,0,4,1,3,2,0,8,2976,10,0
인천광역시,남구,주안5동,주안5동제1투,2874,1775,629,436,459,106,122,5,0,2,0,2,2,2,1,1766,9,1099
인천광역시,남구,주안5동,주안5동제2투,3447,2195,847,479,599,129,119,1,1,1,0,1,1,2,2,2182,13,1252
인천광역시,남구,주안5동,주안5동제3투,2254,1478,515,398,364,106,84,1,1,1,1,0,0,0,3,1474,4,776
인천광역시,남구,주안5동,주안5동제4투,2681,1597,608,387,388,92,108,1,1,0,2,1,1,1,1,1591,6,1084
인천광역시,남구,주안5동,주안5동제5투,3139,2217,849,483,564,130,172,5,1,1,0,0,1,0,2,2208,9,922
인천광역시,남구,주안6동,합계,17908,12679,5169,2794,2998,824,807,14,1,9,0,5,1,5,6,12633,46,5229
인천광역시,남구,주안6동,관내사전투표,3492,3492,1584,690,764,220,217,1,0,1,0,1,0,3,3,3484,8,0
인천광역시,남구,주안6동,주안6동제1투,2699,1628,640,324,410,95,140,4,1,3,0,1,1,0,1,1620,8,1071
인천광역시,남구,주안6동,주안6동제2투,4248,2401,907,559,613,133,172,2,0,2,0,1,0,2,0,2391,10,1847
인천광역시,남구,주안6동,주안6동제3투,2368,1405,469,412,326,116,75,0,0,0,0,1,0,0,0,1399,6,963
인천광역시,남구,주안6동,주안6동제4투,2315,1748,689,392,429,125,96,3,0,1,0,0,0,0,1,1736,12,567
인천광역시,남구,주안6동,주안6동제5투,2786,2005,880,417,456,135,107,4,0,2,0,1,0,0,1,2003,2,781
인천광역시,남구,주안7동,합계,12771,9211,3260,2376,2318,509,662,15,1,15,0,9,5,1,7,9178,33,3560
인천광역시,남구,주안7동,관내사전투표,3048,3048,1199,748,662,181,233,5,0,5,0,3,1,0,0,3037,11,0
인천광역시,남구,주안7동,주안7동제1투,2526,1702,554,500,417,94,120,5,0,1,0,1,1,1,3,1697,5,824
인천광역시,남구,주안7동,주안7동제2투,2651,1727,600,388,511,98,114,3,0,4,0,1,1,0,2,1722,5,924
인천광역시,남구,주안7동,주안7동제3투,2249,1245,405,344,337,64,82,1,0,3,0,0,2,0,1,1239,6,1004
인천광역시,남구,주안7동,주안7동제4투,2297,1489,502,396,391,72,113,1,1,2,0,4,0,0,1,1483,6,808
인천광역시,남구,주안8동,합계,17436,12580,4866,2918,3016,765,900,21,3,13,0,11,3,5,15,12536,44,4856
인천광역시,남구,주안8동,관내사전투표,2379,2379,1066,474,464,152,205,2,0,1,0,0,0,2,3,2369,10,0
인천광역시,남구,주안8동,주안8동제1투,2817,1623,612,352,406,101,130,6,0,1,0,3,1,0,2,1614,9,1194
인천광역시,남구,주안8동,주안8동제2투,2023,1290,498,301,330,61,83,2,0,6,0,2,0,3,3,1289,1,733
인천광역시,남구,주안8동,주안8동제3투,3049,2051,707,516,531,129,135,8,0,2,0,5,2,0,2,2037,14,998
인천광역시,남구,주안8동,주안8동제4투,3118,2345,948,496,562,154,177,0,2,1,0,1,0,0,2,2343,2,773
인천광역시,남구,주안8동,주안8동제5투,4050,2892,1035,779,723,168,170,3,1,2,0,0,0,0,3,2884,8,1158
인천광역시,남구,관교동,합계,13341,10184,3771,2596,2340,681,713,17,0,11,2,6,3,1,6,10147,37,3157
인천광역시,남구,관교동,관내사전투표,2930,2930,1136,677,654,212,225,3,0,6,2,3,1,1,2,2922,8,0
인천광역시,남구,관교동,관교동제1투,2710,2027,679,609,446,161,116,4,0,1,0,1,0,0,1,2018,9,683
인천광역시,남구,관교동,관교동제2투,2326,1510,516,421,368,78,116,1,0,0,0,0,2,0,1,1503,7,816
인천광역시,남구,관교동,관교동제3투,2313,1695,639,458,375,107,101,5,0,1,0,2,0,0,1,1689,6,618
인천광역시,남구,관교동,관교동제4투,3062,2022,801,431,497,123,155,4,0,3,0,0,0,0,1,2015,7,1040
인천광역시,남구,문학동,합계,11689,7197,2808,1573,1817,420,515,7,3,9,0,6,1,3,7,7169,28,4492
인천광역시,남구,문학동,관내사전투표,2286,2286,993,476,515,124,154,2,0,3,0,1,0,1,0,2269,17,0
인천광역시,남구,문학동,문학동제1투,3344,1613,597,365,426,91,121,1,2,1,0,2,1,1,1,1609,4,1731
인천광역시,남구,문학동,문학동제2투,3030,1683,635,343,451,110,135,0,1,2,0,0,0,1,4,1682,1,1347
인천광역시,남구,문학동,문학동제3투,3029,1615,583,389,425,95,105,4,0,3,0,3,0,0,2,1609,6,1414
인천광역시,남구,잘못 투입·구분된 투표지,,0,0,0,0,0,0,0,0,0,0,0,0,0,0,0,0,0,0
인천광역시,연수구,합계,,262343,208175,85853,41920,48166,15928,14622,303,32,231,40,105,55,67,137,207459,716,54168
인천광역시,연수구,거소·선상투표,,668,632,216,84,221,41,21,2,1,2,3,1,3,0,4,599,33,36
인천광역시,연수구,관외사전투표,,20909,20906,9295,3244,4593,1816,1744,18,4,12,4,15,8,13,32,20798,108,3
인천광역시,연수구,재외투표,,2056,1629,999,109,265,72,174,4,1,1,0,1,0,0,0,1626,3,427
인천광역시,연수구,옥련1동,관내사전투표,2198,2198,896,544,449,128,159,2,3,5,0,3,0,2,2,2193,5,0
인천광역시,연수구,옥련1동,합계,15607,11330,4124,2780,2732,760,840,13,3,16,2,7,6,5,6,11294,36,4277
인천광역시,연수구,옥련1동,옥련1동제1투,2883,1918,679,431,480,151,161,2,0,5,0,1,1,0,0,1911,7,965
인천광역시,연수구,옥련1동,옥련1동제2투,1739,1099,329,347,271,67,77,0,0,1,0,1,1,0,1,1095,4,640
인천광역시,연수구,옥련1동,옥련1동제3투,2757,1663,509,507,417,93,114,7,0,3,1,2,3,1,0,1657,6,1094
인천광역시,연수구,옥련1동,옥련1동제4투,2887,2129,795,447,556,152,168,0,0,1,0,0,1,2,2,2124,5,758
인천광역시,연수구,옥련1동,옥련1동제5투,3143,2323,916,504,559,169,161,2,0,1,1,0,0,0,1,2314,9,820
인천광역시,연수구,옥련2동,합계,17971,13970,5555,3036,3240,980,1055,9,0,22,1,6,2,4,8,13918,52,4001
인천광역시,연수구,옥련2동,관내사전투표,4648,4648,2045,911,942,324,392,2,0,9,1,3,1,1,1,4632,16,0
인천광역시,연수구,옥련2동,옥련2동제1투,2566,1598,560,423,380,95,121,2,0,4,0,1,1,1,5,1593,5,968
인천광역시,연수구,옥련2동,옥련2동제2투,2022,1317,486,329,320,90,85,0,0,2,0,0,0,0,0,1312,5,705
인천광역시,연수구,옥련2동,옥련2동제3투,3244,2417,845,603,585,188,175,2,0,4,0,2,0,0,0,2404,13,827
인천광역시,연수구,옥련2동,옥련2동제4투,2695,1845,767,361,453,113,138,0,0,1,0,0,0,1,1,1835,10,850
인천광역시,연수구,옥련2동,옥련2동제5투,2796,2145,852,409,560,170,144,3,0,2,0,0,0,1,1,2142,3,651
인천광역시,연수구,선학동,합계,15534,11199,4235,2691,2670,767,727,19,3,13,7,4,6,2,8,11152,47,4335
인천광역시,연수구,선학동,관내사전투표,2770,2770,1206,600,540,189,199,9,1,4,2,0,2,1,2,2755,15,0
인천광역시,연수구,선학동,선학동제1투,2255,1556,585,383,356,121,98,1,1,1,0,0,0,0,1,1547,9,699
인천광역시,연수구,선학동,선학동제2투,2607,1999,734,497,520,120,120,0,0,0,1,0,1,1,0,1994,5,608
인천광역시,연수구,선학동,선학동제3투,3236,2211,800,535,566,147,150,1,0,4,0,0,1,0,2,2206,5,1025
인천광역시,연수구,선학동,선학동제4투,2005,969,329,248,248,75,57,0,0,3,0,2,1,0,1,964,5,1036
인천광역시,연수구,선학동,선학동제5투,2661,1694,581,428,440,115,103,8,1,1,4,2,1,0,2,1686,8,967
인천광역시,연수구,연수1동,합계,19077,12351,4749,2745,2970,822,946,20,2,15,4,12,7,6,8,12306,45,6726
인천광역시,연수구,연수1동,관내사전투표,3278,3278,1415,629,716,207,280,4,1,5,0,4,2,2,2,3267,11,0
인천광역시,연수구,연수1동,연수1동제1투,2703,1758,683,370,431,118,145,5,0,0,0,0,0,0,0,1752,6,945
인천광역시,연수구,연수1동,연수1동제2투,2563,1809,685,390,433,141,134,5,0,2,0,5,2,3,1,1801,8,754
인천광역시,연수구,연수1동,연수1동제3투,2713,1839,640,458,474,133,118,2,1,4,1,1,0,1,4,1837,2,874
인천광역시,연수구,연수1동,연수1동제4투,2656,1028,380,266,249,62,65,0,0,2,1,0,1,0,0,1026,2,1628
인천광역시,연수구,연수1동,연수1동제5투,2540,1449,519,336,379,97,103,2,0,2,0,1,0,0,1,1440,9,1091
인천광역시,연수구,연수1동,연수1동제6투,2624,1190,427,296,288,64,101,2,0,0,2,1,2,0,0,1183,7,1434
인천광역시,연수구,연수2동,합계,18109,14087,5678,2917,3272,1058,1052,23,4,15,2,3,5,4,12,14045,42,4022
인천광역시,연수구,연수2동,관내사전투표,3371,3370,1527,609,664,247,294,5,0,6,1,1,3,0,2,3359,11,1
인천광역시,연수구,연수2동,연수2동제1투,2732,2003,746,451,481,175,142,1,1,1,0,0,0,0,0,1998,5,729
인천광역시,연수구,연수2동,연수2동제2투,2724,2182,921,440,502,164,143,3,0,1,1,0,2,1,1,2179,3,542
인천광역시,연수구,연수2동,연수2동제3투,2790,1910,632,521,524,103,101,6,2,3,0,0,0,2,4,1898,12,880
인천광역시,연수구,연수2동,연수2동제4투,2055,1643,715,255,384,135,142,2,0,2,0,0,0,1,2,1638,5,412
인천광역시,연수구,연수2동,연수2동제5투,2772,1946,761,386,484,154,147,4,1,1,0,2,0,0,3,1943,3,826
인천광역시,연수구,연수2동,연수2동제6투,1665,1033,376,255,233,80,83,2,0,1,0,0,0,0,0,1030,3,632
인천광역시,연수구,연수3동,합계,14782,11380,4559,2375,2728,772,837,17,4,11,1,8,6,3,14,11335,45,3402
인천광역시,연수구,연수3동,관내사전투표,2844,2844,1240,516,640,192,223,8,3,5,0,1,0,1,6,2835,9,0
인천광역시,연수구,연수3동,연수3동제1투,2593,1988,802,434,469,125,144,2,0,2,0,2,1,1,0,1982,6,605
인천광역시,연수구,연수3동,연수3동제2투,2532,1789,755,334,425,119,143,2,0,0,0,2,0,0,3,1783,6,743
인천광역시,연수구,연수3동,연수3동제3투,2528,1869,697,412,461,144,140,1,0,1,0,3,1,0,1,1861,8,659
인천광역시,연수구,연수3동,연수3동제4투,2059,1223,410,362,279,74,74,4,1,1,1,0,3,0,3,1212,11,836
인천광역시,연수구,연수3동,연수3동제5투,2226,1667,655,317,454,118,113,0,0,2,0,0,1,1,1,1662,5,559
인천광역시,연수구,청학동,합계,22377,15751,5897,3961,3712,943,1062,31,5,33,3,11,5,5,13,15681,70,6626
인천광역시,연수구,청학동,관내사전투표,3336,3336,1395,799,691,196,219,6,0,10,0,2,0,2,3,3323,13,0
인천광역시,연수구,청학동,청학동제1투,3440,2106,748,576,503,102,151,5,0,5,1,0,1,1,1,2094,12,1334
인천광역시,연수구,청학동,청학동제2투,2229,1637,681,354,365,112,111,5,0,1,0,1,1,0,2,1633,4,592
인천광역시,연수구,청학동,청학동제3투,2549,1883,729,455,453,103,120,3,1,1,1,4,0,1,1,1872,11,666
인천광역시,연수구,청학동,청학동제4투,3157,2003,692,475,521,151,149,4,0,6,0,0,1,0,2,2001,2,1154
인천광역시,연수구,청학동,청학동제5투,2901,1855,657,484,461,103,125,5,4,4,0,1,0,0,3,1847,8,1046
인천광역시,연수구,청학동,청학동제6투,2556,1602,558,426,391,87,119,2,0,4,1,1,2,1,0,1592,10,954
인천광역시,연수구,청학동,청학동제7투,2209,1329,437,392,327,89,68,1,0,2,0,2,0,0,1,1319,10,880
인천광역시,연수구,동춘1동,합계,11923,9501,3883,1938,2126,730,744,19,1,5,4,6,0,5,3,9464,37,2422
인천광역시,연수구,동춘1동,관내사전투표,2977,2977,1349,500,598,243,257,5,1,4,1,4,0,0,1,2963,14,0
인천광역시,연수구,동춘1동,동춘1동제1투,1129,636,223,183,143,42,36,4,0,0,1,1,0,1,1,635,1,493
인천광역시,연수구,동춘1동,동춘1동제2투,2648,2047,846,401,466,148,172,1,0,1,1,0,0,2,0,2038,9,601
인천광역시,연수구,동춘1동,동춘1동제3투,2330,1699,672,372,385,122,137,2,0,0,0,1,0,1,1,1693,6,631
인천광역시,연수구,동춘1동,동춘1동제4투,2839,2142,793,482,534,175,142,7,0,0,1,0,0,1,0,2135,7,697
인천광역시,연수구,동춘2동,관내사전투표,3248,3248,1509,510,707,227,265,2,0,2,2,1,1,0,2,3228,20,0
인천광역시,연수구,동춘2동,합계,14852,12085,5194,2181,2771,896,952,20,2,11,4,4,2,1,6,12044,41,2767
인천광역시,연수구,동춘2동,동춘2동제1투,2631,1889,787,323,478,133,155,2,1,3,0,1,0,0,2,1885,4,742
인천광역시,연수구,동춘2동,동춘2동제2투,2828,2234,945,446,482,188,159,2,0,3,2,0,1,1,1,2230,4,594
인천광역시,연수구,동춘2동,동춘2동제3투,2767,2132,909,384,510,144,167,7,1,2,0,2,0,0,1,2127,5,635
인천광역시,연수구,동춘2동,동춘2동제4투,3378,2582,1044,518,594,204,206,7,0,1,0,0,0,0,0,2574,8,796
인천광역시,연수구,동춘3동,관내사전투표,3301,3301,1441,663,641,256,276,5,1,2,0,1,0,4,3,3293,8,0
인천광역시,연수구,동춘3동,합계,13913,11664,4745,2472,2621,917,833,16,1,8,1,3,1,6,6,11630,34,2249
인천광역시,연수구,동춘3동,동춘3동제1투,2522,1976,733,466,466,163,135,2,0,1,0,0,0,0,1,1967,9,546
인천광역시,연수구,동춘3동,동춘3동제2투,2737,2166,861,488,498,169,143,3,0,1,1,0,0,0,0,2164,2,571
인천광역시,연수구,동춘3동,동춘3동제3투,3033,2382,915,521,593,180,155,4,0,3,0,1,0,1,1,2374,8,651
인천광역시,연수구,동춘3동,동춘3동제4투,2320,1839,795,334,423,149,124,2,0,1,0,1,1,1,1,1832,7,481
인천광역시,연수구,송도1동,합계,23716,19970,8233,4219,4491,1684,1211,32,0,33,1,9,1,3,7,19924,46,3746
인천광역시,연수구,송도1동,관내사전투표,5144,5143,2332,947,979,458,377,15,0,15,0,2,0,0,5,5130,13,1
인천광역시,연수구,송도1동,송도1동제1투,2604,2066,918,386,468,149,131,5,0,2,0,0,0,0,1,2060,6,538
인천광역시,연수구,송도1동,송도1동제2투,2637,2100,775,509,488,199,118,3,0,2,0,1,0,0,0,2095,5,537
인천광역시,연수구,송도1동,송도1동제3투,2618,2072,897,363,511,166,119,4,0,5,0,1,0,1,0,2067,5,546
인천광역시,연수구,송도1동,송도1동제4투,2309,1854,761,394,425,154,108,2,0,1,0,2,0,0,0,1847,7,455
인천광역시,연수구,송도1동,송도1동제5투,2555,2105,785,519,500,164,129,2,0,3,0,1,0,0,0,2103,2,450
인천광역시,연수구,송도1동,송도1동제6투,2580,2103,893,431,505,167,97,0,0,4,0,2,0,0,1,2100,3,477
인천광역시,연수구,송도1동,송도1동제7투,3269,2527,872,670,615,227,132,1,0,1,1,0,1,2,0,2522,5,742
인천광역시,연수구,송도2동,합계,29574,24176,10418,4416,5676,2173,1357,42,0,22,1,12,3,7,7,24134,42,5398
인천광역시,연수구,송도2동,관내사전투표,5792,5792,2788,984,1118,531,336,14,0,5,0,2,1,1,2,5782,10,0
인천광역시,연수구,송도2동,송도2동제1투,2143,1714,743,252,414,172,116,2,0,6,0,3,0,1,0,1709,5,429
인천광역시,연수구,송도2동,송도2동제2투,2887,2238,892,458,578,190,110,2,0,1,1,0,0,1,0,2233,5,649
인천광역시,연수구,송도2동,송도2동제3투,3250,2364,885,542,580,229,116,4,0,2,0,1,0,1,1,2361,3,886
인천광역시,연수구,송도2동,송도2동제4투,2184,1703,806,242,397,147,102,4,0,1,0,0,0,1,1,1701,2,481
인천광역시,연수구,송도2동,송도2동제5투,2325,1873,760,339,501,164,100,1,0,2,0,1,1,1,1,1871,2,452
인천광역시,연수구,송도2동,송도2동제6투,2976,2324,967,439,573,191,136,7,0,1,0,3,0,1,0,2318,6,652
인천광역시,연수구,송도2동,송도2동제7투,2905,2249,848,509,569,195,122,2,0,1,0,0,1,0,0,2247,2,656
인천광역시,연수구,송도2동,송도2동제8투,2002,1410,623,217,336,143,86,1,0,1,0,0,0,0,1,1408,2,592
인천광역시,연수구,송도2동,송도2동제9투,3110,2509,1106,434,610,211,133,5,0,2,0,2,0,0,1,2504,5,601
인천광역시,연수구,송도3동,합계,21275,17544,8073,2752,4078,1497,1067,18,1,12,2,3,0,3,3,17509,35,3731
인천광역시,연수구,송도3동,관내사전투표,3943,3943,2015,529,792,330,269,2,0,1,2,0,0,0,0,3940,3,0
인천광역시,연수구,송도3동,송도3동제1투,3877,2908,1268,470,693,259,201,3,0,1,0,2,0,1,1,2899,9,969
인천광역시,연수구,송도3동,송도3동제2투,2571,2068,913,368,493,165,119,4,0,3,0,1,0,0,0,2066,2,503
인천광역시,연수구,송도3동,송도3동제3투,3366,2575,1055,487,657,217,146,2,0,0,0,0,0,1,1,2566,9,791
인천광역시,연수구,송도3동,송도3동제4투,2837,2267,997,397,566,180,113,5,0,3,0,0,0,0,1,2262,5,570
인천광역시,연수구,송도3동,송도3동제5투,1106,874,374,161,190,88,55,0,0,4,0,0,0,0,0,872,2,232
인천광역시,연수구,송도3동,송도3동제6투,1868,1497,748,182,364,121,77,2,0,0,0,0,0,1,0,1495,2,371
인천광역시,연수구,송도3동,송도3동제7투,1707,1412,703,158,323,137,87,0,1,0,0,0,0,0,0,1409,3,295
인천광역시,연수구,잘못 투입·구분된 투표지,,0,0,0,0,0,0,0,0,0,0,0,0,0,0,0,0,0,0
인천광역시,남동구,합계,,430938,327425,136132,66178,77693,21335,23230,470,59,267,80,251,97,89,322,326203,1222,103513
인천광역시,남동구,거소·선상투표,,1007,956,360,149,299,66,28,0,2,4,3,1,3,0,7,922,34,51
인천광역시,남동구,관외사전투표,,32933,32928,15183,4898,7444,2381,2627,42,5,19,16,28,12,6,61,32722,206,5
인천광역시,남동구,재외투표,,2236,1743,1047,127,240,80,232,8,0,0,1,0,0,1,0,1736,7,493
인천광역시,남동구,구월1동,합계,24410,18710,8008,3410,4445,1325,1397,23,1,15,5,15,4,6,12,18666,44,5700
인천광역시,남동구,구월1동,관내사전투표,4593,4592,2291,699,903,298,367,7,1,2,1,5,2,2,3,4581,11,1
인천광역시,남동구,구월1동,구월1동제1투,3228,1990,776,433,493,127,150,5,0,0,1,0,0,0,1,1986,4,1238
인천광역시,남동구,구월1동,구월1동제2투,2607,1629,601,372,424,75,140,4,0,4,1,0,0,3,2,1626,3,978
인천광역시,남동구,구월1동,구월1동제3투,2679,1937,664,497,511,135,111,2,0,5,1,1,1,0,2,1930,7,742
인천광역시,남동구,구월1동,구월1동제4투,2970,2006,689,472,521,133,173,1,0,2,0,5,1,1,0,1998,8,964
인천광역시,남동구,구월1동,구월1동제5투,3319,2522,1122,400,608,213,169,0,0,1,1,1,0,0,2,2517,5,797
인천광역시,남동구,구월1동,구월1동제6투,5014,4034,1865,537,985,344,287,4,0,1,0,3,0,0,2,4028,6,980
인천광역시,남동구,구월2동,합계,28810,22922,9809,4610,5186,1656,1508,30,2,12,4,18,2,2,10,22849,73,5888
인천광역시,남동구,구월2동,관내사전투표,6112,6112,3018,1041,1138,420,458,6,0,3,0,6,0,1,2,6093,19,0
인천광역시,남동구,구월2동,구월2동제1투,2860,2062,899,393,479,172,111,1,0,0,2,0,0,0,1,2058,4,798
인천광역시,남동구,구월2동,구월2동제2투,3300,2653,1109,536,594,210,194,1,0,0,0,1,0,0,1,2646,7,647
인천광역시,남동구,구월2동,구월2동제3투,2847,2153,894,409,524,171,142,1,0,0,2,0,1,0,2,2146,7,694
인천광역시,남동구,구월2동,구월2동제4투,2899,2321,974,494,529,179,127,7,0,1,0,1,0,0,1,2313,8,578
인천광역시,남동구,구월2동,구월2동제5투,3240,2555,1074,492,646,172,154,3,0,1,0,3,1,0,0,2546,9,685
인천광역시,남동구,구월2동,구월2동제6투,2373,1631,622,396,373,109,112,5,1,1,0,3,0,0,2,1624,7,742
인천광역시,남동구,구월2동,구월2동제7투,2687,1766,566,476,498,103,113,3,0,2,0,0,0,1,0,1762,4,921
인천광역시,남동구,구월2동,구월2동제8투,2492,1669,653,373,405,120,97,3,1,4,0,4,0,0,1,1661,8,823
인천광역시,남동구,구월3동,합계,21048,13426,5637,2637,3051,913,1058,20,4,9,3,20,3,5,15,13375,51,7622
인천광역시,남동구,구월3동,관내사전투표,2570,2570,1212,419,534,165,207,9,1,0,0,5,0,2,1,2555,15,0
인천광역시,남동구,구월3동,구월3동제1투,2180,1312,483,312,316,82,111,2,0,1,1,0,1,1,0,1310,2,868
인천광역시,남동구,구월3동,구월3동제2투,2133,1342,522,248,364,83,108,2,1,3,1,0,1,1,4,1338,4,791
인천광역시,남동구,구월3동,구월3동제3투,2480,1609,588,459,370,102,77,3,0,2,0,2,0,0,1,1604,5,871
인천광역시,남동구,구월3동,구월3동제4투,2292,1470,514,411,352,103,76,0,0,1,0,3,0,1,3,1464,6,822
인천광역시,남동구,구월3동,구월3동제5투,3842,2061,1027,205,430,171,210,1,1,0,0,4,1,0,4,2054,7,1781
인천광역시,남동구,구월3동,구월3동제6투,3084,1622,722,290,327,121,147,1,1,2,1,1,0,0,1,1614,8,1462
인천광역시,남동구,구월3동,구월3동제7투,2467,1440,569,293,358,86,122,2,0,0,0,5,0,0,1,1436,4,1027
인천광역시,남동구,구월4동,합계,14220,9116,3354,2174,2406,485,612,10,2,8,2,5,4,0,10,9072,44,5104
인천광역시,남동구,구월4동,관내사전투표,2324,2324,1009,454,551,135,155,2,0,1,1,1,1,0,2,2312,12,0
인천광역시,남동구,구월4동,구월4동제1투,2352,1243,419,288,363,73,86,0,0,1,0,2,0,0,3,1235,8,1109
인천광역시,남동구,구월4동,구월4동제2투,2318,1242,421,350,328,57,77,1,0,2,0,0,0,0,1,1237,5,1076
인천광역시,남동구,구월4동,구월4동제3투,2412,1459,495,366,385,79,117,4,0,2,0,0,2,0,2,1452,7,953
인천광역시,남동구,구월4동,구월4동제4투,2612,1531,560,377,410,68,107,3,1,0,0,1,0,0,1,1528,3,1081
인천광역시,남동구,구월4동,구월4동제5투,2202,1317,450,339,369,73,70,0,1,2,1,1,1,0,1,1308,9,885
인천광역시,남동구,간석1동,합계,19746,14196,5647,3215,3363,877,964,12,2,18,3,10,8,5,15,14139,57,5550
인천광역시,남동구,간석1동,관내사전투표,3211,3211,1492,595,667,187,239,2,0,2,2,4,4,1,3,3198,13,0
인천광역시,남동구,간석1동,간석1동제1투,3743,2399,907,538,611,151,172,1,1,1,1,0,0,0,3,2386,13,1344
인천광역시,남동구,간석1동,간석1동제2투,4004,2230,789,628,526,125,141,3,1,5,0,0,1,0,4,2223,7,1774
인천광역시,남동구,간석1동,간석1동제3투,3038,2083,808,422,543,141,148,1,0,3,0,2,2,1,0,2071,12,955
인천광역시,남동구,간석1동,간석1동제4투,3199,2502,949,607,595,171,159,2,0,6,0,0,0,2,3,2494,8,697
인천광역시,남동구,간석1동,간석1동제5투,2551,1771,702,425,421,102,105,3,0,1,0,4,1,1,2,1767,4,780
인천광역시,남동구,간석2동,합계,17002,12754,4814,2965,3202,823,873,22,3,10,2,4,3,1,4,12726,28,4248
인천광역시,남동구,간석2동,관내사전투표,2415,2415,979,473,628,136,181,7,0,4,0,0,0,0,1,2409,6,0
인천광역시,남동구,간석2동,간석2동제1투,2692,1437,467,380,367,97,114,3,1,1,0,1,1,0,1,1433,4,1255
인천광역시,남동구,간석2동,간석2동제2투,3801,2226,745,640,568,108,144,5,1,2,1,1,2,1,2,2220,6,1575
인천광역시,남동구,간석2동,간석2동제3투,3291,2710,1061,607,655,196,181,1,1,0,1,1,0,0,0,2704,6,581
인천광역시,남동구,간석2동,간석2동제4투,2899,2404,939,511,600,179,169,3,0,1,0,0,0,0,0,2402,2,495
인천광역시,남동구,간석2동,간석2동제5투,1904,1562,623,354,384,107,84,3,0,2,0,1,0,0,0,1558,4,342
인천광역시,남동구,간석3동,합계,22134,15200,5838,3506,3829,855,1027,12,2,15,5,10,8,5,28,15140,60,6934
인천광역시,남동구,간석3동,관내사전투표,3148,3148,1387,651,704,148,227,4,0,3,0,3,1,3,11,3142,6,0
인천광역시,남동구,간석3동,간석3동제1투,3950,2164,772,541,571,117,146,1,0,3,1,1,3,0,4,2160,4,1786
인천광역시,남동구,간석3동,간석3동제2투,3666,2632,1042,568,625,195,178,1,1,1,3,1,1,1,4,2621,11,1034
인천광역시,남동구,간석3동,간석3동제3투,3199,1758,578,428,504,105,124,2,0,1,1,3,1,0,3,1750,8,1441
인천광역시,남동구,간석3동,간석3동제4투,2842,2047,801,478,516,113,128,1,0,1,0,1,1,0,1,2041,6,795
인천광역시,남동구,간석3동,간석3동제5투,3600,2289,856,522,608,119,154,1,0,5,0,1,1,1,5,2273,16,1311
인천광역시,남동구,간석3동,간석3동제6투,1729,1162,402,318,301,58,70,2,1,1,0,0,0,0,0,1153,9,567
인천광역시,남동구,간석4동,합계,20517,14578,5810,3340,3399,928,982,18,5,10,2,9,4,7,10,14524,54,5939
인천광역시,남동구,간석4동,관내사전투표,2404,2404,1102,501,485,139,160,5,0,1,0,2,0,1,0,2396,8,0
인천광역시,남동구,간석4동,간석4동제1투,2719,1630,580,443,381,99,110,0,3,1,0,0,2,1,2,1622,8,1089
인천광역시,남동구,간석4동,간석4동제2투,4460,2573,1017,561,647,162,162,1,1,2,2,3,0,1,3,2562,11,1887
인천광역시,남동구,간석4동,간석4동제3투,3438,2485,896,652,601,159,158,4,1,3,0,1,0,1,2,2478,7,953
인천광역시,남동구,간석4동,간석4동제4투,2800,2192,865,471,524,159,149,6,0,1,0,2,2,3,1,2183,9,608
인천광역시,남동구,간석4동,간석4동제5투,2622,1729,704,365,408,107,136,2,0,1,0,1,0,0,1,1725,4,893
인천광역시,남동구,간석4동,간석4동제6투,2074,1565,646,347,353,103,107,0,0,1,0,0,0,0,1,1558,7,509
인천광역시,남동구,만수1동,합계,14584,10140,3803,2375,2549,556,733,26,2,18,1,9,3,2,12,10089,51,4444
인천광역시,남동구,만수1동,관내사전투표,2498,2498,1090,506,530,130,212,5,1,3,0,4,1,0,1,2483,15,0
인천광역시,남동구,만수1동,만수1동제1투,2567,1709,678,347,449,99,125,2,0,2,1,1,0,0,1,1705,4,858
인천광역시,남동구,만수1동,만수1동제2투,2491,1409,508,341,360,72,96,12,1,6,0,0,0,0,5,1401,8,1082
인천광역시,남동구,만수1동,만수1동제3투,2892,1791,626,441,465,108,136,1,0,1,0,2,1,0,2,1783,8,1101
인천광역시,남동구,만수1동,만수1동제4투,2097,1329,379,437,378,55,55,6,0,4,0,1,1,2,2,1320,9,768
인천광역시,남동구,만수1동,만수1동제5투,2039,1404,522,303,367,92,109,0,0,2,0,1,0,0,1,1397,7,635
인천광역시,남동구,만수2동,합계,19979,15249,6411,2968,3666,968,1106,26,2,10,1,18,5,4,18,15203,46,4730
인천광역시,남동구,만수2동,관내사전투표,4136,4135,1921,739,873,248,327,6,1,0,0,5,0,0,3,4123,12,1
인천광역시,남동구,만수2동,만수2동제1투,2256,1382,540,291,375,78,85,2,0,2,0,3,0,1,1,1378,4,874
인천광역시,남동구,만수2동,만수2동제2투,2432,1563,636,311,372,107,122,3,0,2,0,3,1,0,2,1559,4,869
인천광역시,남동구,만수2동,만수2동제3투,3170,2186,836,471,562,143,153,5,1,1,0,2,1,1,3,2179,7,984
인천광역시,남동구,만수2동,만수2동제4투,2339,1522,578,344,402,83,97,3,0,0,1,1,1,0,5,1515,7,817
인천광역시,남동구,만수2동,만수2동제5투,2987,2389,1017,452,590,154,158,4,0,3,0,2,1,0,3,2384,5,598
인천광역시,남동구,만수2동,만수2동제6투,2659,2072,883,360,492,155,164,3,0,2,0,2,1,2,1,2065,7,587
인천광역시,남동구,만수3동,합계,14813,10994,4475,2353,2646,670,757,12,2,16,2,9,2,3,6,10953,41,3819
인천광역시,남동구,만수3동,관내사전투표,2871,2871,1287,557,630,162,215,3,1,1,0,3,0,0,1,2860,11,0
인천광역시,남동구,만수3동,만수3동제1투,3313,2215,868,486,557,134,151,3,0,8,0,2,0,0,0,2209,6,1098
인천광역시,남동구,만수3동,만수3동제2투,2093,1200,462,288,290,67,74,1,0,4,0,2,0,1,2,1191,9,893
인천광역시,남동구,만수3동,만수3동제3투,2415,1436,524,357,384,61,91,3,0,3,2,2,0,1,1,1429,7,979
인천광역시,남동구,만수3동,만수3동제4투,4121,3272,1334,665,785,246,226,2,1,0,0,0,2,1,2,3264,8,849
인천광역시,남동구,만수4동,합계,17861,13784,5557,2818,3388,930,958,34,2,4,2,14,1,4,13,13725,59,4077
인천광역시,남동구,만수4동,관내사전투표,3846,3846,1740,717,829,240,289,6,0,1,0,3,0,2,3,3830,16,0
인천광역시,남동구,만수4동,만수4동제1투,2273,1523,593,321,386,98,106,3,0,1,0,5,0,0,1,1514,9,750
인천광역시,남동구,만수4동,만수4동제2투,2177,1636,652,322,419,113,117,3,0,1,0,3,0,0,1,1631,5,541
인천광역시,남동구,만수4동,만수4동제3투,2719,1942,790,402,489,123,120,7,0,0,2,0,0,1,1,1935,7,777
인천광역시,남동구,만수4동,만수4동제4투,2576,1893,703,377,491,161,137,8,1,1,0,1,0,0,4,1884,9,683
인천광역시,남동구,만수4동,만수4동제5투,2230,1523,515,374,401,105,112,4,1,0,0,2,1,0,1,1516,7,707
인천광역시,남동구,만수4동,만수4동제6투,2040,1421,564,305,373,90,77,3,0,0,0,0,0,1,2,1415,6,619
인천광역시,남동구,만수5동,합계,14112,9614,3542,2373,2386,544,675,9,3,8,8,8,8,3,8,9575,39,4498
인천광역시,남동구,만수5동,관내사전투표,2157,2157,902,459,488,124,157,2,1,4,2,3,4,0,1,2147,10,0
인천광역시,남동구,만수5동,만수5동제1투,2910,1699,593,427,455,95,117,0,1,2,1,0,0,1,1,1693,6,1211
인천광역시,남동구,만수5동,만수5동제2투,3227,2330,808,622,559,140,187,1,0,1,0,1,1,1,2,2323,7,897
인천광역시,남동구,만수5동,만수5동제3투,2843,1771,643,469,434,100,105,2,0,0,2,1,2,1,1,1760,11,1072
인천광역시,남동구,만수5동,만수5동제4투,2975,1657,596,396,450,85,109,4,1,1,3,3,1,0,3,1652,5,1318
인천광역시,남동구,만수6동,합계,21383,16365,6617,3503,3801,1083,1211,28,4,16,8,11,2,6,17,16307,58,5018
인천광역시,남동구,만수6동,관내사전투표,5430,5430,2418,1045,1136,348,428,13,1,7,2,5,1,3,5,5412,18,0
인천광역시,남동구,만수6동,만수6동제1투,2570,1582,553,396,392,108,117,3,1,3,2,0,0,0,2,1577,5,988
인천광역시,남동구,만수6동,만수6동제2투,2503,1706,662,340,451,97,141,1,0,1,1,1,0,1,2,1698,8,797
인천광역시,남동구,만수6동,만수6동제3투,2865,1944,777,427,475,120,126,3,0,5,1,1,0,1,3,1939,5,921
인천광역시,남동구,만수6동,만수6동제4투,2603,1897,764,370,474,145,130,3,1,0,0,3,0,1,1,1892,5,706
인천광역시,남동구,만수6동,만수6동제5투,3022,2005,793,426,473,133,160,3,1,0,2,0,1,0,3,1995,10,1017
인천광역시,남동구,만수6동,만수6동제6투,2390,1801,650,499,400,132,109,2,0,0,0,1,0,0,1,1794,7,589
인천광역시,남동구,장수서창동,합계,30303,23565,9897,4743,5655,1473,1618,32,2,15,1,13,11,9,23,23492,73,6738
인천광역시,남동구,장수서창동,관내사전투표,4834,4834,2262,857,1003,311,365,4,0,4,0,4,3,2,5,4820,14,0
인천광역시,남동구,장수서창동,장수서창동제1투,3726,2694,994,663,654,171,192,4,0,0,0,1,2,0,4,2685,9,1032
인천광역시,남동구,장수서창동,장수서창동제2투,252,185,38,79,58,4,4,0,0,0,0,0,0,1,0,184,1,67
인천광역시,남동구,장수서창동,장수서창동제3투,4062,2866,1020,759,741,166,158,6,0,2,0,2,0,4,3,2861,5,1196
인천광역시,남동구,장수서창동,장수서창동제4투,2098,1668,712,323,400,99,124,1,0,0,0,1,1,0,0,1661,7,430
인천광역시,남동구,장수서창동,장수서창동제5투,2737,1862,756,383,455,118,133,0,1,3,0,1,2,0,2,1854,8,875
인천광역시,남동구,장수서창동,장수서창동제6투,3936,2891,1240,559,695,159,214,5,0,4,0,3,2,0,1,2882,9,1045
인천광역시,남동구,장수서창동,장수서창동제7투,3847,3074,1393,475,746,238,208,2,0,0,0,0,1,1,3,3067,7,773
인천광역시,남동구,장수서창동,장수서창동제8투,4811,3491,1482,645,903,207,220,10,1,2,1,1,0,1,5,3478,13,1320
인천광역시,남동구,남촌도림동,합계,17629,12507,4786,2899,3063,734,886,31,5,14,4,10,4,5,15,12456,51,5122
인천광역시,남동구,남촌도림동,관내사전투표,2497,2497,1043,557,532,149,180,4,1,7,2,2,2,1,5,2485,12,0
인천광역시,남동구,남촌도림동,남촌도림동제1투,2268,1287,440,337,344,69,78,4,1,1,2,0,1,1,3,1281,6,981
인천광역시,남동구,남촌도림동,남촌도림동제2투,2696,1726,640,344,466,109,146,7,0,2,0,1,0,1,0,1716,10,970
인천광역시,남동구,남촌도림동,남촌도림동제3투,3338,2135,774,504,542,134,150,7,1,2,0,2,1,0,5,2122,13,1203
인천광역시,남동구,남촌도림동,남촌도림동제4투,3768,2561,1011,577,635,140,181,7,0,1,0,1,0,1,0,2554,7,1207
인천광역시,남동구,남촌도림동,남촌도림동제5투,2668,2027,808,475,472,118,141,2,1,1,0,4,0,1,2,2025,2,641
인천광역시,남동구,남촌도림동,남촌도림동제6투,394,274,70,105,72,15,10,0,1,0,0,0,0,0,0,273,1,120
인천광역시,남동구,논현1동,합계,23437,17698,7790,3299,4090,1184,1222,26,3,15,1,15,1,6,12,17664,34,5739
인천광역시,남동구,논현1동,관내사전투표,4396,4396,2186,707,852,284,340,8,0,4,1,3,0,0,4,4389,7,0
인천광역시,남동구,논현1동,논현1동제1투,2425,1638,763,255,360,117,136,0,0,0,0,2,0,0,2,1635,3,787
인천광역시,남동구,논현1동,논현1동제2투,3331,1956,801,417,485,122,117,6,0,1,0,0,0,3,0,1952,4,1375
인천광역시,남동구,논현1동,논현1동제3투,2894,2333,946,448,576,176,175,2,0,4,0,1,0,0,0,2328,5,561
인천광역시,남동구,논현1동,논현1동제4투,2632,1626,623,377,431,88,83,7,0,3,0,7,0,0,2,1621,5,1006
인천광역시,남동구,논현1동,논현1동제5투,2316,1566,649,322,386,98,102,1,2,2,0,0,0,1,1,1564,2,750
인천광역시,남동구,논현1동,논현1동제6투,3104,2407,1070,406,595,170,156,1,1,1,0,0,1,0,1,2402,5,697
인천광역시,남동구,논현1동,논현1동제7투,2339,1776,752,367,405,129,113,1,0,0,0,2,0,2,2,1773,3,563
인천광역시,남동구,논현2동,합계,25248,18926,7980,3827,4501,1190,1285,25,2,18,3,18,4,4,14,18871,55,6322
인천광역시,남동구,논현2동,관내사전투표,4602,4602,2239,819,912,280,319,5,1,6,0,5,1,2,1,4590,12,0
인천광역시,남동구,논현2동,논현2동제1투,2917,1723,699,415,401,87,110,4,1,0,0,0,1,1,2,1721,2,1194
인천광역시,남동구,논현2동,논현2동제2투,1890,1501,568,350,384,111,82,0,0,0,1,0,0,0,2,1498,3,389
인천광역시,남동구,논현2동,논현2동제3투,2240,1618,566,394,414,129,105,5,0,1,1,1,0,0,1,1617,1,622
인천광역시,남동구,논현2동,논현2동제4투,4022,2622,1128,475,663,162,172,2,0,4,0,4,0,0,2,2612,10,1400
인천광역시,남동구,논현2동,논현2동제5투,3925,2743,1135,524,720,163,178,5,0,5,0,2,1,0,2,2735,8,1182
인천광역시,남동구,논현2동,논현2동제6투,2268,1730,670,372,421,112,139,3,0,0,0,1,1,0,1,1720,10,538
인천광역시,남동구,논현2동,논현2동제7투,2081,1575,674,287,389,86,122,1,0,1,1,3,0,1,2,1567,8,506
인천광역시,남동구,논현2동,논현2동제8투,1303,812,301,191,197,60,58,0,0,1,0,2,0,0,1,811,1,491
인천광역시,남동구,논현고잔동,합계,27526,22053,9767,3988,5084,1614,1471,24,4,13,3,6,5,5,12,21996,57,5473
인천광역시,남동구,논현고잔동,관내사전투표,6000,6000,2971,889,1229,429,450,7,1,1,0,1,2,1,4,5985,15,0
인천광역시,남동구,논현고잔동,논현고잔동제1투,2652,1940,884,343,423,162,113,2,0,2,0,2,1,1,3,1936,4,712
인천광역시,남동구,논현고잔동,논현고잔동제2투,3930,2369,936,523,564,152,177,4,2,3,1,1,1,0,1,2365,4,1561
인천광역시,남동구,논현고잔동,논현고잔동제3투,3023,2287,1032,379,553,175,139,0,0,0,0,1,1,0,0,2280,7,736
인천광역시,남동구,논현고잔동,논현고잔동제4투,3020,2451,1201,305,587,170,174,3,0,2,1,1,0,1,0,2445,6,569
인천광역시,남동구,논현고잔동,논현고잔동제5투,2966,2330,783,677,580,175,98,6,0,2,0,0,0,2,0,2323,7,636
인천광역시,남동구,논현고잔동,논현고잔동제6투,2917,2419,1071,373,616,176,175,1,0,1,0,0,0,0,0,2413,6,498
인천광역시,남동구,논현고잔동,논현고잔동제7투,2363,1910,782,366,454,159,138,1,1,2,0,0,0,0,3,1906,4,453
인천광역시,남동구,논현고잔동,논현고잔동제8투,655,347,107,133,78,16,7,0,0,0,1,0,0,0,1,343,4,308
인천광역시,남동구,잘못 투입·구분된 투표지,,0,1,0,1,0,0,0,0,0,0,0,0,0,0,0,1,0,-1
인천광역시,부평구,합계,,455450,345398,146859,66560,82590,21769,24630,501,72,263,64,222,107,103,325,344065,1333,110052
인천광역시,부평구,거소·선상투표,,730,686,258,85,250,41,21,1,2,1,0,3,0,2,5,669,17,44
인천광역시,부평구,관외사전투표,,34221,34218,16054,4764,7655,2496,2771,48,12,15,10,35,14,8,54,33936,282,3
인천광역시,부평구,재외투표,,2588,2054,1301,133,283,77,238,4,0,4,0,0,1,1,1,2043,11,534
인천광역시,부평구,부평1동,합계,27899,21335,9027,4329,4955,1416,1469,22,3,18,2,9,6,8,17,21281,54,6564
인천광역시,부평구,부평1동,관내사전투표,5882,5882,2773,1072,1182,383,434,6,0,6,0,3,1,4,4,5868,14,0
인천광역시,부평구,부평1동,부평1동제1투,2774,1821,699,385,460,120,149,2,0,1,0,1,0,0,1,1818,3,953
인천광역시,부평구,부평1동,부평1동제2투,4607,2595,1193,452,553,181,193,3,1,2,1,3,1,2,1,2586,9,2012
인천광역시,부평구,부평1동,부평1동제3투,2715,2234,863,559,495,175,134,4,0,0,0,1,0,0,1,2232,2,481
인천광역시,부평구,부평1동,부평1동제4투,2954,2220,836,493,580,164,132,3,0,2,0,0,2,0,2,2214,6,734
인천광역시,부평구,부평1동,부평1동제5투,3194,2402,966,510,637,136,137,0,1,2,0,0,1,1,4,2395,7,792
인천광역시,부평구,부평1동,부평1동제6투,2735,2214,898,475,538,146,146,1,0,2,1,0,0,0,1,2208,6,521
인천광역시,부평구,부평1동,부평1동제7투,3038,1967,799,383,510,111,144,3,1,3,0,1,1,1,3,1960,7,1071
인천광역시,부평구,부평2동,관내사전투표,2534,2534,1133,512,561,128,167,8,0,3,0,6,0,1,3,2522,12,0
인천광역시,부평구,부평2동,합계,16361,11196,4526,2284,2899,619,758,28,2,12,4,8,2,3,10,11155,41,5165
인천광역시,부평구,부평2동,부평2동제1투,2840,1621,614,343,450,99,100,6,0,0,0,0,0,0,2,1614,7,1219
인천광역시,부평구,부평2동,부평2동제2투,2890,1918,775,349,525,100,158,4,1,0,1,0,0,1,1,1915,3,972
인천광역시,부평구,부평2동,부평2동제3투,3076,1947,799,365,506,122,140,4,0,4,1,0,1,1,1,1944,3,1129
인천광역시,부평구,부평2동,부평2동제4투,2691,1672,637,351,447,97,119,5,0,2,0,1,0,0,2,1661,11,1019
인천광역시,부평구,부평2동,부평2동제5투,2330,1504,568,364,410,73,74,1,1,3,2,1,1,0,1,1499,5,826
인천광역시,부평구,부평3동,관내사전투표,2438,2438,1007,540,524,149,198,7,0,4,0,2,1,2,0,2434,4,0
인천광역시,부평구,부평3동,합계,12546,8657,3259,2097,2107,469,658,14,1,6,1,5,4,3,9,8633,24,3889
인천광역시,부평구,부평3동,부평3동제1투,3521,2019,747,488,504,116,151,3,0,0,1,0,2,0,2,2014,5,1502
인천광역시,부평구,부평3동,부평3동제2투,1432,929,309,264,246,40,61,0,0,0,0,1,0,1,1,923,6,503
인천광역시,부평구,부평3동,부평3동제3투,2868,1881,719,446,452,93,155,1,0,1,0,2,1,0,6,1876,5,987
인천광역시,부평구,부평3동,부평3동제4투,2287,1390,477,359,381,71,93,3,1,1,0,0,0,0,0,1386,4,897
인천광역시,부평구,부평4동,합계,29824,20659,9078,3727,4966,1166,1558,36,2,12,5,6,8,3,25,20592,67,9165
인천광역시,부평구,부평4동,관내사전투표,5204,5204,2654,716,1034,312,457,6,1,3,0,2,1,0,3,5189,15,0
인천광역시,부평구,부평4동,부평4동제1투,3948,2357,996,505,553,123,161,5,0,0,1,0,2,1,4,2351,6,1591
인천광역시,부평구,부평4동,부평4동제2투,5125,3137,1343,589,783,146,255,4,0,1,0,1,0,0,4,3126,11,1988
인천광역시,부평구,부평4동,부평4동제3투,4020,2725,1101,521,711,175,193,4,0,2,0,1,1,0,5,2714,11,1295
인천광역시,부평구,부평4동,부평4동제4투,3931,2476,1067,430,619,167,174,5,1,0,0,0,1,2,2,2468,8,1455
인천광역시,부평구,부평4동,부평4동제5투,3181,2055,732,521,554,104,119,6,0,4,2,0,2,0,2,2046,9,1126
인천광역시,부평구,부평4동,부평4동제6투,4415,2705,1185,445,712,139,199,6,0,2,2,2,1,0,5,2698,7,1710
인천광역시,부평구,부평5동,관내사전투표,3569,3569,1799,532,727,197,288,5,1,1,0,3,0,2,2,3557,12,0
인천광역시,부평구,부평5동,합계,26004,17060,7469,3050,4107,979,1302,26,6,16,2,18,7,8,10,17000,60,8944
인천광역시,부평구,부평5동,부평5동제1투,4357,2309,1014,393,557,123,188,7,1,6,1,4,2,2,2,2300,9,2048
인천광역시,부평구,부평5동,부평5동제2투,5281,3207,1400,568,762,190,254,3,4,5,0,4,1,2,2,3195,12,2074
인천광역시,부평구,부평5동,부평5동제3투,4192,2677,1107,519,709,153,175,2,0,1,0,1,1,1,2,2671,6,1515
인천광역시,부평구,부평5동,부평5동제4투,4433,2831,1150,542,735,182,199,4,0,2,1,4,1,1,1,2822,9,1602
인천광역시,부평구,부평5동,부평5동제5투,4172,2467,999,496,617,134,198,5,0,1,0,2,2,0,1,2455,12,1705
인천광역시,부평구,부평6동,합계,13151,9280,3896,1861,2269,490,660,19,4,9,3,6,5,5,8,9235,45,3871
인천광역시,부평구,부평6동,관내사전투표,2442,2442,1114,462,529,123,193,6,0,2,0,1,1,1,4,2436,6,0
인천광역시,부평구,부평6동,부평6동제1투,2528,1481,576,311,382,86,101,5,1,5,0,3,1,1,1,1473,8,1047
인천광역시,부평구,부평6동,부평6동제2투,2216,1413,568,249,388,72,111,3,0,1,2,0,2,1,0,1397,16,803
인천광역시,부평구,부평6동,부평6동제3투,2607,1584,716,329,324,76,120,3,2,1,0,2,1,0,2,1576,8,1023
인천광역시,부평구,부평6동,부평6동제4투,3358,2360,922,510,646,133,135,2,1,0,1,0,0,2,1,2353,7,998
인천광역시,부평구,산곡1동,관내사전투표,1983,1983,780,497,416,106,158,7,0,1,1,2,0,1,1,1970,13,0
인천광역시,부평구,산곡1동,합계,13676,9424,3477,2286,2352,519,694,20,1,8,2,9,5,3,11,9387,37,4252
인천광역시,부평구,산곡1동,산곡1동제1투,2100,1130,374,318,294,66,66,2,0,1,0,0,3,0,1,1125,5,970
인천광역시,부평구,산곡1동,산곡1동제2투,2178,1526,569,346,372,96,127,4,0,1,0,4,1,1,1,1522,4,652
인천광역시,부평구,산곡1동,산곡1동제3투,2215,1466,518,351,400,80,111,2,0,0,0,0,0,0,2,1464,2,749
인천광역시,부평구,산곡1동,산곡1동제4투,2618,1627,583,417,426,81,104,2,1,0,1,1,1,1,3,1621,6,991
인천광역시,부평구,산곡1동,산곡1동제5투,2582,1692,653,357,444,90,128,3,0,5,0,2,0,0,3,1685,7,890
인천광역시,부평구,산곡2동,관내사전투표,4953,4953,2444,741,993,348,399,8,0,4,0,3,1,2,1,4944,9,0
인천광역시,부평구,산곡2동,합계,25009,20045,8780,3742,4581,1357,1473,25,2,12,0,10,2,5,9,19998,47,4964
인천광역시,부평구,산곡2동,산곡2동제1투,3127,2277,1008,408,534,162,162,0,0,0,0,0,0,0,0,2274,3,850
인천광역시,부평구,산곡2동,산곡2동제2투,2534,1947,840,382,449,133,133,4,1,1,0,0,0,0,1,1944,3,587
인천광역시,부평구,산곡2동,산곡2동제3투,3880,2942,1289,580,655,192,206,4,1,0,0,3,0,1,2,2933,9,938
인천광역시,부평구,산곡2동,산곡2동제4투,3578,2748,1099,579,686,185,181,2,0,1,0,1,1,1,2,2738,10,830
인천광역시,부평구,산곡2동,산곡2동제5투,3496,2613,1044,523,639,192,195,0,0,3,0,2,0,0,3,2601,12,883
인천광역시,부평구,산곡2동,산곡2동제6투,3441,2565,1056,529,625,145,197,7,0,3,0,1,0,1,0,2564,1,876
인천광역시,부평구,산곡3동,관내사전투표,4124,4124,1713,906,938,267,267,5,3,2,1,4,1,0,2,4109,15,0
인천광역시,부평구,산곡3동,합계,19133,14872,5602,3590,3571,1047,954,18,5,14,6,8,6,6,7,14834,38,4261
인천광역시,부평구,산곡3동,산곡3동제1투,3013,2299,878,537,557,174,142,0,2,0,1,0,1,1,2,2295,4,714
인천광역시,부평구,산곡3동,산곡3동제2투,2653,1839,694,442,426,145,120,2,0,4,0,1,0,1,1,1836,3,814
인천광역시,부평구,산곡3동,산곡3동제3투,2021,1505,585,341,365,105,101,4,0,0,0,2,0,0,0,1503,2,516
인천광역시,부평구,산곡3동,산곡3동제4투,2370,1537,539,363,428,94,102,3,0,1,0,1,2,1,0,1534,3,833
인천광역시,부평구,산곡3동,산곡3동제5투,2340,1834,613,513,411,172,116,2,0,0,3,0,0,2,1,1833,1,506
인천광역시,부평구,산곡3동,산곡3동제6투,2612,1734,580,488,446,90,106,2,0,7,1,0,2,1,1,1724,10,878
인천광역시,부평구,산곡4동,관내사전투표,3789,3789,1744,660,798,269,287,6,1,3,1,6,0,1,5,3781,8,0
인천광역시,부평구,산곡4동,합계,15193,12292,5175,2491,2819,886,836,14,2,11,1,11,1,5,9,12261,31,2901
인천광역시,부평구,산곡4동,산곡4동제1투,2966,2213,915,464,535,139,149,2,0,0,0,3,0,1,0,2208,5,753
인천광역시,부평구,산곡4동,산곡4동제2투,2579,1818,725,412,415,154,100,3,1,2,0,1,0,0,0,1813,5,761
인천광역시,부평구,산곡4동,산곡4동제3투,3062,2330,932,495,570,169,152,0,0,3,0,0,0,3,2,2326,4,732
인천광역시,부평구,산곡4동,산곡4동제4투,2797,2142,859,460,501,155,148,3,0,3,0,1,1,0,2,2133,9,655
인천광역시,부평구,청천1동,합계,7753,4830,1711,1262,1282,238,303,9,1,1,1,0,1,1,5,4815,15,2923
인천광역시,부평구,청천1동,관내사전투표,1296,1296,534,303,333,49,72,0,0,0,0,0,1,0,1,1293,3,0
인천광역시,부평구,청천1동,청천1동제1투,2758,1378,437,371,401,67,92,3,0,0,0,0,0,1,3,1375,3,1380
인천광역시,부평구,청천1동,청천1동제2투,3699,2156,740,588,548,122,139,6,1,1,1,0,0,0,1,2147,9,1543
인천광역시,부평구,청천2동,합계,25970,19364,8045,3711,4787,1226,1454,19,6,14,5,8,1,3,21,19300,64,6606
인천광역시,부평구,청천2동,관내사전투표,3312,3312,1522,606,718,195,248,2,1,2,1,0,0,0,4,3299,13,0
인천광역시,부평구,청천2동,청천2동제1투,3027,1589,536,362,488,77,109,1,1,3,1,1,0,0,4,1583,6,1438
인천광역시,부평구,청천2동,청천2동제2투,3575,2494,954,503,655,170,193,5,0,0,0,2,1,0,5,2488,6,1081
인천광역시,부평구,청천2동,청천2동제3투,2718,2135,858,426,540,129,173,0,1,2,0,0,0,0,1,2130,5,583
인천광역시,부평구,청천2동,청천2동제4투,2631,2055,947,318,471,144,161,2,0,0,2,0,0,0,2,2047,8,576
인천광역시,부평구,청천2동,청천2동제5투,2484,1964,915,339,409,146,144,1,0,1,0,0,0,2,1,1958,6,520
인천광역시,부평구,청천2동,청천2동제6투,2529,1914,792,323,515,125,137,4,1,1,0,2,0,0,4,1904,10,615
인천광역시,부평구,청천2동,청천2동제7투,2790,2051,873,385,491,121,163,3,1,3,1,3,0,1,0,2045,6,739
인천광역시,부평구,청천2동,청천2동제8투,2904,1850,648,449,500,119,126,1,1,2,0,0,0,0,0,1846,4,1054
인천광역시,부평구,갈산1동,합계,13805,9959,4158,1931,2449,584,767,10,0,5,0,3,1,1,13,9922,37,3846
인천광역시,부평구,갈산1동,관내사전투표,2545,2545,1204,407,557,150,213,1,0,2,0,0,1,1,5,2541,4,0
인천광역시,부평구,갈산1동,갈산1동제1투,2205,1271,460,281,344,68,110,0,0,1,0,0,0,0,0,1264,7,934
인천광역시,부평구,갈산1동,갈산1동제2투,3162,2095,823,453,546,118,140,4,0,1,0,2,0,0,4,2091,4,1067
인천광역시,부평구,갈산1동,갈산1동제3투,3042,2057,842,413,486,142,158,3,0,0,0,1,0,0,1,2046,11,985
인천광역시,부평구,갈산1동,갈산1동제4투,2851,1991,829,377,516,106,146,2,0,1,0,0,0,0,3,1980,11,860
인천광역시,부평구,갈산2동,합계,16675,12831,5395,2605,3053,853,834,17,2,9,2,1,4,2,10,12787,44,3844
인천광역시,부평구,갈산2동,관내사전투표,3660,3660,1675,683,812,202,266,8,1,1,1,0,0,0,1,3650,10,0
인천광역시,부평구,갈산2동,갈산2동제1투,2910,2176,913,440,518,167,128,1,0,1,0,1,0,0,0,2169,7,734
인천광역시,부평구,갈산2동,갈산2동제2투,2762,1868,845,329,446,114,121,1,0,2,0,0,2,0,2,1862,6,894
인천광역시,부평구,갈산2동,갈산2동제3투,2748,1910,710,430,500,133,116,5,0,5,1,0,1,1,2,1904,6,838
인천광역시,부평구,갈산2동,갈산2동제4투,3037,2269,906,493,532,177,146,2,1,0,0,0,0,1,1,2259,10,768
인천광역시,부평구,갈산2동,갈산2동제5투,1558,948,346,230,245,60,57,0,0,0,0,0,1,0,4,943,5,610
인천광역시,부평구,삼산1동,합계,28510,21453,9374,3722,5277,1386,1511,27,4,23,6,16,10,9,15,21380,73,7057
인천광역시,부평구,삼산1동,관내사전투표,4596,4596,2208,719,996,305,335,8,0,4,1,4,3,1,1,4585,11,0
인천광역시,부평구,삼산1동,삼산1동제1투,3130,1982,822,371,511,127,135,0,0,3,0,1,1,0,2,1973,9,1148
인천광역시,부평구,삼산1동,삼산1동제2투,3987,2827,1088,611,705,193,219,1,0,2,1,2,0,0,0,2822,5,1160
인천광역시,부평구,삼산1동,삼산1동제3투,2831,1897,766,351,532,106,122,1,0,4,2,1,1,1,1,1888,9,934
인천광역시,부평구,삼산1동,삼산1동제4투,2281,1540,696,249,364,117,97,2,0,1,0,2,1,1,1,1531,9,741
인천광역시,부평구,삼산1동,삼산1동제5투,2235,1414,446,411,384,75,55,4,1,6,2,2,4,4,4,1398,16,821
인천광역시,부평구,삼산1동,삼산1동제6투,4823,3537,1473,623,938,230,252,4,2,2,0,0,0,0,4,3528,9,1286
인천광역시,부평구,삼산1동,삼산1동제7투,4627,3660,1875,387,847,233,296,7,1,1,0,4,0,2,2,3655,5,967
인천광역시,부평구,삼산2동,합계,21515,17601,8139,2832,4104,1219,1202,23,2,6,2,14,3,7,13,17566,35,3914
인천광역시,부평구,삼산2동,관내사전투표,4596,4596,2386,623,879,308,376,7,0,0,1,4,0,2,4,4590,6,0
인천광역시,부평구,삼산2동,삼산2동제1투,3058,2356,1115,368,546,167,149,2,0,2,0,2,0,0,0,2351,5,702
인천광역시,부평구,삼산2동,삼산2동제2투,2772,2269,1133,249,570,145,163,0,1,0,0,3,0,1,2,2267,2,503
인천광역시,부평구,삼산2동,삼산2동제3투,2440,1838,736,386,459,115,136,2,0,1,0,0,1,1,0,1837,1,602
인천광역시,부평구,삼산2동,삼산2동제4투,2769,1889,729,415,481,135,101,11,1,1,1,2,2,1,5,1885,4,880
인천광역시,부평구,삼산2동,삼산2동제5투,2974,2486,1072,459,605,188,147,0,0,1,0,1,0,1,0,2474,12,488
인천광역시,부평구,삼산2동,삼산2동제6투,2906,2167,968,332,564,161,130,1,0,1,0,2,0,1,2,2162,5,739
인천광역시,부평구,부개1동,관내사전투표,2456,2456,1109,499,541,139,147,2,0,2,0,2,2,0,1,2444,12,0
인천광역시,부평구,부개1동,합계,14683,10403,4109,2382,2584,598,629,9,3,12,2,6,4,2,15,10355,48,4280
인천광역시,부평구,부개1동,부개1동제1투,3133,2047,826,449,505,111,136,3,1,3,0,1,0,1,3,2039,8,1086
인천광역시,부평구,부개1동,부개1동제2투,1957,1215,454,301,324,66,60,1,0,1,0,0,0,0,2,1209,6,742
인천광역시,부평구,부개1동,부개1동제3투,2081,1609,636,350,395,115,100,1,0,0,1,1,0,0,2,1601,8,472
인천광역시,부평구,부개1동,부개1동제4투,2902,1664,587,431,428,92,109,2,1,2,0,2,1,1,4,1660,4,1238
인천광역시,부평구,부개1동,부개1동제5투,2154,1412,497,352,391,75,77,0,1,4,1,0,1,0,3,1402,10,742
인천광역시,부평구,부개2동,합계,17786,13592,5689,2656,3343,839,953,24,1,14,2,9,7,6,9,13552,40,4194
인천광역시,부평구,부개2동,관내사전투표,3925,3925,1869,624,871,229,295,9,0,4,0,6,1,1,4,3913,12,0
인천광역시,부평구,부개2동,부개2동제1투,2784,1763,624,428,487,93,115,3,0,1,1,1,3,1,2,1759,4,1021
인천광역시,부평구,부개2동,부개2동제2투,2817,1809,687,408,470,111,115,1,0,2,0,1,1,1,0,1797,12,1008
인천광역시,부평구,부개2동,부개2동제3투,3741,2706,1152,476,681,183,195,6,0,3,0,1,1,1,2,2701,5,1035
인천광역시,부평구,부개2동,부개2동제4투,2216,1646,645,383,383,100,121,5,1,2,1,0,0,0,1,1642,4,570
인천광역시,부평구,부개2동,부개2동제5투,2303,1743,712,337,451,123,112,0,0,2,0,0,1,2,0,1740,3,560
인천광역시,부평구,부개3동,관내사전투표,5634,5634,2754,870,1137,391,440,4,0,3,0,9,1,1,2,5612,22,0
인천광역시,부평구,부개3동,합계,26506,21070,9505,3659,4806,1405,1549,28,3,14,1,15,2,3,11,21001,69,5436
인천광역시,부평구,부개3동,부개3동제1투,2576,1786,765,343,435,122,108,2,0,2,0,0,0,1,1,1779,7,790
인천광역시,부평구,부개3동,부개3동제2투,2610,1586,699,271,405,88,110,6,1,1,0,0,0,0,0,1581,5,1024
인천광역시,부평구,부개3동,부개3동제3투,2982,2223,958,411,495,156,186,6,0,1,1,1,0,1,2,2218,5,759
인천광역시,부평구,부개3동,부개3동제4투,2845,2152,999,318,499,163,161,4,1,0,0,1,0,0,1,2147,5,693
인천광역시,부평구,부개3동,부개3동제5투,3390,2707,1108,547,685,184,170,1,0,2,0,0,0,0,2,2699,8,683
인천광역시,부평구,부개3동,부개3동제6투,3200,2575,1162,450,590,169,190,2,1,1,0,4,0,0,1,2570,5,625
인천광역시,부평구,부개3동,부개3동제7투,3269,2407,1060,449,560,132,184,3,0,4,0,0,1,0,2,2395,12,862
인천광역시,부평구,일신동,합계,10874,8512,3501,1763,2115,526,542,11,1,5,1,4,5,3,8,8485,27,2362
인천광역시,부평구,일신동,관내사전투표,2655,2655,1148,506,638,168,176,2,0,2,0,2,2,1,2,2647,8,0
인천광역시,부평구,일신동,일신동제1투,3051,2068,782,484,533,128,120,3,1,2,1,0,0,1,4,2059,9,983
인천광역시,부평구,일신동,일신동제2투,2797,2013,840,440,506,81,128,4,0,1,0,2,3,0,1,2006,7,784
인천광역시,부평구,일신동,일신동제3투,2371,1776,731,333,438,149,118,2,0,0,0,0,0,1,1,1773,3,595
인천광역시,부평구,십정1동,합계,14983,10384,4024,2417,2628,577,633,22,6,8,1,7,2,3,12,10340,44,4599
인천광역시,부평구,십정1동,관내사전투표,2394,2394,1017,519,564,139,132,4,1,4,0,0,1,0,2,2383,11,0
인천광역시,부평구,십정1동,십정1동제1투,2718,1506,540,390,410,54,98,1,1,1,0,0,0,0,2,1497,9,1212
인천광역시,부평구,십정1동,십정1동제2투,2328,1410,506,350,385,83,73,3,1,1,0,2,0,0,3,1407,3,918
인천광역시,부평구,십정1동,십정1동제3투,3233,2119,813,504,501,122,150,9,1,0,1,3,1,1,3,2109,10,1114
인천광역시,부평구,십정1동,십정1동제4투,1536,955,306,257,271,54,56,3,0,0,0,1,0,0,1,949,6,581
인천광역시,부평구,십정1동,십정1동제5투,2774,2000,842,397,497,125,124,2,2,2,0,1,0,2,1,1995,5,774
인천광역시,부평구,십정2동,합계,20055,13621,5307,3181,3348,756,861,27,1,14,5,11,6,3,18,13538,83,6434
인천광역시,부평구,십정2동,관내사전투표,2189,2189,973,451,448,118,167,3,0,2,2,3,1,0,2,2170,19,0
인천광역시,부평구,십정2동,십정2동제1투,3447,2000,705,512,499,132,115,7,0,3,1,3,2,0,4,1983,17,1447
인천광역시,부평구,십정2동,십정2동제2투,3105,1990,725,530,507,82,124,3,0,4,0,0,1,1,3,1980,10,1115
인천광역시,부평구,십정2동,십정2동제3투,2452,1550,550,377,417,82,99,7,1,0,0,2,0,2,3,1540,10,902
인천광역시,부평구,십정2동,십정2동제4투,2595,1540,539,377,428,88,88,4,0,3,0,1,0,0,1,1529,11,1055
인천광역시,부평구,십정2동,십정2동제5투,2899,1627,614,376,433,79,105,1,0,2,1,0,1,0,3,1615,12,1272
인천광역시,부평구,십정2동,십정2동제6투,3368,2725,1201,558,616,175,163,2,0,0,1,2,1,0,2,2721,4,643
인천광역시,부평구,잘못 투입·구분된 투표지,,0,0,0,0,0,0,0,0,0,0,0,0,0,0,0,0,0,0
인천광역시,계양구,합계,,271262,205824,88890,37234,48622,13418,15790,270,39,188,41,193,73,57,203,205018,806,65438
인천광역시,계양구,거소·선상투표,,483,462,183,58,154,31,18,1,0,2,0,0,3,0,3,453,9,21
인천광역시,계양구,관외사전투표,,20965,20964,9808,2796,4647,1572,1850,39,7,12,6,15,5,9,38,20804,160,1
인천광역시,계양구,재외투표,,1547,1213,762,68,177,40,155,1,0,0,0,1,0,1,2,1207,6,334
인천광역시,계양구,효성1동,합계,23802,17579,7191,3557,4272,1094,1300,27,4,18,3,11,8,7,16,17508,71,6223
인천광역시,계양구,효성1동,관내사전투표,4586,4586,2103,807,983,267,389,5,1,6,0,5,5,0,2,4573,13,0
인천광역시,계양구,효성1동,효성1동제1투,3346,2123,783,488,524,152,163,4,0,2,1,0,1,0,2,2120,3,1223
인천광역시,계양구,효성1동,효성1동제2투,2228,1440,541,337,362,89,96,0,0,3,0,0,1,0,2,1431,9,788
인천광역시,계양구,효성1동,효성1동제3투,3237,2168,845,462,569,116,153,3,0,0,1,1,0,2,1,2153,15,1069
인천광역시,계양구,효성1동,효성1동제4투,2919,1945,790,410,474,118,135,4,0,2,0,0,0,1,2,1936,9,974
인천광역시,계양구,효성1동,효성1동제5투,2291,1495,570,318,400,82,101,3,1,3,0,3,0,4,5,1490,5,796
인천광역시,계양구,효성1동,효성1동제6투,2485,1784,698,400,432,119,119,2,1,1,0,0,1,0,0,1773,11,701
인천광역시,계양구,효성1동,효성1동제7투,2710,2038,861,335,528,151,144,6,1,1,1,2,0,0,2,2032,6,672
인천광역시,계양구,효성2동,합계,24451,17970,7385,3600,4361,1157,1319,21,4,20,1,11,7,2,23,17911,59,6481
인천광역시,계양구,효성2동,관내사전투표,3492,3492,1558,635,784,207,280,6,1,2,0,2,3,0,6,3484,8,0
인천광역시,계양구,효성2동,효성2동제1투,3210,1982,732,491,481,121,136,1,1,5,1,3,0,1,3,1976,6,1228
인천광역시,계양구,효성2동,효성2동제2투,3530,2138,851,429,539,147,149,4,1,3,0,1,2,0,3,2129,9,1392
인천광역시,계양구,효성2동,효성2동제3투,3713,2856,1214,558,683,188,195,5,0,2,0,1,0,0,1,2847,9,857
인천광역시,계양구,효성2동,효성2동제4투,3624,2723,1071,552,720,189,176,1,0,2,0,1,1,0,2,2715,8,901
인천광역시,계양구,효성2동,효성2동제5투,3129,2007,790,430,482,123,162,2,0,4,0,2,0,1,5,2001,6,1122
인천광역시,계양구,효성2동,효성2동제6투,3753,2772,1169,505,672,182,221,2,1,2,0,1,1,0,3,2759,13,981
인천광역시,계양구,계산1동,관내사전투표,2456,2456,1133,414,546,134,194,8,2,1,0,5,1,1,7,2446,10,0
인천광역시,계양구,계산1동,합계,17186,11613,4663,2488,2786,713,832,23,6,12,0,17,5,7,18,11570,43,5573
인천광역시,계양구,계산1동,계산1동제1투,3284,1943,714,466,474,134,138,1,3,2,0,2,0,1,4,1939,4,1341
인천광역시,계양구,계산1동,계산1동제2투,3410,2173,814,466,539,159,169,4,1,2,0,6,2,2,1,2165,8,1237
인천광역시,계양구,계산1동,계산1동제3투,2581,1555,604,352,398,85,99,6,0,1,0,1,2,1,3,1552,3,1026
인천광역시,계양구,계산1동,계산1동제4투,3080,2038,859,444,464,110,147,2,0,2,0,1,0,2,1,2032,6,1042
인천광역시,계양구,계산1동,계산1동제5투,2375,1448,539,346,365,91,85,2,0,4,0,2,0,0,2,1436,12,927
인천광역시,계양구,계산2동,합계,15511,11462,4792,2224,2768,724,837,26,0,8,2,17,3,2,13,11416,46,4049
인천광역시,계양구,계산2동,관내사전투표,4065,4065,1986,624,836,241,337,7,0,3,0,8,0,1,2,4045,20,0
인천광역시,계양구,계산2동,계산2동제1투,2937,1753,689,414,419,107,106,7,0,0,1,1,1,0,3,1748,5,1184
인천광역시,계양구,계산2동,계산2동제2투,3013,1898,713,411,518,115,123,3,0,0,0,3,2,0,2,1890,8,1115
인천광역시,계양구,계산2동,계산2동제3투,2849,2093,797,422,545,149,157,5,0,3,1,4,0,0,4,2087,6,756
인천광역시,계양구,계산2동,계산2동제4투,2647,1653,607,353,450,112,114,4,0,2,0,1,0,1,2,1646,7,994
인천광역시,계양구,계산3동,합계,17205,12895,5659,2112,3152,835,1039,13,4,11,4,21,5,1,5,12861,34,4310
인천광역시,계양구,계산3동,관내사전투표,2982,2982,1422,439,644,213,242,2,2,3,1,6,2,0,1,2977,5,0
인천광역시,계양구,계산3동,계산3동제1투,3274,2299,938,414,593,162,178,3,0,1,0,2,0,0,0,2291,8,975
인천광역시,계양구,계산3동,계산3동제2투,2659,1923,843,280,511,114,161,1,0,0,0,2,0,1,0,1913,10,736
인천광역시,계양구,계산3동,계산3동제3투,2489,1754,764,296,443,102,137,2,0,1,1,3,1,0,1,1751,3,735
인천광역시,계양구,계산3동,계산3동제4투,2930,2049,888,358,501,133,155,2,0,2,0,4,1,0,1,2045,4,881
인천광역시,계양구,계산3동,계산3동제5투,2871,1888,804,325,460,111,166,3,2,4,2,4,1,0,2,1884,4,983
인천광역시,계양구,계산4동,합계,17445,13900,6186,2304,3226,998,1087,15,0,14,3,14,1,3,9,13860,40,3545
인천광역시,계양구,계산4동,관내사전투표,4260,4260,2132,580,852,301,366,2,0,6,2,3,1,1,3,4249,11,0
인천광역시,계양구,계산4동,계산4동제1투,3077,1981,857,317,471,175,150,1,0,2,1,2,0,0,0,1976,5,1096
인천광역시,계양구,계산4동,계산4동제2투,3434,2610,1100,482,614,190,198,6,0,1,0,4,0,1,1,2597,13,824
인천광역시,계양구,계산4동,계산4동제3투,3239,2363,936,474,610,179,146,3,0,3,0,3,0,1,3,2358,5,876
인천광역시,계양구,계산4동,계산4동제4투,3435,2686,1161,451,679,153,227,3,0,2,0,2,0,0,2,2680,6,749
인천광역시,계양구,작전1동,합계,23020,17164,7384,3127,4102,1141,1300,11,3,18,2,4,6,5,13,17116,48,5856
인천광역시,계양구,작전1동,관내사전투표,3760,3760,1806,574,790,258,306,1,1,5,1,2,3,0,2,3749,11,0
인천광역시,계양구,작전1동,작전1동제1투,3890,2703,1132,502,683,178,182,5,2,4,0,0,1,1,0,2690,13,1187
인천광역시,계양구,작전1동,작전1동제2투,3453,2301,950,391,601,146,203,0,0,1,0,1,0,1,4,2298,3,1152
인천광역시,계양구,작전1동,작전1동제3투,3399,2503,1033,512,613,166,164,1,0,4,1,0,0,2,2,2498,5,896
인천광역시,계양구,작전1동,작전1동제4투,2289,1473,580,320,366,87,105,2,0,2,0,1,1,0,4,1468,5,816
인천광역시,계양구,작전1동,작전1동제5투,3553,2444,1007,466,619,152,189,1,0,2,0,0,0,0,1,2437,7,1109
인천광역시,계양구,작전1동,작전1동제6투,2676,1980,876,362,430,154,151,1,0,0,0,0,1,1,0,1976,4,696
인천광역시,계양구,작전2동,합계,20462,14654,6083,2905,3575,903,1055,16,1,10,7,16,8,4,15,14598,56,5808
인천광역시,계양구,작전2동,관내사전투표,3598,3598,1701,610,767,210,283,2,1,1,0,7,1,1,3,3587,11,0
인천광역시,계양구,작전2동,작전2동제1투,2796,1663,674,335,419,105,111,4,0,2,1,0,1,0,1,1653,10,1133
인천광역시,계양구,작전2동,작전2동제2투,2710,1901,766,386,485,95,155,1,0,1,2,4,1,1,1,1898,3,809
인천광역시,계양구,작전2동,작전2동제3투,2608,1732,716,324,427,137,118,1,0,1,0,0,0,0,3,1727,5,876
인천광역시,계양구,작전2동,작전2동제4투,2093,1500,602,300,394,94,97,3,0,0,1,2,1,0,3,1497,3,593
인천광역시,계양구,작전2동,작전2동제5투,2120,1367,552,293,329,90,82,2,0,1,2,1,1,1,2,1356,11,753
인천광역시,계양구,작전2동,작전2동제6투,2414,1501,547,356,394,83,104,3,0,0,0,1,2,1,2,1493,8,913
인천광역시,계양구,작전2동,작전2동제7투,2123,1392,525,301,360,89,105,0,0,4,1,1,1,0,0,1387,5,731
인천광역시,계양구,작전서운동,관내사전투표,3249,3249,1576,496,683,217,248,2,0,2,0,5,1,0,2,3232,17,0
인천광역시,계양구,작전서운동,합계,23649,17844,7899,3058,4136,1249,1357,17,3,17,4,17,8,3,13,17781,63,5805
인천광역시,계양구,작전서운동,작전서운동제1투,2755,1544,623,298,386,97,118,2,0,3,1,1,1,1,2,1533,11,1211
인천광역시,계양구,작전서운동,작전서운동제2투,3358,2605,1152,420,617,181,217,3,0,5,1,2,1,0,1,2600,5,753
인천광역시,계양구,작전서운동,작전서운동제3투,2836,2085,771,414,552,190,142,2,1,1,1,0,0,0,3,2077,8,751
인천광역시,계양구,작전서운동,작전서운동제4투,1877,1302,512,319,277,93,88,4,0,1,0,2,2,0,1,1299,3,575
인천광역시,계양구,작전서운동,작전서운동제5투,3137,2378,1137,319,539,176,191,2,2,0,0,2,0,0,2,2370,8,759
인천광역시,계양구,작전서운동,작전서운동제6투,3016,2277,1094,331,508,148,182,1,0,1,1,2,1,1,2,2272,5,739
인천광역시,계양구,작전서운동,작전서운동제7투,1907,1298,526,274,311,70,105,1,0,3,0,2,1,0,0,1293,5,609
인천광역시,계양구,작전서운동,작전서운동제8투,1514,1106,508,187,263,77,66,0,0,1,0,1,1,1,0,1105,1,408
인천광역시,계양구,계양1동,합계,16611,12443,5193,2526,2894,799,925,13,3,7,1,16,2,5,8,12392,51,4168
인천광역시,계양구,계양1동,관내사전투표,2306,2306,1036,430,467,165,188,3,0,2,1,1,0,0,0,2293,13,0
인천광역시,계양구,계양1동,계양1동제1투,3473,2255,820,596,530,153,140,3,1,1,0,2,1,1,1,2249,6,1218
인천광역시,계양구,계양1동,계양1동제2투,4379,2861,1138,607,711,162,213,2,1,1,0,4,0,1,3,2843,18,1518
인천광역시,계양구,계양1동,계양1동제3투,3702,2889,1269,504,697,175,221,3,1,2,0,5,1,3,2,2883,6,813
인천광역시,계양구,계양1동,계양1동제4투,2751,2132,930,389,489,144,163,2,0,1,0,4,0,0,2,2124,8,619
인천광역시,계양구,계양2동,합계,30009,21261,9140,3979,5042,1269,1613,32,4,27,4,25,9,5,15,21164,97,8748
인천광역시,계양구,계양2동,관내사전투표,4974,4973,2353,778,1078,310,386,6,3,12,0,13,5,2,3,4949,24,1
인천광역시,계양구,계양2동,계양2동제1투,3718,2087,802,448,541,125,154,5,1,5,0,0,1,0,0,2082,5,1631
인천광역시,계양구,계양2동,계양2동제2투,2881,1834,717,391,466,94,142,2,0,1,1,1,1,1,3,1820,14,1047
인천광역시,계양구,계양2동,계양2동제3투,2206,1455,590,298,356,92,102,5,0,2,0,1,1,0,0,1447,8,751
인천광역시,계양구,계양2동,계양2동제4투,2348,1343,493,326,353,78,75,3,0,2,1,1,0,0,3,1335,8,1005
인천광역시,계양구,계양2동,계양2동제5투,2997,2024,774,452,521,120,136,1,0,0,2,3,0,1,4,2014,10,973
인천광역시,계양구,계양2동,계양2동제6투,3989,2452,1014,507,595,115,197,6,0,3,0,2,1,0,1,2441,11,1537
인천광역시,계양구,계양2동,계양2동제7투,3763,2851,1382,406,640,190,215,2,0,2,0,3,0,0,1,2841,10,912
인천광역시,계양구,계양2동,계양2동제8투,3133,2242,1015,373,492,145,206,2,0,0,0,1,0,1,0,2235,7,891
인천광역시,계양구,계양3동,합계,18916,14399,6561,2432,3330,893,1103,15,0,12,4,8,3,3,12,14376,23,4517
인천광역시,계양구,계양3동,관내사전투표,2912,2912,1446,432,580,166,270,2,0,1,0,4,0,0,3,2904,8,0
인천광역시,계양구,계양3동,계양3동제1투,2668,1764,755,335,457,98,109,0,0,4,1,1,1,0,1,1762,2,904
인천광역시,계양구,계양3동,계양3동제2투,374,277,71,123,58,16,8,0,0,0,0,0,0,1,0,277,0,97
인천광역시,계양구,계양3동,계양3동제3투,3302,2478,1146,363,573,180,200,4,0,2,1,1,1,1,0,2472,6,824
인천광역시,계양구,계양3동,계양3동제4투,3150,2184,955,416,495,140,165,1,0,3,1,0,1,1,3,2181,3,966
인천광역시,계양구,계양3동,계양3동제5투,3756,2505,1171,365,619,143,196,2,0,1,1,1,0,0,2,2501,4,1251
인천광역시,계양구,계양3동,계양3동제6투,2754,2279,1017,398,548,150,155,6,0,1,0,1,0,0,3,2279,0,475
인천광역시,계양구,잘못 투입·구분된 투표지,,0,1,1,0,0,0,0,0,0,0,0,0,0,0,0,1,0,-1
인천광역시,서구,합계,,404034,306672,132399,56236,72248,20860,22418,423,64,238,76,177,86,80,264,305569,1103,97362
인천광역시,서구,거소·선상투표,,780,736,255,94,273,46,27,3,1,0,4,1,4,1,4,713,23,44
인천광역시,서구,관외사전투표,,30899,30895,14363,4448,6777,2326,2566,40,12,18,6,18,12,11,63,30660,235,4
인천광역시,서구,재외투표,,2171,1640,1014,96,270,84,169,4,0,0,0,0,0,0,0,1637,3,531
인천광역시,서구,검암경서동,합계,32190,24021,11362,3732,5308,1600,1866,31,1,13,3,21,2,4,14,23957,64,8169
인천광역시,서구,검암경서동,관내사전투표,5678,5678,3069,664,1084,360,472,5,0,5,0,4,0,2,1,5666,12,0
인천광역시,서구,검암경서동,검암경서동제1투,3227,2304,1006,403,535,168,177,6,0,1,1,1,0,0,0,2298,6,923
인천광역시,서구,검암경서동,검암경서동제2투,622,365,103,163,58,25,13,0,0,1,0,0,0,0,0,363,2,257
인천광역시,서구,검암경서동,검암경서동제3투,3452,2033,838,381,511,137,143,6,0,1,1,4,1,1,2,2026,7,1419
인천광역시,서구,검암경서동,검암경서동제4투,2820,2142,1046,329,484,122,149,3,0,0,0,2,0,0,1,2136,6,678
인천광역시,서구,검암경서동,검암경서동제5투,3312,2269,1014,367,538,151,185,5,0,2,0,0,1,0,2,2265,4,1043
인천광역시,서구,검암경서동,검암경서동제6투,2334,1825,824,318,408,124,138,3,0,1,0,2,0,1,0,1819,6,509
인천광역시,서구,검암경서동,검암경서동제7투,2144,1459,711,194,322,96,130,0,0,0,0,1,0,0,1,1455,4,685
인천광역시,서구,검암경서동,검암경서동제8투,2700,2025,841,356,509,166,142,0,0,0,1,1,0,0,3,2019,6,675
인천광역시,서구,검암경서동,검암경서동제9투,2648,1803,883,275,366,127,143,1,0,2,0,1,0,0,2,1800,3,845
인천광역시,서구,검암경서동,검암경서동제10투,3253,2118,1027,282,493,124,174,2,1,0,0,5,0,0,2,2110,8,1135
인천광역시,서구,연희동,합계,35260,24786,10047,4857,6055,1649,1920,24,9,31,7,9,12,8,30,24658,128,10474
인천광역시,서구,연희동,관내사전투표,6469,6469,3038,1027,1353,423,536,6,1,8,3,1,2,2,10,6410,59,0
인천광역시,서구,연희동,연희동제1투,3527,2067,780,420,554,135,158,1,0,6,0,0,1,1,3,2059,8,1460
인천광역시,서구,연희동,연희동제2투,3396,2214,845,493,543,148,156,2,1,1,0,0,2,4,4,2199,15,1182
인천광역시,서구,연희동,연희동제3투,3307,1932,680,497,491,128,120,1,1,3,2,0,0,0,3,1926,6,1375
인천광역시,서구,연희동,연희동제4투,3180,2150,773,489,556,153,162,2,0,1,2,2,1,0,2,2143,7,1030
인천광역시,서구,연희동,연희동제5투,3253,2177,798,423,624,161,153,2,0,2,0,2,1,0,3,2169,8,1076
인천광역시,서구,연희동,연희동제6투,2970,1986,804,395,463,147,157,1,0,4,0,1,2,0,1,1975,11,984
인천광역시,서구,연희동,연희동제7투,3197,1935,795,395,475,97,154,5,3,2,0,1,2,1,2,1932,3,1262
인천광역시,서구,연희동,연희동제8투,2702,1864,754,327,478,130,160,2,1,1,0,1,1,0,1,1856,8,838
인천광역시,서구,연희동,연희동제9투,3259,1992,780,391,518,127,164,2,2,3,0,1,0,0,1,1989,3,1267
인천광역시,서구,청라1동,합계,21256,17350,8586,2175,3871,1350,1286,16,0,7,0,8,1,4,4,17308,42,3906
인천광역시,서구,청라1동,관내사전투표,5353,5353,2830,589,1052,397,451,7,0,3,0,3,0,2,0,5334,19,0
인천광역시,서구,청라1동,청라1동제1투,2918,2334,1184,252,551,175,159,2,0,0,0,1,1,1,1,2327,7,584
인천광역시,서구,청라1동,청라1동제2투,2809,2162,1024,285,537,159,151,0,0,2,0,0,0,0,1,2159,3,647
인천광역시,서구,청라1동,청라1동제3투,2987,2114,933,323,502,199,148,3,0,1,0,1,0,0,0,2110,4,873
인천광역시,서구,청라1동,청라1동제4투,3416,2444,1228,303,532,192,182,0,0,0,0,1,0,0,1,2439,5,972
인천광역시,서구,청라1동,청라1동제5투,3773,2943,1387,423,697,228,195,4,0,1,0,2,0,1,1,2939,4,830
인천광역시,서구,가정1동,합계,12144,8049,3116,1779,2007,522,555,15,1,7,1,5,2,2,12,8024,25,4095
인천광역시,서구,가정1동,관내사전투표,1217,1217,495,268,285,70,82,7,1,2,0,1,0,0,0,1211,6,0
인천광역시,서구,가정1동,가정1동제1투,3605,1837,632,484,469,121,110,4,0,5,0,2,1,2,5,1835,2,1768
인천광역시,서구,가정1동,가정1동제2투,3077,1928,659,473,539,112,131,1,0,0,0,1,1,0,3,1920,8,1149
인천광역시,서구,가정1동,가정1동제3투,4245,3067,1330,554,714,219,232,3,0,0,1,1,0,0,4,3058,9,1178
인천광역시,서구,가정2동,합계,5724,3976,1559,767,984,261,369,4,1,3,1,3,1,2,5,3960,16,1748
인천광역시,서구,가정2동,관내사전투표,1038,1038,455,180,226,60,109,0,0,1,0,0,0,0,1,1032,6,0
인천광역시,서구,가정2동,가정2동제1투,2511,1502,528,332,421,102,103,3,1,1,1,1,0,2,3,1498,4,1009
인천광역시,서구,가정2동,가정2동제2투,2175,1436,576,255,337,99,157,1,0,1,0,2,1,0,1,1430,6,739
인천광역시,서구,가정3동,관내사전투표,1492,1492,660,275,341,86,109,5,0,6,1,2,1,1,0,1487,5,0
인천광역시,서구,가정3동,합계,8569,6217,2464,1330,1504,400,459,11,1,9,3,6,2,1,3,6193,24,2352
인천광역시,서구,가정3동,가정3동제1투,3124,2079,782,443,537,145,161,1,0,0,1,2,0,0,1,2073,6,1045
인천광역시,서구,가정3동,가정3동제2투,1987,1117,407,263,293,50,90,3,1,0,1,1,1,0,2,1112,5,870
인천광역시,서구,가정3동,가정3동제3투,1966,1529,615,349,333,119,99,2,0,3,0,1,0,0,0,1521,8,437
인천광역시,서구,신현원창동,관내사전투표,3180,3180,1345,599,766,189,256,8,2,4,0,0,0,0,2,3171,9,0
인천광역시,서구,신현원창동,합계,20813,15141,5753,3258,3921,987,1100,29,7,12,3,6,2,4,7,15089,52,5672
인천광역시,서구,신현원창동,신현원창동제1투,2814,1619,530,396,461,111,103,0,0,3,1,1,1,1,0,1608,11,1195
인천광역시,서구,신현원창동,신현원창동제2투,2878,1785,639,389,503,112,124,3,1,3,1,1,0,0,2,1778,7,1093
인천광역시,서구,신현원창동,신현원창동제3투,2672,1657,609,339,444,102,149,2,0,1,0,1,1,2,0,1650,7,1015
인천광역시,서구,신현원창동,신현원창동제4투,2275,1499,571,341,364,105,106,5,2,0,0,0,0,0,1,1495,4,776
인천광역시,서구,신현원창동,신현원창동제5투,17,17,2,10,5,0,0,0,0,0,0,0,0,0,0,17,0,0
인천광역시,서구,신현원창동,신현원창동제6투,3844,2928,1122,636,742,216,193,5,1,1,0,0,0,1,2,2919,9,916
인천광역시,서구,신현원창동,신현원창동제7투,3133,2456,935,548,636,152,169,6,1,0,1,3,0,0,0,2451,5,677
인천광역시,서구,석남1동,합계,18746,12635,4738,2928,3226,747,882,9,4,15,6,7,4,9,9,12584,51,6111
인천광역시,서구,석남1동,관내사전투표,2599,2599,1111,558,586,152,172,2,1,1,1,4,0,0,1,2589,10,0
인천광역시,서구,석남1동,석남1동제1투,3477,2238,838,464,618,129,165,1,1,3,1,2,2,2,2,2228,10,1239
인천광역시,서구,석남1동,석남1동제2투,3209,2220,821,552,552,131,145,2,2,3,2,0,2,1,0,2213,7,989
인천광역시,서구,석남1동,석남1동제3투,3431,2026,736,442,546,146,137,1,0,2,0,0,0,2,1,2013,13,1405
인천광역시,서구,석남1동,석남1동제4투,2654,1564,511,434,423,90,93,1,0,2,1,1,0,4,1,1561,3,1090
인천광역시,서구,석남1동,석남1동제5투,3376,1988,721,478,501,99,170,2,0,4,1,0,0,0,4,1980,8,1388
인천광역시,서구,석남2동,합계,12514,8916,3251,2226,2246,544,566,12,1,12,3,7,3,3,6,8880,36,3598
인천광역시,서구,석남2동,관내사전투표,2275,2275,931,523,532,125,138,4,0,4,1,2,1,0,0,2261,14,0
인천광역시,서구,석남2동,석남2동제1투,1522,898,273,303,210,50,51,1,0,2,0,1,0,0,2,893,5,624
인천광역시,서구,석남2동,석남2동제2투,3179,2262,835,509,606,144,151,2,0,2,1,1,1,2,2,2256,6,917
인천광역시,서구,석남2동,석남2동제3투,3372,2253,816,542,583,143,154,3,1,3,0,2,0,0,0,2247,6,1119
인천광역시,서구,석남2동,석남2동제4투,2166,1228,396,349,315,82,72,2,0,1,1,1,1,1,2,1223,5,938
인천광역시,서구,석남3동,합계,12847,8545,3254,1833,2218,511,635,18,3,14,1,7,3,2,10,8509,36,4302
인천광역시,서구,석남3동,관내사전투표,2005,2005,867,375,469,116,154,5,0,3,0,3,0,1,4,1997,8,0
인천광역시,서구,석남3동,석남3동제1투,3538,2151,793,454,561,147,176,0,1,3,1,2,0,0,2,2140,11,1387
인천광역시,서구,석남3동,석남3동제2투,3644,2267,866,454,600,128,188,6,2,5,0,2,2,1,1,2255,12,1377
인천광역시,서구,석남3동,석남3동제3투,3660,2122,728,550,588,120,117,7,0,3,0,0,1,0,3,2117,5,1538
인천광역시,서구,가좌1동,합계,10072,6632,2476,1615,1679,375,410,11,1,11,5,3,5,3,5,6599,33,3440
인천광역시,서구,가좌1동,관내사전투표,1595,1595,699,342,363,72,101,3,1,4,0,0,1,0,0,1586,9,0
인천광역시,서구,가좌1동,가좌1동제1투,2938,1641,559,430,448,89,98,2,0,1,1,3,2,1,0,1634,7,1297
인천광역시,서구,가좌1동,가좌1동제2투,2626,1628,563,435,408,105,98,2,0,2,0,0,1,1,4,1619,9,998
인천광역시,서구,가좌1동,가좌1동제3투,2913,1768,655,408,460,109,113,4,0,4,4,0,1,1,1,1760,8,1145
인천광역시,서구,가좌2동,합계,16839,13278,5455,2815,3085,918,900,19,2,11,2,18,3,4,6,13238,40,3561
인천광역시,서구,가좌2동,관내사전투표,3579,3579,1685,676,722,224,245,2,2,1,0,9,2,1,2,3571,8,0
인천광역시,서구,가좌2동,가좌2동제1투,3100,2180,821,493,535,161,148,3,0,4,0,3,1,1,2,2172,8,920
인천광역시,서구,가좌2동,가좌2동제2투,2892,2001,792,453,484,122,138,1,0,3,1,3,0,0,0,1997,4,891
인천광역시,서구,가좌2동,가좌2동제3투,3060,2224,774,574,536,162,155,7,0,1,1,2,0,2,2,2216,8,836
인천광역시,서구,가좌2동,가좌2동제4투,4208,3294,1383,619,808,249,214,6,0,2,0,1,0,0,0,3282,12,914
인천광역시,서구,가좌3동,합계,14667,10681,3856,2489,2825,656,765,16,2,5,4,8,3,4,10,10643,38,3986
인천광역시,서구,가좌3동,관내사전투표,2782,2782,1181,557,655,154,212,2,0,1,2,2,2,1,3,2772,10,0
인천광역시,서구,가좌3동,가좌3동제1투,2642,1825,556,472,588,95,96,6,0,2,0,2,0,0,1,1818,7,817
인천광역시,서구,가좌3동,가좌3동제2투,3073,1931,666,439,523,151,135,0,0,2,2,2,1,1,1,1923,8,1142
인천광역시,서구,가좌3동,가좌3동제3투,2940,1948,688,483,480,132,154,3,1,0,0,1,0,1,3,1946,2,992
인천광역시,서구,가좌3동,가좌3동제4투,3230,2195,765,538,579,124,168,5,1,0,0,1,0,1,2,2184,11,1035
인천광역시,서구,가좌4동,합계,6831,4670,1644,1117,1231,305,326,7,1,9,3,0,3,1,8,4655,15,2161
인천광역시,서구,가좌4동,관내사전투표,1107,1107,446,230,292,66,63,1,1,0,0,0,2,0,0,1101,6,0
인천광역시,서구,가좌4동,가좌4동제1투,1425,829,297,215,205,38,67,2,0,2,2,0,0,0,1,829,0,596
인천광역시,서구,가좌4동,가좌4동제2투,2479,1580,523,356,436,121,127,2,0,4,1,0,1,1,3,1575,5,899
인천광역시,서구,가좌4동,가좌4동제3투,1820,1154,378,316,298,80,69,2,0,3,0,0,0,0,4,1150,4,666
인천광역시,서구,검단1동,합계,22103,15694,6621,3088,3723,1003,1135,24,5,17,4,11,2,4,14,15651,43,6409
인천광역시,서구,검단1동,관내사전투표,4403,4403,2002,821,917,267,356,8,1,7,0,5,0,1,4,4389,14,0
인천광역시,서구,검단1동,검단1동제1투,3742,2557,1146,434,614,198,153,1,1,0,1,1,0,1,2,2552,5,1185
인천광역시,서구,검단1동,검단1동제2투,2338,1333,502,279,338,94,108,5,0,2,0,1,1,0,2,1332,1,1005
인천광역시,서구,검단1동,검단1동제3투,2387,1578,526,401,423,96,116,4,0,0,1,1,0,0,2,1570,8,809
인천광역시,서구,검단1동,검단1동제4투,3921,2475,1020,519,607,143,172,2,2,1,0,1,0,0,2,2469,6,1446
인천광역시,서구,검단1동,검단1동제5투,2778,1973,871,366,462,117,149,1,0,1,0,2,0,1,1,1971,2,805
인천광역시,서구,검단1동,검단1동제6투,2534,1375,554,268,362,88,81,3,1,6,2,0,1,1,1,1368,7,1159
인천광역시,서구,검단2동,합계,16490,12300,5407,2453,2671,802,887,17,1,7,4,4,4,0,9,12266,34,4190
인천광역시,서구,검단2동,관내사전투표,3651,3651,1762,679,688,222,271,9,0,0,1,0,3,0,3,3638,13,0
인천광역시,서구,검단2동,검단2동제1투,2767,1870,735,434,473,97,120,2,0,2,0,1,0,0,2,1866,4,897
인천광역시,서구,검단2동,검단2동제2투,2887,2051,923,376,436,155,151,2,0,2,0,2,0,0,1,2048,3,836
인천광역시,서구,검단2동,검단2동제3투,3656,2562,1106,501,565,183,189,4,0,0,1,0,1,0,2,2552,10,1094
인천광역시,서구,검단2동,검단2동제4투,3529,2166,881,463,509,145,156,0,1,3,2,1,0,0,1,2162,4,1363
인천광역시,서구,검단3동,합계,16557,12724,6183,1857,2800,881,957,14,0,2,1,6,0,0,5,12706,18,3833
인천광역시,서구,검단3동,관내사전투표,3455,3455,1838,438,678,227,263,4,0,1,1,2,0,0,0,3452,3,0
인천광역시,서구,검단3동,검단3동제1투,2174,1523,709,217,333,133,122,0,0,1,0,3,0,0,1,1519,4,651
인천광역시,서구,검단3동,검단3동제2투,3550,2587,1201,393,606,175,205,2,0,0,0,1,0,0,1,2584,3,963
인천광역시,서구,검단3동,검단3동제3투,4311,3175,1535,445,733,220,229,4,0,0,0,0,0,0,2,3168,7,1136
인천광역시,서구,검단3동,검단3동제4투,3067,1984,900,364,450,126,138,4,0,0,0,0,0,0,1,1983,1,1083
인천광역시,서구,검단4동,관내사전투표,7083,7083,3697,938,1387,462,558,13,1,5,1,2,2,1,5,7072,11,0
인천광역시,서구,검단4동,합계,34495,26744,12500,4250,5964,1800,2058,42,5,20,7,11,8,3,16,26684,60,7751
인천광역시,서구,검단4동,검단4동제1투,4376,3092,1353,599,705,173,242,8,3,0,1,0,0,0,2,3086,6,1284
인천광역시,서구,검단4동,검단4동제2투,3152,2360,1022,436,576,156,156,0,0,2,0,4,2,0,0,2354,6,792
인천광역시,서구,검단4동,검단4동제3투,3164,2349,1050,371,557,179,178,4,0,1,1,2,1,0,2,2346,3,815
인천광역시,서구,검단4동,검단4동제4투,3142,2334,1014,378,533,172,215,6,0,4,0,2,0,1,0,2325,9,808
인천광역시,서구,검단4동,검단4동제5투,4231,2897,1373,442,665,214,185,2,0,1,1,1,2,0,2,2888,9,1334
인천광역시,서구,검단4동,검단4동제6투,4326,3088,1437,489,690,207,250,3,1,2,0,0,0,0,2,3081,7,1238
인천광역시,서구,검단4동,검단4동제7투,1414,1096,465,184,277,83,81,4,0,0,0,0,0,0,0,1094,2,318
인천광역시,서구,검단4동,검단4동제8투,3607,2445,1089,413,574,154,193,2,0,5,3,0,1,1,3,2438,7,1162
인천광역시,서구,청라2동,관내사전투표,4756,4756,2375,717,970,345,313,12,0,2,0,3,1,1,7,4746,10,0
인천광역시,서구,청라2동,합계,23482,19053,8788,3124,4381,1472,1194,28,1,7,3,7,4,4,10,19023,30,4429
인천광역시,서구,청라2동,청라2동제1투,3953,3194,1401,548,788,272,177,1,0,1,0,0,2,1,0,3191,3,759
인천광역시,서구,청라2동,청라2동제2투,1925,1529,691,249,377,110,95,3,0,0,1,1,0,0,0,1527,2,396
인천광역시,서구,청라2동,청라2동제3투,2256,1656,737,262,408,134,106,1,0,1,1,0,0,0,0,1650,6,600
인천광역시,서구,청라2동,청라2동제4투,3958,2910,1145,622,716,252,169,2,1,0,0,1,1,0,0,2909,1,1048
인천광역시,서구,청라2동,청라2동제5투,3623,2859,1482,339,608,223,191,4,0,2,1,2,0,2,1,2855,4,764
인천광역시,서구,청라2동,청라2동제6투,3011,2149,957,387,514,136,143,5,0,1,0,0,0,0,2,2145,4,862
인천광역시,서구,검단5동,합계,16813,12268,5114,2454,3002,807,782,21,5,8,5,8,3,3,11,12223,45,4545
인천광역시,서구,검단5동,관내사전투표,2792,2792,1239,531,637,196,161,5,3,5,2,0,1,0,2,2782,10,0
인천광역시,서구,검단5동,검단5동제1투,3548,2200,948,416,542,129,143,3,0,0,1,1,0,1,6,2190,10,1348
인천광역시,서구,검단5동,검단5동제2투,3461,2405,1003,497,576,169,149,1,0,1,1,0,0,1,1,2399,6,1056
인천광역시,서구,검단5동,검단5동제3투,3349,2195,837,513,540,137,149,5,1,0,0,1,2,0,2,2187,8,1154
인천광역시,서구,검단5동,검단5동제4투,3663,2676,1087,497,707,176,180,7,1,2,1,6,0,1,0,2665,11,987
인천광역시,서구,청라3동,합계,11772,9721,4593,1451,2227,814,604,8,0,0,0,3,3,3,3,9709,12,2051
인천광역시,서구,청라3동,관내사전투표,2910,2910,1542,369,555,254,187,0,0,0,0,0,1,1,1,2910,0,0
인천광역시,서구,청라3동,청라3동제1투,2839,2212,1015,358,507,172,152,1,0,0,0,0,0,2,1,2208,4,627
인천광역시,서구,청라3동,청라3동제2투,3346,2633,1156,448,644,226,148,4,0,0,0,2,0,0,1,2629,4,713
인천광역시,서구,청라3동,청라3동제3투,2677,1966,880,276,521,162,117,3,0,0,0,1,2,0,0,1962,4,711
인천광역시,서구,잘못 투입·구분된 투표지,,0,0,0,0,0,0,0,0,0,0,0,0,0,0,0,0,0,0
인천광역시,강화군,합계,,59875,43938,12153,17041,9559,2233,2267,97,11,58,22,27,33,53,57,43611,327,15937
인천광역시,강화군,거소·선상투표,,293,280,81,46,77,11,8,2,4,2,2,4,2,1,3,243,37,13
인천광역시,강화군,관외사전투표,,5676,5650,2140,1385,1188,422,452,10,1,4,3,2,0,1,3,5611,39,26
인천광역시,강화군,재외투표,,324,270,166,19,38,10,30,5,0,0,0,0,0,0,0,268,2,54
인천광역시,강화군,강화읍,합계,17575,12220,3631,4521,2626,611,683,32,1,15,4,3,9,9,11,12156,64,5355
인천광역시,강화군,강화읍,관내사전투표,3690,3690,1386,1047,769,188,254,7,0,6,1,1,3,4,1,3667,23,0
인천광역시,강화군,강화읍,강화읍제1투,1640,1014,237,462,198,48,61,1,0,0,0,0,1,0,1,1009,5,626
인천광역시,강화군,강화읍,강화읍제2투,2746,1697,429,719,368,81,75,3,0,2,2,0,1,1,2,1683,14,1049
인천광역시,강화군,강화읍,강화읍제3투,1441,825,218,346,180,38,34,2,0,0,0,1,1,1,0,821,4,616
인천광역시,강화군,강화읍,강화읍제4투,1669,1001,232,473,205,45,37,1,0,2,0,1,0,2,1,999,2,668
인천광역시,강화군,강화읍,강화읍제5투,2830,1831,566,627,404,105,110,7,0,3,0,0,2,1,2,1827,4,999
인천광역시,강화군,강화읍,강화읍제6투,1677,1000,239,431,200,68,51,5,1,0,1,0,1,0,1,998,2,677
인천광역시,강화군,강화읍,강화읍제7투,1882,1162,324,416,302,38,61,6,0,2,0,0,0,0,3,1152,10,720
인천광역시,강화군,선원면,합계,5542,3952,1164,1459,838,213,231,7,0,2,0,4,0,1,8,3927,25,1590
인천광역시,강화군,선원면,관내사전투표,1138,1138,379,402,199,62,80,6,0,1,0,1,0,0,3,1133,5,0
인천광역시,강화군,선원면,선원면제1투,1776,1083,248,490,226,55,51,1,0,0,0,2,0,1,1,1075,8,693
인천광역시,강화군,선원면,선원면제2투,2628,1731,537,567,413,96,100,0,0,1,0,1,0,0,4,1719,12,897
인천광역시,강화군,불은면,합계,3752,2605,641,1093,631,117,88,6,1,4,1,2,3,2,4,2593,12,1147
인천광역시,강화군,불은면,관내사전투표,709,709,217,268,162,24,27,2,0,0,1,0,1,2,2,706,3,0
인천광역시,강화군,불은면,불은면제1투,1946,1176,246,511,302,63,41,1,1,3,0,2,1,0,2,1173,3,770
인천광역시,강화군,불은면,불은면제2투,1097,720,178,314,167,30,20,3,0,1,0,0,1,0,0,714,6,377
인천광역시,강화군,길상면,합계,5377,3753,887,1595,819,203,163,7,1,11,3,5,2,4,6,3706,47,1624
인천광역시,강화군,길상면,관내사전투표,1011,1011,317,336,187,56,59,3,0,9,2,4,1,3,4,981,30,0
인천광역시,강화군,길상면,길상면제1투,1663,1049,230,474,239,57,42,1,0,0,0,0,0,0,1,1044,5,614
인천광역시,강화군,길상면,길상면제2투,1140,703,141,342,143,37,29,1,1,2,1,1,0,0,1,699,4,437
인천광역시,강화군,길상면,길상면제3투,978,599,131,250,156,34,22,1,0,0,0,0,0,0,0,594,5,379
인천광역시,강화군,길상면,길상면제4투,585,391,68,193,94,19,11,1,0,0,0,0,1,1,0,388,3,194
인천광역시,강화군,화도면,합계,3482,2472,586,1122,541,115,81,2,0,1,4,1,2,8,0,2463,9,1010
인천광역시,강화군,화도면,관내사전투표,434,434,131,161,93,15,30,0,0,0,0,0,0,1,0,431,3,0
인천광역시,강화군,화도면,화도면제1투,1186,803,185,387,175,28,21,0,0,0,1,0,1,3,0,801,2,383
인천광역시,강화군,화도면,화도면제2투,784,524,117,248,109,33,11,1,0,0,1,0,0,3,0,523,1,260
인천광역시,강화군,화도면,화도면제3투,641,427,89,194,103,25,10,0,0,0,0,1,1,1,0,424,3,214
인천광역시,강화군,화도면,화도면제4투,437,284,64,132,61,14,9,1,0,1,2,0,0,0,0,284,0,153
인천광역시,강화군,양도면,합계,3097,2159,505,882,524,102,109,1,1,12,0,1,1,2,2,2142,17,938
인천광역시,강화군,양도면,관내사전투표,629,629,177,222,167,24,30,0,1,1,0,0,0,1,0,623,6,0
인천광역시,강화군,양도면,양도면제1투,1238,739,183,298,161,42,42,0,0,6,0,1,1,0,0,734,5,499
인천광역시,강화군,양도면,양도면제2투,1230,791,145,362,196,36,37,1,0,5,0,0,0,1,2,785,6,439
인천광역시,강화군,내가면,관내사전투표,448,448,144,160,93,23,24,0,0,1,0,1,1,0,1,448,0,0
인천광역시,강화군,내가면,합계,2555,1920,417,938,404,67,75,2,0,1,0,1,1,2,3,1911,9,635
인천광역시,강화군,내가면,내가면제1투,1040,708,138,348,166,20,31,0,0,0,0,0,0,1,0,704,4,332
인천광역시,강화군,내가면,내가면제2투,528,392,86,198,79,12,10,1,0,0,0,0,0,1,2,389,3,136
인천광역시,강화군,내가면,내가면제3투,539,372,49,232,66,12,10,1,0,0,0,0,0,0,0,370,2,167
인천광역시,강화군,하점면,합계,3315,2319,535,1097,459,86,106,7,0,4,1,1,1,4,5,2306,13,996
인천광역시,강화군,하점면,관내사전투표,631,631,163,272,124,23,38,1,0,3,0,0,0,1,1,626,5,0
인천광역시,강화군,하점면,하점면제1투,1288,806,200,382,151,30,31,6,0,1,0,0,1,0,0,802,4,482
인천광역시,강화군,하점면,하점면제2투,728,481,98,237,95,17,28,0,0,0,0,0,0,0,3,478,3,247
인천광역시,강화군,하점면,하점면제3투,668,401,74,206,89,16,9,0,0,0,1,1,0,3,1,400,1,267
인천광역시,강화군,양사면,관내사전투표,253,253,72,104,50,12,13,0,1,0,0,0,0,0,0,252,1,0
인천광역시,강화군,양사면,합계,1472,1070,227,535,215,38,37,0,1,0,1,0,2,4,3,1063,7,402
인천광역시,강화군,양사면,양사면제1투,401,273,64,141,48,5,10,0,0,0,0,0,1,1,1,271,2,128
인천광역시,강화군,양사면,양사면제2투,512,325,67,158,68,17,9,0,0,0,0,0,0,3,1,323,2,187
인천광역시,강화군,양사면,양사면제3투,306,219,24,132,49,4,5,0,0,0,1,0,1,0,1,217,2,87
인천광역시,강화군,송해면,합계,2561,1844,397,837,420,89,66,9,0,1,1,1,1,3,3,1828,16,717
인천광역시,강화군,송해면,관내사전투표,609,609,142,241,155,33,26,3,0,1,0,0,0,2,0,603,6,0
인천광역시,강화군,송해면,송해면투표소,1952,1235,255,596,265,56,40,6,0,0,1,1,1,1,3,1225,10,717
인천광역시,강화군,교동면,합계,2474,1725,411,735,384,84,78,1,1,0,0,2,5,5,3,1709,16,749
인천광역시,강화군,교동면,관내사전투표,291,291,100,93,51,21,21,0,0,0,0,0,1,1,2,290,1,0
인천광역시,강화군,교동면,교동면제1투,980,635,134,282,159,23,24,1,0,0,0,1,2,1,0,627,8,345
인천광역시,강화군,교동면,교동면제2투,625,416,83,189,92,24,21,0,1,0,0,0,2,2,0,414,2,209
인천광역시,강화군,교동면,교동면제3투,578,383,94,171,82,16,12,0,0,0,0,1,0,1,1,378,5,195
인천광역시,강화군,삼산면,합계,1838,1256,293,567,283,52,37,2,0,1,1,0,4,4,3,1247,9,582
인천광역시,강화군,삼산면,관내사전투표,268,268,74,112,57,10,13,1,0,0,0,0,0,1,0,268,0,0
인천광역시,강화군,삼산면,삼산면제1투,508,303,74,133,69,16,8,0,0,0,0,0,0,0,1,301,2,205
인천광역시,강화군,삼산면,삼산면제2투,273,179,41,62,56,6,7,0,0,0,1,0,1,2,1,177,2,94
인천광역시,강화군,삼산면,삼산면제3투,727,460,93,235,96,17,9,1,0,1,0,0,2,1,1,456,4,267
인천광역시,강화군,삼산면,삼산면제4투,62,46,11,25,5,3,0,0,0,0,0,0,1,0,0,45,1,16
인천광역시,강화군,서도면,합계,542,417,59,205,108,11,21,4,0,0,1,0,0,3,0,412,5,125
인천광역시,강화군,서도면,관내사전투표,93,93,21,34,26,3,7,2,0,0,0,0,0,0,0,93,0,0
인천광역시,강화군,서도면,서도면제1투,251,172,21,104,34,4,6,0,0,0,0,0,0,1,0,170,2,79
인천광역시,강화군,서도면,서도면제2투,198,152,17,67,48,4,8,2,0,0,1,0,0,2,0,149,3,46
인천광역시,강화군,잘못 투입·구분된 투표지,,0,26,13,5,4,2,2,0,0,0,0,0,0,0,0,26,0,-26
인천광역시,옹진군,합계,,18872,14747,3935,5834,3092,875,656,23,5,18,11,17,23,28,45,14562,185,4125
인천광역시,옹진군,거소·선상투표,,185,183,52,38,54,18,6,0,0,0,0,0,0,0,4,172,11,2
인천광역시,옹진군,관외사전투표,,3174,3174,1113,823,679,248,241,4,0,4,1,5,6,2,11,3137,37,0
인천광역시,옹진군,재외투표,,54,45,28,3,7,1,6,0,0,0,0,0,0,0,0,45,0,9
인천광역시,옹진군,북도면,합계,1583,1173,220,621,217,46,32,1,1,2,3,2,3,3,3,1154,19,410
인천광역시,옹진군,북도면,관내사전투표,287,287,71,134,55,14,11,1,0,0,0,1,0,0,0,287,0,0
인천광역시,옹진군,북도면,북도면제1투,325,219,41,135,29,6,5,0,0,0,1,0,1,0,0,218,1,106
인천광역시,옹진군,북도면,북도면제2투,229,138,22,74,26,11,3,0,0,1,0,0,0,0,1,138,0,91
인천광역시,옹진군,북도면,북도면제3투,742,529,86,278,107,15,13,0,1,1,2,1,2,3,2,511,18,213
인천광역시,옹진군,연평면,합계,1545,1123,277,433,264,81,38,3,0,4,2,4,2,2,2,1112,11,422
인천광역시,옹진군,연평면,관내사전투표,617,616,145,216,152,52,26,3,0,4,2,1,2,2,2,607,9,1
인천광역시,옹진군,연평면,연평면제1투,849,461,122,197,101,28,9,0,0,0,0,3,0,0,0,460,1,388
인천광역시,옹진군,연평면,연평면제2투,79,46,10,20,11,1,3,0,0,0,0,0,0,0,0,45,1,33
인천광역시,옹진군,백령면,합계,4104,3014,752,1298,568,223,104,2,2,2,3,1,1,9,7,2972,42,1090
인천광역시,옹진군,백령면,관내사전투표,1000,1000,305,282,201,116,51,0,1,0,2,0,0,5,4,967,33,0
인천광역시,옹진군,백령면,백령면제1투,1171,694,178,331,127,34,18,0,0,1,0,0,0,2,0,691,3,477
인천광역시,옹진군,백령면,백령면제2투,1201,798,187,347,165,60,25,1,0,1,1,1,1,1,3,793,5,403
인천광역시,옹진군,백령면,백령면제3투,421,319,53,214,35,6,7,1,1,0,0,0,0,1,0,318,1,102
인천광역시,옹진군,백령면,백령면제4투,311,203,29,124,40,7,3,0,0,0,0,0,0,0,0,203,0,108
인천광역시,옹진군,대청면,관내사전투표,311,311,86,122,62,23,7,2,0,0,0,0,2,0,1,305,6,0
인천광역시,옹진군,대청면,합계,1156,958,195,536,143,45,20,2,0,0,0,0,2,1,5,949,9,198
인천광역시,옹진군,대청면,대청면제1투,375,270,51,166,30,10,9,0,0,0,0,0,0,0,3,269,1,105
인천광역시,옹진군,대청면,대청면제2투,304,228,47,138,33,5,3,0,0,0,0,0,0,0,0,226,2,76
인천광역시,옹진군,대청면,대청면제3투,166,149,11,110,18,7,1,0,0,0,0,0,0,1,1,149,0,17
인천광역시,옹진군,덕적면,관내사전투표,388,388,110,140,96,14,16,2,1,0,0,1,1,2,1,384,4,0
인천광역시,옹진군,덕적면,합계,1452,1082,273,472,239,39,33,3,2,2,0,1,3,4,4,1075,7,370
인천광역시,옹진군,덕적면,덕적면제1투,399,225,54,88,60,14,6,0,0,0,0,0,0,1,1,224,1,174
인천광역시,옹진군,덕적면,덕적면제2투,283,185,38,88,50,5,2,0,0,0,0,0,0,0,1,184,1,98
인천광역시,옹진군,덕적면,덕적면제3투,204,150,37,81,23,2,4,0,0,0,0,0,1,1,1,150,0,54
인천광역시,옹진군,덕적면,덕적면제4투,73,59,11,42,3,1,1,0,1,0,0,0,0,0,0,59,0,14
인천광역시,옹진군,덕적면,덕적면제5투,54,33,8,13,4,2,2,1,0,2,0,0,1,0,0,33,0,21
인천광역시,옹진군,덕적면,덕적면제6투,51,42,15,20,3,1,2,0,0,0,0,0,0,0,0,41,1,9
인천광역시,옹진군,자월면,관내사전투표,225,225,60,99,44,14,7,0,0,0,0,0,1,0,0,225,0,0
인천광역시,옹진군,자월면,합계,1016,775,147,366,190,32,26,0,0,0,1,2,2,1,0,767,8,241
인천광역시,옹진군,자월면,자월면제1투,305,183,39,89,39,7,3,0,0,0,0,2,1,1,0,181,2,122
인천광역시,옹진군,자월면,자월면제2투,190,141,13,66,51,5,4,0,0,0,0,0,0,0,0,139,2,49
인천광역시,옹진군,자월면,자월면제3투,217,165,27,81,40,4,9,0,0,0,1,0,0,0,0,162,3,52
인천광역시,옹진군,자월면,자월면제4투,79,61,8,31,16,2,3,0,0,0,0,0,0,0,0,60,1,18
인천광역시,옹진군,영흥면,관내사전투표,907,907,310,287,185,37,41,1,0,1,0,1,3,3,5,874,33,0
인천광역시,옹진군,영흥면,합계,4603,3219,877,1244,731,142,150,8,0,4,1,2,4,6,9,3178,41,1384
인천광역시,옹진군,영흥면,영흥면제1투,1551,928,257,357,205,49,53,1,0,0,0,1,0,0,1,924,4,623
인천광역시,옹진군,영흥면,영흥면제2투,1348,828,190,332,219,36,40,5,0,1,1,0,0,1,2,827,1,520
인천광역시,옹진군,영흥면,영흥면제3투,797,556,120,268,122,20,16,1,0,2,0,0,1,2,1,553,3,241
인천광역시,옹진군,잘못 투입·구분된 투표지,,0,1,1,0,0,0,0,0,0,0,0,0,0,0,0,1,0,-1
광주광역시,합계,,,1166901,957321,583847,14882,287222,20862,43719,152,111,655,103,2265,136,264,614,954832,2489,209580
광주광역시,동구,합계,,83378,66287,37053,1308,23438,1372,2665,13,5,45,10,115,13,19,47,66103,184,17091
광주광역시,동구,거소·선상투표,,201,182,92,5,71,3,6,0,0,0,2,0,1,0,2,182,0,19
광주광역시,동구,관외사전투표,,10495,10495,6442,173,2933,295,578,1,0,5,1,22,0,3,8,10461,34,0
광주광역시,동구,재외투표,,443,345,240,9,56,6,33,0,0,0,0,1,0,0,0,345,0,98
광주광역시,동구,충장동,합계,3695,2506,1248,56,1022,56,116,0,0,3,0,2,0,0,0,2503,3,1189
광주광역시,동구,충장동,관내사전투표,853,853,434,15,324,20,55,0,0,1,0,2,0,0,0,851,2,0
광주광역시,동구,충장동,충장동제1투,1712,945,475,30,393,21,24,0,0,1,0,0,0,0,0,944,1,767
광주광역시,동구,충장동,충장동제2투,1130,708,339,11,305,15,37,0,0,1,0,0,0,0,0,708,0,422
광주광역시,동구,동명동,합계,3920,2971,1656,61,1051,64,127,0,0,1,0,6,0,1,0,2967,4,949
광주광역시,동구,동명동,관내사전투표,1303,1303,750,21,409,32,85,0,0,0,0,5,0,1,0,1303,0,0
광주광역시,동구,동명동,동명동제1투,1227,714,392,23,254,22,21,0,0,1,0,0,0,0,0,713,1,513
광주광역시,동구,동명동,동명동제2투,1390,954,514,17,388,10,21,0,0,0,0,1,0,0,0,951,3,436
광주광역시,동구,계림1동,합계,5367,3685,1877,87,1518,50,126,0,1,3,1,9,0,2,2,3676,9,1682
광주광역시,동구,계림1동,관내사전투표,1264,1264,618,23,547,16,48,0,1,1,0,5,0,2,0,1261,3,0
광주광역시,동구,계림1동,계림1동제1투,1715,1008,541,24,400,11,25,0,0,1,0,1,0,0,1,1004,4,707
광주광역시,동구,계림1동,계림1동제2투,1745,1074,564,33,412,16,44,0,0,1,0,2,0,0,1,1073,1,671
광주광역시,동구,계림1동,계림1동제3투,643,339,154,7,159,7,9,0,0,0,1,1,0,0,0,338,1,304
광주광역시,동구,계림2동,합계,6708,5279,2881,106,2010,89,161,0,0,5,1,7,1,1,6,5268,11,1429
광주광역시,동구,계림2동,관내사전투표,1568,1568,876,36,576,23,46,0,0,3,0,2,0,1,2,1565,3,0
광주광역시,동구,계림2동,계림2동제1투,1429,1031,590,15,349,21,47,0,0,2,1,1,1,0,2,1029,2,398
광주광역시,동구,계림2동,계림2동제2투,1505,944,497,18,388,13,24,0,0,0,0,1,0,0,1,942,2,561
광주광역시,동구,계림2동,계림2동제3투,2206,1736,918,37,697,32,44,0,0,0,0,3,0,0,1,1732,4,470
광주광역시,동구,산수1동,합계,5061,3675,2074,42,1360,54,123,0,0,2,0,3,0,2,4,3664,11,1386
광주광역시,동구,산수1동,관내사전투표,1139,1139,675,11,395,20,30,0,0,0,0,1,0,1,1,1134,5,0
광주광역시,동구,산수1동,산수1동제1투,1653,1091,577,9,431,16,51,0,0,1,0,2,0,0,2,1089,2,562
광주광역시,동구,산수1동,산수1동제2투,1694,1096,626,19,400,15,29,0,0,1,0,0,0,1,1,1092,4,598
광주광역시,동구,산수1동,산수1동제3투,575,349,196,3,134,3,13,0,0,0,0,0,0,0,0,349,0,226
광주광역시,동구,산수2동,합계,7596,6002,3253,136,2273,108,204,0,1,1,0,13,0,0,3,5992,10,1594
광주광역시,동구,산수2동,관내사전투표,1548,1548,839,25,586,29,56,0,0,1,0,4,0,0,1,1541,7,0
광주광역시,동구,산수2동,산수2동제1투,1799,1209,644,32,472,14,44,0,0,0,0,1,0,0,0,1207,2,590
광주광역시,동구,산수2동,산수2동제2투,1023,742,392,24,281,15,27,0,0,0,0,0,0,0,2,741,1,281
광주광역시,동구,산수2동,산수2동제3투,1690,1252,726,17,433,23,49,0,0,0,0,4,0,0,0,1252,0,438
광주광역시,동구,산수2동,산수2동제4투,1536,1251,652,38,501,27,28,0,1,0,0,4,0,0,0,1251,0,285
광주광역시,동구,지산1동,합계,3531,2673,1505,42,933,65,99,2,1,3,0,8,1,1,2,2662,11,858
광주광역시,동구,지산1동,관내사전투표,1052,1052,592,15,373,19,41,1,1,1,0,3,1,0,1,1048,4,0
광주광역시,동구,지산1동,지산1동제1투,1661,1150,657,24,397,27,36,0,0,1,0,4,0,0,0,1146,4,511
광주광역시,동구,지산1동,지산1동제2투,818,471,256,3,163,19,22,1,0,1,0,1,0,1,1,468,3,347
광주광역시,동구,지산2동,합계,4153,3202,1741,76,1166,65,137,0,0,3,0,6,1,0,2,3197,5,951
광주광역시,동구,지산2동,관내사전투표,1165,1165,655,26,398,22,59,0,0,0,0,1,0,0,0,1161,4,0
광주광역시,동구,지산2동,지산2동제1투,2030,1366,737,39,499,32,54,0,0,2,0,1,0,0,1,1365,1,664
광주광역시,동구,지산2동,지산2동제2투,958,671,349,11,269,11,24,0,0,1,0,4,1,0,1,671,0,287
광주광역시,동구,서남동,합계,3035,2088,1164,44,723,45,94,0,0,3,0,5,0,3,1,2082,6,947
광주광역시,동구,서남동,관내사전투표,992,992,585,13,326,19,39,0,0,1,0,3,0,3,1,990,2,0
광주광역시,동구,서남동,서남동제1투,1068,596,320,19,211,13,32,0,0,0,0,0,0,0,0,595,1,472
광주광역시,동구,서남동,서남동제2투,975,500,259,12,186,13,23,0,0,2,0,2,0,0,0,497,3,475
광주광역시,동구,학동,합계,6598,5265,2942,100,1870,102,215,4,0,2,1,4,1,2,3,5246,19,1333
광주광역시,동구,학동,관내사전투표,1769,1769,989,30,603,42,90,3,0,1,1,2,0,1,1,1763,6,0
광주광역시,동구,학동,학동제1투,1141,699,403,15,248,6,23,0,0,0,0,0,1,0,0,696,3,442
광주광역시,동구,학동,학동제2투,1829,1348,758,26,485,20,51,1,0,0,0,2,0,0,0,1343,5,481
광주광역시,동구,학동,학동제3투,1859,1449,792,29,534,34,51,0,0,1,0,0,0,1,2,1444,5,410
광주광역시,동구,학운동,관내사전투표,2853,2853,1568,62,1011,77,115,0,0,3,1,4,1,2,1,2845,8,0
광주광역시,동구,학운동,합계,9820,7990,4200,199,3092,179,276,1,0,9,1,8,1,2,1,7969,21,1830
광주광역시,동구,학운동,학운동제1투,1719,1106,572,32,439,21,34,1,0,1,0,1,0,0,0,1101,5,613
광주광역시,동구,학운동,학운동제2투,2049,1588,835,35,614,39,58,0,0,3,0,2,0,0,0,1586,2,461
광주광역시,동구,학운동,학운동제3투,1383,1058,526,27,458,17,26,0,0,1,0,0,0,0,0,1055,3,325
광주광역시,동구,학운동,학운동제4투,1816,1385,699,43,570,25,43,0,0,1,0,1,0,0,0,1382,3,431
광주광역시,동구,지원1동,관내사전투표,1713,1712,983,18,584,38,74,1,0,0,1,4,1,0,0,1704,8,1
광주광역시,동구,지원1동,합계,5711,4537,2539,81,1620,83,178,2,0,1,1,7,3,0,4,4519,18,1174
광주광역시,동구,지원1동,지원1동제1투,1492,1033,567,19,396,14,33,0,0,0,0,0,1,0,1,1031,2,459
광주광역시,동구,지원1동,지원1동제2투,1730,1252,690,29,458,21,43,1,0,1,0,2,0,0,2,1247,5,478
광주광역시,동구,지원1동,지원1동제3투,776,540,299,15,182,10,28,0,0,0,0,1,1,0,1,537,3,236
광주광역시,동구,지원2동,합계,7044,5392,3199,91,1740,108,192,3,2,4,2,14,4,2,9,5370,22,1652
광주광역시,동구,지원2동,관내사전투표,1534,1534,889,26,508,26,52,1,0,2,1,4,4,1,6,1520,14,0
광주광역시,동구,지원2동,지원2동제1투,2348,1852,1154,30,536,43,77,2,0,0,1,2,0,0,1,1846,6,496
광주광역시,동구,지원2동,지원2동제2투,1850,1115,619,17,411,19,36,0,2,2,0,6,0,1,1,1114,1,735
광주광역시,동구,지원2동,지원2동제3투,1312,891,537,18,285,20,27,0,0,0,0,2,0,0,1,890,1,421
광주광역시,동구,잘못 투입·구분된 투표지,,0,0,0,0,0,0,0,0,0,0,0,0,0,0,0,0,0,0
광주광역시,서구,합계,,247595,204787,124183,3182,62218,4627,9247,20,17,198,32,450,20,45,116,204355,432,42808
광주광역시,서구,거소·선상투표,,624,574,303,11,189,28,15,1,1,1,1,1,0,0,5,556,18,50
광주광역시,서구,관외사전투표,,27780,27776,17523,479,6906,957,1685,3,4,26,8,56,4,8,26,27685,91,4
광주광역시,서구,재외투표,,1045,844,623,6,109,14,86,0,0,1,0,0,0,0,1,840,4,201
광주광역시,서구,양동,합계,4000,3005,1542,50,1300,33,65,0,0,2,1,5,0,1,0,2999,6,995
광주광역시,서구,양동,관내사전투표,946,946,475,16,418,12,21,0,0,1,0,0,0,1,0,944,2,0
광주광역시,서구,양동,양동제1투,1611,1169,604,24,497,15,24,0,0,0,1,1,0,0,0,1166,3,442
광주광역시,서구,양동,양동제2투,1443,890,463,10,385,6,20,0,0,1,0,4,0,0,0,889,1,553
광주광역시,서구,양3동,관내사전투표,949,949,596,9,279,24,33,0,0,1,0,5,0,0,1,948,1,0
광주광역시,서구,양3동,합계,3814,3036,1803,38,999,58,112,1,0,2,0,12,0,1,2,3028,8,778
광주광역시,서구,양3동,양3동제1투,2039,1479,853,20,511,24,61,0,0,0,0,5,0,1,0,1475,4,560
광주광역시,서구,양3동,양3동제2투,826,608,354,9,209,10,18,1,0,1,0,2,0,0,1,605,3,218
광주광역시,서구,농성1동,합계,6344,4676,2593,80,1731,69,176,1,2,2,0,9,0,3,1,4667,9,1668
광주광역시,서구,농성1동,관내사전투표,1607,1607,882,29,584,26,72,1,1,1,0,4,0,1,0,1601,6,0
광주광역시,서구,농성1동,농성1동제1투,1440,927,514,13,359,10,29,0,0,0,0,1,0,0,0,926,1,513
광주광역시,서구,농성1동,농성1동제2투,1644,1032,551,19,400,15,39,0,1,1,0,2,0,2,1,1031,1,612
광주광역시,서구,농성1동,농성1동제3투,1653,1110,646,19,388,18,36,0,0,0,0,2,0,0,0,1109,1,543
광주광역시,서구,농성2동,합계,4593,3445,1892,61,1252,67,151,0,0,3,0,7,0,0,2,3435,10,1148
광주광역시,서구,농성2동,관내사전투표,1281,1281,727,24,450,20,49,0,0,3,0,4,0,0,1,1278,3,0
광주광역시,서구,농성2동,농성2동제1투,1576,966,511,15,364,24,42,0,0,0,0,3,0,0,1,960,6,610
광주광역시,서구,농성2동,농성2동제2투,1736,1198,654,22,438,23,60,0,0,0,0,0,0,0,0,1197,1,538
광주광역시,서구,광천동,합계,7369,5550,3164,113,1908,132,193,1,0,6,1,7,2,2,4,5533,17,1819
광주광역시,서구,광천동,관내사전투표,2018,2017,1180,24,679,41,79,0,0,3,1,6,0,2,0,2015,2,1
광주광역시,서구,광천동,광천동제1투,1506,855,485,25,286,19,31,0,0,0,0,1,2,0,2,851,4,651
광주광역시,서구,광천동,광천동제2투,2742,1945,1096,52,664,52,70,1,0,1,0,0,0,0,1,1937,8,797
광주광역시,서구,광천동,광천동제3투,1103,733,403,12,279,20,13,0,0,2,0,0,0,0,1,730,3,370
광주광역시,서구,유덕동,합계,7736,6388,4128,87,1687,132,300,0,0,4,2,17,0,4,6,6367,21,1348
광주광역시,서구,유덕동,관내사전투표,2237,2237,1480,30,552,48,109,0,0,3,1,3,0,4,1,2231,6,0
광주광역시,서구,유덕동,유덕동제1투,773,508,291,10,173,8,16,0,0,0,0,0,0,0,4,502,6,265
광주광역시,서구,유덕동,유덕동제2투,2351,1785,1175,28,432,43,92,0,0,0,0,9,0,0,1,1780,5,566
광주광역시,서구,유덕동,유덕동제3투,2375,1858,1182,19,530,33,83,0,0,1,1,5,0,0,0,1854,4,517
광주광역시,서구,치평동,합계,22764,18891,11811,288,5419,456,812,4,3,16,2,33,1,5,3,18853,38,3873
광주광역시,서구,치평동,관내사전투표,6844,6844,4422,71,1813,180,318,0,1,6,1,13,1,1,1,6828,16,0
광주광역시,서구,치평동,치평동제1투,2914,2157,1311,38,671,45,75,1,2,2,0,5,0,1,1,2152,5,757
광주광역시,서구,치평동,치평동제2투,2396,1822,1121,30,559,34,71,1,0,2,0,2,0,1,0,1821,1,574
광주광역시,서구,치평동,치평동제3투,2383,1838,1080,41,588,44,79,0,0,1,0,1,0,0,0,1834,4,545
광주광역시,서구,치평동,치평동제4투,2668,2102,1235,40,685,56,77,1,0,2,1,3,0,1,0,2101,1,566
광주광역시,서구,치평동,치평동제5투,2062,1692,1076,33,478,24,70,0,0,1,0,3,0,1,1,1687,5,370
광주광역시,서구,치평동,치평동제6투,3497,2436,1566,35,625,73,122,1,0,2,0,6,0,0,0,2430,6,1061
광주광역시,서구,상무1동,합계,16935,12867,7763,208,3950,278,602,1,0,7,5,26,1,0,7,12848,19,4068
광주광역시,서구,상무1동,관내사전투표,3786,3786,2312,59,1143,74,179,0,0,2,1,11,1,0,2,3784,2,0
광주광역시,서구,상무1동,상무1동제1투,2025,1248,725,25,410,24,56,0,0,0,1,3,0,0,2,1246,2,777
광주광역시,서구,상무1동,상무1동제2투,2618,1953,1192,34,596,34,89,0,0,0,1,4,0,0,0,1950,3,665
광주광역시,서구,상무1동,상무1동제3투,2808,2029,1156,35,683,62,84,1,0,3,0,2,0,0,1,2027,2,779
광주광역시,서구,상무1동,상무1동제4투,2407,1239,750,20,369,35,56,0,0,1,0,1,0,0,1,1233,6,1168
광주광역시,서구,상무1동,상무1동제5투,3291,2612,1628,35,749,49,138,0,0,1,2,5,0,0,1,2608,4,679
광주광역시,서구,상무2동,합계,18833,14112,7982,260,4937,278,561,0,3,10,1,29,6,5,9,14081,31,4721
광주광역시,서구,상무2동,관내사전투표,4166,4166,2334,58,1484,100,166,0,1,2,0,7,1,3,6,4162,4,0
광주광역시,서구,상무2동,상무2동제1투,2664,1908,1048,32,699,33,74,0,2,2,0,9,1,1,0,1901,7,756
광주광역시,서구,상무2동,상무2동제2투,2352,1557,879,28,578,18,45,0,0,2,0,0,2,0,1,1553,4,795
광주광역시,서구,상무2동,상무2동제3투,3102,2301,1395,57,710,39,89,0,0,2,1,3,0,0,2,2298,3,801
광주광역시,서구,상무2동,상무2동제4투,2940,1844,1033,42,637,28,87,0,0,2,0,6,1,0,0,1836,8,1096
광주광역시,서구,상무2동,상무2동제5투,3609,2336,1293,43,829,60,100,0,0,0,0,4,1,1,0,2331,5,1273
광주광역시,서구,화정1동,합계,11602,8920,5218,139,2877,200,424,1,1,9,1,27,0,1,6,8904,16,2682
광주광역시,서구,화정1동,관내사전투표,2595,2595,1575,42,776,53,133,0,1,1,1,6,0,0,2,2590,5,0
광주광역시,서구,화정1동,화정1동제1투,3070,2417,1492,29,707,56,113,0,0,3,0,9,0,1,1,2411,6,653
광주광역시,서구,화정1동,화정1동제2투,2966,2013,1117,44,695,58,89,0,0,3,0,3,0,0,2,2011,2,953
광주광역시,서구,화정1동,화정1동제3투,2971,1895,1034,24,699,33,89,1,0,2,0,9,0,0,1,1892,3,1076
광주광역시,서구,화정2동,합계,14624,12257,7418,191,3801,256,535,0,0,6,0,25,1,1,7,12241,16,2367
광주광역시,서구,화정2동,관내사전투표,4341,4341,2688,52,1294,96,196,0,0,0,0,10,0,0,3,4339,2,0
광주광역시,서구,화정2동,화정2동제1투,2869,2002,1183,39,637,50,83,0,0,0,0,3,1,1,2,1999,3,867
광주광역시,서구,화정2동,화정2동제2투,1491,1188,727,22,349,28,54,0,0,1,0,4,0,0,1,1186,2,303
광주광역시,서구,화정2동,화정2동제3투,2984,2364,1387,42,783,37,102,0,0,1,0,5,0,0,0,2357,7,620
광주광역시,서구,화정2동,화정2동제4투,2939,2362,1433,36,738,45,100,0,0,4,0,3,0,0,1,2360,2,577
광주광역시,서구,화정3동,합계,7952,6306,3549,115,2253,113,239,0,0,2,0,12,0,0,5,6288,18,1646
광주광역시,서구,화정3동,관내사전투표,1558,1558,925,24,501,39,61,0,0,0,0,2,0,0,1,1553,5,0
광주광역시,서구,화정3동,화정3동제1투,1564,1171,635,22,439,14,51,0,0,2,0,4,0,0,1,1168,3,393
광주광역시,서구,화정3동,화정3동제2투,1892,1305,718,24,488,18,48,0,0,0,0,4,0,0,1,1301,4,587
광주광역시,서구,화정3동,화정3동제3투,2938,2272,1271,45,825,42,79,0,0,0,0,2,0,0,2,2266,6,666
광주광역시,서구,화정4동,관내사전투표,3878,3877,2259,67,1276,100,150,0,0,2,1,10,0,3,1,3869,8,1
광주광역시,서구,화정4동,합계,13541,11144,6460,207,3753,220,445,2,1,5,1,27,0,4,4,11129,15,2397
광주광역시,서구,화정4동,화정4동제1투,2659,1817,1009,36,660,35,70,0,1,1,0,2,0,0,2,1816,1,842
광주광역시,서구,화정4동,화정4동제2투,1803,1483,837,30,538,27,44,0,0,0,0,5,0,0,1,1482,1,320
광주광역시,서구,화정4동,화정4동제3투,1498,1166,687,24,375,14,61,0,0,0,0,3,0,0,0,1164,2,332
광주광역시,서구,화정4동,화정4동제4투,1899,1532,918,29,479,29,71,0,0,1,0,2,0,1,0,1530,2,367
광주광역시,서구,화정4동,화정4동제5투,1804,1269,750,21,425,15,49,2,0,1,0,5,0,0,0,1268,1,535
광주광역시,서구,서창동,합계,3882,2926,1643,52,1047,58,98,1,2,1,0,13,1,0,1,2917,9,956
광주광역시,서구,서창동,관내사전투표,546,546,308,8,184,12,21,0,0,1,0,6,0,0,1,541,5,0
광주광역시,서구,서창동,서창동제1투,1243,746,430,12,258,11,23,1,2,0,0,7,1,0,0,745,1,497
광주광역시,서구,서창동,서창동제2투,560,408,219,4,164,7,13,0,0,0,0,0,0,0,0,407,1,152
광주광역시,서구,서창동,서창동제3투,1533,1226,686,28,441,28,41,0,0,0,0,0,0,0,0,1224,2,307
광주광역시,서구,금호1동,관내사전투표,3711,3711,2218,43,1213,66,146,2,0,3,2,8,0,2,1,3704,7,0
광주광역시,서구,금호1동,합계,15670,12589,7522,172,4071,233,527,2,0,7,3,22,2,3,5,12569,20,3081
광주광역시,서구,금호1동,금호1동제1투,2464,1876,1101,37,630,25,79,0,0,0,0,0,1,1,0,1874,2,588
광주광역시,서구,금호1동,금호1동제2투,2806,2117,1215,36,715,46,94,0,0,2,0,3,1,0,2,2114,3,689
광주광역시,서구,금호1동,금호1동제3투,2101,1309,741,19,471,15,55,0,0,0,1,2,0,0,0,1304,5,792
광주광역시,서구,금호1동,금호1동제4투,2866,2299,1469,18,654,46,100,0,0,2,0,7,0,0,2,2298,1,567
광주광역시,서구,금호1동,금호1동제5투,1722,1277,778,19,388,35,53,0,0,0,0,2,0,0,0,1275,2,445
광주광역시,서구,금호2동,합계,20704,17919,11470,203,4870,388,834,0,0,69,2,50,0,2,8,17896,23,2785
광주광역시,서구,금호2동,관내사전투표,7061,7061,4602,70,1794,171,360,0,0,44,0,14,0,0,2,7057,4,0
광주광역시,서구,금호2동,금호2동제1투,3178,2327,1464,29,655,57,100,0,0,13,0,4,0,1,1,2324,3,851
광주광역시,서구,금호2동,금호2동제2투,2941,2327,1499,31,630,34,114,0,0,6,1,7,0,0,1,2323,4,614
광주광역시,서구,금호2동,금호2동제3투,2968,2525,1623,21,713,50,98,0,0,2,1,12,0,1,1,2522,3,443
광주광역시,서구,금호2동,금호2동제4투,2744,2195,1401,27,619,38,95,0,0,2,0,4,0,0,2,2188,7,549
광주광역시,서구,금호2동,금호2동제5투,1812,1484,881,25,459,38,67,0,0,2,0,9,0,0,1,1482,2,328
광주광역시,서구,풍암동,관내사전투표,7267,7266,4522,81,2108,166,346,1,0,10,0,14,0,2,4,7254,12,1
광주광역시,서구,풍암동,합계,26138,21670,13353,295,6497,466,957,1,0,18,2,36,1,4,9,21639,31,4468
광주광역시,서구,풍암동,풍암동제1투,2375,1872,1114,34,608,38,73,0,0,0,0,2,0,0,1,1870,2,503
광주광역시,서구,풍암동,풍암동제2투,1693,1306,872,8,339,21,58,0,0,2,1,4,0,0,0,1305,1,387
광주광역시,서구,풍암동,풍암동제3투,2189,1789,1133,27,500,33,89,0,0,3,0,2,1,0,0,1788,1,400
광주광역시,서구,풍암동,풍암동제4투,2340,1926,1149,36,603,60,74,0,0,1,1,1,0,0,0,1925,1,414
광주광역시,서구,풍암동,풍암동제5투,2044,1625,1048,22,442,25,84,0,0,0,0,3,0,0,0,1624,1,419
광주광역시,서구,풍암동,풍암동제6투,2893,2017,1271,41,570,39,88,0,0,0,0,3,0,0,2,2014,3,876
광주광역시,서구,풍암동,풍암동제7투,3393,2186,1351,16,672,40,89,0,0,2,0,6,0,2,2,2180,6,1207
광주광역시,서구,풍암동,풍암동제8투,1944,1683,893,30,655,44,56,0,0,0,0,1,0,0,0,1679,4,261
광주광역시,서구,동천동,합계,11645,9889,6421,127,2662,191,429,1,0,1,2,36,1,1,5,9877,12,1756
광주광역시,서구,동천동,관내사전투표,3204,3204,2105,47,814,75,144,0,0,1,0,12,1,1,1,3201,3,0
광주광역시,서구,동천동,동천동제1투,1904,1469,898,21,455,23,60,0,0,0,1,7,0,0,1,1466,3,435
광주광역시,서구,동천동,동천동제2투,2096,1750,1200,17,418,25,76,0,0,0,1,8,0,0,1,1746,4,346
광주광역시,서구,동천동,동천동제3투,2297,1962,1268,26,531,39,89,1,0,0,0,7,0,0,0,1961,1,335
광주광역시,서구,동천동,동천동제4투,2144,1504,950,16,444,29,60,0,0,0,0,2,0,0,2,1503,1,640
광주광역시,서구,잘못 투입·구분된 투표지,,0,3,2,0,0,0,1,0,0,0,0,0,0,0,0,3,0,-3
광주광역시,남구,합계,,177247,146037,85642,2521,47663,3085,6013,38,19,142,12,296,21,56,89,145597,440,31210
광주광역시,남구,거소·선상투표,,439,407,212,12,151,8,6,0,2,2,0,2,1,3,0,399,8,32
광주광역시,남구,관외사전투표,,22072,22072,13823,341,5742,739,1244,5,1,17,2,45,2,4,22,21987,85,0
광주광역시,남구,재외투표,,875,710,521,15,89,14,68,0,0,0,0,1,0,1,0,709,1,165
광주광역시,남구,양림동,합계,6206,5036,2933,73,1685,88,218,0,2,2,2,14,1,2,0,5020,16,1170
광주광역시,남구,양림동,관내사전투표,2136,2136,1297,26,659,40,96,0,1,2,0,7,0,1,0,2129,7,0
광주광역시,남구,양림동,양림동제1투,1451,911,490,15,345,9,46,0,0,0,0,2,0,0,0,907,4,540
광주광역시,남구,양림동,양림동제2투,2619,1989,1146,32,681,39,76,0,1,0,2,5,1,1,0,1984,5,630
광주광역시,남구,방림1동,합계,5858,4713,2727,83,1615,89,160,1,0,7,0,10,0,1,1,4694,19,1145
광주광역시,남구,방림1동,관내사전투표,1897,1897,1134,35,603,46,65,0,0,4,0,5,0,0,0,1892,5,0
광주광역시,남구,방림1동,방림1동제1투,2180,1573,892,27,556,22,64,1,0,1,0,3,0,1,0,1567,6,607
광주광역시,남구,방림1동,방림1동제2투,1781,1243,701,21,456,21,31,0,0,2,0,2,0,0,1,1235,8,538
광주광역시,남구,방림2동,합계,7311,5802,3313,106,2016,107,214,4,0,9,0,18,0,1,2,5790,12,1509
광주광역시,남구,방림2동,관내사전투표,1417,1416,817,23,482,25,51,0,0,2,0,8,0,0,2,1410,6,1
광주광역시,남구,방림2동,방림2동제1투,1873,1176,645,22,431,22,42,3,0,3,0,3,0,1,0,1172,4,697
광주광역시,남구,방림2동,방림2동제2투,2515,1958,1156,43,639,39,72,1,0,2,0,5,0,0,0,1957,1,557
광주광역시,남구,방림2동,방림2동제3투,1506,1252,695,18,464,21,49,0,0,2,0,2,0,0,0,1251,1,254
광주광역시,남구,봉선1동,합계,12544,9916,5764,190,3361,169,360,3,1,13,1,22,0,4,6,9894,22,2628
광주광역시,남구,봉선1동,관내사전투표,3874,3874,2247,68,1306,69,156,0,0,7,0,9,0,2,0,3864,10,0
광주광역시,남구,봉선1동,봉선1동제1투,1948,1367,776,31,468,29,50,1,0,1,0,3,0,1,2,1362,5,581
광주광역시,남구,봉선1동,봉선1동제2투,1811,1290,721,33,462,19,51,1,0,0,0,2,0,0,1,1290,0,521
광주광역시,남구,봉선1동,봉선1동제3투,2449,1755,1009,34,611,28,56,0,1,2,0,7,0,1,1,1750,5,694
광주광역시,남구,봉선1동,봉선1동제4투,2462,1630,1011,24,514,24,47,1,0,3,1,1,0,0,2,1628,2,832
광주광역시,남구,봉선2동,합계,19148,16328,9280,403,5427,416,652,12,4,18,1,22,4,7,9,16255,73,2820
광주광역시,남구,봉선2동,관내사전투표,5564,5564,3326,107,1665,150,238,3,3,8,1,11,2,5,5,5524,40,0
광주광역시,남구,봉선2동,봉선2동제1투,2936,2305,1264,67,829,62,78,0,0,0,0,1,0,0,0,2301,4,631
광주광역시,남구,봉선2동,봉선2동제2투,2150,1527,846,49,500,38,59,5,1,1,0,1,1,2,2,1505,22,623
광주광역시,남구,봉선2동,봉선2동제3투,2563,2039,1127,31,733,37,98,1,0,3,0,5,0,0,1,2036,3,524
광주광역시,남구,봉선2동,봉선2동제4투,3134,2558,1502,78,804,47,111,3,0,6,0,2,1,0,1,2555,3,576
광주광역시,남구,봉선2동,봉선2동제5투,2801,2335,1215,71,896,82,68,0,0,0,0,2,0,0,0,2334,1,466
광주광역시,남구,사직동,합계,4350,2954,1555,70,1158,40,106,0,0,3,1,5,2,1,3,2944,10,1396
광주광역시,남구,사직동,관내사전투표,860,860,485,15,302,12,38,0,0,1,0,1,2,0,1,857,3,0
광주광역시,남구,사직동,사직동제1투,1513,847,409,23,369,9,30,0,0,1,1,1,0,0,2,845,2,666
광주광역시,남구,사직동,사직동제2투,1977,1247,661,32,487,19,38,0,0,1,0,3,0,1,0,1242,5,730
광주광역시,남구,월산동,합계,7727,5564,2929,90,2243,86,181,0,0,6,0,5,3,2,4,5549,15,2163
광주광역시,남구,월산동,관내사전투표,1496,1496,763,22,604,35,61,0,0,3,0,0,0,0,2,1490,6,0
광주광역시,남구,월산동,월산동제1투,1056,666,362,6,267,5,21,0,0,1,0,1,0,1,0,664,2,390
광주광역시,남구,월산동,월산동제2투,1473,970,476,22,416,12,38,0,0,0,0,1,1,0,1,967,3,503
광주광역시,남구,월산동,월산동제3투,1595,937,510,16,372,12,21,0,0,1,0,1,2,0,1,936,1,658
광주광역시,남구,월산동,월산동제4투,2107,1495,818,24,584,22,40,0,0,1,0,2,0,1,0,1492,3,612
광주광역시,남구,월산4동,합계,7343,5352,2862,115,2053,99,178,0,1,3,0,11,0,4,6,5332,20,1991
광주광역시,남구,월산4동,관내사전투표,1468,1468,786,32,569,27,46,0,0,3,0,1,0,0,2,1466,2,0
광주광역시,남구,월산4동,월산4동제1투,2177,1343,734,26,473,36,56,0,0,0,0,7,0,2,2,1336,7,834
광주광역시,남구,월산4동,월산4동제2투,1788,1237,683,29,478,15,25,0,1,0,0,1,0,0,2,1234,3,551
광주광역시,남구,월산4동,월산4동제3투,1910,1304,659,28,533,21,51,0,0,0,0,2,0,2,0,1296,8,606
광주광역시,남구,월산5동,합계,5966,4528,2476,79,1697,77,160,0,1,6,0,10,0,3,4,4513,15,1438
광주광역시,남구,월산5동,관내사전투표,1665,1665,929,38,588,31,61,0,0,4,0,5,0,2,1,1659,6,0
광주광역시,남구,월산5동,월산5동제1투,2329,1518,811,17,609,20,51,0,0,2,0,1,0,1,2,1514,4,811
광주광역시,남구,월산5동,월산5동제2투,1972,1345,736,24,500,26,48,0,1,0,0,4,0,0,1,1340,5,627
광주광역시,남구,백운1동,합계,9649,7904,4632,137,2661,138,292,1,0,6,0,16,0,1,6,7890,14,1745
광주광역시,남구,백운1동,관내사전투표,2322,2322,1410,35,737,33,94,0,0,2,0,4,0,1,4,2320,2,0
광주광역시,남구,백운1동,백운1동제1투,2514,1803,965,32,688,48,62,1,0,0,0,2,0,0,2,1800,3,711
광주광역시,남구,백운1동,백운1동제2투,2388,1880,1166,35,583,29,54,0,0,2,0,6,0,0,0,1875,5,508
광주광역시,남구,백운1동,백운1동제3투,2425,1899,1091,35,653,28,82,0,0,2,0,4,0,0,0,1895,4,526
광주광역시,남구,백운2동,합계,4836,3654,2022,59,1350,68,126,2,0,1,1,6,0,0,3,3638,16,1182
광주광역시,남구,백운2동,관내사전투표,1189,1189,695,13,408,26,38,0,0,0,0,3,0,0,1,1184,5,0
광주광역시,남구,백운2동,백운2동제1투,2445,1577,840,31,596,30,65,2,0,1,1,2,0,0,2,1570,7,868
광주광역시,남구,백운2동,백운2동제2투,1202,888,487,15,346,12,23,0,0,0,0,1,0,0,0,884,4,314
광주광역시,남구,주월1동,관내사전투표,4113,4113,2487,50,1325,82,157,1,1,1,0,3,1,0,0,4108,5,0
광주광역시,남구,주월1동,합계,14168,11354,6707,170,3773,197,442,2,3,6,3,16,2,2,5,11328,26,2814
광주광역시,남구,주월1동,주월1동제1투,2644,1908,1037,29,714,37,77,0,1,1,1,3,0,0,3,1903,5,736
광주광역시,남구,주월1동,주월1동제2투,2519,1786,1022,28,625,28,69,0,1,0,1,3,1,0,0,1778,8,733
광주광역시,남구,주월1동,주월1동제3투,2458,1700,1001,27,569,24,67,1,0,2,0,1,0,1,2,1695,5,758
광주광역시,남구,주월1동,주월1동제4투,2434,1847,1160,36,540,26,72,0,0,2,1,6,0,1,0,1844,3,587
광주광역시,남구,주월2동,관내사전투표,1755,1755,1001,28,626,26,63,0,0,2,0,2,0,1,0,1749,6,0
광주광역시,남구,주월2동,합계,7217,5572,3136,93,1988,87,223,0,1,10,0,9,1,2,4,5554,18,1645
광주광역시,남구,주월2동,주월2동제1투,1516,978,505,16,384,13,48,0,0,5,0,3,0,0,1,975,3,538
광주광역시,남구,주월2동,주월2동제2투,1871,1351,806,24,435,24,51,0,0,2,0,2,1,0,0,1345,6,520
광주광역시,남구,주월2동,주월2동제3투,2075,1488,824,25,543,24,61,0,1,1,0,2,0,1,3,1485,3,587
광주광역시,남구,효덕동,관내사전투표,7005,7005,4373,75,2045,149,321,0,0,4,1,20,0,5,1,6994,11,0
광주광역시,남구,효덕동,합계,30830,25631,15635,355,7908,521,1066,5,0,22,1,57,1,9,4,25584,47,5199
광주광역시,남구,효덕동,효덕동제1투,2698,2033,1261,23,612,38,87,0,0,3,0,3,0,2,0,2029,4,665
광주광역시,남구,효덕동,효덕동제2투,2774,2165,1320,27,668,36,97,2,0,5,0,4,0,0,1,2160,5,609
광주광역시,남구,효덕동,효덕동제3투,2663,2163,1191,38,787,45,95,0,0,2,0,2,0,0,0,2160,3,500
광주광역시,남구,효덕동,효덕동제4투,2531,2033,1207,43,658,51,65,1,0,0,0,3,1,1,1,2031,2,498
광주광역시,남구,효덕동,효덕동제5투,2823,2206,1355,30,676,43,90,0,0,2,0,4,0,0,0,2200,6,617
광주광역시,남구,효덕동,효덕동제6투,2054,1589,966,33,481,33,65,0,0,3,0,5,0,0,0,1586,3,465
광주광역시,남구,효덕동,효덕동제7투,2823,2142,1322,32,643,41,91,0,0,2,0,5,0,0,0,2136,6,681
광주광역시,남구,효덕동,효덕동제8투,2674,2143,1310,32,701,34,59,0,0,0,0,2,0,1,0,2139,4,531
광주광역시,남구,효덕동,효덕동제9투,2785,2152,1330,22,637,51,96,2,0,1,0,9,0,0,1,2149,3,633
광주광역시,남구,송암동,합계,6085,5014,3137,72,1447,99,224,1,1,4,0,13,1,0,2,5001,13,1071
광주광역시,남구,송암동,관내사전투표,1343,1343,909,17,326,32,46,0,0,1,0,8,0,0,1,1340,3,0
광주광역시,남구,송암동,송암동제1투,1003,633,401,8,189,6,23,0,1,0,0,1,0,0,1,630,3,370
광주광역시,남구,송암동,송암동제2투,1919,1567,906,29,518,30,71,1,0,2,0,3,1,0,0,1561,6,352
광주광역시,남구,송암동,송암동제3투,1820,1471,921,18,414,31,84,0,0,1,0,1,0,0,0,1470,1,349
광주광역시,남구,대촌동,합계,4623,3526,1978,58,1299,43,93,2,2,7,0,14,3,9,8,3516,10,1097
광주광역시,남구,대촌동,관내사전투표,949,949,530,14,346,20,22,0,0,3,0,6,1,1,2,945,4,0
광주광역시,남구,대촌동,대촌동제1투,1700,1194,659,21,448,16,34,2,0,2,0,5,0,4,2,1193,1,506
광주광역시,남구,대촌동,대촌동제2투,671,433,228,8,174,4,13,0,1,1,0,2,0,0,1,432,1,238
광주광역시,남구,대촌동,대촌동제3투,1303,950,561,15,331,3,24,0,1,1,0,1,2,4,3,946,4,353
광주광역시,남구,잘못 투입·구분된 투표지,,0,0,0,0,0,0,0,0,0,0,0,0,0,0,0,0,0,0
광주광역시,북구,합계,,356097,292001,177850,4241,88501,6274,13206,48,24,157,23,622,31,87,172,291236,765,64096
광주광역시,북구,거소·선상투표,,826,774,417,25,262,19,24,1,1,0,0,3,0,1,6,759,15,52
광주광역시,북구,관외사전투표,,38387,38382,24468,596,9427,1253,2293,5,7,20,6,77,4,8,37,38201,181,5
광주광역시,북구,재외투표,,1497,1205,895,12,144,28,116,0,0,0,0,1,0,3,0,1199,6,292
광주광역시,북구,중흥1동,관내사전투표,830,830,478,15,277,20,34,0,0,3,0,1,0,0,0,828,2,0
광주광역시,북구,중흥1동,합계,3194,2285,1267,37,843,45,77,0,0,3,0,3,1,1,0,2277,8,909
광주광역시,북구,중흥1동,중흥1동투표소,2364,1455,789,22,566,25,43,0,0,0,0,2,1,1,0,1449,6,909
광주광역시,북구,중흥2동,합계,6661,5099,2713,84,1950,110,196,2,1,1,1,20,1,2,5,5086,13,1562
광주광역시,북구,중흥2동,관내사전투표,1825,1825,989,27,667,48,78,0,0,0,0,6,0,2,2,1819,6,0
광주광역시,북구,중흥2동,중흥2동제1투,1548,1164,609,26,462,21,38,1,0,0,0,4,0,0,1,1162,2,384
광주광역시,북구,중흥2동,중흥2동제2투,1617,1023,566,17,365,22,41,0,0,0,1,6,1,0,1,1020,3,594
광주광역시,북구,중흥2동,중흥2동제3투,1671,1087,549,14,456,19,39,1,1,1,0,4,0,0,1,1085,2,584
광주광역시,북구,중흥3동,관내사전투표,1293,1293,702,16,498,20,50,0,0,0,0,2,1,1,1,1291,2,0
광주광역시,북구,중흥3동,합계,4730,3538,2002,57,1271,57,127,0,0,1,0,9,2,1,1,3528,10,1192
광주광역시,북구,중흥3동,중흥3동제1투,1847,1214,733,20,393,21,37,0,0,1,0,5,1,0,0,1211,3,633
광주광역시,북구,중흥3동,중흥3동제2투,1590,1031,567,21,380,16,40,0,0,0,0,2,0,0,0,1026,5,559
광주광역시,북구,중앙동,합계,3326,2340,1224,44,927,45,82,1,0,4,0,4,0,0,0,2331,9,986
광주광역시,북구,중앙동,관내사전투표,901,901,479,22,337,20,34,0,0,4,0,2,0,0,0,898,3,0
광주광역시,북구,중앙동,중앙동투표소,2425,1439,745,22,590,25,48,1,0,0,0,2,0,0,0,1433,6,986
광주광역시,북구,임동,합계,7279,5671,3304,94,1971,86,192,0,1,4,0,4,0,4,0,5660,11,1608
광주광역시,북구,임동,관내사전투표,1899,1899,1134,22,632,28,75,0,0,1,0,3,0,2,0,1897,2,0
광주광역시,북구,임동,임동제1투,2890,2088,1237,34,712,32,66,0,1,1,0,0,0,1,0,2084,4,802
광주광역시,북구,임동,임동제2투,2490,1684,933,38,627,26,51,0,0,2,0,1,0,1,0,1679,5,806
광주광역시,북구,신안동,관내사전투표,2211,2211,1270,41,734,52,93,0,1,2,0,8,0,2,1,2204,7,0
광주광역시,북구,신안동,합계,8827,6399,3667,104,2196,142,245,1,1,4,0,16,0,3,4,6383,16,2428
광주광역시,북구,신안동,신안동제1투,2513,1428,794,20,532,28,49,0,0,1,0,1,0,1,1,1427,1,1085
광주광역시,북구,신안동,신안동제2투,1750,1177,712,12,383,23,40,0,0,0,0,2,0,0,1,1173,4,573
광주광역시,북구,신안동,신안동제3투,2353,1583,891,31,547,39,63,1,0,1,0,5,0,0,1,1579,4,770
광주광역시,북구,용봉동,합계,28007,22828,14052,332,6637,558,1129,6,1,12,5,40,1,6,9,22788,40,5179
광주광역시,북구,용봉동,관내사전투표,6422,6422,4171,67,1517,215,405,3,0,2,1,18,0,1,5,6405,17,0
광주광역시,북구,용봉동,용봉동제1투,2556,1707,1001,31,546,42,76,0,0,1,0,2,0,1,0,1700,7,849
광주광역시,북구,용봉동,용봉동제2투,2380,1828,1056,55,594,36,75,2,0,0,1,3,1,1,0,1824,4,552
광주광역시,북구,용봉동,용봉동제3투,2567,1991,1213,24,595,48,102,0,0,0,0,5,0,0,2,1989,2,576
광주광역시,북구,용봉동,용봉동제4투,1884,1201,655,22,434,16,70,1,0,1,0,0,0,0,0,1199,2,683
광주광역시,북구,용봉동,용봉동제5투,3737,2985,1925,27,838,57,125,0,0,4,3,4,0,0,1,2984,1,752
광주광역시,북구,용봉동,용봉동제6투,3861,2993,1750,54,974,70,132,0,0,2,0,5,0,1,1,2989,4,868
광주광역시,북구,용봉동,용봉동제7투,2130,1753,1037,32,580,42,55,0,1,2,0,1,0,1,0,1751,2,377
광주광역시,북구,용봉동,용봉동제8투,2470,1948,1244,20,559,32,89,0,0,0,0,2,0,1,0,1947,1,522
광주광역시,북구,운암1동,합계,14441,12383,7538,168,3827,262,531,1,1,4,1,18,2,5,4,12362,21,2058
광주광역시,북구,운암1동,관내사전투표,4137,4137,2581,38,1228,91,181,0,0,2,1,3,2,2,2,4131,6,0
광주광역시,북구,운암1동,운암1동제1투,2931,2224,1383,28,655,45,107,1,0,0,0,1,0,0,0,2220,4,707
광주광역시,북구,운암1동,운암1동제2투,2741,2097,1184,30,743,38,93,0,0,1,0,3,0,1,1,2094,3,644
광주광역시,북구,운암1동,운암1동제3투,1793,1537,926,37,478,34,51,0,0,0,0,7,0,0,1,1534,3,256
광주광역시,북구,운암1동,운암1동제4투,2839,2388,1464,35,723,54,99,0,1,1,0,4,0,2,0,2383,5,451
광주광역시,북구,운암2동,합계,10876,8379,4849,113,2904,146,305,1,2,8,1,25,0,1,2,8357,22,2497
광주광역시,북구,운암2동,관내사전투표,3182,3182,1912,48,1024,57,120,0,1,5,1,7,0,0,0,3175,7,0
광주광역시,북구,운암2동,운암2동제1투,1773,1072,610,17,401,15,22,0,1,0,0,2,0,0,1,1069,3,701
광주광역시,북구,운암2동,운암2동제2투,1569,987,555,9,367,20,28,1,0,0,0,4,0,0,0,984,3,582
광주광역시,북구,운암2동,운암2동제3투,2141,1564,882,14,548,33,80,0,0,1,0,1,0,1,0,1560,4,577
광주광역시,북구,운암2동,운암2동제4투,2211,1574,890,25,564,21,55,0,0,2,0,11,0,0,1,1569,5,637
광주광역시,북구,운암3동,관내사전투표,4068,4068,2443,56,1266,105,179,0,0,2,0,8,2,1,1,4063,5,0
광주광역시,북구,운암3동,합계,12525,10404,6237,169,3273,210,455,2,0,3,0,27,2,3,6,10387,17,2121
광주광역시,북구,운암3동,운암3동제1투,1791,1349,760,27,477,26,51,0,0,0,0,4,0,1,0,1346,3,442
광주광역시,북구,운암3동,운암3동제2투,2076,1587,972,33,468,28,77,0,0,0,0,5,0,0,1,1584,3,489
광주광역시,북구,운암3동,운암3동제3투,1791,1288,746,20,425,24,64,2,0,1,0,3,0,0,2,1287,1,503
광주광역시,북구,운암3동,운암3동제4투,2799,2112,1316,33,637,27,84,0,0,0,0,7,0,1,2,2107,5,687
광주광역시,북구,동림동,관내사전투표,3161,3161,1968,35,895,75,161,0,0,1,0,13,2,1,0,3151,10,0
광주광역시,북구,동림동,합계,14629,12007,7515,127,3524,230,518,4,0,3,1,37,2,6,5,11972,35,2622
광주광역시,북구,동림동,동림동제1투,2677,1978,1311,24,525,28,75,1,0,1,0,7,0,1,2,1975,3,699
광주광역시,북구,동림동,동림동제2투,2141,1578,950,14,496,43,66,1,0,1,1,2,0,0,1,1575,3,563
광주광역시,북구,동림동,동림동제3투,2433,1978,1283,23,539,32,85,1,0,0,0,5,0,1,1,1970,8,455
광주광역시,북구,동림동,동림동제4투,2518,2063,1234,23,673,33,83,1,0,0,0,9,0,2,0,2058,5,455
광주광역시,북구,동림동,동림동제5투,1699,1249,769,8,396,19,48,0,0,0,0,1,0,1,1,1243,6,450
광주광역시,북구,우산동,합계,10522,7821,4219,147,2985,149,272,0,1,8,0,10,0,2,3,7796,25,2701
광주광역시,북구,우산동,관내사전투표,2494,2494,1379,37,917,52,99,0,1,0,0,4,0,0,0,2489,5,0
광주광역시,북구,우산동,우산동제1투,1647,935,505,21,363,18,24,0,0,0,0,1,0,0,0,932,3,712
광주광역시,북구,우산동,우산동제2투,1914,1290,690,25,497,29,40,0,0,1,0,1,0,0,3,1286,4,624
광주광역시,북구,우산동,우산동제3투,1449,1023,560,16,377,20,42,0,0,3,0,1,0,0,0,1019,4,426
광주광역시,북구,우산동,우산동제4투,1493,949,477,14,411,11,26,0,0,2,0,2,0,0,0,943,6,544
광주광역시,북구,우산동,우산동제5투,1525,1130,608,34,420,19,41,0,0,2,0,1,0,2,0,1127,3,395
광주광역시,북구,풍향동,합계,3614,2713,1581,50,907,41,114,0,0,3,0,8,0,1,1,2706,7,901
광주광역시,북구,풍향동,관내사전투표,1031,1031,641,10,307,20,47,0,0,1,0,3,0,0,0,1029,2,0
광주광역시,북구,풍향동,풍향동제1투,1321,889,495,21,323,13,34,0,0,1,0,1,0,0,0,888,1,432
광주광역시,북구,풍향동,풍향동제2투,1262,793,445,19,277,8,33,0,0,1,0,4,0,1,1,789,4,469
광주광역시,북구,문화동,합계,10567,8249,4610,185,2975,140,281,3,0,5,1,19,1,3,6,8229,20,2318
광주광역시,북구,문화동,관내사전투표,2545,2545,1423,41,915,40,104,0,0,3,0,7,0,0,1,2534,11,0
광주광역시,북구,문화동,문화동제1투,2446,1527,793,49,608,27,37,2,0,0,0,2,0,0,4,1522,5,919
광주광역시,북구,문화동,문화동제2투,1961,1458,809,42,540,21,39,0,0,1,0,5,0,0,0,1457,1,503
광주광역시,북구,문화동,문화동제3투,2279,1798,1058,37,587,41,64,0,0,1,1,2,1,2,1,1795,3,481
광주광역시,북구,문화동,문화동제4투,1336,921,527,16,325,11,37,1,0,0,0,3,0,1,0,921,0,415
광주광역시,북구,문흥1동,합계,12862,10709,6664,138,3220,212,416,3,1,2,1,26,0,2,3,10688,21,2153
광주광역시,북구,문흥1동,관내사전투표,4100,4100,2575,56,1205,88,147,2,1,1,0,16,0,1,0,4092,8,0
광주광역시,북구,문흥1동,문흥1동제1투,1804,1327,850,14,367,23,67,1,0,0,1,1,0,0,1,1325,2,477
광주광역시,북구,문흥1동,문흥1동제2투,1662,1218,747,24,369,20,51,0,0,0,0,3,0,0,0,1214,4,444
광주광역시,북구,문흥1동,문흥1동제3투,1936,1528,909,22,506,26,60,0,0,0,0,2,0,1,0,1526,2,408
광주광역시,북구,문흥1동,문흥1동제4투,1772,1390,874,13,411,32,52,0,0,1,0,1,0,0,1,1385,5,382
광주광역시,북구,문흥1동,문흥1동제5투,1588,1146,709,9,362,23,39,0,0,0,0,3,0,0,1,1146,0,442
광주광역시,북구,문흥2동,합계,12929,10597,6535,100,3242,195,455,1,2,7,0,27,1,5,7,10577,20,2332
광주광역시,북구,문흥2동,관내사전투표,3781,3781,2363,32,1124,76,154,0,1,3,0,16,0,2,3,3774,7,0
광주광역시,북구,문흥2동,문흥2동제1투,1821,1419,896,20,422,16,58,0,0,2,0,0,0,1,0,1415,4,402
광주광역시,북구,문흥2동,문흥2동제2투,1578,1234,764,4,386,22,55,0,0,0,0,1,0,0,2,1234,0,344
광주광역시,북구,문흥2동,문흥2동제3투,2023,1567,1017,9,423,36,75,0,0,0,0,4,0,1,1,1566,1,456
광주광역시,북구,문흥2동,문흥2동제4투,1794,1228,683,21,447,17,49,0,1,2,0,0,1,1,1,1223,5,566
광주광역시,북구,문흥2동,문흥2동제5투,1932,1368,812,14,440,28,64,1,0,0,0,6,0,0,0,1365,3,564
광주광역시,북구,두암1동,합계,6801,5270,2917,78,1968,85,189,1,0,6,1,8,2,1,7,5263,7,1531
광주광역시,북구,두암1동,관내사전투표,1918,1918,1043,27,727,38,71,0,0,2,0,4,0,0,2,1914,4,0
광주광역시,북구,두암1동,두암1동제1투,1553,1112,577,16,458,19,35,1,0,1,0,1,1,1,2,1112,0,441
광주광역시,북구,두암1동,두암1동제2투,1831,1188,695,10,414,14,48,0,0,2,1,2,0,0,1,1187,1,643
광주광역시,북구,두암1동,두암1동제3투,1499,1052,602,25,369,14,35,0,0,1,0,1,1,0,2,1050,2,447
광주광역시,북구,두암2동,합계,13333,10416,5962,148,3647,185,417,1,0,10,0,14,2,3,5,10394,22,2917
광주광역시,북구,두암2동,관내사전투표,3380,3380,2002,38,1125,68,130,0,0,2,0,7,1,1,1,3375,5,0
광주광역시,북구,두암2동,두암2동제1투,1976,1266,667,24,489,26,55,0,0,1,0,1,0,1,0,1264,2,710
광주광역시,북구,두암2동,두암2동제2투,1659,1165,637,22,426,17,55,0,0,2,0,0,0,1,0,1160,5,494
광주광역시,북구,두암2동,두암2동제3투,1741,1156,647,21,410,17,50,0,0,3,0,1,1,0,2,1152,4,585
광주광역시,북구,두암2동,두암2동제4투,2134,1580,927,24,544,19,59,1,0,0,0,1,0,0,0,1575,5,554
광주광역시,북구,두암2동,두암2동제5투,2443,1869,1082,19,653,38,68,0,0,2,0,4,0,0,2,1868,1,574
광주광역시,북구,두암3동,관내사전투표,2839,2839,1581,29,1076,40,95,0,0,2,0,6,0,0,3,2832,7,0
광주광역시,북구,두암3동,합계,12048,9108,5069,139,3364,141,323,1,0,9,2,20,0,4,11,9083,25,2940
광주광역시,북구,두암3동,두암3동제1투,1205,614,332,15,239,5,18,0,0,0,0,1,0,1,0,611,3,591
광주광역시,북구,두암3동,두암3동제2투,1916,1455,822,19,498,31,71,0,0,4,0,3,0,0,2,1450,5,461
광주광역시,북구,두암3동,두암3동제3투,1852,1213,733,20,398,16,40,0,0,1,1,1,0,1,0,1211,2,639
광주광역시,북구,두암3동,두암3동제4투,2087,1391,739,21,565,21,29,0,0,2,1,1,0,2,3,1384,7,696
광주광역시,북구,두암3동,두암3동제5투,2149,1596,862,35,588,28,70,1,0,0,0,8,0,0,3,1595,1,553
광주광역시,북구,삼각동,합계,10158,8234,5054,97,2452,196,389,0,0,5,1,20,0,1,3,8218,16,1924
광주광역시,북구,삼각동,관내사전투표,2689,2689,1703,29,730,78,133,0,0,3,1,7,0,0,0,2684,5,0
광주광역시,북구,삼각동,삼각동제1투,3094,2081,1254,36,637,47,100,0,0,0,0,3,0,1,2,2080,1,1013
광주광역시,북구,삼각동,삼각동제2투,2194,1815,1099,17,568,35,82,0,0,1,0,6,0,0,1,1809,6,379
광주광역시,북구,삼각동,삼각동제3투,2181,1649,998,15,517,36,74,0,0,1,0,4,0,0,0,1645,4,532
광주광역시,북구,일곡동,합계,21342,17960,11670,239,4607,406,938,3,2,7,0,41,1,5,12,17931,29,3382
광주광역시,북구,일곡동,관내사전투표,6173,6173,4046,62,1517,160,356,2,0,3,0,11,0,2,3,6162,11,0
광주광역시,북구,일곡동,일곡동제1투,3107,2335,1566,27,571,45,112,1,2,0,0,6,0,0,3,2333,2,772
광주광역시,북구,일곡동,일곡동제2투,2593,1813,1141,24,510,37,85,0,0,0,0,7,1,2,1,1808,5,780
광주광역시,북구,일곡동,일곡동제3투,1749,1410,942,13,349,26,73,0,0,0,0,5,0,0,1,1409,1,339
광주광역시,북구,일곡동,일곡동제4투,2398,1921,1267,38,479,41,90,0,0,2,0,0,0,1,2,1920,1,477
광주광역시,북구,일곡동,일곡동제5투,2656,2228,1448,32,580,49,107,0,0,1,0,7,0,0,0,2224,4,428
광주광역시,북구,일곡동,일곡동제6투,2666,2080,1260,43,601,48,115,0,0,1,0,5,0,0,2,2075,5,586
광주광역시,북구,매곡동,합계,10921,9257,5777,130,2755,170,376,0,0,1,0,22,0,2,5,9238,19,1664
광주광역시,북구,매곡동,관내사전투표,3700,3700,2373,57,1034,63,154,0,0,0,0,12,0,0,1,3694,6,0
광주광역시,북구,매곡동,매곡동제1투,1990,1540,915,19,494,30,74,0,0,0,0,0,0,0,3,1535,5,450
광주광역시,북구,매곡동,매곡동제2투,2754,2058,1241,33,654,44,73,0,0,0,0,7,0,1,0,2053,5,696
광주광역시,북구,매곡동,매곡동제3투,2477,1959,1248,21,573,33,75,0,0,1,0,3,0,1,1,1956,3,518
광주광역시,북구,오치1동,합계,9120,6925,4078,105,2264,134,306,0,0,4,0,10,1,0,0,6902,23,2195
광주광역시,북구,오치1동,관내사전투표,2105,2105,1293,32,634,31,104,0,0,2,0,2,0,0,0,2098,7,0
광주광역시,북구,오치1동,오치1동제1투,2406,1563,916,22,525,34,56,0,0,1,0,4,0,0,0,1558,5,843
광주광역시,북구,오치1동,오치1동제2투,2118,1517,896,19,499,33,64,0,0,0,0,3,0,0,0,1514,3,601
광주광역시,북구,오치1동,오치1동제3투,2491,1740,973,32,606,36,82,0,0,1,0,1,1,0,0,1732,8,751
광주광역시,북구,오치2동,합계,11712,9108,5311,131,3030,166,397,3,0,5,0,26,1,4,9,9083,25,2604
광주광역시,북구,오치2동,관내사전투표,3728,3728,2232,56,1171,67,163,2,0,3,0,14,0,2,4,3714,14,0
광주광역시,북구,오치2동,오치2동제1투,1877,1301,790,21,402,25,53,1,0,0,0,2,0,0,1,1295,6,576
광주광역시,북구,오치2동,오치2동제2투,1836,1086,586,18,418,13,44,0,0,2,0,2,1,0,1,1085,1,750
광주광역시,북구,오치2동,오치2동제3투,2009,1350,772,17,459,24,71,0,0,0,0,2,0,1,2,1348,2,659
광주광역시,북구,오치2동,오치2동제4투,2262,1643,931,19,580,37,66,0,0,0,0,6,0,1,1,1641,2,619
광주광역시,북구,석곡동,합계,2187,1665,934,24,608,17,61,2,0,2,0,3,0,2,2,1655,10,522
광주광역시,북구,석곡동,관내사전투표,553,553,320,5,190,9,23,0,0,0,0,2,0,0,0,549,4,0
광주광역시,북구,석곡동,석곡동제1투,1203,797,455,11,292,3,30,1,0,1,0,1,0,2,1,797,0,406
광주광역시,북구,석곡동,석곡동제2투,431,315,159,8,126,5,8,1,0,1,0,0,0,0,1,309,6,116
광주광역시,북구,건국동,합계,27130,21664,14225,305,5590,450,988,3,1,6,1,35,2,2,9,21617,47,5466
광주광역시,북구,건국동,관내사전투표,4101,4101,2708,52,1010,88,205,1,0,3,1,10,0,0,2,4080,21,0
광주광역시,북구,건국동,건국동제1투,3169,2376,1547,25,629,48,112,0,1,1,0,6,0,0,3,2372,4,793
광주광역시,북구,건국동,건국동제2투,2194,1732,1121,15,481,43,70,0,0,0,0,0,0,0,1,1731,1,462
광주광역시,북구,건국동,건국동제3투,2538,1951,1267,44,503,40,88,0,0,1,0,5,0,0,0,1948,3,587
광주광역시,북구,건국동,건국동제4투,2604,1897,1187,37,553,33,76,0,0,0,0,4,0,0,1,1891,6,707
광주광역시,북구,건국동,건국동제5투,3307,2409,1560,40,629,60,111,1,0,0,0,2,0,0,1,2404,5,898
광주광역시,북구,건국동,건국동제6투,1756,1133,677,23,372,27,25,0,0,1,0,0,1,2,1,1129,4,623
광주광역시,북구,건국동,건국동제7투,3793,2986,2012,34,739,58,135,1,0,0,0,5,0,0,0,2984,2,807
광주광역시,북구,건국동,건국동제8투,3668,3079,2146,35,674,53,166,0,0,0,0,3,1,0,0,3078,1,589
광주광역시,북구,양산동,합계,25646,20611,13096,263,5731,396,994,3,2,10,1,49,5,6,10,20566,45,5035
광주광역시,북구,양산동,관내사전투표,7380,7380,4866,79,1803,156,411,1,2,3,0,23,3,3,5,7355,25,0
광주광역시,북구,양산동,양산동제1투,4100,2724,1740,37,737,57,136,0,0,1,1,6,1,1,1,2718,6,1376
광주광역시,북구,양산동,양산동제2투,2987,2211,1397,30,625,52,98,1,0,0,0,4,0,1,1,2209,2,776
광주광역시,북구,양산동,양산동제3투,2731,2067,1270,22,647,31,83,0,0,1,0,9,1,0,0,2064,3,664
광주광역시,북구,양산동,양산동제4투,3437,2599,1602,45,781,48,116,1,0,0,0,4,0,0,2,2599,0,838
광주광역시,북구,양산동,양산동제5투,2594,1858,1117,29,605,31,65,0,0,0,0,2,0,0,1,1850,8,736
광주광역시,북구,양산동,양산동제6투,2417,1772,1104,21,533,21,85,0,0,5,0,1,0,1,0,1771,1,645
광주광역시,북구,잘못 투입·구분된 투표지,,0,0,0,0,0,0,0,0,0,0,0,0,0,0,0,0,0,0
광주광역시,광산구,합계,,302584,248209,159119,3630,65402,5504,12588,33,46,113,26,782,51,57,190,247541,668,54375
광주광역시,광산구,거소·선상투표,,684,646,340,13,213,20,21,1,3,1,1,2,1,1,5,622,24,38
광주광역시,광산구,관외사전투표,,30269,30266,19305,576,7055,1057,1952,8,12,12,3,76,7,10,38,30111,155,3
광주광역시,광산구,재외투표,,1003,804,601,13,91,19,79,1,0,0,0,0,0,0,0,804,0,199
광주광역시,광산구,송정1동,합계,8433,6622,3964,121,2104,125,258,1,0,5,0,16,0,2,7,6603,19,1811
광주광역시,광산구,송정1동,관내사전투표,2113,2113,1254,39,679,47,79,0,0,2,0,4,0,1,1,2106,7,0
광주광역시,광산구,송정1동,송정1동제1투,2260,1509,862,26,520,25,68,0,0,1,0,1,0,1,2,1506,3,751
광주광역시,광산구,송정1동,송정1동제2투,1794,1198,703,26,401,19,38,0,0,2,0,2,0,0,1,1192,6,596
광주광역시,광산구,송정1동,송정1동제3투,2266,1802,1145,30,504,34,73,1,0,0,0,9,0,0,3,1799,3,464
광주광역시,광산구,송정2동,합계,6121,4892,2749,99,1657,100,238,0,1,2,1,15,0,1,8,4871,21,1229
광주광역시,광산구,송정2동,관내사전투표,2152,2152,1256,31,649,51,131,0,1,2,1,11,0,1,5,2139,13,0
광주광역시,광산구,송정2동,송정2동제1투,1388,828,423,20,330,16,33,0,0,0,0,2,0,0,0,824,4,560
광주광역시,광산구,송정2동,송정2동제2투,1411,999,556,30,360,15,34,0,0,0,0,1,0,0,2,998,1,412
광주광역시,광산구,송정2동,송정2동제3투,1170,913,514,18,318,18,40,0,0,0,0,1,0,0,1,910,3,257
광주광역시,광산구,도산동,합계,10827,8431,5215,137,2436,177,387,1,0,2,0,32,2,3,7,8399,32,2396
광주광역시,광산구,도산동,관내사전투표,3280,3280,2038,61,938,62,142,1,0,1,0,17,2,1,4,3267,13,0
광주광역시,광산구,도산동,도산동제1투,2180,1439,862,16,450,33,69,0,0,0,0,3,0,0,0,1433,6,741
광주광역시,광산구,도산동,도산동제2투,2592,1712,1038,24,506,46,80,0,0,1,0,8,0,2,1,1706,6,880
광주광역시,광산구,도산동,도산동제3투,2775,2000,1277,36,542,36,96,0,0,0,0,4,0,0,2,1993,7,775
광주광역시,광산구,신흥동,합계,3633,2715,1570,63,909,51,108,0,0,0,0,2,2,1,3,2709,6,918
광주광역시,광산구,신흥동,관내사전투표,895,895,511,14,307,23,36,0,0,0,0,1,0,1,2,895,0,0
광주광역시,광산구,신흥동,신흥동제1투,1233,777,433,15,282,12,28,0,0,0,0,1,2,0,0,773,4,456
광주광역시,광산구,신흥동,신흥동제2투,1505,1043,626,34,320,16,44,0,0,0,0,0,0,0,1,1041,2,462
광주광역시,광산구,어룡동,합계,19387,15099,9473,208,4277,263,770,2,2,9,1,47,2,2,10,15066,33,4288
광주광역시,광산구,어룡동,관내사전투표,3752,3752,2455,40,940,61,233,1,1,2,0,11,1,0,0,3745,7,0
광주광역시,광산구,어룡동,어룡동제1투,1493,973,533,18,366,11,37,0,0,2,0,5,0,0,0,972,1,520
광주광역시,광산구,어룡동,어룡동제2투,2177,1550,942,28,463,27,81,1,0,1,1,2,0,0,1,1547,3,627
광주광역시,광산구,어룡동,어룡동제3투,1823,1300,813,21,388,22,47,0,0,0,0,5,0,0,2,1298,2,523
광주광역시,광산구,어룡동,어룡동제4투,2340,1429,840,23,471,20,57,0,1,1,0,7,0,1,2,1423,6,911
광주광역시,광산구,어룡동,어룡동제5투,2043,1549,998,14,408,28,88,0,0,0,0,6,0,0,3,1545,4,494
광주광역시,광산구,어룡동,어룡동제6투,2596,2047,1282,29,583,47,92,0,0,3,0,3,1,1,1,2042,5,549
광주광역시,광산구,어룡동,어룡동제7투,3163,2499,1610,35,658,47,135,0,0,0,0,8,0,0,1,2494,5,664
광주광역시,광산구,우산동,합계,18084,13411,8082,235,4097,248,632,3,1,11,5,39,5,4,13,13375,36,4673
광주광역시,광산구,우산동,관내사전투표,4110,4110,2636,55,1093,86,207,1,0,2,2,15,0,1,4,4102,8,0
광주광역시,광산구,우산동,우산동제1투,2860,1913,1093,33,644,34,94,1,1,2,1,2,2,0,0,1907,6,947
광주광역시,광산구,우산동,우산동제2투,756,437,242,11,151,9,21,0,0,0,0,0,0,0,1,435,2,319
광주광역시,광산구,우산동,우산동제3투,2057,1310,708,38,496,11,38,0,0,2,0,4,0,1,4,1302,8,747
광주광역시,광산구,우산동,우산동제4투,1524,1003,617,18,289,18,50,0,0,0,0,7,0,0,1,1000,3,521
광주광역시,광산구,우산동,우산동제5투,3716,2737,1727,39,767,55,133,0,0,2,1,5,1,1,2,2733,4,979
광주광역시,광산구,우산동,우산동제6투,1363,856,519,15,248,15,52,0,0,2,0,3,1,0,0,855,1,507
광주광역시,광산구,우산동,우산동제7투,1698,1045,540,26,409,20,37,1,0,1,1,3,1,1,1,1041,4,653
광주광역시,광산구,월곡1동,합계,11011,8713,5328,130,2588,172,422,1,2,5,0,37,2,0,7,8694,19,2298
광주광역시,광산구,월곡1동,관내사전투표,3403,3403,2186,52,904,76,153,1,0,3,0,20,0,0,2,3397,6,0
광주광역시,광산구,월곡1동,월곡1동제1투,1730,1052,590,18,387,15,35,0,0,0,0,2,0,0,2,1049,3,678
광주광역시,광산구,월곡1동,월곡1동제2투,1231,802,457,24,258,10,49,0,0,0,0,2,0,0,0,800,2,429
광주광역시,광산구,월곡1동,월곡1동제3투,2478,1977,1191,15,583,52,117,0,2,0,0,11,1,0,1,1973,4,501
광주광역시,광산구,월곡1동,월곡1동제4투,2169,1479,904,21,456,19,68,0,0,2,0,2,1,0,2,1475,4,690
광주광역시,광산구,월곡2동,합계,12302,9567,5960,117,2737,177,484,0,2,3,3,46,4,3,9,9545,22,2735
광주광역시,광산구,월곡2동,관내사전투표,2551,2551,1625,35,696,48,123,0,0,1,1,10,1,1,3,2544,7,0
광주광역시,광산구,월곡2동,월곡2동제1투,1950,1123,619,21,393,32,45,0,0,1,2,2,0,0,1,1116,7,827
광주광역시,광산구,월곡2동,월곡2동제2투,1663,1061,586,17,377,18,52,0,2,1,0,0,1,1,3,1058,3,602
광주광역시,광산구,월곡2동,월곡2동제3투,2254,1654,1033,15,493,26,71,0,0,0,0,10,1,1,1,1651,3,600
광주광역시,광산구,월곡2동,월곡2동제4투,2019,1670,1087,17,416,20,115,0,0,0,0,12,1,0,0,1668,2,349
광주광역시,광산구,월곡2동,월곡2동제5투,1865,1508,1010,12,362,33,78,0,0,0,0,12,0,0,1,1508,0,357
광주광역시,광산구,비아동,합계,5212,3990,2477,60,1177,76,176,0,1,3,1,6,2,0,2,3981,9,1222
광주광역시,광산구,비아동,관내사전투표,1596,1596,997,27,474,34,54,0,1,1,0,4,0,0,0,1592,4,0
광주광역시,광산구,비아동,비아동제1투,1305,855,528,14,243,19,45,0,0,2,0,1,1,0,1,854,1,450
광주광역시,광산구,비아동,비아동제2투,2311,1539,952,19,460,23,77,0,0,0,1,1,1,0,1,1535,4,772
광주광역시,광산구,첨단1동,합계,16983,14524,9316,207,3755,381,780,0,0,7,0,32,0,1,6,14485,39,2459
광주광역시,광산구,첨단1동,관내사전투표,5454,5454,3643,61,1231,160,329,0,0,2,0,14,0,1,2,5443,11,0
광주광역시,광산구,첨단1동,첨단1동제1투,3037,2250,1407,37,619,61,115,0,0,1,0,7,0,0,0,2247,3,787
광주광역시,광산구,첨단1동,첨단1동제2투,2784,2259,1419,53,611,61,105,0,0,1,0,3,0,0,0,2253,6,525
광주광역시,광산구,첨단1동,첨단1동제3투,3244,2610,1619,35,747,65,124,0,0,2,0,6,0,0,3,2601,9,634
광주광역시,광산구,첨단1동,첨단1동제4투,2464,1951,1228,21,547,34,107,0,0,1,0,2,0,0,1,1941,10,513
광주광역시,광산구,첨단2동,관내사전투표,5538,5538,3695,62,1280,137,318,2,1,2,1,27,0,0,4,5529,9,0
광주광역시,광산구,첨단2동,합계,26863,21589,14107,286,5338,488,1212,5,5,8,2,83,4,2,10,21550,39,5274
광주광역시,광산구,첨단2동,첨단2동제1투,1558,1043,629,17,309,22,59,0,0,0,0,5,0,0,0,1041,2,515
광주광역시,광산구,첨단2동,첨단2동제2투,3103,2039,1294,36,509,52,136,0,0,0,0,6,0,0,2,2035,4,1064
광주광역시,광산구,첨단2동,첨단2동제3투,2316,1679,1025,18,461,41,115,3,2,0,0,8,1,0,1,1675,4,637
광주광역시,광산구,첨단2동,첨단2동제4투,2135,1587,1043,28,374,38,90,0,0,1,0,9,0,0,0,1583,4,548
광주광역시,광산구,첨단2동,첨단2동제5투,2853,2390,1560,36,603,61,114,0,0,0,0,7,0,2,1,2384,6,463
광주광역시,광산구,첨단2동,첨단2동제6투,2087,1744,1185,23,410,29,81,0,1,1,1,8,1,0,0,1740,4,343
광주광역시,광산구,첨단2동,첨단2동제7투,2759,2250,1534,23,529,42,113,0,0,1,0,7,0,0,1,2250,0,509
광주광역시,광산구,첨단2동,첨단2동제8투,2120,1334,813,19,396,28,71,0,0,2,0,1,1,0,1,1332,2,786
광주광역시,광산구,첨단2동,첨단2동제9투,2394,1985,1329,24,467,38,115,0,1,1,0,5,1,0,0,1981,4,409
광주광역시,광산구,신가동,합계,15534,12251,8025,205,3115,222,600,1,1,4,1,44,2,0,3,12223,28,3283
광주광역시,광산구,신가동,관내사전투표,3333,3333,2202,75,803,65,164,1,1,0,0,12,0,0,1,3324,9,0
광주광역시,광산구,신가동,신가동제1투,1893,1110,613,20,388,24,52,0,0,0,0,3,2,0,2,1104,6,783
광주광역시,광산구,신가동,신가동제2투,2578,2065,1397,30,493,28,100,0,0,2,0,11,0,0,0,2061,4,513
광주광역시,광산구,신가동,신가동제3투,979,654,395,10,207,12,23,0,0,1,0,4,0,0,0,652,2,325
광주광역시,광산구,신가동,신가동제4투,2916,2119,1383,34,561,36,93,0,0,1,0,6,0,0,0,2114,5,797
광주광역시,광산구,신가동,신가동제5투,3835,2970,2035,36,663,57,168,0,0,0,1,8,0,0,0,2968,2,865
광주광역시,광산구,운남동,관내사전투표,5190,5190,3527,37,1217,103,273,0,0,1,0,24,0,1,1,5184,6,0
광주광역시,광산구,운남동,합계,22231,18425,12079,199,4695,358,961,0,3,5,0,71,3,4,18,18396,29,3806
광주광역시,광산구,운남동,운남동제1투,2389,1781,1156,10,481,40,80,0,0,0,0,12,0,0,1,1780,1,608
광주광역시,광산구,운남동,운남동제2투,1513,1214,811,28,282,21,66,0,0,0,0,2,0,1,1,1212,2,299
광주광역시,광산구,운남동,운남동제3투,1852,1285,827,19,345,27,59,0,0,0,0,1,0,0,2,1280,5,567
광주광역시,광산구,운남동,운남동제4투,1288,1001,614,18,295,21,49,0,1,0,0,0,0,0,3,1001,0,287
광주광역시,광산구,운남동,운남동제5투,2192,1661,1082,23,428,27,88,0,0,1,0,6,0,0,1,1656,5,531
광주광역시,광산구,운남동,운남동제6투,1899,1556,922,28,474,38,85,0,0,0,0,2,2,0,4,1555,1,343
광주광역시,광산구,운남동,운남동제7투,2000,1668,1099,15,421,30,95,0,1,0,0,3,1,0,1,1666,2,332
광주광역시,광산구,운남동,운남동제8투,2090,1606,1061,13,400,21,85,0,0,3,0,14,0,2,4,1603,3,484
광주광역시,광산구,운남동,운남동제9투,1818,1463,980,8,352,30,81,0,1,0,0,7,0,0,0,1459,4,355
광주광역시,광산구,신창동,합계,22899,18679,12571,222,4366,388,1012,1,2,10,1,59,3,5,6,18646,33,4220
광주광역시,광산구,신창동,관내사전투표,6395,6395,4493,61,1304,150,349,1,2,5,1,17,0,1,2,6386,9,0
광주광역시,광산구,신창동,신창동제1투,850,557,307,8,211,7,20,0,0,0,0,1,0,2,0,556,1,293
광주광역시,광산구,신창동,신창동제2투,2993,2303,1484,27,591,33,144,0,0,0,0,19,0,0,1,2299,4,690
광주광역시,광산구,신창동,신창동제3투,1471,1107,766,24,224,28,59,0,0,1,0,3,0,1,0,1106,1,364
광주광역시,광산구,신창동,신창동제4투,3184,2226,1493,34,496,50,137,0,0,0,0,7,1,0,1,2219,7,958
광주광역시,광산구,신창동,신창동제5투,2901,2005,1304,24,514,52,103,0,0,2,0,3,0,0,1,2003,2,896
광주광역시,광산구,신창동,신창동제6투,2313,1961,1324,19,472,34,100,0,0,0,0,6,1,0,0,1956,5,352
광주광역시,광산구,신창동,신창동제7투,2792,2125,1400,25,554,34,100,0,0,2,0,3,1,1,1,2121,4,667
광주광역시,광산구,수완동,관내사전투표,9129,9129,6559,85,1850,205,405,3,1,1,0,12,0,0,0,9121,8,0
광주광역시,광산구,수완동,합계,46588,38344,26131,470,8995,855,1749,5,3,13,3,61,0,7,12,38304,40,8244
광주광역시,광산구,수완동,수완동제1투,2850,2457,1665,31,589,52,112,0,0,1,0,5,0,0,0,2455,2,393
광주광역시,광산구,수완동,수완동제2투,3067,2476,1634,29,622,55,122,0,0,1,0,8,0,1,1,2473,3,591
광주광역시,광산구,수완동,수완동제3투,2147,1599,1064,23,396,36,75,0,0,1,1,0,0,0,0,1596,3,548
광주광역시,광산구,수완동,수완동제4투,4310,3250,2194,38,790,63,152,0,0,1,0,4,0,0,4,3246,4,1060
광주광역시,광산구,수완동,수완동제5투,2621,2161,1430,34,565,46,82,0,0,0,0,2,0,1,0,2160,1,460
광주광역시,광산구,수완동,수완동제6투,3476,2767,1872,34,650,61,141,0,0,2,0,4,0,1,0,2765,2,709
광주광역시,광산구,수완동,수완동제7투,3789,2656,1766,27,688,48,115,0,1,0,0,5,0,1,1,2652,4,1133
광주광역시,광산구,수완동,수완동제8투,3234,2703,1868,23,610,69,123,0,1,1,1,4,0,0,0,2700,3,531
광주광역시,광산구,수완동,수완동제9투,2951,2161,1418,26,551,51,105,0,0,1,0,5,0,3,0,2160,1,790
광주광역시,광산구,수완동,수완동제10투,1991,1573,1035,35,373,45,79,0,0,0,1,1,0,0,1,1570,3,418
광주광역시,광산구,수완동,수완동제11투,2744,2136,1423,25,533,48,94,0,0,3,0,7,0,0,1,2134,2,608
광주광역시,광산구,수완동,수완동제12투,2123,1600,1094,25,350,38,86,1,0,1,0,2,0,0,1,1598,2,523
광주광역시,광산구,수완동,수완동제13투,2156,1676,1109,35,428,38,58,1,0,0,0,2,0,0,3,1674,2,480
광주광역시,광산구,하남동,합계,13564,11193,7463,109,2786,237,508,1,4,5,0,52,0,4,5,11174,19,2371
광주광역시,광산구,하남동,관내사전투표,3924,3924,2724,37,877,92,163,0,2,1,0,21,0,1,0,3918,6,0
광주광역시,광산구,하남동,하남동제1투,2418,1651,1035,20,466,31,84,0,0,0,0,6,0,0,2,1644,7,767
광주광역시,광산구,하남동,하남동제2투,334,235,104,2,110,5,10,1,1,1,0,1,0,0,0,235,0,99
광주광역시,광산구,하남동,하남동제3투,3699,2850,1935,29,682,50,129,0,0,3,0,16,0,3,2,2849,1,849
광주광역시,광산구,하남동,하남동제4투,3189,2533,1665,21,651,59,122,0,1,0,0,8,0,0,1,2528,5,656
광주광역시,광산구,임곡동,합계,1912,1455,821,35,513,16,51,1,0,0,0,8,0,1,4,1450,5,457
광주광역시,광산구,임곡동,관내사전투표,638,638,348,19,232,7,24,1,0,0,0,4,0,1,1,637,1,0
광주광역시,광산구,임곡동,임곡동제1투,657,413,231,5,149,5,16,0,0,0,0,3,0,0,1,410,3,244
광주광역시,광산구,임곡동,임곡동제2투,617,404,242,11,132,4,11,0,0,0,0,1,0,0,2,403,1,213
광주광역시,광산구,동곡동,관내사전투표,374,374,224,9,121,0,11,0,0,0,0,7,0,0,1,373,1,0
광주광역시,광산구,동곡동,합계,1701,1273,697,20,481,9,44,0,0,1,0,9,1,0,5,1267,6,428
광주광역시,광산구,동곡동,동곡동투표소,1327,899,473,11,360,9,33,0,0,1,0,2,1,0,4,894,5,428
광주광역시,광산구,평동,합계,3592,2598,1498,37,913,30,70,0,2,2,1,24,0,3,2,2582,16,994
광주광역시,광산구,평동,관내사전투표,1010,1010,634,11,308,11,31,0,1,0,0,8,0,1,1,1006,4,0
광주광역시,광산구,평동,평동제1투,1405,784,425,13,292,15,23,0,1,2,0,7,0,1,0,779,5,621
광주광역시,광산구,평동,평동제2투,1177,804,439,13,313,4,16,0,0,0,1,9,0,1,1,797,7,373
광주광역시,광산구,삼도동,합계,2007,1465,778,31,560,14,39,0,1,2,2,10,3,3,6,1449,16,542
광주광역시,광산구,삼도동,관내사전투표,452,452,226,14,164,4,22,0,1,1,1,5,0,2,3,443,9,0
광주광역시,광산구,삼도동,삼도동제1투,948,588,329,6,222,9,11,0,0,0,1,3,0,1,2,584,4,360
광주광역시,광산구,삼도동,삼도동제2투,607,425,223,11,174,1,6,0,0,1,0,2,3,0,1,422,3,182
광주광역시,광산구,본량동,관내사전투표,357,357,152,15,133,11,16,0,0,3,0,5,3,0,2,340,17,0
광주광역시,광산구,본량동,합계,1744,1257,569,37,544,21,35,1,1,3,1,11,8,0,4,1235,22,487
광주광역시,광산구,본량동,본량동제1투,955,669,307,19,306,6,15,1,1,0,0,6,2,0,1,664,5,286
광주광역시,광산구,본량동,본량동제2투,432,231,110,3,105,4,4,0,0,0,1,0,3,0,1,231,0,201
광주광역시,광산구,잘못 투입·구분된 투표지,,0,0,0,0,0,0,0,0,0,0,0,0,0,0,0,0,0,0
대전광역시,합계,,,1220602,945897,404545,191376,218769,59820,63669,1069,168,620,234,611,256,406,758,942301,3596,274705
대전광역시,동구,합계,,194189,143823,57580,33015,34729,7746,9376,162,42,126,44,91,43,75,155,143184,639,50366
대전광역시,동구,거소·선상투표,,444,423,162,58,136,27,6,4,1,1,3,0,2,2,2,404,19,21
대전광역시,동구,관외사전투표,,16304,16299,7630,2374,3458,1231,1406,16,4,5,3,10,4,9,31,16181,118,5
대전광역시,동구,재외투표,,781,619,396,46,77,20,75,2,0,1,0,0,0,1,0,618,1,162
대전광역시,동구,중앙동,합계,5367,3289,1012,1218,777,108,140,1,1,5,2,2,1,2,3,3272,17,2078
대전광역시,동구,중앙동,관내사전투표,922,922,367,271,194,36,44,0,1,1,2,2,0,0,1,919,3,0
대전광역시,동구,중앙동,중앙동제1투,1787,965,259,400,240,30,28,0,0,0,0,0,1,1,2,961,4,822
대전광역시,동구,중앙동,중앙동제2투,865,522,143,207,131,13,25,1,0,1,0,0,0,0,0,521,1,343
대전광역시,동구,중앙동,중앙동제3투,1793,880,243,340,212,29,43,0,0,3,0,0,0,1,0,871,9,913
대전광역시,동구,신인동,합계,10894,8419,3349,2074,2010,418,489,9,4,11,3,5,0,4,10,8386,33,2475
대전광역시,동구,신인동,관내사전투표,3023,3023,1459,591,630,148,172,1,2,0,1,1,0,2,5,3012,11,0
대전광역시,동구,신인동,신인동제1투,2291,1485,510,439,352,77,90,2,0,2,1,1,0,1,1,1476,9,806
대전광역시,동구,신인동,신인동제2투,2376,1669,596,439,435,93,94,4,0,4,0,2,0,0,0,1667,2,707
대전광역시,동구,신인동,신인동제3투,2062,1500,572,359,395,66,91,1,2,5,0,1,0,1,1,1494,6,562
대전광역시,동구,신인동,신인동제4투,1142,742,212,246,198,34,42,1,0,0,1,0,0,0,3,737,5,400
대전광역시,동구,효동,합계,18679,13954,6215,2716,3324,695,891,24,1,13,3,4,5,5,14,13910,44,4725
대전광역시,동구,효동,관내사전투표,3097,3097,1711,401,587,159,217,6,0,2,0,2,3,1,2,3091,6,0
대전광역시,동구,효동,효동제1투,2597,1792,580,535,478,92,99,1,0,1,0,0,0,1,2,1789,3,805
대전광역시,동구,효동,효동제2투,3219,2261,880,520,576,88,172,7,0,2,2,0,1,1,1,2250,11,958
대전광역시,동구,효동,효동제3투,3399,2156,902,429,558,118,124,4,1,4,1,0,0,1,4,2146,10,1243
대전광역시,동구,효동,효동제4투,3522,2556,1196,423,630,132,158,3,0,3,0,1,1,1,4,2552,4,966
대전광역시,동구,효동,효동제5투,2845,2092,946,408,495,106,121,3,0,1,0,1,0,0,1,2082,10,753
대전광역시,동구,판암1동,합계,7595,5627,2094,1383,1419,318,365,5,1,3,2,2,2,9,6,5609,18,1968
대전광역시,동구,판암1동,관내사전투표,1664,1664,685,348,381,99,137,2,0,0,0,0,1,1,4,1658,6,0
대전광역시,동구,판암1동,판암1동제1투,2236,1507,527,437,394,65,61,2,1,2,2,1,1,5,1,1499,8,729
대전광역시,동구,판암1동,판암1동제2투,1796,1180,469,251,294,80,80,0,0,1,0,0,0,2,0,1177,3,616
대전광역시,동구,판암1동,판암1동제3투,1899,1276,413,347,350,74,87,1,0,0,0,1,0,1,1,1275,1,623
대전광역시,동구,판암2동,합계,8793,6140,2125,1711,1633,252,335,15,5,8,2,4,1,5,6,6102,38,2653
대전광역시,동구,판암2동,관내사전투표,1894,1894,736,519,452,61,101,3,2,0,2,1,1,1,1,1880,14,0
대전광역시,동구,판암2동,판암2동제1투,1817,1092,340,355,270,38,71,7,0,3,0,1,0,2,2,1089,3,725
대전광역시,동구,판암2동,판암2동제2투,2324,1386,394,395,460,63,50,2,3,2,0,1,0,1,2,1373,13,938
대전광역시,동구,판암2동,판암2동제3투,2758,1768,655,442,451,90,113,3,0,3,0,1,0,1,1,1760,8,990
대전광역시,동구,용운동,합계,13514,9746,3930,2247,2310,524,655,12,4,10,1,5,2,4,9,9713,33,3768
대전광역시,동구,용운동,관내사전투표,2544,2544,1141,534,534,140,177,3,1,6,0,2,0,0,2,2540,4,0
대전광역시,동구,용운동,용운동제1투,1939,1182,416,318,287,64,87,0,0,2,0,0,0,1,0,1175,7,757
대전광역시,동구,용운동,용운동제2투,2707,1610,544,453,425,68,99,6,2,2,0,2,0,1,0,1602,8,1097
대전광역시,동구,용운동,용운동제3투,3304,2299,931,533,543,133,143,2,1,0,1,0,0,2,3,2292,7,1005
대전광역시,동구,용운동,용운동제4투,3020,2111,898,409,521,119,149,1,0,0,0,1,2,0,4,2104,7,909
대전광역시,동구,대동,합계,9374,6580,2598,1603,1617,352,361,11,1,3,1,3,2,4,5,6561,19,2794
대전광역시,동구,대동,관내사전투표,1644,1644,694,354,382,89,111,5,0,2,1,0,0,1,1,1640,4,0
대전광역시,동구,대동,대동제1투,2879,1866,790,411,444,110,98,2,1,0,0,1,0,1,1,1859,7,1013
대전광역시,동구,대동,대동제2투,2141,1242,404,374,331,57,67,3,0,0,0,0,0,1,1,1238,4,899
대전광역시,동구,대동,대동제3투,2710,1828,710,464,460,96,85,1,0,1,0,2,2,1,2,1824,4,882
대전광역시,동구,자양동,합계,9497,6690,2545,1561,1514,448,542,8,2,4,2,13,3,1,7,6650,40,2807
대전광역시,동구,자양동,관내사전투표,2366,2366,1052,410,475,180,223,2,0,0,0,4,0,0,3,2349,17,0
대전광역시,동구,자양동,자양동제1투,2244,1339,476,306,339,85,113,3,2,2,2,3,1,1,0,1333,6,905
대전광역시,동구,자양동,자양동제2투,2363,1368,467,339,310,107,130,0,0,1,0,2,2,0,3,1361,7,995
대전광역시,동구,자양동,자양동제3투,2524,1617,550,506,390,76,76,3,0,1,0,4,0,0,1,1607,10,907
대전광역시,동구,가양1동,합계,11549,8122,2904,2192,2053,413,492,3,1,7,1,3,5,3,4,8081,41,3427
대전광역시,동구,가양1동,관내사전투표,1983,1983,870,467,429,79,118,0,0,3,0,0,2,1,2,1971,12,0
대전광역시,동구,가양1동,가양1동제1투,2088,1262,389,395,341,64,64,1,0,0,0,0,0,0,1,1255,7,826
대전광역시,동구,가양1동,가양1동제2투,1580,998,306,320,259,51,57,0,0,1,0,1,0,0,0,995,3,582
대전광역시,동구,가양1동,가양1동제3투,3401,2281,833,541,616,130,143,2,1,0,0,2,1,1,1,2271,10,1120
대전광역시,동구,가양1동,가양1동제4투,2497,1598,506,469,408,89,110,0,0,3,1,0,2,1,0,1589,9,899
대전광역시,동구,가양2동,합계,15813,11046,4196,2704,2716,573,752,7,3,10,4,5,1,5,15,10991,55,4767
대전광역시,동구,가양2동,관내사전투표,2711,2711,1192,560,601,136,196,1,0,3,1,1,0,0,3,2694,17,0
대전광역시,동구,가양2동,가양2동제1투,3045,2126,805,511,574,108,109,2,0,3,0,1,0,0,4,2117,9,919
대전광역시,동구,가양2동,가양2동제2투,2563,1629,596,421,398,102,102,0,0,2,0,0,0,4,0,1625,4,934
대전광역시,동구,가양2동,가양2동제3투,2584,1530,506,392,419,80,117,0,0,0,1,0,0,0,5,1520,10,1054
대전광역시,동구,가양2동,가양2동제4투,2775,1760,625,466,443,80,125,4,3,2,2,1,1,1,0,1753,7,1015
대전광역시,동구,가양2동,가양2동제5투,2135,1290,472,354,281,67,103,0,0,0,0,2,0,0,3,1282,8,845
대전광역시,동구,용전동,합계,16127,11119,4504,2388,2729,600,806,7,2,8,3,13,4,4,10,11078,41,5008
대전광역시,동구,용전동,관내사전투표,2761,2761,1307,453,616,142,215,2,0,3,0,7,0,2,3,2750,11,0
대전광역시,동구,용전동,용전동제1투,3179,2088,818,482,512,107,154,0,1,0,1,5,0,0,2,2082,6,1091
대전광역시,동구,용전동,용전동제2투,3201,1997,721,461,548,106,147,1,0,2,2,0,1,0,1,1990,7,1204
대전광역시,동구,용전동,용전동제3투,3769,2166,802,523,554,128,140,1,1,2,0,0,2,0,3,2156,10,1603
대전광역시,동구,용전동,용전동제4투,3217,2107,856,469,499,117,150,3,0,1,0,1,1,2,1,2100,7,1110
대전광역시,동구,성남동,합계,10311,7604,2984,1787,1947,376,448,6,2,11,4,3,3,3,3,7577,27,2707
대전광역시,동구,성남동,관내사전투표,1897,1897,878,363,413,99,125,1,1,6,1,0,1,1,0,1889,8,0
대전광역시,동구,성남동,성남동제1투,3572,2535,977,585,675,129,154,1,1,0,2,1,1,1,2,2529,6,1037
대전광역시,동구,성남동,성남동제2투,2043,1371,474,388,377,61,58,2,0,1,1,1,0,1,1,1365,6,672
대전광역시,동구,성남동,성남동제3투,2799,1801,655,451,482,87,111,2,0,4,0,1,1,0,0,1794,7,998
대전광역시,동구,홍도동,관내사전투표,1922,1922,893,342,409,102,164,0,0,1,1,1,0,0,1,1914,8,0
대전광역시,동구,홍도동,합계,9525,6749,2655,1585,1665,339,452,4,1,4,5,3,5,2,5,6725,24,2776
대전광역시,동구,홍도동,홍도동제1투,1739,1183,383,355,318,52,67,0,1,1,2,0,1,1,0,1181,2,556
대전광역시,동구,홍도동,홍도동제2투,3041,2094,807,522,536,96,113,4,0,2,2,1,2,0,4,2089,5,947
대전광역시,동구,홍도동,홍도동제3투,2823,1550,572,366,402,89,108,0,0,0,0,1,2,1,0,1541,9,1273
대전광역시,동구,삼성동,합계,12323,8825,3271,2386,2195,442,450,10,6,13,3,4,0,3,10,8793,32,3498
대전광역시,동구,삼성동,관내사전투표,2011,2011,919,437,434,100,97,0,1,5,0,3,0,1,3,2000,11,0
대전광역시,동구,삼성동,삼성동제1투,1571,1031,312,352,278,37,45,0,0,1,1,0,0,1,0,1027,4,540
대전광역시,동구,삼성동,삼성동제2투,1975,1300,482,345,322,80,64,2,2,0,1,0,0,0,1,1299,1,675
대전광역시,동구,삼성동,삼성동제3투,3453,2402,885,657,602,111,129,4,1,3,0,1,0,0,2,2395,7,1051
대전광역시,동구,삼성동,삼성동제4투,3313,2081,673,595,559,114,115,4,2,4,1,0,0,1,4,2072,9,1232
대전광역시,동구,대청동,관내사전투표,340,340,138,104,73,12,11,0,0,0,1,0,0,1,0,340,0,0
대전광역시,동구,대청동,합계,2137,1493,458,593,335,38,52,5,0,0,1,1,1,2,3,1489,4,644
대전광역시,동구,대청동,대청동제1투,887,588,171,242,135,10,24,4,0,0,0,0,1,0,0,587,1,299
대전광역시,동구,대청동,대청동제2투,910,565,149,247,127,16,17,1,0,0,0,1,0,1,3,562,3,345
대전광역시,동구,산내동,합계,15162,11079,4552,2389,2814,572,659,13,3,9,1,11,2,7,12,11044,35,4083
대전광역시,동구,산내동,관내사전투표,2655,2655,1252,507,585,129,159,4,1,5,1,1,0,2,2,2648,7,0
대전광역시,동구,산내동,산내동제1투,3507,2280,942,451,606,103,157,7,0,3,0,5,2,1,0,2277,3,1227
대전광역시,동구,산내동,산내동제2투,816,483,138,171,136,22,7,0,1,0,0,0,0,2,2,479,4,333
대전광역시,동구,산내동,산내동제3투,2729,2091,922,370,541,107,146,0,0,0,0,1,0,0,2,2089,2,638
대전광역시,동구,산내동,산내동제4투,2052,1407,524,361,345,87,77,1,0,1,0,0,0,1,0,1397,10,645
대전광역시,동구,산내동,산내동제5투,981,645,183,198,198,36,24,0,0,0,0,1,0,0,1,641,4,336
대전광역시,동구,산내동,산내동제6투,2422,1518,591,331,403,88,89,1,1,0,0,3,0,1,5,1513,5,904
대전광역시,동구,잘못 투입·구분된 투표지,,0,0,0,0,0,0,0,0,0,0,0,0,0,0,0,0,0,0
대전광역시,중구,합계,,208017,157397,62115,37657,37504,8885,9795,239,34,119,54,100,51,78,134,156765,632,50620
대전광역시,중구,거소·선상투표,,497,465,155,74,154,21,20,4,2,3,6,1,1,1,1,443,22,32
대전광역시,중구,관외사전투표,,17515,17514,8299,2566,3663,1334,1433,26,8,9,6,20,4,9,26,17403,111,1
대전광역시,중구,재외투표,,1134,862,545,60,137,38,80,0,0,0,0,0,0,1,0,861,1,272
대전광역시,중구,은행선화동,합계,13570,8680,3450,2115,1977,480,597,9,0,5,3,3,4,2,10,8655,25,4890
대전광역시,중구,은행선화동,관내사전투표,1838,1838,839,397,336,93,160,2,0,1,1,1,1,0,2,1833,5,0
대전광역시,중구,은행선화동,은행선화동제1투,3044,1763,700,417,421,93,117,3,0,0,1,0,1,1,2,1756,7,1281
대전광역시,중구,은행선화동,은행선화동제2투,3013,1892,745,435,464,111,127,0,0,2,1,0,0,1,2,1888,4,1121
대전광역시,중구,은행선화동,은행선화동제3투,3225,1919,715,511,471,102,108,3,0,0,0,2,2,0,2,1916,3,1306
대전광역시,중구,은행선화동,은행선화동제4투,2450,1268,451,355,285,81,85,1,0,2,0,0,0,0,2,1262,6,1182
대전광역시,중구,목동,합계,10651,8487,3927,1507,1880,517,604,9,1,8,2,4,3,4,4,8470,17,2164
대전광역시,중구,목동,관내사전투표,2636,2636,1394,367,493,182,187,2,0,3,0,1,0,1,1,2631,5,0
대전광역시,중구,목동,목동제1투,2262,1596,660,382,333,89,122,0,0,2,1,1,1,1,0,1592,4,666
대전광역시,중구,목동,목동제2투,3131,2233,1009,366,555,123,160,5,1,1,1,1,2,2,0,2226,7,898
대전광역시,중구,목동,목동제3투,2622,2022,864,392,499,123,135,2,0,2,0,1,0,0,3,2021,1,600
대전광역시,중구,중촌동,합계,11451,8635,3431,1954,2128,513,534,12,2,9,4,4,2,0,5,8598,37,2816
대전광역시,중구,중촌동,관내사전투표,1972,1972,865,382,448,112,155,1,1,3,0,0,0,0,0,1967,5,0
대전광역시,중구,중촌동,중촌동제1투,1562,971,334,285,225,74,46,0,1,0,0,1,0,0,2,968,3,591
대전광역시,중구,중촌동,중촌동제2투,1645,1270,531,289,305,76,64,1,0,2,0,1,0,0,0,1269,1,375
대전광역시,중구,중촌동,중촌동제3투,2504,1735,648,398,458,102,109,5,0,2,1,0,0,0,1,1724,11,769
대전광역시,중구,중촌동,중촌동제4투,2503,1832,786,361,442,109,122,1,0,2,0,0,0,0,1,1824,8,671
대전광역시,중구,중촌동,중촌동제5투,1265,855,267,239,250,40,38,4,0,0,3,2,2,0,1,846,9,410
대전광역시,중구,대흥동,합계,10768,7694,3186,1748,1782,429,490,12,1,4,2,3,2,3,7,7669,25,3074
대전광역시,중구,대흥동,관내사전투표,2223,2223,1053,398,446,134,171,6,0,1,0,1,1,1,1,2213,10,0
대전광역시,중구,대흥동,대흥동제1투,3131,1780,689,407,439,98,133,2,0,0,1,0,0,1,3,1773,7,1351
대전광역시,중구,대흥동,대흥동제2투,2126,1347,490,444,266,65,70,2,0,2,0,1,0,1,0,1341,6,779
대전광역시,중구,대흥동,대흥동제3투,3288,2344,954,499,631,132,116,2,1,1,1,1,1,0,3,2342,2,944
대전광역시,중구,문창동,합계,4280,2898,939,967,699,114,153,1,0,4,3,1,2,1,1,2885,13,1382
대전광역시,중구,문창동,관내사전투표,642,642,256,195,126,24,37,0,0,1,1,0,0,0,1,641,1,0
대전광역시,중구,문창동,문창동제1투,1574,926,304,310,230,39,35,1,0,1,1,0,0,0,0,921,5,648
대전광역시,중구,문창동,문창동제2투,2064,1330,379,462,343,51,81,0,0,2,1,1,2,1,0,1323,7,734
대전광역시,중구,석교동,합계,13532,9386,3196,2660,2484,398,544,17,0,10,3,6,6,6,6,9336,50,4146
대전광역시,중구,석교동,관내사전투표,1658,1658,691,392,390,68,97,3,0,4,1,3,1,0,0,1650,8,0
대전광역시,중구,석교동,석교동제1투,2344,1454,467,437,396,68,73,2,0,1,0,0,0,1,0,1445,9,890
대전광역시,중구,석교동,석교동제2투,2424,1575,527,485,394,61,87,6,0,1,1,1,1,1,1,1566,9,849
대전광역시,중구,석교동,석교동제3투,2161,1373,477,406,343,59,75,0,0,2,0,2,1,1,1,1367,6,788
대전광역시,중구,석교동,석교동제4투,2452,1626,523,473,452,64,102,1,0,1,1,0,1,0,2,1620,6,826
대전광역시,중구,석교동,석교동제5투,2493,1700,511,467,509,78,110,5,0,1,0,0,2,3,2,1688,12,793
대전광역시,중구,대사동,합계,5629,4165,1494,1216,989,201,220,6,1,3,4,1,1,1,6,4143,22,1464
대전광역시,중구,대사동,관내사전투표,1722,1722,714,460,345,84,101,2,1,0,1,1,1,0,2,1712,10,0
대전광역시,중구,대사동,대사동제1투,2477,1579,439,549,431,64,74,2,0,3,3,0,0,1,3,1569,10,898
대전광역시,중구,대사동,대사동제2투,1430,864,341,207,213,53,45,2,0,0,0,0,0,0,1,862,2,566
대전광역시,중구,부사동,합계,5971,4090,1415,1121,1083,193,232,9,2,4,0,3,0,1,6,4069,21,1881
대전광역시,중구,부사동,관내사전투표,963,963,397,237,217,42,55,1,2,1,0,1,0,0,4,957,6,0
대전광역시,중구,부사동,부사동제1투,2391,1511,478,462,412,73,75,3,0,0,0,0,0,1,0,1504,7,880
대전광역시,중구,부사동,부사동제2투,2617,1616,540,422,454,78,102,5,0,3,0,2,0,0,2,1608,8,1001
대전광역시,중구,용두동,합계,8047,6047,2406,1405,1441,315,430,9,1,6,0,3,0,4,3,6023,24,2000
대전광역시,중구,용두동,관내사전투표,1820,1820,823,383,377,87,135,2,0,0,0,1,0,2,1,1811,9,0
대전광역시,중구,용두동,용두동제1투,1971,1476,609,305,368,73,106,2,0,3,0,0,0,0,2,1468,8,495
대전광역시,중구,용두동,용두동제2투,1832,1112,388,325,260,56,71,2,1,1,0,2,0,2,0,1108,4,720
대전광역시,중구,용두동,용두동제3투,2424,1639,586,392,436,99,118,3,0,2,0,0,0,0,0,1636,3,785
대전광역시,중구,오류동,합계,7973,6255,2357,1687,1443,392,324,11,2,6,1,6,0,1,4,6234,21,1718
대전광역시,중구,오류동,관내사전투표,1983,1983,860,443,409,121,136,1,0,2,0,3,0,0,0,1975,8,0
대전광역시,중구,오류동,오류동제1투,1679,1011,352,272,255,64,55,1,2,3,0,0,0,1,1,1006,5,668
대전광역시,중구,오류동,오류동제2투,2372,1839,661,532,443,118,74,4,0,1,0,0,0,0,2,1835,4,533
대전광역시,중구,오류동,오류동제3투,1939,1422,484,440,336,89,59,5,0,0,1,3,0,0,1,1418,4,517
대전광역시,중구,태평1동,합계,10320,8023,3473,1695,1840,445,506,6,2,4,3,9,2,3,7,7995,28,2297
대전광역시,중구,태평1동,관내사전투표,1917,1917,937,357,408,90,116,1,0,0,1,1,0,0,4,1915,2,0
대전광역시,중구,태평1동,태평1동제1투,2325,1778,781,329,426,106,125,0,0,1,0,2,0,0,1,1771,7,547
대전광역시,중구,태평1동,태평1동제2투,2206,1337,443,391,331,72,83,2,1,0,2,0,1,1,1,1328,9,869
대전광역시,중구,태평1동,태평1동제3투,3872,2991,1312,618,675,177,182,3,1,3,0,6,1,2,1,2981,10,881
대전광역시,중구,태평2동,합계,20057,15809,6026,4164,3786,873,852,35,3,8,3,3,5,6,5,15769,40,4248
대전광역시,중구,태평2동,관내사전투표,3864,3864,1749,855,809,211,217,5,0,2,2,2,0,2,1,3855,9,0
대전광역시,중구,태평2동,태평2동제1투,1826,1131,352,361,320,45,45,1,0,0,0,0,2,0,1,1127,4,695
대전광역시,중구,태평2동,태평2동제2투,2157,1530,509,488,349,81,90,3,1,2,0,1,0,0,1,1525,5,627
대전광역시,중구,태평2동,태평2동제3투,2740,1924,679,557,465,108,99,8,1,2,0,0,0,0,0,1919,5,816
대전광역시,중구,태평2동,태평2동제4투,3050,2296,892,574,557,120,139,8,0,0,1,0,0,0,1,2292,4,754
대전광역시,중구,태평2동,태평2동제5투,2818,2211,798,618,541,136,95,8,1,0,0,0,2,4,1,2204,7,607
대전광역시,중구,태평2동,태평2동제6투,3602,2853,1047,711,745,172,167,2,0,2,0,0,1,0,0,2847,6,749
대전광역시,중구,유천1동,합계,5619,3754,1297,1109,945,181,198,3,0,2,0,1,3,1,1,3741,13,1865
대전광역시,중구,유천1동,관내사전투표,1076,1076,443,261,250,55,62,1,0,0,0,0,0,1,1,1074,2,0
대전광역시,중구,유천1동,유천1동제1투,2446,1424,430,481,364,58,78,1,0,2,0,1,2,0,0,1417,7,1022
대전광역시,중구,유천1동,유천1동제2투,2097,1254,424,367,331,68,58,1,0,0,0,0,1,0,0,1250,4,843
대전광역시,중구,유천2동,합계,11066,8305,3026,2392,1979,407,434,17,1,4,4,2,2,5,7,8280,25,2761
대전광역시,중구,유천2동,관내사전투표,1725,1725,758,395,364,107,88,1,1,2,0,1,1,1,1,1720,5,0
대전광역시,중구,유천2동,유천2동제1투,1403,951,280,310,250,44,57,1,0,1,0,1,0,1,3,948,3,452
대전광역시,중구,유천2동,유천2동제2투,2163,1351,473,395,356,56,60,3,0,1,1,0,0,0,1,1346,5,812
대전광역시,중구,유천2동,유천2동제3투,2575,1764,681,461,416,79,112,3,0,0,2,0,0,3,2,1759,5,811
대전광역시,중구,유천2동,유천2동제4투,3200,2514,834,831,593,121,117,9,0,0,1,0,1,0,0,2507,7,686
대전광역시,중구,문화1동,합계,16535,13028,5179,3053,3156,776,754,12,3,8,3,9,2,15,10,12980,48,3507
대전광역시,중구,문화1동,관내사전투표,3256,3256,1490,630,702,189,222,3,2,0,1,2,1,4,1,3247,9,0
대전광역시,중구,문화1동,문화1동제1투,3386,2458,881,643,640,142,127,2,1,1,1,4,1,4,2,2449,9,928
대전광역시,중구,문화1동,문화1동제2투,1454,980,338,279,242,42,66,1,0,1,1,0,0,1,2,973,7,474
대전광역시,중구,문화1동,문화1동제3투,2400,1665,598,409,440,104,99,1,0,1,0,0,0,3,3,1658,7,735
대전광역시,중구,문화1동,문화1동제4투,3184,2557,1039,570,648,161,124,1,0,5,0,1,0,3,2,2554,3,627
대전광역시,중구,문화1동,문화1동제5투,2855,2112,833,522,484,138,116,4,0,0,0,2,0,0,0,2099,13,743
대전광역시,중구,문화2동,합계,11129,8079,2920,2149,1970,458,500,11,5,7,4,8,5,5,8,8050,29,3050
대전광역시,중구,문화2동,관내사전투표,2197,2197,887,512,488,141,142,5,1,2,0,5,2,2,0,2187,10,0
대전광역시,중구,문화2동,문화2동제1투,1640,1016,316,323,255,54,58,0,0,1,1,0,1,2,3,1014,2,624
대전광역시,중구,문화2동,문화2동제2투,2805,1898,664,514,490,88,128,2,3,1,1,1,0,1,3,1896,2,907
대전광역시,중구,문화2동,문화2동제3투,2237,1461,504,416,353,87,83,3,1,2,1,1,1,0,1,1453,8,776
대전광역시,중구,문화2동,문화2동제4투,2250,1507,549,384,384,88,89,1,0,1,1,1,1,0,1,1500,7,743
대전광역시,중구,산성동,관내사전투표,2641,2641,1073,641,613,137,158,5,0,2,1,1,1,0,3,2635,6,0
대전광역시,중구,산성동,합계,22273,15221,5394,4015,3968,800,890,30,0,15,3,13,7,9,17,15161,60,7052
대전광역시,중구,산성동,산성동제1투,2135,1286,383,411,328,65,82,2,0,0,0,2,0,2,2,1277,9,849
대전광역시,중구,산성동,산성동제2투,2347,1588,548,419,434,93,77,3,0,0,0,0,0,1,3,1578,10,759
대전광역시,중구,산성동,산성동제3투,3141,1813,626,504,470,90,101,8,0,2,0,3,2,1,2,1809,4,1328
대전광역시,중구,산성동,산성동제4투,2408,1782,586,494,489,103,98,1,0,1,1,2,0,1,0,1776,6,626
대전광역시,중구,산성동,산성동제5투,2481,1566,555,406,415,88,86,4,0,4,0,0,1,0,3,1562,4,915
대전광역시,중구,산성동,산성동제6투,3273,2082,714,485,593,112,148,4,0,4,1,5,1,1,2,2070,12,1191
대전광역시,중구,산성동,산성동제7투,3113,2016,790,495,489,97,128,3,0,2,0,0,2,2,2,2010,6,1097
대전광역시,중구,산성동,산성동제8투,734,447,119,160,137,15,12,0,0,0,0,0,0,1,0,444,3,287
대전광역시,중구,잘못 투입·구분된 투표지,,0,0,0,0,0,0,0,0,0,0,0,0,0,0,0,0,0,0
대전광역시,서구,합계,,394539,307774,133604,59593,70732,20091,21396,317,48,175,59,216,69,124,230,306654,1120,86765
대전광역시,서구,거소·선상투표,,753,722,258,101,261,49,18,3,2,4,1,3,1,0,1,702,20,31
대전광역시,서구,관외사전투표,,36372,36360,17522,4755,7697,2936,3035,44,8,17,9,31,9,17,48,36128,232,12
대전광역시,서구,재외투표,,2274,1855,1102,115,302,73,245,9,0,0,1,0,0,0,1,1848,7,419
대전광역시,서구,복수동,합계,14387,11004,4771,2263,2627,637,650,9,0,1,4,5,2,4,3,10976,28,3383
대전광역시,서구,복수동,관내사전투표,2856,2856,1397,507,617,150,166,3,0,0,0,3,1,0,2,2846,10,0
대전광역시,서구,복수동,복수동제1투,2367,1590,555,432,402,89,101,0,0,0,3,1,0,3,1,1587,3,777
대전광역시,서구,복수동,복수동제2투,2826,2036,817,451,512,132,113,2,0,0,0,1,0,1,0,2029,7,790
대전광역시,서구,복수동,복수동제3투,3066,2404,1107,500,549,132,107,2,0,0,0,0,1,0,0,2398,6,662
대전광역시,서구,복수동,복수동제4투,3272,2118,895,373,547,134,163,2,0,1,1,0,0,0,0,2116,2,1154
대전광역시,서구,도마1동,관내사전투표,1489,1489,615,349,329,87,95,0,0,2,0,0,1,1,1,1480,9,0
대전광역시,서구,도마1동,합계,13102,8706,2937,2388,2319,460,545,6,1,7,1,6,2,1,4,8677,29,4396
대전광역시,서구,도마1동,도마1동제1투,2305,1403,414,432,403,59,86,4,0,1,0,1,1,0,0,1401,2,902
대전광역시,서구,도마1동,도마1동제2투,2736,1827,582,531,489,104,113,1,0,1,0,0,0,0,0,1821,6,909
대전광역시,서구,도마1동,도마1동제3투,1785,1141,362,338,312,64,58,0,0,3,0,1,0,0,0,1138,3,644
대전광역시,서구,도마1동,도마1동제4투,2347,1386,459,368,401,63,90,0,1,0,0,1,0,0,1,1384,2,961
대전광역시,서구,도마1동,도마1동제5투,2440,1460,505,370,385,83,103,1,0,0,1,3,0,0,2,1453,7,980
대전광역시,서구,도마2동,관내사전투표,2688,2688,1161,562,617,151,175,3,0,1,0,4,2,0,3,2679,9,0
대전광역시,서구,도마2동,합계,15982,11317,4016,3024,2846,638,701,10,3,9,0,12,6,5,12,11282,35,4665
대전광역시,서구,도마2동,도마2동제1투,2659,1522,498,439,405,69,100,1,1,3,0,0,1,0,1,1518,4,1137
대전광역시,서구,도마2동,도마2동제2투,2678,1654,558,507,397,83,94,1,2,1,0,2,2,1,1,1649,5,1024
대전광역시,서구,도마2동,도마2동제3투,2104,1252,379,383,345,52,78,1,0,2,0,3,0,2,4,1249,3,852
대전광역시,서구,도마2동,도마2동제4투,2950,1996,718,499,507,133,124,2,0,1,0,2,1,1,2,1990,6,954
대전광역시,서구,도마2동,도마2동제5투,2903,2205,702,634,575,150,130,2,0,1,0,1,0,1,1,2197,8,698
대전광역시,서구,정림동,관내사전투표,3368,3368,1431,748,742,162,255,3,0,5,0,2,1,3,3,3355,13,0
대전광역시,서구,정림동,합계,13672,10445,4121,2377,2518,592,741,11,2,19,1,6,4,7,8,10407,38,3227
대전광역시,서구,정림동,정림동제1투,2104,1425,563,329,341,90,91,3,2,3,0,0,0,1,0,1423,2,679
대전광역시,서구,정림동,정림동제2투,2099,1547,613,354,370,94,104,1,0,2,1,1,0,0,2,1542,5,552
대전광역시,서구,정림동,정림동제3투,1807,1161,415,280,299,73,78,1,0,2,0,1,1,1,2,1153,8,646
대전광역시,서구,정림동,정림동제4투,2073,1314,466,352,329,73,83,0,0,2,0,1,1,1,1,1309,5,759
대전광역시,서구,정림동,정림동제5투,2221,1630,633,314,437,100,130,3,0,5,0,1,1,1,0,1625,5,591
대전광역시,서구,변동,합계,13042,8861,3273,2310,2172,423,614,8,1,6,2,5,3,4,7,8828,33,4181
대전광역시,서구,변동,관내사전투표,1927,1927,843,456,401,83,129,1,1,1,0,0,0,0,4,1919,8,0
대전광역시,서구,변동,변동제1투,2526,1556,532,426,399,59,122,4,0,3,0,2,1,2,0,1550,6,970
대전광역시,서구,변동,변동제2투,3923,2487,912,646,630,121,163,3,0,1,0,1,0,0,1,2478,9,1436
대전광역시,서구,변동,변동제3투,2000,1240,406,319,324,76,103,0,0,0,0,2,1,1,1,1233,7,760
대전광역시,서구,변동,변동제4투,2666,1651,580,463,418,84,97,0,0,1,2,0,1,1,1,1648,3,1015
대전광역시,서구,용문동,합계,12288,8461,3227,2018,2053,456,643,9,1,6,4,5,3,6,7,8438,23,3827
대전광역시,서구,용문동,관내사전투표,2115,2115,965,404,439,122,170,1,0,2,0,2,0,1,1,2107,8,0
대전광역시,서구,용문동,용문동제1투,3847,2088,825,475,489,112,172,2,1,2,2,1,1,0,1,2083,5,1759
대전광역시,서구,용문동,용문동제2투,3133,2117,737,550,538,121,151,5,0,1,2,1,1,4,3,2114,3,1016
대전광역시,서구,용문동,용문동제3투,3193,2141,700,589,587,101,150,1,0,1,0,1,1,1,2,2134,7,1052
대전광역시,서구,탄방동,관내사전투표,3260,3260,1663,477,641,215,237,3,0,6,0,2,1,1,3,3249,11,0
대전광역시,서구,탄방동,합계,20189,14575,6295,2721,3407,972,1075,17,0,9,1,10,3,8,11,14529,46,5614
대전광역시,서구,탄방동,탄방동제1투,3472,1875,739,392,488,105,139,2,0,0,0,0,1,1,2,1869,6,1597
대전광역시,서구,탄방동,탄방동제2투,3553,2297,925,476,524,162,191,5,0,1,0,2,0,1,1,2288,9,1256
대전광역시,서구,탄방동,탄방동제3투,1847,1421,580,281,363,88,103,1,0,0,0,0,0,1,0,1417,4,426
대전광역시,서구,탄방동,탄방동제4투,1646,1278,512,252,299,105,103,3,0,0,0,0,0,0,1,1275,3,368
대전광역시,서구,탄방동,탄방동제5투,2968,2082,889,386,516,145,128,0,0,1,1,5,1,3,3,2078,4,886
대전광역시,서구,탄방동,탄방동제6투,3443,2362,987,457,576,152,174,3,0,1,0,1,0,1,1,2353,9,1081
대전광역시,서구,둔산1동,합계,14568,12812,5677,2532,2764,965,791,18,0,3,1,9,1,3,4,12768,44,1756
대전광역시,서구,둔산1동,관내사전투표,5823,5823,3010,778,1064,445,482,8,0,1,0,7,0,1,2,5798,25,0
대전광역시,서구,둔산1동,둔산1동제1투,2283,1707,610,452,454,119,58,3,0,0,0,1,0,1,1,1699,8,576
대전광역시,서구,둔산1동,둔산1동제2투,2086,1744,696,366,452,143,78,4,0,0,0,0,0,0,0,1739,5,342
대전광역시,서구,둔산1동,둔산1동제3투,2357,1880,745,489,393,144,100,1,0,1,0,1,1,1,0,1876,4,477
대전광역시,서구,둔산1동,둔산1동제4투,2019,1658,616,447,401,114,73,2,0,1,1,0,0,0,1,1656,2,361
대전광역시,서구,둔산2동,합계,25250,20726,9935,3359,4492,1494,1343,21,3,8,2,12,3,2,6,20680,46,4524
대전광역시,서구,둔산2동,관내사전투표,4239,4239,2302,505,806,302,306,5,0,0,0,4,0,0,2,4232,7,0
대전광역시,서구,둔산2동,둔산2동제1투,3294,2624,1158,519,600,178,154,1,0,0,0,2,0,0,1,2613,11,670
대전광역시,서구,둔산2동,둔산2동제2투,3205,2565,1224,432,545,182,168,3,1,2,0,1,0,1,1,2560,5,640
대전광역시,서구,둔산2동,둔산2동제3투,3421,2727,1152,554,646,191,165,6,1,1,2,3,1,0,0,2722,5,694
대전광역시,서구,둔산2동,둔산2동제4투,2863,2331,962,498,572,146,139,2,0,3,0,1,0,0,0,2323,8,532
대전광역시,서구,둔산2동,둔산2동제5투,2837,2348,1127,328,526,210,147,2,0,1,0,1,1,1,1,2345,3,489
대전광역시,서구,둔산2동,둔산2동제6투,2813,2387,1303,295,465,180,141,0,0,0,0,0,0,0,1,2385,2,426
대전광역시,서구,둔산2동,둔산2동제7투,2578,1505,707,228,332,105,123,2,1,1,0,0,1,0,0,1500,5,1073
대전광역시,서구,둔산3동,합계,15887,12828,5282,3014,2997,799,655,11,0,3,2,10,4,4,5,12786,42,3059
대전광역시,서구,둔산3동,관내사전투표,4198,4198,2016,818,841,267,235,2,0,1,1,0,1,0,0,4182,16,0
대전광역시,서구,둔산3동,둔산3동제1투,2091,1570,662,359,372,97,73,0,0,0,0,4,1,0,0,1568,2,521
대전광역시,서구,둔산3동,둔산3동제2투,2578,2031,786,469,522,142,103,1,0,0,0,2,0,2,1,2028,3,547
대전광역시,서구,둔산3동,둔산3동제3투,2050,1630,551,474,407,123,72,1,0,0,0,0,0,0,0,1628,2,420
대전광역시,서구,둔산3동,둔산3동제4투,3146,2236,851,555,552,124,133,4,0,0,1,3,1,1,1,2226,10,910
대전광역시,서구,둔산3동,둔산3동제5투,1824,1163,416,339,303,46,39,3,0,2,0,1,1,1,3,1154,9,661
대전광역시,서구,괴정동,합계,15679,10364,4461,1990,2326,646,869,9,1,11,2,2,1,3,5,10326,38,5315
대전광역시,서구,괴정동,관내사전투표,2703,2703,1353,380,530,185,240,2,0,0,1,1,0,1,0,2693,10,0
대전광역시,서구,괴정동,괴정동제1투,3823,2213,904,458,532,126,172,2,1,4,0,0,1,0,3,2203,10,1610
대전광역시,서구,괴정동,괴정동제2투,4296,2327,997,426,520,150,214,3,0,5,1,0,0,1,1,2318,9,1969
대전광역시,서구,괴정동,괴정동제3투,2588,1532,577,368,377,80,120,1,0,2,0,0,0,1,1,1527,5,1056
대전광역시,서구,괴정동,괴정동제4투,2269,1589,630,358,367,105,123,1,0,0,0,1,0,0,0,1585,4,680
대전광역시,서구,가장동,합계,9688,7339,2746,1901,1766,383,496,3,2,5,1,7,1,3,5,7319,20,2349
대전광역시,서구,가장동,관내사전투표,1405,1405,589,355,305,56,93,1,1,0,0,1,1,0,1,1403,2,0
대전광역시,서구,가장동,가장동제1투,1435,843,302,249,207,30,49,0,0,1,0,1,0,0,1,840,3,592
대전광역시,서구,가장동,가장동제2투,1974,1310,442,317,349,70,123,1,1,1,0,1,0,1,1,1307,3,664
대전광역시,서구,가장동,가장동제3투,2713,2170,805,565,507,149,129,1,0,2,1,2,0,1,1,2163,7,543
대전광역시,서구,가장동,가장동제4투,2161,1611,608,415,398,78,102,0,0,1,0,2,0,1,1,1606,5,550
대전광역시,서구,내동,합계,17565,13536,5409,3127,3227,834,863,6,2,8,3,3,3,6,6,13497,39,4029
대전광역시,서구,내동,관내사전투표,3113,3113,1450,617,649,179,207,1,0,1,0,1,2,0,1,3108,5,0
대전광역시,서구,내동,내동제1투,2221,1505,588,372,368,81,86,2,0,1,0,0,0,1,0,1499,6,716
대전광역시,서구,내동,내동제2투,2365,1425,487,421,355,72,82,1,1,2,0,1,0,0,0,1422,3,940
대전광역시,서구,내동,내동제3투,3617,2480,956,559,591,177,178,0,1,2,1,0,0,1,3,2469,11,1137
대전광역시,서구,내동,내동제4투,3181,2637,973,674,642,169,162,1,0,0,1,0,1,2,2,2627,10,544
대전광역시,서구,내동,내동제5투,3068,2376,955,484,622,156,148,1,0,2,1,1,0,2,0,2372,4,692
대전광역시,서구,갈마1동,합계,17021,12045,4895,2674,2749,759,878,20,2,4,2,18,0,4,11,12016,29,4976
대전광역시,서구,갈마1동,관내사전투표,3550,3550,1570,735,753,212,258,6,0,0,0,8,0,2,1,3545,5,0
대전광역시,서구,갈마1동,갈마1동제1투,2122,1604,638,420,339,100,94,2,1,1,0,3,0,0,1,1599,5,518
대전광역시,서구,갈마1동,갈마1동제2투,2148,1433,519,353,333,97,125,2,0,0,1,1,0,0,1,1432,1,715
대전광역시,서구,갈마1동,갈마1동제3투,3315,1856,740,381,463,119,145,1,1,0,0,2,0,0,0,1852,4,1459
대전광역시,서구,갈마1동,갈마1동제4투,2840,1751,663,405,429,101,136,2,0,2,1,0,0,1,3,1743,8,1089
대전광역시,서구,갈마1동,갈마1동제5투,3046,1851,765,380,432,130,120,7,0,1,0,4,0,1,5,1845,6,1195
대전광역시,서구,갈마2동,합계,19865,13841,6284,2370,3034,897,1136,10,1,10,3,17,1,3,12,13778,63,6024
대전광역시,서구,갈마2동,관내사전투표,4197,4197,2112,568,808,302,362,1,0,4,1,5,0,1,5,4169,28,0
대전광역시,서구,갈마2동,갈마2동제1투,3310,1573,694,246,333,115,170,1,0,2,1,3,0,0,2,1567,6,1737
대전광역시,서구,갈마2동,갈마2동제2투,3174,2221,957,423,541,132,154,4,0,1,0,3,1,0,1,2217,4,953
대전광역시,서구,갈마2동,갈마2동제3투,2922,2054,920,344,494,114,171,0,1,2,0,0,0,0,2,2048,6,868
대전광역시,서구,갈마2동,갈마2동제4투,2798,1575,690,294,346,93,140,1,0,0,0,5,0,1,1,1571,4,1223
대전광역시,서구,갈마2동,갈마2동제5투,3464,2221,911,495,512,141,139,3,0,1,1,1,0,1,1,2206,15,1243
대전광역시,서구,월평1동,합계,9164,6133,2577,1234,1463,374,440,3,0,1,0,6,1,1,5,6105,28,3031
대전광역시,서구,월평1동,관내사전투표,2099,2099,992,330,475,123,161,0,0,0,0,3,0,1,1,2086,13,0
대전광역시,서구,월평1동,월평1동제1투,2248,1268,485,289,331,61,94,0,0,0,0,1,0,0,1,1262,6,980
대전광역시,서구,월평1동,월평1동제2투,2472,1522,602,353,358,102,100,3,0,0,0,0,0,0,0,1518,4,950
대전광역시,서구,월평1동,월평1동제3투,2345,1244,498,262,299,88,85,0,0,1,0,2,1,0,3,1239,5,1101
대전광역시,서구,월평2동,합계,12573,9665,3770,2266,2373,621,555,13,2,4,4,6,4,2,10,9630,35,2908
대전광역시,서구,월평2동,관내사전투표,2898,2898,1261,585,653,185,196,2,1,1,0,1,0,0,2,2887,11,0
대전광역시,서구,월평2동,월평2동제1투,1972,1128,414,272,307,58,64,2,0,2,0,1,1,0,3,1124,4,844
대전광역시,서구,월평2동,월평2동제2투,2622,2076,870,453,487,145,109,6,0,0,0,2,0,0,1,2073,3,546
대전광역시,서구,월평2동,월평2동제3투,2283,1455,503,376,413,65,76,2,0,0,3,1,1,1,2,1443,12,828
대전광역시,서구,월평2동,월평2동제4투,2798,2108,722,580,513,168,110,1,1,1,1,1,2,1,2,2103,5,690
대전광역시,서구,월평3동,합계,17118,14429,6446,2674,3322,1028,886,4,2,12,3,9,3,6,8,14403,26,2689
대전광역시,서구,월평3동,관내사전투표,4879,4879,2475,762,958,347,314,0,0,3,0,5,3,2,3,4872,7,0
대전광역시,서구,월평3동,월평3동제1투,2155,1639,670,359,405,99,97,1,0,1,0,1,0,0,0,1633,6,516
대전광역시,서구,월평3동,월평3동제2투,2182,1708,750,304,429,102,113,2,0,1,1,1,0,1,0,1704,4,474
대전광역시,서구,월평3동,월평3동제3투,2893,2269,1031,385,546,165,129,0,2,2,1,1,0,1,3,2266,3,624
대전광역시,서구,월평3동,월평3동제4투,2679,2126,775,501,536,186,118,1,0,4,0,0,0,1,1,2123,3,553
대전광역시,서구,월평3동,월평3동제5투,2330,1808,745,363,448,129,115,0,0,1,1,1,0,1,1,1805,3,522
대전광역시,서구,만년동,관내사전투표,2964,2964,1528,409,591,205,222,3,0,0,0,1,0,2,0,2961,3,0
대전광역시,서구,만년동,합계,10070,8340,3928,1324,1887,584,575,10,1,3,0,2,3,4,2,8323,17,1730
대전광역시,서구,만년동,만년동제1투,3105,2137,959,334,536,144,149,3,1,2,0,0,1,0,1,2130,7,968
대전광역시,서구,만년동,만년동제2투,1712,1394,653,202,319,115,95,2,0,0,0,0,1,1,1,1389,5,318
대전광역시,서구,만년동,만년동제3투,2289,1845,788,379,441,120,109,2,0,1,0,1,1,1,0,1843,2,444
대전광역시,서구,가수원동,관내사전투표,3926,3926,1915,675,776,258,275,7,1,0,0,2,0,2,0,3911,15,0
대전광역시,서구,가수원동,합계,26014,20654,9698,3456,4733,1354,1296,25,4,10,1,7,2,8,10,20604,50,5360
대전광역시,서구,가수원동,가수원동제1투,2154,1418,509,316,381,89,111,1,0,3,0,2,1,1,1,1415,3,736
대전광역시,서구,가수원동,가수원동제2투,2498,1709,605,483,413,105,93,0,1,2,0,0,1,2,1,1706,3,789
대전광역시,서구,가수원동,가수원동제3투,2762,1791,699,424,450,84,121,2,0,2,0,0,0,3,2,1787,4,971
대전광역시,서구,가수원동,가수원동제4투,2420,1918,1021,243,411,130,107,4,0,0,0,0,0,0,0,1916,2,502
대전광역시,서구,가수원동,가수원동제5투,2931,2358,1133,378,515,167,154,3,1,0,0,1,0,0,0,2352,6,573
대전광역시,서구,가수원동,가수원동제6투,2032,1628,912,170,342,100,96,1,0,0,1,1,0,0,2,1625,3,404
대전광역시,서구,가수원동,가수원동제7투,2024,1666,813,217,405,124,101,1,0,0,0,0,0,0,1,1662,4,358
대전광역시,서구,가수원동,가수원동제8투,1659,1402,686,183,340,112,71,0,0,1,0,1,0,0,3,1397,5,257
대전광역시,서구,가수원동,가수원동제9투,3608,2838,1405,367,700,185,167,6,1,2,0,0,0,0,0,2833,5,770
대전광역시,서구,관저1동,합계,11970,9478,4362,1612,2065,647,720,6,3,4,2,5,3,6,7,9442,36,2492
대전광역시,서구,관저1동,관내사전투표,3337,3337,1723,512,604,212,258,4,1,1,0,3,1,3,2,3324,13,0
대전광역시,서구,관저1동,관저1동제1투,2954,1988,883,310,449,152,178,1,0,3,0,1,1,2,1,1981,7,966
대전광역시,서구,관저1동,관저1동제2투,2059,1546,592,336,394,126,88,0,1,0,2,0,0,1,1,1541,5,513
대전광역시,서구,관저1동,관저1동제3투,3620,2607,1164,454,618,157,196,1,1,0,0,1,1,0,3,2596,11,1013
대전광역시,서구,관저2동,관내사전투표,6187,6187,3215,779,1320,375,456,8,0,2,1,9,1,0,4,6170,17,0
대전광역시,서구,관저2동,합계,26384,20721,9824,3125,4732,1384,1519,20,0,7,5,15,4,6,17,20658,63,5663
대전광역시,서구,관저2동,관저2동제1투,3194,2218,933,395,576,151,143,3,0,1,1,0,0,1,1,2205,13,976
대전광역시,서구,관저2동,관저2동제2투,3526,2670,1185,416,671,198,176,1,0,1,1,0,0,2,4,2655,15,856
대전광역시,서구,관저2동,관저2동제3투,2996,2091,972,279,499,140,190,0,0,2,0,2,0,0,3,2087,4,905
대전광역시,서구,관저2동,관저2동제4투,3491,2524,1157,431,574,164,189,1,0,0,0,1,2,0,1,2520,4,967
대전광역시,서구,관저2동,관저2동제5투,3738,2717,1206,540,583,197,177,2,0,1,1,0,0,3,1,2711,6,1021
대전광역시,서구,관저2동,관저2동제6투,3252,2314,1156,285,509,159,188,5,0,0,1,3,1,0,3,2310,4,938
대전광역시,서구,기성동,관내사전투표,776,776,268,261,148,23,41,5,0,0,2,3,0,5,3,759,17,0
대전광역시,서구,기성동,합계,3662,2556,788,863,599,86,107,12,7,4,4,5,2,11,15,2503,53,1106
대전광역시,서구,기성동,기성동제1투,678,398,97,166,104,12,14,0,0,0,0,0,0,1,3,397,1,280
대전광역시,서구,기성동,기성동제2투,1102,650,217,188,159,29,28,3,3,0,1,1,1,2,2,634,16,452
대전광역시,서구,기성동,기성동제3투,1106,732,206,248,188,22,24,4,4,4,1,1,1,3,7,713,19,374
대전광역시,서구,잘못 투입·구분된 투표지,,0,1,0,0,1,0,0,0,0,0,0,0,0,0,0,1,0,-1
대전광역시,유성구,합계,,266632,218087,103313,35445,47081,16145,14723,209,20,98,33,114,47,78,118,217424,663,48545
대전광역시,유성구,거소·선상투표,,478,449,169,76,123,38,12,1,0,3,1,1,1,0,5,430,19,29
대전광역시,유성구,관외사전투표,,29188,29187,14366,3810,5969,2491,2299,11,4,15,3,16,14,7,31,29036,151,1
대전광역시,유성구,재외투표,,2123,1712,984,120,293,68,232,4,0,1,0,1,1,0,0,1704,8,411
대전광역시,유성구,진잠동,합계,23468,17245,7386,3517,4085,1036,1098,19,4,12,3,14,5,3,12,17194,51,6223
대전광역시,유성구,진잠동,관내사전투표,3667,3667,1728,628,797,236,249,2,1,3,0,6,1,1,0,3652,15,0
대전광역시,유성구,진잠동,진잠동제1투,3258,1839,683,440,477,88,130,2,0,6,0,0,1,0,0,1827,12,1419
대전광역시,유성구,진잠동,진잠동제2투,2452,1805,755,346,445,112,137,3,0,0,0,1,1,0,1,1801,4,647
대전광역시,유성구,진잠동,진잠동제3투,2410,1774,724,346,433,127,126,4,0,0,0,1,1,0,5,1767,7,636
대전광역시,유성구,진잠동,진잠동제4투,2272,1143,414,310,274,72,57,1,3,0,1,2,0,0,4,1138,5,1129
대전광역시,유성구,진잠동,진잠동제5투,385,266,61,97,77,14,16,0,0,0,0,0,0,1,0,266,0,119
대전광역시,유성구,진잠동,진잠동제6투,551,354,110,117,102,10,12,0,0,0,1,0,1,0,0,353,1,197
대전광역시,유성구,진잠동,진잠동제7투,2877,2133,1003,398,478,104,141,1,0,3,0,3,0,1,0,2132,1,744
대전광역시,유성구,진잠동,진잠동제8투,2643,1968,881,368,479,117,117,1,0,0,0,1,0,0,1,1965,3,675
대전광역시,유성구,진잠동,진잠동제9투,2953,2296,1027,467,523,156,113,5,0,0,1,0,0,0,1,2293,3,657
대전광역시,유성구,온천1동,합계,25610,18230,7703,3602,4193,1285,1291,19,2,16,4,20,2,10,12,18159,71,7380
대전광역시,유성구,온천1동,관내사전투표,6037,6037,2902,1010,1242,391,447,5,1,6,1,6,1,1,2,6015,22,0
대전광역시,유성구,온천1동,온천1동제1투,3406,2007,729,470,545,113,124,1,0,5,2,5,0,1,3,1998,9,1399
대전광역시,유성구,온천1동,온천1동제2투,3693,2262,784,592,577,147,148,1,1,2,0,1,0,2,4,2259,3,1431
대전광역시,유성구,온천1동,온천1동제3투,3860,2720,1037,606,683,191,180,5,0,3,0,4,0,2,0,2711,9,1140
대전광역시,유성구,온천1동,온천1동제4투,3369,1941,722,447,465,141,141,3,0,0,0,4,1,2,0,1926,15,1428
대전광역시,유성구,온천1동,온천1동제5투,2668,1678,846,198,332,158,138,0,0,0,0,0,0,0,1,1673,5,990
대전광역시,유성구,온천1동,온천1동제6투,2577,1585,683,279,349,144,113,4,0,0,1,0,0,2,2,1577,8,992
대전광역시,유성구,온천2동,합계,26590,20830,9282,3780,4574,1706,1373,21,1,7,5,4,2,9,6,20770,60,5760
대전광역시,유성구,온천2동,관내사전투표,5027,5027,2623,578,930,471,394,1,0,1,0,3,2,4,2,5009,18,0
대전광역시,유성구,온천2동,온천2동제1투,3317,2000,695,529,525,96,141,4,1,2,0,0,0,0,0,1993,7,1317
대전광역시,유성구,온천2동,온천2동제2투,2885,1918,727,504,459,110,109,1,0,0,1,0,0,2,0,1913,5,967
대전광역시,유성구,온천2동,온천2동제3투,2116,1449,632,269,265,159,115,0,0,1,1,1,0,0,2,1445,4,667
대전광역시,유성구,온천2동,온천2동제4투,1851,1432,617,276,338,110,81,4,0,1,0,0,0,0,0,1427,5,419
대전광역시,유성구,온천2동,온천2동제5투,1885,1543,713,265,357,111,89,3,0,1,2,0,0,0,1,1542,1,342
대전광역시,유성구,온천2동,온천2동제6투,1969,1538,752,239,303,144,91,2,0,0,1,0,0,2,0,1534,4,431
대전광역시,유성구,온천2동,온천2동제7투,2911,2202,860,542,512,171,110,0,0,1,0,0,0,0,0,2196,6,709
대전광역시,유성구,온천2동,온천2동제8투,2391,1886,887,281,417,154,141,0,0,0,0,0,0,1,0,1881,5,505
대전광역시,유성구,온천2동,온천2동제9투,2238,1835,776,297,468,180,102,6,0,0,0,0,0,0,1,1830,5,403
대전광역시,유성구,노은1동,합계,17068,14225,7011,2322,2924,998,896,12,0,5,4,6,5,6,5,14194,31,2843
대전광역시,유성구,노은1동,관내사전투표,5937,5937,3168,816,1125,383,411,3,0,2,1,3,3,3,3,5921,16,0
대전광역시,유성구,노은1동,노은1동제1투,2375,1758,929,223,329,141,124,1,0,1,0,0,1,2,1,1752,6,617
대전광역시,유성구,노은1동,노은1동제2투,2598,2074,975,394,433,151,115,1,0,0,2,1,0,0,0,2072,2,524
대전광역시,유성구,노은1동,노은1동제3투,3300,2463,1152,395,571,175,160,4,0,1,0,0,0,0,0,2458,5,837
대전광역시,유성구,노은1동,노은1동제4투,2858,1993,787,494,466,148,86,3,0,1,1,2,1,1,1,1991,2,865
대전광역시,유성구,노은2동,합계,16355,13449,6743,2233,2749,903,746,19,0,3,1,8,0,7,5,13417,32,2906
대전광역시,유성구,노은2동,관내사전투표,3366,3366,1748,464,628,247,258,2,0,3,1,5,0,2,3,3361,5,0
대전광역시,유성구,노은2동,노은2동제1투,3162,2559,1249,503,504,171,121,4,0,0,0,0,0,2,1,2555,4,603
대전광역시,유성구,노은2동,노은2동제2투,3264,2566,1294,409,562,185,107,4,0,0,0,0,0,0,1,2562,4,698
대전광역시,유성구,노은2동,노은2동제3투,2481,1847,908,336,384,113,92,4,0,0,0,2,0,1,0,1840,7,634
대전광역시,유성구,노은2동,노은2동제4투,2624,1893,861,372,434,100,112,3,0,0,0,1,0,1,0,1884,9,731
대전광역시,유성구,노은2동,노은2동제5투,1458,1218,683,149,237,87,56,2,0,0,0,0,0,1,0,1215,3,240
대전광역시,유성구,신성동,합계,16349,13504,5696,2505,3157,1277,794,16,0,2,2,3,1,6,5,13464,40,2845
대전광역시,유성구,신성동,관내사전투표,4375,4375,2029,681,950,420,273,5,0,1,0,2,0,0,2,4363,12,0
대전광역시,유성구,신성동,신성동제1투,1691,1133,474,224,253,100,73,0,0,1,1,0,0,1,1,1128,5,558
대전광역시,유성구,신성동,신성동제2투,1848,1512,728,254,309,118,98,3,0,0,0,0,0,1,0,1511,1,336
대전광역시,유성구,신성동,신성동제3투,2468,1883,917,272,422,116,142,2,0,0,0,0,1,2,0,1874,9,585
대전광역시,유성구,신성동,신성동제4투,2097,1640,732,323,335,158,84,2,0,0,0,0,0,1,1,1636,4,457
대전광역시,유성구,신성동,신성동제5투,2219,1679,416,374,534,272,74,0,0,0,1,1,0,0,1,1673,6,540
대전광역시,유성구,신성동,신성동제6투,1651,1282,400,377,354,93,50,4,0,0,0,0,0,1,0,1279,3,369
대전광역시,유성구,전민동,합계,16889,14200,7087,2206,2821,1112,914,17,1,2,1,5,1,5,5,14177,23,2689
대전광역시,유성구,전민동,관내사전투표,5052,5052,2706,627,899,422,375,4,1,2,1,3,0,0,1,5041,11,0
대전광역시,유성구,전민동,전민동제1투,2205,1655,841,237,341,120,110,3,0,0,0,1,0,1,0,1654,1,550
대전광역시,유성구,전민동,전민동제2투,2741,1941,895,345,400,168,125,0,0,0,0,0,0,2,1,1936,5,800
대전광역시,유성구,전민동,전민동제3투,2092,1681,836,275,361,108,93,3,0,0,0,1,1,0,1,1679,2,411
대전광역시,유성구,전민동,전민동제4투,2235,1796,821,353,389,122,105,1,0,0,0,0,0,0,2,1793,3,439
대전광역시,유성구,전민동,전민동제5투,2564,2075,988,369,431,172,106,6,0,0,0,0,0,2,0,2074,1,489
대전광역시,유성구,구즉동,합계,20131,15466,7605,2149,3368,940,1281,14,4,11,1,12,8,8,14,15415,51,4665
대전광역시,유성구,구즉동,관내사전투표,4796,4796,2684,493,876,298,420,4,0,6,0,3,0,0,3,4787,9,0
대전광역시,유성구,구즉동,구즉동제1투,1434,880,381,137,220,60,64,2,1,0,0,2,1,5,1,874,6,554
대전광역시,유성구,구즉동,구즉동제2투,274,170,55,69,33,1,9,0,0,0,0,0,2,0,0,169,1,104
대전광역시,유성구,구즉동,구즉동제3투,2156,1279,517,283,301,71,86,4,1,1,1,4,2,0,5,1276,3,877
대전광역시,유성구,구즉동,구즉동제4투,2790,2037,964,269,502,107,183,0,0,1,0,0,0,2,1,2029,8,753
대전광역시,유성구,구즉동,구즉동제5투,2813,2033,971,296,466,130,156,1,0,0,0,0,2,0,1,2023,10,780
대전광역시,유성구,구즉동,구즉동제6투,2578,1906,943,229,402,139,179,2,2,2,0,2,1,0,1,1902,4,672
대전광역시,유성구,구즉동,구즉동제7투,3290,2365,1090,373,568,134,184,1,0,1,0,1,0,1,2,2355,10,925
대전광역시,유성구,관평동,합계,19150,16367,8302,2241,3406,1261,1090,17,2,5,1,6,1,3,4,16339,28,2783
대전광역시,유성구,관평동,관내사전투표,5847,5847,3214,657,1039,463,454,5,2,1,0,1,0,0,0,5836,11,0
대전광역시,유성구,관평동,관평동제1투,2281,1905,959,245,423,138,133,5,0,0,0,1,0,0,0,1904,1,376
대전광역시,유성구,관평동,관평동제2투,2658,2212,1151,304,453,159,131,1,0,0,0,2,0,0,2,2203,9,446
대전광역시,유성구,관평동,관평동제3투,2804,2281,1182,261,511,173,148,2,0,1,0,0,0,1,0,2279,2,523
대전광역시,유성구,관평동,관평동제4투,2715,2068,793,462,522,185,93,3,0,3,1,0,1,2,1,2066,2,647
대전광역시,유성구,관평동,관평동제5투,2845,2054,1003,312,458,143,131,1,0,0,0,2,0,0,1,2051,3,791
대전광역시,유성구,원신흥동,관내사전투표,6746,6746,3488,971,1306,445,501,6,0,0,1,4,0,2,2,6726,20,0
대전광역시,유성구,원신흥동,합계,30988,24717,11451,4108,5639,1759,1628,23,1,9,5,13,6,8,7,24657,60,6271
대전광역시,유성구,원신흥동,원신흥동제1투,3328,2378,1048,443,567,163,146,2,0,1,0,2,1,1,0,2374,4,950
대전광역시,유성구,원신흥동,원신흥동제2투,3268,2241,934,410,583,138,158,6,0,1,3,0,1,2,1,2237,4,1027
대전광역시,유성구,원신흥동,원신흥동제3투,3390,2744,1307,439,620,201,167,2,0,0,0,1,0,2,0,2739,5,646
대전광역시,유성구,원신흥동,원신흥동제4투,3194,2588,1046,540,641,220,130,1,0,0,0,2,1,0,1,2582,6,606
대전광역시,유성구,원신흥동,원신흥동제5투,3334,2080,884,332,544,136,170,2,1,3,0,1,0,1,1,2075,5,1254
대전광역시,유성구,원신흥동,원신흥동제6투,2731,2058,1063,252,437,166,129,1,0,2,0,1,1,0,1,2053,5,673
대전광역시,유성구,원신흥동,원신흥동제7투,2943,2400,1074,452,552,178,133,0,0,1,0,2,1,0,0,2393,7,543
대전광역시,유성구,원신흥동,원신흥동제8투,2054,1482,607,269,389,112,94,3,0,1,1,0,1,0,1,1478,4,572
대전광역시,유성구,노은3동,합계,22245,18505,9528,2776,3779,1271,1069,16,1,7,2,5,0,6,7,18467,38,3740
대전광역시,유성구,노은3동,관내사전투표,5434,5434,2949,759,971,373,359,3,0,2,0,3,0,2,1,5422,12,0
대전광역시,유성구,노은3동,노은3동제1투,2184,1793,899,283,395,125,78,2,1,2,1,0,0,1,1,1788,5,391
대전광역시,유성구,노은3동,노은3동제2투,2553,1844,811,351,431,114,120,2,0,2,0,1,0,1,2,1835,9,709
대전광역시,유성구,노은3동,노은3동제3투,2115,1712,889,250,361,131,70,4,0,0,1,0,0,2,1,1709,3,403
대전광역시,유성구,노은3동,노은3동제4투,2376,1861,881,350,411,128,86,2,0,0,0,0,0,0,0,1858,3,515
대전광역시,유성구,노은3동,노은3동제5투,2755,2315,1291,303,449,161,108,1,0,0,0,0,0,0,0,2313,2,440
대전광역시,유성구,노은3동,노은3동제6투,2764,2066,1069,267,433,145,147,0,0,1,0,0,0,0,1,2063,3,698
대전광역시,유성구,노은3동,노은3동제7투,2064,1480,739,213,328,94,101,2,0,0,0,1,0,0,1,1479,1,584
대전광역시,유성구,잘못 투입·구분된 투표지,,0,1,0,0,1,0,0,0,0,0,0,0,0,0,0,1,0,-1
대전광역시,대덕구,합계,,157225,118816,47933,25666,28723,6953,8379,142,24,102,44,90,46,51,121,118274,542,38409
대전광역시,대덕구,거소·선상투표,,392,368,133,54,125,22,10,2,1,2,1,1,0,2,0,353,15,24
대전광역시,대덕구,관외사전투표,,13888,13871,6541,1827,2940,1111,1239,14,4,10,5,11,5,2,33,13742,129,17
대전광역시,대덕구,재외투표,,647,504,313,36,78,11,64,1,0,0,0,0,0,0,0,503,1,143
대전광역시,대덕구,오정동,합계,12868,8987,3264,2388,2212,495,551,9,1,11,2,9,3,2,5,8952,35,3881
대전광역시,대덕구,오정동,관내사전투표,1832,1832,825,427,360,96,111,1,0,4,0,1,1,0,1,1827,5,0
대전광역시,대덕구,오정동,오정동제1투,2027,1334,464,365,349,81,57,3,0,1,1,1,2,0,1,1325,9,693
대전광역시,대덕구,오정동,오정동제2투,1283,781,262,208,214,34,48,0,1,3,1,2,0,0,1,774,7,502
대전광역시,대덕구,오정동,오정동제3투,1660,1003,371,224,253,63,85,0,0,1,0,2,0,0,0,999,4,657
대전광역시,대덕구,오정동,오정동제4투,1851,1141,340,343,304,65,84,0,0,0,0,0,0,1,0,1137,4,710
대전광역시,대덕구,오정동,오정동제5투,2402,1755,644,491,426,94,92,1,0,0,0,2,0,0,1,1751,4,647
대전광역시,대덕구,오정동,오정동제6투,1813,1141,358,330,306,62,74,4,0,2,0,1,0,1,1,1139,2,672
대전광역시,대덕구,대화동,합계,6752,4649,1591,1183,1226,226,292,7,4,8,5,8,10,4,12,4576,73,2103
대전광역시,대덕구,대화동,관내사전투표,1058,1058,409,222,259,55,76,1,0,0,3,1,5,1,5,1037,21,0
대전광역시,대덕구,대화동,대화동제1투,1887,1122,385,269,300,47,47,6,3,3,2,4,5,2,6,1079,43,765
대전광역시,대덕구,대화동,대화동제2투,1503,959,308,288,243,47,63,0,0,4,0,1,0,0,1,955,4,544
대전광역시,대덕구,대화동,대화동제3투,2304,1510,489,404,424,77,106,0,1,1,0,2,0,1,0,1505,5,794
대전광역시,대덕구,회덕동,합계,12076,8754,3170,2334,2161,491,529,8,0,13,6,4,3,4,5,8728,26,3322
대전광역시,대덕구,회덕동,관내사전투표,1509,1509,639,355,316,72,116,1,0,3,2,0,1,0,1,1506,3,0
대전광역시,대덕구,회덕동,회덕동제1투,2771,2041,762,495,512,130,129,0,0,2,1,3,1,1,0,2036,5,730
대전광역시,대덕구,회덕동,회덕동제2투,2185,1417,476,415,361,70,86,2,0,1,1,0,0,0,0,1412,5,768
대전광역시,대덕구,회덕동,회덕동제3투,2239,1366,473,387,335,78,79,2,0,1,2,0,1,2,2,1362,4,873
대전광역시,대덕구,회덕동,회덕동제4투,2806,2061,731,550,539,125,101,2,0,2,0,1,0,1,2,2054,7,745
대전광역시,대덕구,회덕동,회덕동제5투,566,360,89,132,98,16,18,1,0,4,0,0,0,0,0,358,2,206
대전광역시,대덕구,비래동,합계,13562,9853,3877,2479,2331,484,626,11,0,3,2,1,3,2,10,9829,24,3709
대전광역시,대덕구,비래동,관내사전투표,2042,2042,947,441,432,81,126,2,0,0,0,0,0,1,3,2033,9,0
대전광역시,대덕구,비래동,비래동제1투,2423,1626,560,470,392,76,121,0,0,0,0,1,2,1,1,1624,2,797
대전광역시,대덕구,비래동,비래동제2투,2152,1451,567,379,334,65,100,1,0,0,0,0,1,0,2,1449,2,701
대전광역시,대덕구,비래동,비래동제3투,2218,1428,526,354,386,67,85,3,0,2,1,0,0,0,3,1427,1,790
대전광역시,대덕구,비래동,비래동제4투,2506,1689,651,458,398,89,87,3,0,1,1,0,0,0,0,1688,1,817
대전광역시,대덕구,비래동,비래동제5투,2221,1617,626,377,389,106,107,2,0,0,0,0,0,0,1,1608,9,604
대전광역시,대덕구,송촌동,합계,21073,16426,7157,2958,3935,1053,1223,17,0,15,3,6,3,7,10,16387,39,4647
대전광역시,대덕구,송촌동,관내사전투표,4615,4615,2290,674,951,286,376,5,0,6,1,3,0,2,2,4596,19,0
대전광역시,대덕구,송촌동,송촌동제1투,2667,2066,848,402,513,143,152,1,0,2,1,0,1,0,1,2064,2,601
대전광역시,대덕구,송촌동,송촌동제2투,2693,1901,800,347,492,121,135,1,0,2,0,0,1,0,1,1900,1,792
대전광역시,대덕구,송촌동,송촌동제3투,2647,2017,898,324,495,139,149,1,0,1,1,1,0,1,0,2010,7,630
대전광역시,대덕구,송촌동,송촌동제4투,2975,2303,1033,352,564,165,174,5,0,0,0,2,0,2,2,2299,4,672
대전광역시,대덕구,송촌동,송촌동제5투,1557,975,361,237,241,60,70,1,0,1,0,0,0,1,1,973,2,582
대전광역시,대덕구,송촌동,송촌동제6투,1886,1198,416,308,315,61,91,3,0,1,0,0,0,1,1,1197,1,688
대전광역시,대덕구,송촌동,송촌동제7투,2033,1351,511,314,364,78,76,0,0,2,0,0,1,0,2,1348,3,682
대전광역시,대덕구,중리동,합계,16378,11065,4329,2643,2733,558,704,15,2,9,3,10,3,6,12,11027,38,5313
대전광역시,대덕구,중리동,관내사전투표,2237,2237,1054,427,488,104,143,4,0,2,0,5,2,1,2,2232,5,0
대전광역시,대덕구,중리동,중리동제1투,2111,1292,452,363,342,54,70,0,0,2,0,0,0,4,2,1289,3,819
대전광역시,대덕구,중리동,중리동제2투,1560,982,375,232,254,43,69,2,0,3,0,0,0,0,0,978,4,578
대전광역시,대덕구,중리동,중리동제3투,2065,1279,509,286,284,91,96,2,0,1,2,1,0,0,1,1273,6,786
대전광역시,대덕구,중리동,중리동제4투,2284,1605,583,404,417,86,99,2,1,1,0,0,1,1,1,1596,9,679
대전광역시,대덕구,중리동,중리동제5투,2122,1195,435,301,303,60,83,3,1,0,1,1,0,0,1,1189,6,927
대전광역시,대덕구,중리동,중리동제6투,2075,1284,464,370,335,48,61,0,0,0,0,1,0,0,3,1282,2,791
대전광역시,대덕구,중리동,중리동제7투,1924,1191,457,260,310,72,83,2,0,0,0,2,0,0,2,1188,3,733
대전광역시,대덕구,법1동,합계,9673,7095,2787,1613,1767,372,478,8,3,9,4,7,2,5,4,7059,36,2578
대전광역시,대덕구,법1동,관내사전투표,1800,1800,791,346,411,98,132,1,0,2,1,4,0,2,2,1790,10,0
대전광역시,대덕구,법1동,법1동제1투,1237,722,274,166,170,48,53,2,0,1,3,1,2,0,0,720,2,515
대전광역시,대덕구,법1동,법1동제2투,2018,1397,578,274,357,82,92,3,0,2,0,0,0,0,1,1389,8,621
대전광역시,대덕구,법1동,법1동제3투,2715,2016,782,479,490,99,152,0,1,1,0,2,0,3,0,2009,7,699
대전광역시,대덕구,법1동,법1동제4투,1903,1160,362,348,339,45,49,2,2,3,0,0,0,0,1,1151,9,743
대전광역시,대덕구,법2동,합계,13688,10785,4180,2427,2698,675,699,19,2,7,2,8,3,8,14,10742,43,2903
대전광역시,대덕구,법2동,관내사전투표,2789,2789,1191,571,616,198,186,2,0,2,1,2,1,3,3,2776,13,0
대전광역시,대덕구,법2동,법2동제1투,2065,1336,392,416,403,45,57,3,1,3,1,0,1,1,5,1328,8,729
대전광역시,대덕구,법2동,법2동제2투,2947,2265,804,572,567,152,156,1,0,0,0,4,1,0,3,2260,5,682
대전광역시,대덕구,법2동,법2동제3투,3158,2363,950,463,617,155,158,8,0,1,0,0,0,1,1,2354,9,795
대전광역시,대덕구,법2동,법2동제4투,663,374,120,115,91,20,24,1,0,0,0,0,0,2,0,373,1,289
대전광역시,대덕구,법2동,법2동제5투,2066,1658,723,290,404,105,118,4,1,1,0,2,0,1,2,1651,7,408
대전광역시,대덕구,신탄진동,합계,9848,7171,2668,1739,1816,391,487,10,2,2,7,13,3,3,8,7149,22,2677
대전광역시,대덕구,신탄진동,관내사전투표,2037,2037,856,441,460,123,138,1,2,0,1,3,1,0,2,2028,9,0
대전광역시,대덕구,신탄진동,신탄진동제1투,2209,1301,426,315,378,67,102,1,0,0,3,5,0,1,1,1299,2,908
대전광역시,대덕구,신탄진동,신탄진동제2투,2516,1840,680,455,455,105,123,7,0,1,2,4,0,2,3,1837,3,676
대전광역시,대덕구,신탄진동,신탄진동제3투,2675,1737,614,448,467,85,110,1,0,0,1,1,2,0,1,1730,7,938
대전광역시,대덕구,신탄진동,신탄진동제4투,411,256,92,80,56,11,14,0,0,1,0,0,0,0,1,255,1,155
대전광역시,대덕구,석봉동,합계,9072,6870,2816,1425,1704,393,493,10,1,1,1,4,3,0,3,6854,16,2202
대전광역시,대덕구,석봉동,관내사전투표,1686,1686,817,276,359,93,133,3,1,1,0,0,0,0,0,1683,3,0
대전광역시,대덕구,석봉동,석봉동제1투,2288,1484,559,347,382,80,110,0,0,0,0,1,1,0,0,1480,4,804
대전광역시,대덕구,석봉동,석봉동제2투,1464,942,265,306,256,37,64,4,0,0,1,2,1,0,0,936,6,522
대전광역시,대덕구,석봉동,석봉동제3투,3634,2758,1175,496,707,183,186,3,0,0,0,1,1,0,3,2755,3,876
대전광역시,대덕구,덕암동,합계,11772,8410,3383,1871,2018,429,636,9,2,11,1,5,5,3,5,8378,32,3362
대전광역시,대덕구,덕암동,관내사전투표,2028,2028,948,407,417,92,150,1,0,1,0,2,0,0,3,2021,7,0
대전광역시,대덕구,덕암동,덕암동제1투,2598,1578,596,356,397,94,119,1,0,1,1,0,1,1,1,1568,10,1020
대전광역시,대덕구,덕암동,덕암동제2투,3279,2234,868,504,562,118,154,5,1,7,0,3,2,1,0,2225,9,1045
대전광역시,대덕구,덕암동,덕암동제3투,2993,1926,699,451,503,100,160,2,1,1,0,0,2,0,1,1920,6,1067
대전광역시,대덕구,덕암동,덕암동제4투,874,644,272,153,139,25,53,0,0,1,0,0,0,1,0,644,0,230
대전광역시,대덕구,목상동,합계,5536,4008,1724,689,979,242,348,2,2,1,2,3,0,3,0,3995,13,1528
대전광역시,대덕구,목상동,관내사전투표,1152,1152,554,146,272,74,96,0,1,1,0,1,0,1,0,1146,6,0
대전광역시,대덕구,목상동,목상동제1투,2205,1333,531,271,327,81,116,2,0,0,0,1,0,1,0,1330,3,872
대전광역시,대덕구,목상동,목상동제2투,2179,1523,639,272,380,87,136,0,1,0,2,1,0,1,0,1519,4,656
대전광역시,대덕구,잘못 투입·구분된 투표지,,0,0,0,0,0,0,0,0,0,0,0,0,0,0,0,0,0,0
울산광역시,합계,,,941093,744960,282794,203602,128520,60289,62187,829,128,575,240,641,220,411,926,741362,3598,196133
울산광역시,중구,합계,,198415,157051,56657,47625,26458,12399,12307,183,21,130,53,115,52,95,161,156256,795,41364
울산광역시,중구,거소·선상투표,,441,423,138,88,110,40,20,4,0,0,1,1,0,4,3,409,14,18
울산광역시,중구,관외사전투표,,15690,15688,6572,2973,2780,1636,1493,10,4,11,7,12,5,8,31,15542,146,2
울산광역시,중구,재외투표,,937,709,434,46,102,40,75,5,0,0,0,0,0,0,0,702,7,228
울산광역시,중구,학성동,합계,9631,7098,1938,3083,1146,404,444,8,0,15,1,8,2,5,7,7061,37,2533
울산광역시,중구,학성동,관내사전투표,2205,2204,731,841,305,128,168,3,0,6,1,3,0,0,5,2191,13,1
울산광역시,중구,학성동,학성동제1투,1957,1230,303,550,218,86,61,4,0,1,0,1,0,0,1,1225,5,727
울산광역시,중구,학성동,학성동제2투,1865,1258,325,596,180,73,69,0,0,5,0,1,1,1,1,1252,6,607
울산광역시,중구,학성동,학성동제3투,1750,1257,301,573,225,65,80,1,0,1,0,2,0,1,0,1249,8,493
울산광역시,중구,학성동,학성동제4투,1854,1149,278,523,218,52,66,0,0,2,0,1,1,3,0,1144,5,705
울산광역시,중구,반구1동,합계,15215,11643,4307,3373,1921,851,1058,13,2,8,4,7,8,10,19,11581,62,3572
울산광역시,중구,반구1동,관내사전투표,3348,3348,1512,773,451,218,353,5,0,3,1,3,1,4,1,3325,23,0
울산광역시,중구,반구1동,반구1동제1투,2801,1909,707,528,361,148,148,1,0,1,2,0,1,1,3,1901,8,892
울산광역시,중구,반구1동,반구1동제2투,3057,2225,697,762,381,171,185,4,1,1,0,2,0,3,9,2216,9,832
울산광역시,중구,반구1동,반구1동제3투,3145,2094,618,757,382,155,155,2,1,3,1,1,3,1,2,2081,13,1051
울산광역시,중구,반구1동,반구1동제4투,2864,2067,773,553,346,159,217,1,0,0,0,1,3,1,4,2058,9,797
울산광역시,중구,반구2동,합계,7742,5870,1887,2033,971,446,471,8,3,3,1,0,1,5,6,5835,35,1872
울산광역시,중구,반구2동,관내사전투표,1713,1713,668,459,267,145,152,3,1,1,0,0,1,2,1,1700,13,0
울산광역시,중구,반구2동,반구2동제1투,2077,1332,392,529,211,80,106,1,0,0,0,0,0,1,3,1323,9,745
울산광역시,중구,반구2동,반구2동제2투,2007,1438,430,504,247,125,119,2,1,0,1,0,0,1,0,1430,8,569
울산광역시,중구,반구2동,반구2동제3투,1945,1387,397,541,246,96,94,2,1,2,0,0,0,1,2,1382,5,558
울산광역시,중구,복산1동,합계,6834,5027,1554,1912,844,330,338,7,0,3,3,3,2,0,5,5001,26,1807
울산광역시,중구,복산1동,관내사전투표,1622,1622,569,577,251,101,107,3,0,0,2,1,0,0,2,1613,9,0
울산광역시,중구,복산1동,복산1동제1투,2038,1431,438,507,264,95,114,1,0,2,0,2,2,0,1,1426,5,607
울산광역시,중구,복산1동,복산1동제2투,1876,1149,345,476,180,64,72,2,0,1,1,0,0,0,1,1142,7,727
울산광역시,중구,복산1동,복산1동제3투,1298,825,202,352,149,70,45,1,0,0,0,0,0,0,1,820,5,473
울산광역시,중구,복산2동,합계,8066,6337,2283,1868,1077,532,505,6,2,10,2,6,4,2,6,6303,34,1729
울산광역시,중구,복산2동,관내사전투표,1943,1943,847,456,295,167,155,3,0,2,0,3,0,0,3,1931,12,0
울산광역시,중구,복산2동,복산2동제1투,1825,1332,425,444,247,109,93,1,0,3,1,1,1,0,1,1326,6,493
울산광역시,중구,복산2동,복산2동제2투,2478,1798,632,506,323,162,153,1,2,4,0,0,1,0,2,1786,12,680
울산광역시,중구,복산2동,복산2동제3투,1820,1264,379,462,212,94,104,1,0,1,1,2,2,2,0,1260,4,556
울산광역시,중구,성안동,합계,15560,12165,4687,3322,2071,954,1015,19,3,5,3,16,4,9,10,12118,47,3395
울산광역시,중구,성안동,관내사전투표,3649,3649,1598,881,566,253,330,4,0,1,0,3,0,2,3,3641,8,0
울산광역시,중구,성안동,성안동제1투,2967,2110,762,593,378,176,183,3,1,0,0,1,0,3,2,2102,8,857
울산광역시,중구,성안동,성안동제2투,2772,1979,686,603,365,152,151,2,0,3,0,0,3,4,3,1972,7,793
울산광역시,중구,성안동,성안동제3투,3093,2253,839,639,359,200,187,6,1,0,2,5,0,0,2,2240,13,840
울산광역시,중구,성안동,성안동제4투,3079,2174,802,606,403,173,164,4,1,1,1,7,1,0,0,2163,11,905
울산광역시,중구,중앙동,합계,12897,8899,2342,3967,1447,593,440,11,2,13,5,6,3,5,5,8839,60,3998
울산광역시,중구,중앙동,관내사전투표,1907,1907,630,747,277,130,105,1,0,1,1,2,1,2,0,1897,10,0
울산광역시,중구,중앙동,중앙동제1투,3176,1860,456,811,334,153,91,2,1,1,1,0,1,1,2,1854,6,1316
울산광역시,중구,중앙동,중앙동제2투,2423,1619,356,762,268,106,94,3,0,5,2,2,0,1,1,1600,19,804
울산광역시,중구,중앙동,중앙동제3투,1979,1258,326,609,203,62,46,1,0,4,0,0,1,1,0,1253,5,721
울산광역시,중구,중앙동,중앙동제4투,1935,1292,312,601,221,79,58,2,0,2,1,2,0,0,2,1280,12,643
울산광역시,중구,중앙동,중앙동제5투,1477,963,262,437,144,63,46,2,1,0,0,0,0,0,0,955,8,514
울산광역시,중구,우정동,합계,16452,12858,4322,4492,2186,940,821,12,0,7,1,6,2,9,4,12802,56,3594
울산광역시,중구,우정동,관내사전투표,2688,2688,1050,850,392,193,187,3,0,1,0,2,0,2,1,2681,7,0
울산광역시,중구,우정동,우정동제1투,2983,1962,545,787,374,137,99,5,0,3,0,1,0,2,1,1954,8,1021
울산광역시,중구,우정동,우정동제2투,2100,1281,308,602,197,90,71,1,0,2,0,0,0,1,1,1273,8,819
울산광역시,중구,우정동,우정동제3투,1802,1279,362,511,222,97,75,0,0,1,1,0,0,2,0,1271,8,523
울산광역시,중구,우정동,우정동제4투,3518,2855,1060,853,529,215,187,2,0,0,0,0,1,1,0,2848,7,663
울산광역시,중구,우정동,우정동제5투,3361,2793,997,889,472,208,202,1,0,0,0,3,1,1,1,2775,18,568
울산광역시,중구,태화동,합계,25241,20769,8073,5746,3580,1766,1463,24,1,19,2,13,2,8,15,20712,57,4472
울산광역시,중구,태화동,관내사전투표,4623,4623,2060,1060,685,407,379,8,0,4,0,4,0,2,4,4613,10,0
울산광역시,중구,태화동,태화동제1투,2533,1805,631,620,303,119,119,1,0,0,0,2,0,0,4,1799,6,728
울산광역시,중구,태화동,태화동제2투,2647,1897,628,662,324,154,116,2,0,3,0,0,0,0,1,1890,7,750
울산광역시,중구,태화동,태화동제3투,3125,2377,715,892,428,183,138,2,0,2,0,2,2,0,1,2365,12,748
울산광역시,중구,태화동,태화동제4투,2528,2046,763,614,334,175,147,0,0,4,0,1,0,1,3,2042,4,482
울산광역시,중구,태화동,태화동제5투,2778,2143,629,775,389,174,150,7,0,4,1,2,0,3,1,2135,8,635
울산광역시,중구,태화동,태화동제6투,2632,2221,848,548,450,210,153,2,0,1,1,1,0,2,1,2217,4,411
울산광역시,중구,태화동,태화동제7투,2282,1930,944,319,361,172,130,1,0,0,0,0,0,0,0,1927,3,352
울산광역시,중구,태화동,태화동제8투,2093,1727,855,256,306,172,131,1,1,1,0,1,0,0,0,1724,3,366
울산광역시,중구,다운동,합계,21168,15974,5222,5479,2741,1247,1149,12,0,12,7,9,5,13,12,15908,66,5194
울산광역시,중구,다운동,관내사전투표,3438,3438,1350,975,545,254,281,4,0,1,4,6,1,1,1,3423,15,0
울산광역시,중구,다운동,다운동제1투,3239,2278,668,841,436,195,124,1,0,1,0,1,1,1,0,2269,9,961
울산광역시,중구,다운동,다운동제2투,2768,1789,568,680,272,145,106,2,0,2,0,0,0,3,2,1780,9,979
울산광역시,중구,다운동,다운동제3투,2627,1899,613,688,289,141,151,2,0,1,0,0,2,1,4,1892,7,728
울산광역시,중구,다운동,다운동제4투,3087,2148,574,868,384,165,140,1,0,3,1,0,0,3,1,2140,8,939
울산광역시,중구,다운동,다운동제5투,3036,2142,627,786,388,165,163,1,0,3,1,0,0,1,1,2136,6,894
울산광역시,중구,다운동,다운동제6투,2973,2280,822,641,427,182,184,1,0,1,1,2,1,3,3,2268,12,693
울산광역시,중구,병영1동,합계,19241,15047,5510,4590,2395,1114,1300,26,2,9,7,7,8,6,15,14989,58,4194
울산광역시,중구,병영1동,관내사전투표,4246,4246,1721,1130,613,300,444,8,1,3,0,3,1,0,5,4229,17,0
울산광역시,중구,병영1동,병영1동제1투,2508,1552,451,645,246,94,96,1,0,2,1,1,2,1,1,1541,11,956
울산광역시,중구,병영1동,병영1동제2투,2303,1461,396,569,239,114,126,2,0,1,1,1,1,0,3,1453,8,842
울산광역시,중구,병영1동,병영1동제3투,2716,1901,593,753,258,124,144,6,1,1,2,0,2,3,5,1892,9,815
울산광역시,중구,병영1동,병영1동제4투,1999,1363,385,573,219,94,74,4,0,2,0,1,2,2,1,1357,6,636
울산광역시,중구,병영1동,병영1동제5투,2596,2093,885,467,380,152,198,5,0,0,3,0,0,0,0,2090,3,503
울산광역시,중구,병영1동,병영1동제6투,2873,2431,1079,453,440,236,218,0,0,0,0,1,0,0,0,2427,4,442
울산광역시,중구,병영2동,합계,15548,11860,4497,3238,1969,901,1120,10,1,11,5,16,5,4,15,11792,68,3688
울산광역시,중구,병영2동,관내사전투표,2262,2262,1030,508,278,142,272,2,0,2,1,4,2,1,8,2250,12,0
울산광역시,중구,병영2동,병영2동제1투,2371,1662,524,569,283,131,133,2,0,2,0,3,0,1,1,1649,13,709
울산광역시,중구,병영2동,병영2동제2투,1461,954,294,306,189,66,81,2,1,1,1,0,0,0,2,943,11,507
울산광역시,중구,병영2동,병영2동제3투,1412,914,255,330,165,85,69,1,0,2,0,0,0,1,0,908,6,498
울산광역시,중구,병영2동,병영2동제4투,1789,1197,350,471,187,79,96,0,0,1,1,1,1,1,2,1190,7,592
울산광역시,중구,병영2동,병영2동제5투,2555,1944,723,520,340,140,198,2,0,3,1,3,1,0,1,1932,12,611
울산광역시,중구,병영2동,병영2동제6투,3698,2927,1321,534,527,258,271,1,0,0,1,5,1,0,1,2920,7,771
울산광역시,중구,약사동,합계,7752,6683,2891,1414,1118,605,595,8,1,4,4,5,1,7,8,6661,22,1069
울산광역시,중구,약사동,관내사전투표,2779,2779,1313,549,422,231,237,2,1,2,2,0,0,3,5,2767,12,0
울산광역시,중구,약사동,약사동제1투,2483,2024,855,442,349,190,173,4,0,1,2,2,1,1,2,2022,2,459
울산광역시,중구,약사동,약사동제2투,2490,1880,723,423,347,184,185,2,0,1,0,3,0,3,1,1872,8,610
울산광역시,중구,잘못 투입·구분된 투표지,,0,1,0,1,0,0,0,0,0,0,0,0,0,0,0,1,0,-1
울산광역시,남구,합계,,276867,219569,80662,63331,39040,18536,16078,259,29,128,66,146,36,103,237,218651,918,57298
울산광역시,남구,거소·선상투표,,592,557,196,103,175,17,34,3,1,5,1,0,0,1,6,542,15,35
울산광역시,남구,관외사전투표,,22543,22528,9336,4223,4078,2549,2022,26,12,8,9,18,6,11,54,22352,176,15
울산광역시,남구,재외투표,,1392,1090,635,80,156,57,155,1,0,0,0,1,0,0,0,1085,5,302
울산광역시,남구,신정1동,합계,16055,11972,3492,5035,1902,782,663,16,0,12,2,7,2,8,5,11926,46,4083
울산광역시,남구,신정1동,관내사전투표,3235,3235,1116,1251,441,207,192,2,0,2,1,4,0,4,3,3223,12,0
울산광역시,남구,신정1동,신정1동제1투,3407,2018,519,931,345,118,91,1,0,3,0,1,1,0,1,2011,7,1389
울산광역시,남구,신정1동,신정1동제2투,3109,2020,500,904,345,140,111,4,0,3,1,1,1,0,1,2011,9,1089
울산광역시,남구,신정1동,신정1동제3투,3004,2268,674,896,377,172,129,5,0,2,0,1,0,2,0,2258,10,736
울산광역시,남구,신정1동,신정1동제4투,3300,2431,683,1053,394,145,140,4,0,2,0,0,0,2,0,2423,8,869
울산광역시,남구,신정2동,합계,18186,14585,4959,4679,2756,1212,878,20,0,4,5,4,0,6,11,14534,51,3601
울산광역시,남구,신정2동,관내사전투표,3099,3099,1212,858,483,290,229,8,0,0,2,2,0,0,3,3087,12,0
울산광역시,남구,신정2동,신정2동제1투,2776,1719,482,691,297,134,103,2,0,2,0,0,0,0,2,1713,6,1057
울산광역시,남구,신정2동,신정2동제2투,3248,2566,964,705,512,204,164,2,0,1,1,0,0,1,2,2556,10,682
울산광역시,남구,신정2동,신정2동제3투,3637,2811,937,924,560,211,158,3,0,1,0,0,0,2,2,2798,13,826
울산광역시,남구,신정2동,신정2동제4투,3327,2617,793,908,535,216,150,2,0,0,2,0,0,1,1,2608,9,710
울산광역시,남구,신정2동,신정2동제5투,2099,1773,571,593,369,157,74,3,0,0,0,2,0,2,1,1772,1,326
울산광역시,남구,신정3동,합계,13414,9923,3385,3381,1676,743,665,10,0,9,4,4,3,5,6,9891,32,3491
울산광역시,남구,신정3동,관내사전투표,2951,2951,1189,912,429,201,200,0,0,3,2,2,2,1,2,2943,8,0
울산광역시,남구,신정3동,신정3동제1투,3133,1823,475,762,328,124,121,1,0,2,0,1,0,2,0,1816,7,1310
울산광역시,남구,신정3동,신정3동제2투,3748,2999,1157,752,587,282,208,5,0,0,1,0,1,0,1,2994,5,749
울산광역시,남구,신정3동,신정3동제3투,3582,2150,564,955,332,136,136,4,0,4,1,1,0,2,3,2138,12,1432
울산광역시,남구,신정4동,합계,17844,14219,5339,4191,2475,1164,938,17,4,8,6,11,1,4,9,14167,52,3625
울산광역시,남구,신정4동,관내사전투표,3734,3734,1582,1008,590,286,239,6,2,0,4,3,0,0,2,3722,12,0
울산광역시,남구,신정4동,신정4동제1투,3702,3011,1209,751,558,262,216,1,0,3,0,1,0,1,0,3002,9,691
울산광역시,남구,신정4동,신정4동제2투,2436,1728,512,672,280,147,98,3,0,0,1,4,0,1,1,1719,9,708
울산광역시,남구,신정4동,신정4동제3투,2140,1592,513,556,302,103,101,1,0,2,1,2,1,1,2,1585,7,548
울산광역시,남구,신정4동,신정4동제4투,1543,1012,289,417,176,61,57,5,1,0,0,0,0,0,1,1007,5,531
울산광역시,남구,신정4동,신정4동제5투,1737,1091,394,341,181,83,82,1,0,2,0,0,0,0,2,1086,5,646
울산광역시,남구,신정4동,신정4동제6투,2552,2051,840,446,388,222,145,0,1,1,0,1,0,1,1,2046,5,501
울산광역시,남구,신정5동,합계,7520,5542,1744,2047,915,395,402,3,1,5,1,5,1,1,3,5523,19,1978
울산광역시,남구,신정5동,관내사전투표,1908,1908,698,631,275,138,148,1,1,2,0,2,1,1,2,1900,8,0
울산광역시,남구,신정5동,신정5동제1투,2934,1932,514,767,349,154,139,0,0,1,0,1,0,0,0,1925,7,1002
울산광역시,남구,신정5동,신정5동제2투,2678,1702,532,649,291,103,115,2,0,2,1,2,0,0,1,1698,4,976
울산광역시,남구,달동,합계,22191,16262,5692,4964,2918,1332,1200,24,0,7,3,17,3,5,13,16178,84,5929
울산광역시,남구,달동,관내사전투표,3456,3456,1466,838,535,280,294,5,0,2,0,6,1,0,5,3432,24,0
울산광역시,남구,달동,달동제1투,4086,2478,829,795,451,198,182,8,0,0,1,2,1,1,0,2468,10,1608
울산광역시,남구,달동,달동제2투,2963,1839,536,713,317,149,108,3,0,1,0,2,0,1,0,1830,9,1124
울산광역시,남구,달동,달동제3투,2348,1757,594,549,332,137,130,6,0,0,0,1,0,0,1,1750,7,591
울산광역시,남구,달동,달동제4투,2656,1703,448,731,315,104,85,0,0,1,1,2,0,0,3,1690,13,953
울산광역시,남구,달동,달동제5투,3259,2334,848,574,492,211,187,0,0,1,0,2,1,0,3,2319,15,925
울산광역시,남구,달동,달동제6투,3423,2695,971,764,476,253,214,2,0,2,1,2,0,3,1,2689,6,728
울산광역시,남구,삼산동,합계,38740,28747,11401,7302,5072,2402,2374,27,0,18,9,16,4,9,27,28661,86,9993
울산광역시,남구,삼산동,관내사전투표,7492,7492,3422,1583,1138,618,669,10,0,1,3,4,0,4,8,7460,32,0
울산광역시,남구,삼산동,삼산동제1투,3556,2463,846,738,442,230,187,1,0,3,1,1,1,1,3,2454,9,1093
울산광역시,남구,삼산동,삼산동제2투,3305,2324,828,691,445,174,174,2,0,1,1,0,0,1,2,2319,5,981
울산광역시,남구,삼산동,삼산동제3투,2999,2054,680,714,361,163,125,2,0,1,1,1,0,0,1,2049,5,945
울산광역시,남구,삼산동,삼산동제4투,3684,1710,566,523,322,137,144,1,0,0,2,0,0,2,5,1702,8,1974
울산광역시,남구,삼산동,삼산동제5투,3291,2294,910,536,449,189,194,3,0,2,1,1,1,0,0,2286,8,997
울산광역시,남구,삼산동,삼산동제6투,3770,2890,1192,636,510,263,274,1,0,2,0,0,2,0,4,2884,6,880
울산광역시,남구,삼산동,삼산동제7투,3659,2829,1287,551,467,235,275,1,0,1,0,5,0,0,1,2823,6,830
울산광역시,남구,삼산동,삼산동제8투,3177,2144,724,658,442,177,127,5,0,5,0,2,0,1,0,2141,3,1033
울산광역시,남구,삼산동,삼산동제9투,3807,2547,946,672,496,216,205,1,0,2,0,2,0,0,3,2543,4,1260
울산광역시,남구,삼호동,관내사전투표,3356,3356,1398,825,552,275,273,7,0,2,0,2,0,1,7,3342,14,0
울산광역시,남구,삼호동,합계,18625,13982,4900,4311,2511,1107,1020,22,1,9,1,10,3,8,22,13925,57,4643
울산광역시,남구,삼호동,삼호동제1투,3453,2523,840,816,457,228,162,2,0,1,0,3,2,1,3,2515,8,930
울산광역시,남구,삼호동,삼호동제2투,3080,2029,640,731,377,128,136,3,0,0,0,1,0,1,3,2020,9,1051
울산광역시,남구,삼호동,삼호동제3투,2559,1635,454,633,311,108,113,0,0,1,0,0,0,3,5,1628,7,924
울산광역시,남구,삼호동,삼호동제4투,3194,2179,676,783,390,162,143,5,1,4,0,3,0,1,2,2170,9,1015
울산광역시,남구,삼호동,삼호동제5투,2983,2260,892,523,424,206,193,5,0,1,1,1,1,1,2,2250,10,723
울산광역시,남구,무거동,합계,25632,20901,8174,5277,3700,1981,1581,25,4,11,10,16,3,12,26,20820,81,4731
울산광역시,남구,무거동,관내사전투표,4933,4933,2263,938,778,459,450,1,0,2,3,3,0,4,4,4905,28,0
울산광역시,남구,무거동,무거동제1투,3077,2207,766,693,382,183,166,3,0,1,1,1,0,1,3,2200,7,870
울산광역시,남구,무거동,무거동제2투,2093,1583,545,511,255,158,97,3,2,2,1,1,0,0,3,1578,5,510
울산광역시,남구,무거동,무거동제3투,3211,2548,948,666,480,247,174,5,1,6,4,1,1,0,4,2537,11,663
울산광역시,남구,무거동,무거동제4투,2829,2188,893,460,427,211,180,4,0,0,1,1,0,1,4,2182,6,641
울산광역시,남구,무거동,무거동제5투,3208,2385,728,843,434,225,137,1,1,0,0,2,1,2,3,2377,8,823
울산광역시,남구,무거동,무거동제6투,3173,2518,1041,528,468,244,213,5,0,0,0,5,1,2,3,2510,8,655
울산광역시,남구,무거동,무거동제7투,3108,2539,990,638,476,254,164,3,0,0,0,2,0,2,2,2531,8,569
울산광역시,남구,옥동,합계,19233,16235,6142,4540,3044,1385,1020,13,0,9,6,13,0,8,9,16189,46,2998
울산광역시,남구,옥동,관내사전투표,4639,4639,2076,990,782,420,329,5,0,3,2,7,0,3,3,4620,19,0
울산광역시,남구,옥동,옥동제1투,2143,1532,453,576,272,119,101,1,0,2,1,0,0,1,1,1527,5,611
울산광역시,남구,옥동,옥동제2투,2849,2343,865,710,437,170,154,1,0,0,1,0,0,0,0,2338,5,506
울산광역시,남구,옥동,옥동제3투,2424,2024,774,565,383,174,119,2,0,0,1,1,0,1,3,2023,1,400
울산광역시,남구,옥동,옥동제4투,2304,1684,567,485,353,144,115,3,0,2,1,3,0,0,1,1674,10,620
울산광역시,남구,옥동,옥동제5투,2599,2060,714,670,403,153,112,1,0,0,0,2,0,0,0,2055,5,539
울산광역시,남구,옥동,옥동제6투,2275,1953,693,544,414,205,90,0,0,2,0,0,0,3,1,1952,1,322
울산광역시,남구,야음장생포동,합계,10299,7263,2036,3073,1196,448,432,12,0,6,3,9,3,5,4,7227,36,3036
울산광역시,남구,야음장생포동,관내사전투표,2011,2011,755,686,300,125,121,1,0,2,1,4,0,1,0,1996,15,0
울산광역시,남구,야음장생포동,야음장생포동제1투,2799,1665,395,750,291,109,99,5,0,1,1,3,3,3,0,1660,5,1134
울산광역시,남구,야음장생포동,야음장생포동제2투,2001,1257,332,544,212,86,73,0,0,1,1,1,0,0,2,1252,5,744
울산광역시,남구,야음장생포동,야음장생포동제3투,2431,1587,415,695,280,81,97,6,0,2,0,1,0,0,1,1578,9,844
울산광역시,남구,야음장생포동,야음장생포동제4투,1057,743,139,398,113,47,42,0,0,0,0,0,0,1,1,741,2,314
울산광역시,남구,대현동,합계,20569,16430,6107,4721,2917,1384,1169,21,1,9,5,6,1,8,16,16365,65,4139
울산광역시,남구,대현동,관내사전투표,4335,4335,1892,984,692,384,344,7,0,3,1,3,0,1,4,4315,20,0
울산광역시,남구,대현동,대현동제1투,2945,2043,675,690,371,154,137,1,0,1,2,0,0,1,3,2035,8,902
울산광역시,남구,대현동,대현동제2투,3029,2503,911,696,484,230,164,2,0,0,0,0,0,2,3,2492,11,526
울산광역시,남구,대현동,대현동제3투,3135,2328,813,707,448,183,161,1,1,0,2,2,0,0,1,2319,9,807
울산광역시,남구,대현동,대현동제4투,2751,2092,776,587,405,173,139,5,0,1,0,0,0,2,0,2088,4,659
울산광역시,남구,대현동,대현동제5투,3335,2482,874,758,424,217,187,2,0,2,0,1,0,1,4,2470,12,853
울산광역시,남구,대현동,대현동제6투,1039,647,166,299,93,43,37,3,0,2,0,0,1,1,1,646,1,392
울산광역시,남구,수암동,합계,12561,10597,4084,2805,1892,924,825,5,2,2,0,3,4,5,11,10562,35,1964
울산광역시,남구,수암동,관내사전투표,3626,3626,1582,842,549,323,306,0,0,2,0,1,1,3,6,3615,11,0
울산광역시,남구,수암동,수암동제1투,1398,1100,386,262,244,107,96,1,0,0,0,0,0,0,0,1096,4,298
울산광역시,남구,수암동,수암동제2투,2306,1637,541,554,272,127,129,1,0,0,0,1,1,0,4,1630,7,669
울산광역시,남구,수암동,수암동제3투,2936,2408,922,647,477,197,152,2,2,0,0,1,0,0,1,2401,7,528
울산광역시,남구,수암동,수암동제4투,2295,1826,653,500,350,170,142,1,0,0,0,0,2,2,0,1820,6,469
울산광역시,남구,선암동,합계,11471,8736,3040,2599,1657,654,700,14,3,6,1,6,2,7,15,8704,32,2735
울산광역시,남구,선암동,관내사전투표,1176,1176,519,284,184,65,111,3,1,2,0,0,1,0,2,1172,4,0
울산광역시,남구,선암동,선암동제1투,2665,1724,540,612,313,119,121,1,1,0,0,1,0,2,5,1715,9,941
울산광역시,남구,선암동,선암동제2투,3613,2733,992,726,555,221,213,6,0,1,1,3,1,3,4,2726,7,880
울산광역시,남구,선암동,선암동제3투,1969,1546,465,524,291,117,137,1,1,2,0,0,0,1,3,1542,4,423
울산광역시,남구,선암동,선암동제4투,2048,1557,524,453,314,132,118,3,0,1,0,2,0,1,1,1549,8,491
울산광역시,남구,잘못 투입·구분된 투표지,,0,0,0,0,0,0,0,0,0,0,0,0,0,0,0,0,0,0
울산광역시,동구,합계,,138379,109054,44931,23701,19290,8337,11590,78,17,105,39,139,36,48,160,108471,583,29325
울산광역시,동구,거소·선상투표,,264,260,87,41,68,22,12,0,1,2,2,1,0,1,3,240,20,4
울산광역시,동구,관외사전투표,,10594,10594,4701,1579,1896,1055,1170,10,3,7,4,12,5,8,29,10479,115,0
울산광역시,동구,재외투표,,422,326,202,21,43,16,40,0,0,0,0,1,0,0,0,323,3,96
울산광역시,동구,방어동,합계,30659,22147,8556,5487,3949,1619,2296,16,3,25,8,32,12,13,33,22049,98,8512
울산광역시,동구,방어동,관내사전투표,5147,5146,2344,1045,783,356,568,4,0,2,2,13,3,2,8,5130,16,1
울산광역시,동구,방어동,방어동제1투,3301,1954,604,620,379,151,181,1,2,4,0,1,0,1,4,1948,6,1347
울산광역시,동구,방어동,방어동제2투,2463,1608,469,587,264,132,126,0,0,8,0,1,3,2,4,1596,12,855
울산광역시,동구,방어동,방어동제3투,2500,1610,556,471,277,109,177,1,1,0,0,5,0,1,0,1598,12,890
울산광역시,동구,방어동,방어동제4투,2192,1539,559,437,251,105,165,0,0,2,3,0,2,1,3,1528,11,653
울산광역시,동구,방어동,방어동제5투,3183,2157,769,581,440,139,207,2,0,4,1,0,1,0,6,2150,7,1026
울산광역시,동구,방어동,방어동제6투,3379,2340,955,450,471,169,277,1,0,2,0,6,1,1,0,2333,7,1039
울산광역시,동구,방어동,방어동제7투,2978,2042,782,467,386,161,226,2,0,1,2,2,0,2,3,2034,8,936
울산광역시,동구,방어동,방어동제8투,2727,1684,627,384,331,150,173,4,0,1,0,1,1,2,3,1677,7,1043
울산광역시,동구,방어동,방어동제9투,2789,2067,891,445,367,147,196,1,0,1,0,3,1,1,2,2055,12,722
울산광역시,동구,일산동,합계,5686,3998,1387,1198,713,269,370,2,0,8,0,7,3,5,7,3969,29,1688
울산광역시,동구,일산동,관내사전투표,1245,1245,493,339,185,84,115,0,0,3,0,5,2,0,2,1228,17,0
울산광역시,동구,일산동,일산동제1투,2243,1412,447,473,256,91,127,0,0,1,0,2,1,5,2,1405,7,831
울산광역시,동구,일산동,일산동제2투,2198,1341,447,386,272,94,128,2,0,4,0,0,0,0,3,1336,5,857
울산광역시,동구,화정동,관내사전투표,3135,3135,1424,662,491,206,333,0,0,5,0,3,0,2,4,3130,5,0
울산광역시,동구,화정동,합계,16519,12320,4983,2829,2248,862,1284,6,0,12,0,10,5,4,20,12263,57,4199
울산광역시,동구,화정동,화정동제1투,3625,2902,1383,372,523,267,341,1,0,1,0,0,2,0,4,2894,8,723
울산광역시,동구,화정동,화정동제2투,2910,1748,503,615,351,104,152,3,0,1,0,2,0,1,6,1738,10,1162
울산광역시,동구,화정동,화정동제3투,2621,1769,718,382,344,114,191,1,0,0,0,1,1,0,1,1753,16,852
울산광역시,동구,화정동,화정동제4투,1975,1329,398,444,275,92,100,1,0,4,0,2,1,1,2,1320,9,646
울산광역시,동구,화정동,화정동제5투,2253,1437,557,354,264,79,167,0,0,1,0,2,1,0,3,1428,9,816
울산광역시,동구,대송동,합계,10298,7860,3211,1680,1397,614,876,10,1,8,6,5,3,3,8,7822,38,2438
울산광역시,동구,대송동,관내사전투표,2212,2212,1037,388,339,164,264,1,0,1,1,2,0,1,2,2200,12,0
울산광역시,동구,대송동,대송동제1투,1955,1386,537,297,251,114,170,4,0,2,2,0,2,0,1,1380,6,569
울산광역시,동구,대송동,대송동제2투,2982,2213,878,454,429,171,258,4,1,2,3,1,0,1,4,2206,7,769
울산광역시,동구,대송동,대송동제3투,3149,2049,759,541,378,165,184,1,0,3,0,2,1,1,1,2036,13,1100
울산광역시,동구,전하1동,합계,12471,9988,4130,2249,1747,741,1028,3,0,14,7,10,3,1,14,9947,41,2483
울산광역시,동구,전하1동,관내사전투표,3380,3380,1558,656,520,270,348,2,0,2,1,5,1,0,4,3367,13,0
울산광역시,동구,전하1동,전하1동제1투,1419,862,318,240,151,65,84,0,0,0,0,2,1,0,0,861,1,557
울산광역시,동구,전하1동,전하1동제2투,3011,2140,800,553,405,154,198,0,0,3,3,2,1,1,6,2126,14,871
울산광역시,동구,전하1동,전하1동제3투,2492,1815,707,427,354,106,198,0,0,6,3,1,0,0,4,1806,9,677
울산광역시,동구,전하1동,전하1동제4투,2169,1791,747,373,317,146,200,1,0,3,0,0,0,0,0,1787,4,378
울산광역시,동구,전하2동,합계,16842,13683,5825,2855,2387,1010,1482,17,2,6,3,15,0,2,18,13622,61,3159
울산광역시,동구,전하2동,관내사전투표,4227,4227,1995,786,644,298,467,4,0,2,2,5,0,0,4,4207,20,0
울산광역시,동구,전하2동,전하2동제1투,2182,1467,505,471,250,93,128,2,1,0,0,3,0,1,3,1457,10,715
울산광역시,동구,전하2동,전하2동제2투,2122,1364,467,392,248,110,133,4,0,2,0,1,0,1,1,1359,5,758
울산광역시,동구,전하2동,전하2동제3투,1716,1184,420,344,210,81,113,1,0,2,0,4,0,0,3,1178,6,532
울산광역시,동구,전하2동,전하2동제4투,2506,2045,853,362,441,149,223,3,1,0,0,1,0,0,3,2036,9,461
울산광역시,동구,전하2동,전하2동제5투,1606,1314,609,196,238,108,155,0,0,0,1,0,0,0,2,1309,5,292
울산광역시,동구,전하2동,전하2동제6투,2483,2082,976,304,356,171,263,3,0,0,0,1,0,0,2,2076,6,401
울산광역시,동구,남목1동,합계,7850,6192,2466,1536,1066,453,598,3,0,4,1,20,1,1,3,6152,40,1658
울산광역시,동구,남목1동,관내사전투표,1853,1853,860,359,276,148,188,1,0,0,1,7,0,0,0,1840,13,0
울산광역시,동구,남목1동,남목1동제1투,1711,1156,401,315,235,79,107,0,0,3,0,4,1,0,1,1146,10,555
울산광역시,동구,남목1동,남목1동제2투,2049,1480,480,489,264,93,137,0,0,1,0,4,0,1,1,1470,10,569
울산광역시,동구,남목1동,남목1동제3투,2237,1703,725,373,291,133,166,2,0,0,0,5,0,0,1,1696,7,534
울산광역시,동구,남목2동,합계,16634,13527,5895,2523,2447,1082,1470,6,5,11,3,10,3,7,14,13476,51,3107
울산광역시,동구,남목2동,관내사전투표,2983,2983,1411,563,453,225,307,1,2,2,0,3,0,3,3,2973,10,0
울산광역시,동구,남목2동,남목2동제1투,2222,1538,589,366,292,129,154,1,0,0,1,1,0,0,2,1535,3,684
울산광역시,동구,남목2동,남목2동제2투,1612,1189,481,261,220,88,131,0,0,0,2,3,0,2,0,1188,1,423
울산광역시,동구,남목2동,남목2동제3투,4085,3116,1284,576,620,238,367,1,2,7,0,2,0,2,3,3102,14,969
울산광역시,동구,남목2동,남목2동제4투,2712,2101,956,345,346,178,257,3,1,1,0,1,2,0,3,2093,8,611
울산광역시,동구,남목2동,남목2동제5투,3020,2600,1174,412,516,224,254,0,0,1,0,0,1,0,3,2585,15,420
울산광역시,동구,남목3동,합계,10140,8159,3488,1703,1329,594,964,5,2,8,5,16,1,3,11,8129,30,1981
울산광역시,동구,남목3동,관내사전투표,2211,2211,1114,334,329,137,276,1,1,4,0,6,0,0,2,2204,7,0
울산광역시,동구,남목3동,남목3동제1투,2406,1798,732,335,346,148,223,0,1,0,2,3,0,0,1,1791,7,608
울산광역시,동구,남목3동,남목3동제2투,2425,1738,662,449,289,126,193,2,0,1,2,3,0,1,4,1732,6,687
울산광역시,동구,남목3동,남목3동제3투,2464,1933,871,342,302,156,243,2,0,2,1,4,1,1,4,1929,4,531
울산광역시,동구,남목3동,남목3동제4투,634,479,109,243,63,27,29,0,0,1,0,0,0,1,0,473,6,155
울산광역시,동구,잘못 투입·구분된 투표지,,0,0,0,0,0,0,0,0,0,0,0,0,0,0,0,0,0,0
울산광역시,북구,합계,,151453,122933,52058,26596,20115,10004,12916,146,20,85,31,137,48,58,164,122378,555,28520
울산광역시,북구,거소·선상투표,,331,314,106,55,88,26,21,1,1,1,2,0,0,0,5,306,8,17
울산광역시,북구,관외사전투표,,13135,13134,5685,2165,2323,1283,1453,23,5,4,5,17,7,9,26,13005,129,1
울산광역시,북구,재외투표,,583,426,234,25,82,26,55,1,0,0,0,1,0,0,1,425,1,157
울산광역시,북구,농소1동,합계,20431,15573,5834,4296,2698,1163,1425,19,2,16,3,13,5,5,23,15502,71,4858
울산광역시,북구,농소1동,관내사전투표,2702,2702,1101,709,372,204,283,6,0,4,0,3,1,1,5,2689,13,0
울산광역시,북구,농소1동,농소1동제1투,2713,1803,536,697,291,117,140,3,0,5,0,1,2,1,1,1794,9,910
울산광역시,북구,농소1동,농소1동제2투,4014,2423,731,859,441,167,196,3,1,1,0,2,1,1,5,2408,15,1591
울산광역시,북구,농소1동,농소1동제3투,3434,2724,1083,658,500,213,246,1,0,0,2,4,0,2,3,2712,12,710
울산광역시,북구,농소1동,농소1동제4투,1403,970,323,316,166,79,76,2,0,3,0,0,0,0,2,967,3,433
울산광역시,북구,농소1동,농소1동제5투,1300,956,349,265,180,60,87,1,0,1,0,2,1,0,2,948,8,344
울산광역시,북구,농소1동,농소1동제6투,2943,2389,995,495,440,201,242,3,1,1,0,1,0,0,2,2381,8,554
울산광역시,북구,농소1동,농소1동제7투,1922,1606,716,297,308,122,155,0,0,1,1,0,0,0,3,1603,3,316
울산광역시,북구,농소2동,합계,26364,21171,8906,4613,3529,1770,2181,12,2,21,4,10,5,9,30,21092,79,5193
울산광역시,북구,농소2동,관내사전투표,7112,7112,3476,1142,1029,590,819,6,2,7,0,4,2,1,13,7091,21,0
울산광역시,북구,농소2동,농소2동제1투,3667,2691,1206,479,487,232,272,0,0,0,1,1,0,1,0,2679,12,976
울산광역시,북구,농소2동,농소2동제2투,1655,1112,351,395,148,102,104,2,0,3,0,1,0,1,2,1109,3,543
울산광역시,북구,농소2동,농소2동제3투,3506,2457,878,693,420,205,242,1,0,3,0,0,1,2,3,2448,9,1049
울산광역시,북구,농소2동,농소2동제4투,2339,1610,509,543,288,126,121,1,0,1,2,2,1,1,2,1597,13,729
울산광역시,북구,농소2동,농소2동제5투,2237,1582,577,375,323,152,138,1,0,6,0,0,0,1,3,1576,6,655
울산광역시,북구,농소2동,농소2동제6투,2698,2041,762,504,374,167,215,1,0,1,1,2,1,2,5,2035,6,657
울산광역시,북구,농소2동,농소2동제7투,3150,2566,1147,482,460,196,270,0,0,0,0,0,0,0,2,2557,9,584
울산광역시,북구,농소3동,관내사전투표,5858,5858,3017,858,773,483,682,6,0,1,1,11,2,2,5,5841,17,0
울산광역시,북구,농소3동,합계,27084,21890,9962,4292,3541,1843,2080,24,4,10,4,28,7,4,27,21826,64,5194
울산광역시,북구,농소3동,농소3동제1투,2781,2001,798,572,328,144,139,5,1,1,0,1,1,1,4,1995,6,780
울산광역시,북구,농소3동,농소3동제2투,3694,2737,1110,612,487,235,274,1,1,1,0,2,1,0,5,2729,8,957
울산광역시,북구,농소3동,농소3동제3투,2449,1874,804,382,302,184,181,0,0,4,1,4,1,0,3,1866,8,575
울산광역시,북구,농소3동,농소3동제4투,2720,1930,733,512,344,165,159,4,0,0,1,3,0,0,4,1925,5,790
울산광역시,북구,농소3동,농소3동제5투,1781,1195,531,273,190,75,112,1,0,3,1,1,0,0,0,1187,8,586
울산광역시,북구,농소3동,농소3동제6투,2873,2313,1114,357,430,201,200,0,1,0,0,3,1,0,2,2309,4,560
울산광역시,북구,농소3동,농소3동제7투,3079,2474,1157,492,412,214,183,5,1,0,0,3,0,1,3,2471,3,605
울산광역시,북구,농소3동,농소3동제8투,1849,1508,698,234,275,142,150,2,0,0,0,0,1,0,1,1503,5,341
울산광역시,북구,강동동,합계,9020,6911,2730,1874,1042,502,681,12,0,7,0,6,8,5,10,6877,34,2109
울산광역시,북구,강동동,관내사전투표,1907,1907,901,339,256,148,246,1,0,3,0,4,2,0,1,1901,6,0
울산광역시,북구,강동동,강동동제1투,1788,1145,437,307,191,89,109,1,0,2,0,1,2,0,3,1142,3,643
울산광역시,북구,강동동,강동동제2투,1363,879,205,466,107,46,37,1,0,0,0,1,2,3,5,873,6,484
울산광역시,북구,강동동,강동동제3투,621,448,96,241,61,20,18,5,0,0,0,0,1,0,0,442,6,173
울산광역시,북구,강동동,강동동제4투,442,306,67,178,36,12,9,0,0,1,0,0,1,0,0,304,2,136
울산광역시,북구,강동동,강동동제5투,2899,2226,1024,343,391,187,262,4,0,1,0,0,0,2,1,2215,11,673
울산광역시,북구,효문동,합계,20079,15510,6337,3639,2530,1183,1687,17,1,10,3,17,9,12,9,15454,56,4569
울산광역시,북구,효문동,관내사전투표,3327,3327,1709,451,452,249,434,3,0,5,0,4,2,2,4,3315,12,0
울산광역시,북구,효문동,효문동제1투,2192,1419,430,505,234,97,134,5,0,0,0,1,2,2,0,1410,9,773
울산광역시,북구,효문동,효문동제2투,631,400,93,198,52,23,29,0,1,0,0,0,0,3,0,399,1,231
울산광역시,북구,효문동,효문동제3투,2141,1787,729,417,297,137,190,0,0,2,2,5,0,1,1,1781,6,354
울산광역시,북구,효문동,효문동제4투,3403,2541,946,706,456,174,235,2,0,1,1,4,3,2,3,2533,8,862
울산광역시,북구,효문동,효문동제5투,3054,1984,787,471,328,167,222,0,0,1,0,1,2,0,0,1979,5,1070
울산광역시,북구,효문동,효문동제6투,2483,1971,869,358,330,173,226,6,0,0,0,1,0,1,1,1965,6,512
울산광역시,북구,효문동,효문동제7투,2848,2081,774,533,381,163,217,1,0,1,0,1,0,1,0,2072,9,767
울산광역시,북구,송정동,합계,16430,13762,5967,2967,2050,1086,1537,22,2,8,8,25,2,9,20,13703,59,2668
울산광역시,북구,송정동,관내사전투표,5776,5776,2884,895,719,460,754,7,1,3,3,10,0,4,7,5747,29,0
울산광역시,북구,송정동,송정동제1투,2186,1702,621,491,260,139,167,1,0,4,3,5,0,1,1,1693,9,484
울산광역시,북구,송정동,송정동제2투,1861,1494,683,283,244,107,169,0,0,0,1,0,0,0,3,1490,4,367
울산광역시,북구,송정동,송정동제3투,2170,1595,586,426,280,147,142,3,0,0,0,1,2,1,1,1589,6,575
울산광역시,북구,송정동,송정동제4투,2452,1808,718,421,298,142,204,7,0,0,1,5,0,3,4,1803,5,644
울산광역시,북구,송정동,송정동제5투,1985,1387,475,451,249,91,101,4,1,1,0,4,0,0,4,1381,6,598
울산광역시,북구,양정동,합계,8976,7234,3316,1238,1098,584,937,4,2,5,1,12,3,1,6,7207,27,1742
울산광역시,북구,양정동,관내사전투표,2351,2351,1245,276,306,169,332,2,1,2,0,5,0,1,2,2341,10,0
울산광역시,북구,양정동,양정동제1투,2490,2027,892,335,327,189,275,0,0,0,0,3,1,0,2,2024,3,463
울산광역시,북구,양정동,양정동제2투,1773,1191,472,277,196,98,136,1,0,2,1,3,0,0,2,1188,3,582
울산광역시,북구,양정동,양정동제3투,2362,1665,707,350,269,128,194,1,1,1,0,1,2,0,0,1654,11,697
울산광역시,북구,염포동,합계,9020,7008,2981,1432,1134,538,859,11,1,3,1,8,2,4,7,6981,27,2012
울산광역시,북구,염포동,관내사전투표,2265,2265,1103,341,306,176,321,1,0,0,0,4,0,2,2,2256,9,0
울산광역시,북구,염포동,염포동제1투,1059,746,303,182,110,58,78,2,1,1,0,1,1,0,2,739,7,313
울산광역시,북구,염포동,염포동제2투,1272,849,292,254,156,55,85,1,0,0,0,1,1,1,1,847,2,423
울산광역시,북구,염포동,염포동제3투,2691,2143,954,358,359,174,282,7,0,1,0,1,0,1,0,2137,6,548
울산광역시,북구,염포동,염포동제4투,1733,1005,329,297,203,75,93,0,0,1,1,1,0,0,2,1002,3,728
울산광역시,북구,잘못 투입·구분된 투표지,,0,0,0,0,0,0,0,0,0,0,0,0,0,0,0,0,0,0
울산광역시,울주군,합계,,175979,136353,48486,42349,23617,11013,9296,163,41,127,51,104,48,107,204,135606,747,39626
울산광역시,울주군,거소·선상투표,,420,399,133,83,121,35,7,2,0,0,0,0,1,1,0,383,16,21
울산광역시,울주군,관외사전투표,,17021,17013,6874,3701,2965,1689,1502,21,6,11,8,10,5,5,43,16840,173,8
울산광역시,울주군,재외투표,,1021,692,383,53,140,37,75,1,0,0,0,0,0,1,0,690,2,329
울산광역시,울주군,온산읍,합계,18120,12267,4219,3826,2135,1022,944,14,6,11,1,8,2,11,16,12215,52,5853
울산광역시,울주군,온산읍,관내사전투표,2935,2935,1240,732,422,241,268,5,3,4,0,3,0,0,7,2925,10,0
울산광역시,울주군,온산읍,온산읍제1투,2502,1246,307,547,220,87,75,1,2,1,0,0,1,2,2,1245,1,1256
울산광역시,울주군,온산읍,온산읍제2투,2255,1566,591,387,293,135,147,1,1,2,0,2,0,1,1,1561,5,689
울산광역시,울주군,온산읍,온산읍제3투,2270,1296,379,484,246,94,83,1,0,0,0,0,0,2,1,1290,6,974
울산광역시,울주군,온산읍,온산읍제4투,2621,1525,500,470,324,121,90,0,0,1,0,3,0,1,1,1511,14,1096
울산광역시,울주군,온산읍,온산읍제5투,1988,1221,440,358,213,108,91,3,0,2,0,0,0,0,3,1218,3,767
울산광역시,울주군,온산읍,온산읍제6투,2763,1969,682,530,361,203,176,3,0,0,0,0,1,2,0,1958,11,794
울산광역시,울주군,온산읍,온산읍제7투,786,509,80,318,56,33,14,0,0,1,1,0,0,3,1,507,2,277
울산광역시,울주군,언양읍,관내사전투표,3846,3846,1546,1045,610,306,299,0,4,11,1,2,2,0,1,3827,19,0
울산광역시,울주군,언양읍,합계,19609,14675,4878,5042,2474,1136,955,14,7,30,6,10,6,9,16,14583,92,4934
울산광역시,울주군,언양읍,언양읍제1투,2564,1578,396,667,269,119,104,1,1,2,2,0,0,1,2,1564,14,986
울산광역시,울주군,언양읍,언양읍제2투,2747,2014,676,655,368,171,114,2,1,3,0,5,2,3,4,2004,10,733
울산광역시,울주군,언양읍,언양읍제3투,2034,1338,329,636,224,77,51,4,0,4,1,1,0,1,2,1330,8,696
울산광역시,울주군,언양읍,언양읍제4투,2229,1557,508,544,261,110,114,2,0,2,0,1,1,1,2,1546,11,672
울산광역시,울주군,언양읍,언양읍제5투,1213,794,171,466,92,35,19,2,0,0,0,0,1,3,1,790,4,419
울산광역시,울주군,언양읍,언양읍제6투,2362,1719,610,495,335,148,115,2,0,3,1,0,0,0,2,1711,8,643
울산광역시,울주군,언양읍,언양읍제7투,2614,1829,642,534,315,170,139,1,1,5,1,1,0,0,2,1811,18,785
울산광역시,울주군,온양읍,합계,18049,13242,4536,4174,2439,1037,923,22,4,15,3,4,3,5,20,13185,57,4807
울산광역시,울주군,온양읍,관내사전투표,2763,2763,1149,663,457,238,230,3,1,1,1,1,2,0,4,2750,13,0
울산광역시,울주군,온양읍,온양읍제1투,1899,1205,268,634,158,74,57,2,0,2,0,0,1,2,2,1200,5,694
울산광역시,울주군,온양읍,온양읍제2투,1531,986,283,424,158,66,52,0,0,0,0,0,0,0,1,984,2,545
울산광역시,울주군,온양읍,온양읍제3투,2583,1586,473,600,290,114,86,2,1,6,1,1,0,1,2,1577,9,997
울산광역시,울주군,온양읍,온양읍제4투,1789,1355,455,405,276,105,99,5,0,1,0,1,0,1,2,1350,5,434
울산광역시,울주군,온양읍,온양읍제5투,2018,1497,562,368,309,123,123,1,0,1,0,0,0,0,5,1492,5,521
울산광역시,울주군,온양읍,온양읍제6투,3339,2271,782,654,458,197,157,8,0,2,1,1,0,1,1,2262,9,1068
울산광역시,울주군,온양읍,온양읍제7투,2127,1579,564,426,333,120,119,1,2,2,0,0,0,0,3,1570,9,548
울산광역시,울주군,범서읍,합계,48306,39597,16398,9370,7085,3514,2916,52,4,21,13,36,8,13,37,39467,130,8709
울산광역시,울주군,범서읍,관내사전투표,9560,9560,4629,1772,1456,822,807,8,0,3,3,10,1,1,9,9521,39,0
울산광역시,울주군,범서읍,범서읍제1투,3453,2681,1040,665,497,255,200,3,0,4,1,6,0,0,2,2673,8,772
울산광역시,울주군,범서읍,범서읍제2투,2595,1849,601,578,378,162,107,2,0,1,2,3,0,5,1,1840,9,746
울산광역시,울주군,범서읍,범서읍제3투,1410,1058,243,564,146,54,39,1,0,0,2,0,1,2,3,1055,3,352
울산광역시,울주군,범서읍,범서읍제4투,2754,2053,757,563,377,170,163,3,0,2,1,0,4,1,4,2045,8,701
울산광역시,울주군,범서읍,범서읍제5투,3904,2945,1212,725,538,241,203,11,0,0,0,3,0,1,4,2938,7,959
울산광역시,울주군,범서읍,범서읍제6투,2007,1528,606,363,283,142,123,2,0,0,1,0,1,1,1,1523,5,479
울산광역시,울주군,범서읍,범서읍제7투,2374,1855,633,546,345,184,130,3,0,1,1,1,0,1,3,1848,7,519
울산광역시,울주군,범서읍,범서읍제8투,2961,2207,923,515,433,174,148,2,0,2,0,2,0,0,1,2200,7,754
울산광역시,울주군,범서읍,범서읍제9투,2785,2133,744,560,437,192,176,7,1,2,0,3,0,0,4,2126,7,652
울산광역시,울주군,범서읍,범서읍제10투,2857,2153,816,599,388,186,146,5,0,0,1,3,1,0,1,2146,7,704
울산광역시,울주군,범서읍,범서읍제11투,2583,2106,974,385,384,191,154,3,2,2,1,2,0,0,1,2099,7,477
울산광역시,울주군,범서읍,범서읍제12투,3331,2778,1300,522,509,264,176,0,0,1,0,0,0,0,0,2772,6,553
울산광역시,울주군,범서읍,범서읍제13투,3663,3011,1275,615,579,306,222,0,1,2,0,2,0,0,2,3004,7,652
울산광역시,울주군,범서읍,범서읍제14투,2069,1680,645,398,335,171,122,2,0,1,0,1,0,1,1,1677,3,389
울산광역시,울주군,서생면,합계,6573,4550,1156,2185,668,278,212,6,0,4,2,3,4,4,6,4528,22,2023
울산광역시,울주군,서생면,관내사전투표,1027,1027,332,450,121,65,50,1,0,0,2,1,0,1,2,1025,2,0
울산광역시,울주군,서생면,서생면제1투,2022,1296,304,653,204,77,44,1,0,2,0,1,3,0,1,1290,6,726
울산광역시,울주군,서생면,서생면제2투,1160,725,155,404,93,31,35,0,0,1,0,1,0,2,2,724,1,435
울산광역시,울주군,서생면,서생면제3투,2364,1502,365,678,250,105,83,4,0,1,0,0,1,1,1,1489,13,862
울산광역시,울주군,청량면,합계,11884,8869,2863,3137,1585,667,534,7,0,5,1,12,4,5,13,8833,36,3015
울산광역시,울주군,청량면,관내사전투표,1484,1484,584,490,217,102,77,1,0,1,0,3,1,0,2,1478,6,0
울산광역시,울주군,청량면,청량면제1투,1469,854,197,439,131,51,23,2,0,1,0,2,0,1,1,848,6,615
울산광역시,울주군,청량면,청량면제2투,1943,1392,423,501,252,110,92,1,0,2,0,1,0,0,4,1386,6,551
울산광역시,울주군,청량면,청량면제3투,2764,2085,617,742,405,166,140,0,0,1,1,2,3,4,1,2082,3,679
울산광역시,울주군,청량면,청량면제4투,2999,2300,865,607,453,186,171,1,0,0,0,2,0,0,4,2289,11,699
울산광역시,울주군,청량면,청량면제5투,1225,754,177,358,127,52,31,2,0,0,0,2,0,0,1,750,4,471
울산광역시,울주군,웅촌면,합계,6623,4873,1389,2040,792,334,250,2,2,5,5,4,2,6,4,4835,38,1750
울산광역시,울주군,웅촌면,관내사전투표,1027,1027,386,344,145,66,62,0,1,2,0,2,0,0,1,1009,18,0
울산광역시,울주군,웅촌면,웅촌면제1투,1948,1283,300,642,192,81,53,1,1,1,3,0,1,2,1,1278,5,665
울산광역시,울주군,웅촌면,웅촌면제2투,1358,929,213,476,138,52,34,0,0,0,2,0,0,3,1,919,10,429
울산광역시,울주군,웅촌면,웅촌면제3투,2290,1634,490,578,317,135,101,1,0,2,0,2,1,1,1,1629,5,656
울산광역시,울주군,두동면,합계,3445,2356,634,1115,312,117,94,5,5,5,4,3,5,8,14,2321,35,1089
울산광역시,울주군,두동면,관내사전투표,673,673,235,259,84,35,31,4,2,4,3,2,1,2,3,665,8,0
울산광역시,울주군,두동면,두동면제1투,1898,1133,273,553,154,66,50,1,2,1,1,1,3,3,9,1117,16,765
울산광역시,울주군,두동면,두동면제2투,874,550,126,303,74,16,13,0,1,0,0,0,1,3,2,539,11,324
울산광역시,울주군,두서면,합계,2787,2014,477,1061,287,91,53,3,0,2,1,6,0,10,9,2000,14,773
울산광역시,울주군,두서면,관내사전투표,547,547,171,232,70,30,25,1,0,1,1,5,0,1,3,540,7,0
울산광역시,울주군,두서면,두서면제1투,1631,1072,238,581,167,46,22,2,0,1,0,1,0,6,3,1067,5,559
울산광역시,울주군,두서면,두서면제2투,609,395,68,248,50,15,6,0,0,0,0,0,0,3,3,393,2,214
울산광역시,울주군,상북면,합계,6762,4749,1276,2152,730,295,227,3,4,5,3,3,2,11,14,4725,24,2013
울산광역시,울주군,상북면,관내사전투표,1306,1306,467,459,185,90,88,1,2,0,1,0,2,4,2,1301,5,0
울산광역시,울주군,상북면,상북면제1투,2075,1283,319,558,228,96,69,1,1,2,0,2,0,0,4,1280,3,792
울산광역시,울주군,상북면,상북면제2투,1184,747,179,410,87,31,27,1,0,0,2,0,0,3,1,741,6,437
울산광역시,울주군,상북면,상북면제3투,2197,1413,311,725,230,78,43,0,1,3,0,1,0,4,7,1403,10,784
울산광역시,울주군,삼남면,합계,13831,9900,3008,3820,1716,694,548,11,3,13,3,4,6,16,10,9852,48,3931
울산광역시,울주군,삼남면,관내사전투표,2583,2583,979,805,425,195,154,4,2,1,1,0,1,0,3,2570,13,0
울산광역시,울주군,삼남면,삼남면제1투,3569,2250,617,954,389,145,117,5,0,3,2,2,1,5,1,2241,9,1319
울산광역시,울주군,삼남면,삼남면제2투,2385,1524,404,610,281,119,93,2,0,4,0,0,2,2,2,1519,5,861
울산광역시,울주군,삼남면,삼남면제3투,3401,2345,666,923,446,158,125,0,1,3,0,2,1,4,1,2330,15,1056
울산광역시,울주군,삼남면,삼남면제4투,1893,1198,342,528,175,77,59,0,0,2,0,0,1,5,3,1192,6,695
울산광역시,울주군,삼동면,합계,1528,1157,262,590,168,67,56,0,0,0,1,1,0,2,2,1149,8,371
울산광역시,울주군,삼동면,관내사전투표,361,361,109,173,49,18,11,0,0,0,0,0,0,0,0,360,1,0
울산광역시,울주군,삼동면,삼동면제1투,676,437,84,237,65,23,21,0,0,0,0,0,0,1,1,432,5,239
울산광역시,울주군,삼동면,삼동면제2투,491,359,69,180,54,26,24,0,0,0,1,1,0,1,1,357,2,132
울산광역시,울주군,잘못 투입·구분된 투표지,,0,0,0,0,0,0,0,0,0,0,0,0,0,0,0,0,0,0
세종특별자치시,합계,,,189421,152801,77767,23211,32010,9192,9353,153,34,88,42,126,50,76,135,152237,564,36620
세종특별자치시,세종특별자치시,합계,,189421,152801,77767,23211,32010,9192,9353,153,34,88,42,126,50,76,135,152237,564,36620
세종특별자치시,세종특별자치시,거소·선상투표,,487,451,173,63,107,37,18,4,5,4,0,2,2,3,5,423,28,36
세종특별자치시,세종특별자치시,관외사전투표,,23465,23465,12365,2810,4399,1868,1811,23,7,8,6,19,6,7,25,23354,111,0
세종특별자치시,세종특별자치시,재외투표,,1213,983,667,41,130,38,100,3,0,0,0,0,0,0,0,979,4,230
세종특별자치시,세종특별자치시,조치원읍,관내사전투표,5473,5473,2695,933,1063,306,427,7,1,2,2,3,3,3,5,5450,23,0
세종특별자치시,세종특별자치시,조치원읍,합계,32584,22954,9859,4943,5212,1205,1527,31,5,14,10,18,6,6,20,22856,98,9630
세종특별자치시,세종특별자치시,조치원읍,조치원읍제1투,2495,1421,480,455,347,52,75,4,0,1,0,1,0,0,3,1418,3,1074
세종특별자치시,세종특별자치시,조치원읍,조치원읍제2투,1773,1030,353,337,237,45,49,1,0,1,0,0,0,1,1,1025,5,743
세종특별자치시,세종특별자치시,조치원읍,조치원읍제3투,2432,1404,478,412,369,67,61,0,0,3,1,0,1,0,2,1394,10,1028
세종특별자치시,세종특별자치시,조치원읍,조치원읍제4투,2251,1597,702,312,374,96,106,0,0,0,0,0,1,0,0,1591,6,654
세종특별자치시,세종특별자치시,조치원읍,조치원읍제5투,872,488,178,135,118,16,33,0,1,0,0,0,0,0,1,482,6,384
세종특별자치시,세종특별자치시,조치원읍,조치원읍제6투,1171,692,278,155,172,36,45,0,0,1,0,0,0,0,0,687,5,479
세종특별자치시,세종특별자치시,조치원읍,조치원읍제7투,3806,2511,1084,498,571,142,193,2,0,3,3,2,0,0,2,2500,11,1295
세종특별자치시,세종특별자치시,조치원읍,조치원읍제8투,2480,1570,613,367,389,73,105,5,1,3,1,2,1,1,2,1563,7,910
세종특별자치시,세종특별자치시,조치원읍,조치원읍제9투,2764,1985,905,374,464,106,122,3,0,0,0,5,0,0,0,1979,6,779
세종특별자치시,세종특별자치시,조치원읍,조치원읍제10투,1898,1204,504,263,271,71,86,1,0,0,3,1,0,0,0,1200,4,694
세종특별자치시,세종특별자치시,조치원읍,조치원읍제11투,2940,1855,714,444,470,96,117,1,2,0,0,1,0,1,1,1847,8,1085
세종특별자치시,세종특별자치시,조치원읍,조치원읍제12투,2229,1724,875,258,367,99,108,7,0,0,0,3,0,0,3,1720,4,505
세종특별자치시,세종특별자치시,연기면,합계,2612,1878,789,408,463,92,104,1,0,7,0,3,1,0,3,1871,7,734
세종특별자치시,세종특별자치시,연기면,관내사전투표,904,904,434,152,188,55,66,1,0,2,0,1,0,0,1,900,4,0
세종특별자치시,세종특별자치시,연기면,연기면투표소,1708,974,355,256,275,37,38,0,0,5,0,2,1,0,2,971,3,734
세종특별자치시,세종특별자치시,연동면,합계,2788,1891,601,620,464,74,96,3,1,7,0,7,3,4,3,1883,8,897
세종특별자치시,세종특별자치시,연동면,관내사전투표,351,351,144,97,72,14,22,0,0,0,0,1,1,0,0,351,0,0
세종특별자치시,세종특별자치시,연동면,연동면제1투,1365,836,249,305,195,33,38,1,0,5,0,1,0,0,3,830,6,529
세종특별자치시,세종특별자치시,연동면,연동면제2투,1072,704,208,218,197,27,36,2,1,2,0,5,2,4,0,702,2,368
세종특별자치시,세종특별자치시,부강면,합계,5187,3650,1368,985,828,198,218,2,4,1,1,7,1,3,8,3624,26,1537
세종특별자치시,세종특별자치시,부강면,관내사전투표,1081,1081,454,274,210,54,73,0,2,1,0,1,0,1,5,1075,6,0
세종특별자치시,세종특별자치시,부강면,부강면제1투,2725,1664,629,370,414,108,119,2,0,0,0,5,0,1,2,1650,14,1061
세종특별자치시,세종특별자치시,부강면,부강면제2투,1381,905,285,341,204,36,26,0,2,0,1,1,1,1,1,899,6,476
세종특별자치시,세종특별자치시,금남면,합계,7492,5229,1954,1428,1309,217,247,9,2,8,2,4,7,9,6,5202,27,2263
세종특별자치시,세종특별자치시,금남면,관내사전투표,1607,1607,676,374,370,74,89,2,1,4,1,0,5,3,1,1600,7,0
세종특별자치시,세종특별자치시,금남면,금남면제1투,2636,1583,598,434,387,68,79,3,1,3,0,1,1,2,1,1578,5,1053
세종특별자치시,세종특별자치시,금남면,금남면제2투,1091,674,212,204,198,25,22,0,0,1,0,0,0,2,2,666,8,417
세종특별자치시,세종특별자치시,금남면,금남면제3투,1273,827,270,240,237,34,35,0,0,0,0,3,0,1,2,822,5,446
세종특별자치시,세종특별자치시,금남면,금남면제4투,885,538,198,176,117,16,22,4,0,0,1,0,1,1,0,536,2,347
세종특별자치시,세종특별자치시,전의면,합계,5178,3501,1141,1086,901,133,179,5,2,6,2,3,6,4,8,3476,25,1677
세종특별자치시,세종특별자치시,전의면,관내사전투표,833,833,356,186,187,36,60,2,0,1,0,0,2,1,1,832,1,0
세종특별자치시,세종특별자치시,전의면,전의면제1투,1770,1012,293,334,271,46,53,0,1,1,1,0,1,1,1,1003,9,758
세종특별자치시,세종특별자치시,전의면,전의면제2투,1934,1238,385,390,337,41,54,2,1,2,1,3,2,2,5,1225,13,696
세종특별자치시,세종특별자치시,전의면,전의면제3투,641,418,107,176,106,10,12,1,0,2,0,0,1,0,1,416,2,223
세종특별자치시,세종특별자치시,전동면,합계,3316,2084,686,689,506,82,75,3,3,5,3,2,3,3,4,2064,20,1232
세종특별자치시,세종특별자치시,전동면,관내사전투표,614,614,254,158,127,33,19,0,1,2,2,2,1,2,3,604,10,0
세종특별자치시,세종특별자치시,전동면,전동면제1투,1374,765,227,287,189,27,25,0,1,2,1,0,0,0,1,760,5,609
세종특별자치시,세종특별자치시,전동면,전동면제2투,490,313,93,89,97,8,19,2,0,0,0,0,1,1,0,310,3,177
세종특별자치시,세종특별자치시,전동면,전동면제3투,838,392,112,155,93,14,12,1,1,1,0,0,1,0,0,390,2,446
세종특별자치시,세종특별자치시,소정면,합계,2252,1565,492,516,343,84,103,1,0,3,0,6,0,3,5,1556,9,687
세종특별자치시,세종특별자치시,소정면,관내사전투표,495,495,168,157,109,23,32,1,0,1,0,0,0,3,1,495,0,0
세종특별자치시,세종특별자치시,소정면,소정면투표소,1757,1070,324,359,234,61,71,0,0,2,0,6,0,0,4,1061,9,687
세종특별자치시,세종특별자치시,장군면,합계,4657,3032,1221,803,665,137,158,2,1,4,1,4,4,6,4,3010,22,1625
세종특별자치시,세종특별자치시,장군면,관내사전투표,752,752,365,155,134,40,47,0,0,3,0,1,2,1,1,749,3,0
세종특별자치시,세종특별자치시,장군면,장군면제1투,1841,1063,423,298,241,40,50,1,0,0,0,2,1,1,1,1058,5,778
세종특별자치시,세종특별자치시,장군면,장군면제2투,1581,910,338,247,209,52,50,0,1,1,0,0,0,3,1,902,8,671
세종특별자치시,세종특별자치시,장군면,장군면제3투,483,307,95,103,81,5,11,1,0,0,1,1,1,1,1,301,6,176
세종특별자치시,세종특별자치시,연서면,합계,6420,4554,1819,1199,1068,196,211,7,1,4,2,8,3,3,7,4528,26,1866
세종특별자치시,세종특별자치시,연서면,관내사전투표,1195,1195,605,196,250,61,74,3,0,0,0,0,0,0,0,1189,6,0
세종특별자치시,세종특별자치시,연서면,연서면제1투,1105,714,235,235,183,22,27,0,0,2,0,2,1,2,1,710,4,391
세종특별자치시,세종특별자치시,연서면,연서면제2투,595,405,151,135,80,19,12,1,0,1,0,0,0,0,2,401,4,190
세종특별자치시,세종특별자치시,연서면,연서면제3투,784,522,179,209,98,17,9,1,0,0,0,4,1,0,0,518,4,262
세종특별자치시,세종특별자치시,연서면,연서면제4투,2741,1718,649,424,457,77,89,2,1,1,2,2,1,1,4,1710,8,1023
세종특별자치시,세종특별자치시,한솔동,합계,13399,11490,6868,1047,2199,680,638,7,1,1,1,12,1,1,7,11463,27,1909
세종특별자치시,세종특별자치시,한솔동,관내사전투표,4397,4397,2785,336,743,259,248,1,1,0,1,6,1,1,3,4385,12,0
세종특별자치시,세종특별자치시,한솔동,한솔동제1투,2017,1604,949,152,283,101,113,0,0,1,0,2,0,0,1,1602,2,413
세종특별자치시,세종특별자치시,한솔동,한솔동제2투,1841,1578,981,148,288,93,63,1,0,0,0,1,0,0,1,1576,2,263
세종특별자치시,세종특별자치시,한솔동,한솔동제3투,1626,1333,733,146,314,76,57,2,0,0,0,0,0,0,0,1328,5,293
세종특별자치시,세종특별자치시,한솔동,한솔동제4투,2716,2053,1129,246,455,108,105,3,0,0,0,3,0,0,1,2050,3,663
세종특별자치시,세종특별자치시,한솔동,한솔동제5투,802,525,291,19,116,43,52,0,0,0,0,0,0,0,1,522,3,277
세종특별자치시,세종특별자치시,도담동,합계,19078,15854,8839,1706,3206,1109,923,9,0,3,4,6,1,3,8,15817,37,3224
세종특별자치시,세종특별자치시,도담동,관내사전투표,5602,5602,3276,538,1041,389,340,3,0,1,1,3,1,0,1,5594,8,0
세종특별자치시,세종특별자치시,도담동,도담동제1투,1569,1166,622,117,253,99,70,3,0,0,0,0,0,0,0,1164,2,403
세종특별자치시,세종특별자치시,도담동,도담동제2투,2187,1520,713,262,355,78,92,2,0,2,0,0,0,1,3,1508,12,667
세종특별자치시,세종특별자치시,도담동,도담동제3투,2615,1877,999,219,429,111,111,1,0,0,2,1,0,0,0,1873,4,738
세종특별자치시,세종특별자치시,도담동,도담동제4투,2268,1879,1101,170,368,131,105,0,0,0,0,0,0,1,0,1876,3,389
세종특별자치시,세종특별자치시,도담동,도담동제5투,2305,1814,977,218,392,130,91,0,0,0,0,0,0,0,3,1811,3,491
세종특별자치시,세종특별자치시,도담동,도담동제6투,2532,1996,1151,182,368,171,114,0,0,0,1,2,0,1,1,1991,5,536
세종특별자치시,세종특별자치시,아름동,합계,14101,12251,7378,1068,2320,750,691,10,0,2,2,8,1,2,5,12237,14,1850
세종특별자치시,세종특별자치시,아름동,관내사전투표,4833,4833,3017,416,810,282,287,6,0,2,0,4,1,0,1,4826,7,0
세종특별자치시,세종특별자치시,아름동,아름동제1투,2288,1832,1107,138,367,128,87,1,0,0,1,2,0,0,0,1831,1,456
세종특별자치시,세종특별자치시,아름동,아름동제2투,1940,1506,889,133,312,87,81,0,0,0,0,1,0,0,2,1505,1,434
세종특별자치시,세종특별자치시,아름동,아름동제3투,2488,1960,1065,186,463,123,119,1,0,0,0,0,0,2,0,1959,1,528
세종특별자치시,세종특별자치시,아름동,아름동제4투,2552,2120,1300,195,368,130,117,2,0,0,1,1,0,0,2,2116,4,432
세종특별자치시,세종특별자치시,종촌동,합계,18868,15991,9132,1645,3195,989,943,19,1,5,2,7,1,7,6,15952,39,2877
세종특별자치시,세종특별자치시,종촌동,관내사전투표,6153,6153,3699,557,1089,394,383,6,0,2,0,5,1,3,3,6142,11,0
세종특별자치시,세종특별자치시,종촌동,종촌동제1투,2839,2178,1242,221,487,102,114,0,0,1,1,0,0,2,0,2170,8,661
세종특별자치시,세종특별자치시,종촌동,종촌동제2투,2965,2421,1381,236,506,145,144,2,0,1,1,0,0,1,0,2417,4,544
세종특별자치시,세종특별자치시,종촌동,종촌동제3투,2656,2126,1136,249,476,137,112,2,0,0,0,1,0,1,3,2117,9,530
세종특별자치시,세종특별자치시,종촌동,종촌동제4투,2405,1808,979,204,380,129,106,5,0,0,0,0,0,0,0,1803,5,597
세종특별자치시,세종특별자치시,종촌동,종촌동제5투,1850,1305,695,178,257,82,84,4,1,1,0,1,0,0,0,1303,2,545
세종특별자치시,세종특별자치시,고운동,합계,14667,11965,6730,1199,2562,686,733,8,0,4,1,5,3,6,8,11945,20,2702
세종특별자치시,세종특별자치시,고운동,관내사전투표,3600,3600,2161,308,704,200,210,3,0,1,0,3,1,3,3,3597,3,0
세종특별자치시,세종특별자치시,고운동,고운동제1투,2240,1616,852,185,369,101,100,0,0,0,1,0,0,2,2,1612,4,624
세종특별자치시,세종특별자치시,고운동,고운동제2투,2363,1818,982,194,413,118,97,1,0,2,0,1,1,1,1,1811,7,545
세종특별자치시,세종특별자치시,고운동,고운동제3투,3110,2357,1295,250,524,119,162,2,0,0,0,0,1,0,1,2354,3,753
세종특별자치시,세종특별자치시,고운동,고운동제4투,1790,1380,786,129,282,83,95,2,0,0,0,0,0,0,1,1378,2,410
세종특별자치시,세종특별자치시,고운동,고운동제5투,1564,1194,654,133,270,65,69,0,0,1,0,1,0,0,0,1193,1,370
세종특별자치시,세종특별자치시,보람동,합계,11657,10012,5684,955,2133,617,578,6,1,2,5,5,1,6,3,9996,16,1645
세종특별자치시,세종특별자치시,보람동,관내사전투표,3952,3952,2406,331,697,250,249,3,0,2,1,2,1,2,1,3945,7,0
세종특별자치시,세종특별자치시,보람동,보람동제1투,2818,2203,1215,220,539,112,111,1,0,0,0,1,0,2,1,2202,1,615
세종특별자치시,세종특별자치시,보람동,보람동제2투,2687,2166,1160,230,513,131,123,2,1,0,2,0,0,1,0,2163,3,521
세종특별자치시,세종특별자치시,보람동,보람동제3투,2200,1691,903,174,384,124,95,0,0,0,2,2,0,1,1,1686,5,509
세종특별자치시,세종특별자치시,잘못 투입·구분된 투표지,,0,1,1,0,0,0,0,0,0,0,0,0,0,0,0,1,0,-1
경기도,합계,,,10262309,7916009,3319812,1637345,1807308,540023,546373,10778,1302,5058,1858,6139,2213,2883,6553,7887645,28364,2346300
경기도,수원시장안구,합계,,239609,190917,81392,37143,43344,13774,13660,245,33,136,43,180,43,69,149,190211,706,48692
경기도,수원시장안구,거소·선상투표,,593,554,153,112,179,37,17,5,4,0,1,8,2,0,2,520,34,39
경기도,수원시장안구,관외사전투표,,21481,21481,9983,2939,4749,1850,1693,26,7,13,7,26,2,6,36,21337,144,0
경기도,수원시장안구,재외투표,,1592,1245,758,77,202,50,140,3,0,0,0,3,0,0,2,1235,10,347
경기도,수원시장안구,파장동,합계,19520,14494,5848,3229,3469,905,933,20,0,12,0,21,3,6,8,14454,40,5026
경기도,수원시장안구,파장동,관내사전투표,3513,3513,1576,732,751,194,231,2,0,1,0,16,1,1,1,3506,7,0
경기도,수원시장안구,파장동,파장동제1투,1747,1083,376,300,281,60,56,2,0,0,0,1,0,1,0,1077,6,664
경기도,수원시장안구,파장동,파장동제2투,2679,1747,646,461,429,98,104,1,0,0,0,1,0,1,0,1741,6,932
경기도,수원시장안구,파장동,파장동제3투,2673,1683,607,421,443,92,106,2,0,2,0,1,2,0,2,1678,5,990
경기도,수원시장안구,파장동,파장동제4투,2206,1487,528,366,379,93,108,1,0,3,0,2,0,0,1,1481,6,719
경기도,수원시장안구,파장동,파장동제5투,2535,1549,571,397,376,97,100,0,0,3,0,0,0,1,2,1547,2,986
경기도,수원시장안구,파장동,파장동제6투,2163,1761,803,271,406,135,134,4,0,3,0,0,0,1,1,1758,3,402
경기도,수원시장안구,파장동,파장동제7투,2004,1671,741,281,404,136,94,8,0,0,0,0,0,1,1,1666,5,333
경기도,수원시장안구,율천동,합계,32202,26533,11935,4177,5859,2289,2068,29,3,12,3,20,3,8,15,26421,112,5669
경기도,수원시장안구,율천동,관내사전투표,6876,6876,3388,825,1299,661,648,6,1,1,0,7,0,1,6,6843,33,0
경기도,수원시장안구,율천동,율천동제1투,2732,1974,835,350,462,167,146,1,0,0,0,1,1,1,1,1965,9,758
경기도,수원시장안구,율천동,율천동제2투,2965,1990,788,452,444,130,147,5,0,3,2,0,0,0,3,1974,16,975
경기도,수원시장안구,율천동,율천동제3투,2078,1780,854,249,407,136,126,2,0,1,0,1,0,0,1,1777,3,298
경기도,수원시장안구,율천동,율천동제4투,3080,2543,1162,437,565,180,191,1,0,0,1,1,0,1,0,2539,4,537
경기도,수원시장안구,율천동,율천동제5투,3272,2596,1085,490,620,205,180,5,0,1,0,0,0,1,2,2589,7,676
경기도,수원시장안구,율천동,율천동제6투,2846,2075,901,348,482,165,161,2,1,4,0,2,1,2,0,2069,6,771
경기도,수원시장안구,율천동,율천동제7투,3486,2663,1148,503,619,187,181,4,1,0,0,7,1,1,1,2653,10,823
경기도,수원시장안구,율천동,율천동제8투,1121,909,300,50,229,208,106,1,0,0,0,0,0,0,1,895,14,212
경기도,수원시장안구,율천동,율천동제9투,3746,3127,1474,473,732,250,182,2,0,2,0,1,0,1,0,3117,10,619
경기도,수원시장안구,정자1동,합계,24602,19493,8531,3710,4388,1426,1321,15,1,15,1,16,5,4,11,19444,49,5109
경기도,수원시장안구,정자1동,관내사전투표,4120,4120,1944,706,873,299,272,2,0,3,0,7,1,2,1,4110,10,0
경기도,수원시장안구,정자1동,정자1동제1투,3082,2063,804,431,492,152,161,3,0,3,0,3,3,0,3,2055,8,1019
경기도,수원시장안구,정자1동,정자1동제2투,1646,1011,396,243,217,56,88,0,0,3,1,2,0,1,1,1008,3,635
경기도,수원시장안구,정자1동,정자1동제3투,3416,2591,1081,552,596,211,138,1,0,3,0,2,0,0,0,2584,7,825
경기도,수원시장안구,정자1동,정자1동제4투,3797,2827,1176,665,600,198,172,3,1,2,0,0,0,0,3,2820,7,970
경기도,수원시장안구,정자1동,정자1동제5투,1787,1178,424,324,276,77,66,3,0,0,0,1,1,0,0,1172,6,609
경기도,수원시장안구,정자1동,정자1동제6투,3218,2729,1335,356,630,189,213,0,0,0,0,1,0,0,1,2725,4,489
경기도,수원시장안구,정자1동,정자1동제7투,3536,2974,1371,433,704,244,211,3,0,1,0,0,0,1,2,2970,4,562
경기도,수원시장안구,정자2동,합계,22810,17436,7292,3680,4021,1118,1174,30,4,17,3,26,10,11,6,17392,44,5374
경기도,수원시장안구,정자2동,관내사전투표,3011,3011,1332,637,597,217,203,4,0,2,0,8,1,3,1,3005,6,0
경기도,수원시장안구,정자2동,정자2동제1투,2871,1674,613,415,420,100,109,1,1,2,0,3,2,1,0,1667,7,1197
경기도,수원시장안구,정자2동,정자2동제2투,3081,2239,848,541,574,116,139,4,0,2,0,6,0,2,0,2232,7,842
경기도,수원시장안구,정자2동,정자2동제3투,3393,2285,865,549,548,164,141,4,0,1,0,1,3,0,0,2276,9,1108
경기도,수원시장안구,정자2동,정자2동제4투,2074,1352,484,392,315,60,81,6,1,8,2,1,1,1,0,1352,0,722
경기도,수원시장안구,정자2동,정자2동제5투,2728,2248,992,395,528,155,160,4,1,0,1,2,0,0,2,2240,8,480
경기도,수원시장안구,정자2동,정자2동제6투,3364,2718,1201,484,639,173,195,6,1,2,0,3,2,3,3,2712,6,646
경기도,수원시장안구,정자2동,정자2동제7투,2288,1909,957,267,400,133,146,1,0,0,0,2,1,1,0,1908,1,379
경기도,수원시장안구,정자3동,합계,30106,25739,12499,3795,5407,2008,1887,26,0,12,4,17,2,10,21,25688,51,4367
경기도,수원시장안구,정자3동,관내사전투표,5921,5921,3182,693,1085,459,457,9,0,4,1,7,0,2,6,5905,16,0
경기도,수원시장안구,정자3동,정자3동제1투,2291,1742,770,333,376,142,113,1,0,1,0,1,0,1,1,1739,3,549
경기도,수원시장안구,정자3동,정자3동제2투,2269,1849,797,387,399,123,132,4,0,0,1,2,1,0,0,1846,3,420
경기도,수원시장안구,정자3동,정자3동제3투,2906,2422,1199,281,563,173,194,1,0,1,1,3,0,2,1,2419,3,484
경기도,수원시장안구,정자3동,정자3동제4투,2400,2038,960,275,483,169,141,2,0,1,0,0,0,0,2,2033,5,362
경기도,수원시장안구,정자3동,정자3동제5투,3523,2936,1368,436,633,255,227,1,0,1,0,1,1,1,5,2929,7,587
경기도,수원시장안구,정자3동,정자3동제6투,3632,3115,1464,513,667,238,221,3,0,1,0,0,0,0,2,3109,6,517
경기도,수원시장안구,정자3동,정자3동제7투,2069,1620,831,251,316,103,115,1,0,0,0,1,0,1,0,1619,1,449
경기도,수원시장안구,정자3동,정자3동제8투,3119,2618,1305,368,523,228,183,1,0,2,1,1,0,0,1,2613,5,501
경기도,수원시장안구,정자3동,정자3동제9투,1976,1478,623,258,362,118,104,3,0,1,0,1,0,3,3,1476,2,498
경기도,수원시장안구,영화동,합계,17541,11935,4296,3229,2867,666,766,12,2,6,6,10,2,10,10,11882,53,5606
경기도,수원시장안구,영화동,관내사전투표,2610,2610,1072,670,553,119,171,4,0,2,0,3,0,1,3,2598,12,0
경기도,수원시장안구,영화동,영화동제1투,3096,1749,548,529,459,84,108,2,0,2,2,2,0,2,2,1740,9,1347
경기도,수원시장안구,영화동,영화동제2투,2846,1698,523,492,437,99,127,2,0,1,2,1,1,2,0,1687,11,1148
경기도,수원시장안구,영화동,영화동제3투,3365,2276,808,624,553,139,136,1,2,1,0,1,1,2,1,2269,7,1089
경기도,수원시장안구,영화동,영화동제4투,2716,1827,666,482,431,129,106,2,0,0,2,1,0,1,0,1820,7,889
경기도,수원시장안구,영화동,영화동제5투,2908,1775,679,432,434,96,118,1,0,0,0,2,0,2,4,1768,7,1133
경기도,수원시장안구,송죽동,합계,14820,11042,4513,2298,2643,710,778,28,3,12,6,5,5,0,8,11009,33,3778
경기도,수원시장안구,송죽동,관내사전투표,2809,2809,1311,502,585,179,210,7,1,2,0,1,2,0,2,2802,7,0
경기도,수원시장안구,송죽동,송죽동제1투,3077,2097,858,411,515,141,151,2,0,3,2,0,2,0,2,2087,10,980
경기도,수원시장안구,송죽동,송죽동제2투,2818,1977,765,400,508,136,150,10,0,2,1,2,0,0,0,1974,3,841
경기도,수원시장안구,송죽동,송죽동제3투,3096,2136,819,493,511,138,150,7,2,2,2,2,1,0,1,2128,8,960
경기도,수원시장안구,송죽동,송죽동제4투,3020,2023,760,492,524,116,117,2,0,3,1,0,0,0,3,2018,5,997
경기도,수원시장안구,조원1동,관내사전투표,4005,4005,1709,832,821,251,359,4,0,4,1,3,0,3,5,3992,13,0
경기도,수원시장안구,조원1동,합계,23500,17344,6693,4122,4023,1093,1256,19,7,20,8,9,4,6,17,17277,67,6156
경기도,수원시장안구,조원1동,조원1동제1투,3709,2235,827,536,536,153,167,3,0,4,0,0,0,0,1,2227,8,1474
경기도,수원시장안구,조원1동,조원1동제2투,2571,1722,720,365,404,93,125,1,2,0,1,0,0,1,3,1715,7,849
경기도,수원시장안구,조원1동,조원1동제3투,2934,1868,660,464,495,99,130,3,1,3,2,1,1,0,1,1860,8,1066
경기도,수원시장안구,조원1동,조원1동제4투,2484,1703,638,446,406,90,108,2,2,3,2,2,0,0,0,1699,4,781
경기도,수원시장안구,조원1동,조원1동제5투,3102,2176,706,744,493,104,97,3,1,6,0,0,2,2,5,2163,13,926
경기도,수원시장안구,조원1동,조원1동제6투,2038,1564,586,336,373,143,117,2,0,0,1,0,1,0,0,1559,5,474
경기도,수원시장안구,조원1동,조원1동제7투,2657,2071,847,399,495,160,153,1,1,0,1,3,0,0,2,2062,9,586
경기도,수원시장안구,조원2동,관내사전투표,4445,4445,1936,840,952,328,363,5,0,1,0,7,1,1,1,4435,10,0
경기도,수원시장안구,조원2동,합계,15317,12989,5291,2684,2991,1038,928,13,0,4,2,8,1,2,2,12964,25,2328
경기도,수원시장안구,조원2동,조원2동제1투,2947,2278,889,528,570,165,119,0,0,0,1,0,0,0,1,2273,5,669
경기도,수원시장안구,조원2동,조원2동제2투,2750,2129,808,460,506,197,153,2,0,0,0,0,0,0,0,2126,3,621
경기도,수원시장안구,조원2동,조원2동제3투,2710,2167,878,401,522,178,179,3,0,1,1,1,0,0,0,2164,3,543
경기도,수원시장안구,조원2동,조원2동제4투,2465,1970,780,455,441,170,114,3,0,2,0,0,0,1,0,1966,4,495
경기도,수원시장안구,연무동,합계,15525,10632,3600,3091,2546,584,699,19,2,13,2,11,4,6,11,10588,44,4893
경기도,수원시장안구,연무동,관내사전투표,1820,1820,714,483,371,107,129,1,0,2,0,1,0,3,2,1813,7,0
경기도,수원시장안구,연무동,연무동제1투,1526,852,265,276,201,56,44,3,1,1,1,2,0,0,0,850,2,674
경기도,수원시장안구,연무동,연무동제2투,2216,1431,460,433,362,65,94,4,0,1,0,1,2,0,1,1423,8,785
경기도,수원시장안구,연무동,연무동제3투,3384,2221,717,613,591,139,145,3,0,1,0,1,1,1,4,2216,5,1163
경기도,수원시장안구,연무동,연무동제4투,419,310,73,138,76,8,10,0,1,0,1,1,0,0,0,308,2,109
경기도,수원시장안구,연무동,연무동제5투,2933,1975,662,586,455,103,144,4,0,3,0,4,0,0,3,1964,11,958
경기도,수원시장안구,연무동,연무동제6투,3227,2023,709,562,490,106,133,4,0,5,0,1,1,2,1,2014,9,1204
경기도,수원시장안구,잘못 투입·구분된 투표지,,0,0,0,0,0,0,0,0,0,0,0,0,0,0,0,0,0,0
경기도,수원시권선구,합계,,290343,222078,95263,42801,51061,15482,15573,273,43,175,60,195,69,77,206,221278,800,68265
경기도,수원시권선구,거소·선상투표,,551,521,160,91,173,30,23,3,4,0,3,2,4,3,5,501,20,30
경기도,수원시권선구,관외사전투표,,26085,26032,12290,3682,5556,2052,2151,35,7,9,10,22,10,6,39,25869,163,53
경기도,수원시권선구,재외투표,,1552,1248,779,63,195,57,142,6,0,2,0,0,0,2,0,1246,2,304
경기도,수원시권선구,세류1동,관내사전투표,1908,1908,839,395,418,112,134,2,0,3,0,0,0,0,2,1905,3,0
경기도,수원시권선구,세류1동,합계,8772,6804,2744,1539,1553,460,461,12,1,5,2,1,2,1,7,6788,16,1968
경기도,수원시권선구,세류1동,세류1동제1투,1712,1384,576,298,296,106,98,3,1,0,1,1,1,0,1,1382,2,328
경기도,수원시권선구,세류1동,세류1동제2투,2647,1620,604,403,369,112,117,5,0,1,0,0,1,1,1,1614,6,1027
경기도,수원시권선구,세류1동,세류1동제3투,2505,1892,725,443,470,130,112,2,0,1,1,0,0,0,3,1887,5,613
경기도,수원시권선구,세류2동,관내사전투표,2626,2625,1149,526,569,167,185,4,0,2,3,5,1,0,1,2612,13,1
경기도,수원시권선구,세류2동,합계,20404,13017,4899,3162,3191,780,862,20,2,15,6,11,2,2,14,12966,51,7387
경기도,수원시권선구,세류2동,세류2동제1투,3613,2010,741,553,482,108,107,2,0,3,0,2,0,1,3,2002,8,1603
경기도,수원시권선구,세류2동,세류2동제2투,2524,1565,564,397,402,90,103,5,0,0,0,0,1,0,0,1562,3,959
경기도,수원시권선구,세류2동,세류2동제3투,2634,1523,542,391,374,94,109,2,2,1,1,1,0,0,2,1519,4,1111
경기도,수원시권선구,세류2동,세류2동제4투,3274,1866,674,466,485,108,114,3,0,4,1,2,0,0,2,1859,7,1408
경기도,수원시권선구,세류2동,세류2동제5투,3297,1973,747,476,467,112,155,3,0,2,0,0,0,1,1,1964,9,1324
경기도,수원시권선구,세류2동,세류2동제6투,2436,1455,482,353,412,101,89,1,0,3,1,1,0,0,5,1448,7,981
경기도,수원시권선구,세류3동,관내사전투표,3309,3309,1363,771,705,210,214,8,6,5,0,6,2,1,3,3294,15,0
경기도,수원시권선구,세류3동,합계,18817,12370,4626,3109,3012,731,776,13,8,11,0,11,8,6,14,12325,45,6447
경기도,수원시권선구,세류3동,세류3동제1투,2948,1682,603,468,405,82,109,0,0,2,0,2,2,1,3,1677,5,1266
경기도,수원시권선구,세류3동,세류3동제2투,2972,1663,618,407,442,83,99,2,0,0,0,1,1,1,1,1655,8,1309
경기도,수원시권선구,세류3동,세류3동제3투,3225,2060,710,523,559,132,123,0,0,2,0,1,0,0,5,2055,5,1165
경기도,수원시권선구,세류3동,세류3동제4투,3273,1716,645,406,430,117,107,1,1,1,0,0,0,3,1,1712,4,1557
경기도,수원시권선구,세류3동,세류3동제5투,3090,1940,687,534,471,107,124,2,1,1,0,1,3,0,1,1932,8,1150
경기도,수원시권선구,평동,합계,27203,19868,7798,4410,4783,1311,1407,22,1,18,9,16,3,9,20,19807,61,7335
경기도,수원시권선구,평동,관내사전투표,3708,3708,1737,683,769,203,287,2,0,2,0,6,0,2,4,3695,13,0
경기도,수원시권선구,평동,평동제1투,1965,1213,411,349,285,93,68,2,0,1,0,0,0,0,1,1210,3,752
경기도,수원시권선구,평동,평동제2투,2101,1352,434,434,317,68,86,2,1,5,0,1,1,0,1,1350,2,749
경기도,수원시권선구,평동,평동제3투,2878,1840,700,408,482,112,124,2,0,1,1,2,1,1,2,1836,4,1038
경기도,수원시권선구,평동,평동제4투,2704,1817,714,355,471,135,125,2,0,2,1,3,0,2,3,1813,4,887
경기도,수원시권선구,평동,평동제5투,3525,2435,889,543,635,182,168,1,0,2,0,1,0,1,3,2425,10,1090
경기도,수원시권선구,평동,평동제6투,3770,2630,1024,657,576,164,189,3,0,0,2,1,1,2,2,2621,9,1140
경기도,수원시권선구,평동,평동제7투,3182,2334,841,538,619,164,152,3,0,3,5,1,0,0,1,2327,7,848
경기도,수원시권선구,평동,평동제8투,3370,2539,1048,443,629,190,208,5,0,2,0,1,0,1,3,2530,9,831
경기도,수원시권선구,서둔동,합계,30539,21348,8482,4603,5111,1371,1561,33,5,37,5,19,7,13,20,21267,81,9191
경기도,수원시권선구,서둔동,관내사전투표,4034,4034,1814,842,814,228,284,9,2,5,3,2,2,2,3,4010,24,0
경기도,수원시권선구,서둔동,서둔동제1투,1733,1083,361,288,257,70,97,1,0,2,0,4,1,0,1,1082,1,650
경기도,수원시권선구,서둔동,서둔동제2투,2144,1514,570,333,385,97,115,4,0,4,0,1,0,0,2,1511,3,630
경기도,수원시권선구,서둔동,서둔동제3투,3264,2039,665,495,570,132,145,3,0,1,0,7,1,3,3,2025,14,1225
경기도,수원시권선구,서둔동,서둔동제4투,1934,1014,307,288,276,79,58,1,0,2,0,0,0,0,0,1011,3,920
경기도,수원시권선구,서둔동,서둔동제5투,3424,2351,955,529,536,149,165,4,0,2,0,0,1,1,1,2343,8,1073
경기도,수원시권선구,서둔동,서둔동제6투,3717,2464,981,503,612,172,178,0,1,6,1,0,1,1,1,2457,7,1253
경기도,수원시권선구,서둔동,서둔동제7투,2420,1902,802,332,475,146,130,4,2,3,1,0,1,0,4,1900,2,518
경기도,수원시권선구,서둔동,서둔동제8투,3780,2460,991,518,593,136,190,6,0,7,0,1,0,6,3,2451,9,1320
경기도,수원시권선구,서둔동,서둔동제9투,4089,2487,1036,475,593,162,199,1,0,5,0,4,0,0,2,2477,10,1602
경기도,수원시권선구,구운동,합계,20570,15401,6411,3296,3617,923,1027,16,3,8,3,10,6,9,12,15341,60,5169
경기도,수원시권선구,구운동,관내사전투표,3567,3567,1634,709,761,200,230,7,0,3,1,3,0,3,1,3552,15,0
경기도,수원시권선구,구운동,구운동제1투,2622,1624,644,345,401,85,126,1,1,0,0,3,0,4,3,1613,11,998
경기도,수원시권선구,구운동,구운동제2투,3059,2338,975,534,501,153,160,2,1,0,1,1,2,0,1,2331,7,721
경기도,수원시권선구,구운동,구운동제3투,2424,1574,550,404,432,75,96,2,0,3,1,1,0,0,1,1565,9,850
경기도,수원시권선구,구운동,구운동제4투,2904,1930,792,426,466,113,113,1,1,1,0,0,2,2,4,1921,9,974
경기도,수원시권선구,구운동,구운동제5투,3433,2888,1226,551,694,207,195,0,0,1,0,2,2,0,2,2880,8,545
경기도,수원시권선구,구운동,구운동제6투,2561,1480,590,327,362,90,107,3,0,0,0,0,0,0,0,1479,1,1081
경기도,수원시권선구,권선1동,합계,19466,13546,5521,2957,3062,983,898,17,7,9,5,11,7,3,19,13499,47,5920
경기도,수원시권선구,권선1동,관내사전투표,3012,3012,1387,549,602,225,220,5,0,2,1,3,1,0,4,2999,13,0
경기도,수원시권선구,권선1동,권선1동제1투,2691,1948,694,537,451,140,111,3,2,1,0,1,3,0,4,1947,1,743
경기도,수원시권선구,권선1동,권선1동제2투,3183,1995,869,389,447,158,122,1,0,0,2,0,0,1,0,1989,6,1188
경기도,수원시권선구,권선1동,권선1동제3투,3230,1855,756,388,423,137,131,3,1,0,1,1,1,0,2,1844,11,1375
경기도,수원시권선구,권선1동,권선1동제4투,2367,1301,419,394,312,77,87,1,2,2,0,1,1,0,2,1298,3,1066
경기도,수원시권선구,권선1동,권선1동제5투,2414,1414,552,346,322,83,95,2,1,3,1,3,0,1,3,1412,2,1000
경기도,수원시권선구,권선1동,권선1동제6투,2569,2021,844,354,505,163,132,2,1,1,0,2,1,1,4,2010,11,548
경기도,수원시권선구,권선2동,합계,34704,28442,12452,5194,6512,2271,1832,23,2,22,6,14,7,6,20,28361,81,6262
경기도,수원시권선구,권선2동,관내사전투표,5791,5791,2730,974,1198,436,417,2,1,7,2,1,3,0,3,5774,17,0
경기도,수원시권선구,권선2동,권선2동제1투,2644,2050,760,484,506,146,134,4,0,0,0,3,0,0,1,2038,12,594
경기도,수원시권선구,권선2동,권선2동제2투,3256,2501,877,647,565,218,174,0,0,2,0,0,0,0,6,2489,12,755
경기도,수원시권선구,권선2동,권선2동제3투,2165,1620,623,347,430,119,92,2,0,2,0,0,0,1,0,1616,4,545
경기도,수원시권선구,권선2동,권선2동제4투,2219,1558,651,315,376,105,101,4,0,1,0,1,0,2,1,1557,1,661
경기도,수원시권선구,권선2동,권선2동제5투,2325,1763,768,325,390,143,128,1,1,2,0,0,1,0,0,1759,4,562
경기도,수원시권선구,권선2동,권선2동제6투,2041,1564,704,249,361,131,103,1,0,0,2,3,2,0,2,1558,6,477
경기도,수원시권선구,권선2동,권선2동제7투,3021,2488,1173,422,564,191,129,0,0,1,1,0,0,1,0,2482,6,533
경기도,수원시권선구,권선2동,권선2동제8투,3280,2660,1135,474,650,224,156,3,0,2,1,2,0,1,4,2652,8,620
경기도,수원시권선구,권선2동,권선2동제9투,3030,2487,1151,460,511,223,128,2,0,2,0,3,0,0,1,2481,6,543
경기도,수원시권선구,권선2동,권선2동제10투,2487,2021,970,211,512,187,133,2,0,2,0,0,1,1,1,2020,1,466
경기도,수원시권선구,권선2동,권선2동제11투,2445,1939,910,286,449,148,137,2,0,1,0,1,0,0,1,1935,4,506
경기도,수원시권선구,곡선동,관내사전투표,3982,3982,2045,514,793,294,312,6,0,1,1,2,1,2,3,3974,8,0
경기도,수원시권선구,곡선동,합계,22536,16094,7512,2444,3632,1238,1164,20,2,8,4,7,7,6,11,16055,39,6442
경기도,수원시권선구,곡선동,곡선동제1투,1718,1285,607,189,300,106,76,1,0,0,0,0,0,1,1,1281,4,433
경기도,수원시권선구,곡선동,곡선동제2투,2959,2466,1041,502,562,192,158,2,0,0,0,2,1,1,0,2461,5,493
경기도,수원시권선구,곡선동,곡선동제3투,3615,2273,956,412,584,159,146,1,0,3,1,0,1,0,2,2265,8,1342
경기도,수원시권선구,곡선동,곡선동제4투,2827,2262,1115,276,527,175,158,2,0,1,1,2,2,1,1,2261,1,565
경기도,수원시권선구,곡선동,곡선동제5투,3241,1579,758,219,331,131,129,1,1,1,0,0,1,1,0,1573,6,1662
경기도,수원시권선구,곡선동,곡선동제6투,4194,2247,990,332,535,181,185,7,1,2,1,1,1,0,4,2240,7,1947
경기도,수원시권선구,입북동,합계,12517,10228,4583,1744,2349,743,741,15,1,9,1,5,0,1,11,10203,25,2289
경기도,수원시권선구,입북동,관내사전투표,2030,2030,997,318,418,136,146,4,0,3,0,3,0,0,1,2026,4,0
경기도,수원시권선구,입북동,입북동제1투,2364,1758,766,316,428,124,108,3,0,2,0,1,0,1,2,1751,7,606
경기도,수원시권선구,입북동,입북동제2투,3211,2499,1027,489,615,174,180,4,1,1,1,0,0,0,2,2494,5,712
경기도,수원시권선구,입북동,입북동제3투,2540,1968,840,346,452,149,164,3,0,3,0,1,0,0,5,1963,5,572
경기도,수원시권선구,입북동,입북동제4투,2372,1973,953,275,436,160,143,1,0,0,0,0,0,0,1,1969,4,399
경기도,수원시권선구,금곡동,관내사전투표,4743,4743,2390,728,954,312,326,5,0,2,1,14,1,1,2,4736,7,0
경기도,수원시권선구,금곡동,합계,25359,20441,9241,3798,4520,1379,1360,28,0,9,3,41,1,7,6,20393,48,4918
경기도,수원시권선구,금곡동,금곡동제1투,1664,1197,502,248,274,79,85,3,0,1,0,1,0,1,0,1194,3,467
경기도,수원시권선구,금곡동,금곡동제2투,2420,1802,824,338,383,127,122,3,0,1,0,2,0,0,1,1801,1,618
경기도,수원시권선구,금곡동,금곡동제3투,3276,2482,1060,492,554,187,170,7,0,2,0,1,0,2,1,2476,6,794
경기도,수원시권선구,금곡동,금곡동제4투,2929,2317,966,521,524,159,127,5,0,2,0,3,0,1,1,2309,8,612
경기도,수원시권선구,금곡동,금곡동제5투,3118,2534,1070,539,558,175,171,0,0,0,0,12,0,1,0,2526,8,584
경기도,수원시권선구,금곡동,금곡동제6투,2212,1645,685,316,418,109,105,3,0,1,0,3,0,0,0,1640,5,567
경기도,수원시권선구,금곡동,금곡동제7투,2214,1678,852,228,374,108,109,1,0,0,0,3,0,0,0,1675,3,536
경기도,수원시권선구,금곡동,금곡동제8투,2783,2043,892,388,481,123,145,1,0,0,2,2,0,1,1,2036,7,740
경기도,수원시권선구,호매실동,합계,21268,16674,7743,2703,3788,1149,1164,10,0,13,3,25,5,3,8,16614,60,4594
경기도,수원시권선구,호매실동,관내사전투표,5042,5042,2599,724,980,313,391,2,0,4,0,9,0,0,2,5024,18,0
경기도,수원시권선구,호매실동,호매실동제1투,2931,2035,819,455,458,143,143,0,0,0,0,3,2,1,2,2026,9,896
경기도,수원시권선구,호매실동,호매실동제2투,3122,2386,939,401,629,203,198,1,0,1,0,3,0,0,2,2377,9,736
경기도,수원시권선구,호매실동,호매실동제3투,2419,1706,917,152,384,117,120,3,0,0,1,4,0,0,0,1698,8,713
경기도,수원시권선구,호매실동,호매실동제4투,1875,1182,510,239,259,85,76,1,0,0,1,2,1,0,1,1175,7,693
경기도,수원시권선구,호매실동,호매실동제5투,3185,2343,1028,385,619,158,135,2,0,3,1,3,1,0,0,2335,8,842
경기도,수원시권선구,호매실동,호매실동제6투,2694,1980,931,347,459,130,101,1,0,5,0,1,1,2,1,1979,1,714
경기도,수원시권선구,잘못 투입·구분된 투표지,,0,44,22,6,7,4,4,0,0,0,0,0,0,0,0,43,1,-44
경기도,수원시팔달구,합계,,167122,123458,49814,27782,28228,8218,8315,172,20,94,27,105,36,53,109,122973,485,43664
경기도,수원시팔달구,거소·선상투표,,247,233,81,31,97,6,3,1,1,2,0,0,0,0,2,224,9,14
경기도,수원시팔달구,관외사전투표,,15626,15625,7262,2403,3275,1245,1264,17,2,9,7,12,6,7,20,15529,96,1
경기도,수원시팔달구,재외투표,,1157,913,572,54,155,38,90,3,0,1,0,0,0,0,0,913,0,244
경기도,수원시팔달구,행궁동,합계,9685,6304,2067,2006,1477,341,342,15,2,9,0,11,2,3,4,6279,25,3381
경기도,수원시팔달구,행궁동,관내사전투표,1929,1929,738,546,406,104,113,5,1,0,0,5,0,2,3,1923,6,0
경기도,수원시팔달구,행궁동,행궁동제1투,3358,1834,547,617,452,104,92,6,0,2,0,2,1,0,1,1824,10,1524
경기도,수원시팔달구,행궁동,행궁동제2투,2143,1268,386,426,316,66,58,3,1,5,0,1,0,1,0,1263,5,875
경기도,수원시팔달구,행궁동,행궁동제3투,2255,1273,396,417,303,67,79,1,0,2,0,3,1,0,0,1269,4,982
경기도,수원시팔달구,매교동,합계,8516,5518,1870,1656,1381,262,293,8,0,4,2,9,3,4,4,5496,22,2998
경기도,수원시팔달구,매교동,관내사전투표,1463,1463,523,460,313,65,83,3,0,1,1,5,1,3,0,1458,5,0
경기도,수원시팔달구,매교동,매교동제1투,2538,1364,457,427,325,64,73,1,0,1,1,3,1,0,1,1354,10,1174
경기도,수원시팔달구,매교동,매교동제2투,2121,1260,405,378,332,66,68,2,0,1,0,1,1,1,2,1257,3,861
경기도,수원시팔달구,매교동,매교동제3투,2394,1431,485,391,411,67,69,2,0,1,0,0,0,0,1,1427,4,963
경기도,수원시팔달구,매산동,관내사전투표,1894,1894,776,411,390,121,178,3,2,0,0,2,0,0,1,1884,10,0
경기도,수원시팔달구,매산동,합계,9549,6574,2475,1650,1509,407,480,9,3,3,0,3,0,1,8,6548,26,2975
경기도,수원시팔달구,매산동,매산동제1투,3301,1509,584,382,341,89,91,4,1,0,0,0,0,1,5,1498,11,1792
경기도,수원시팔달구,매산동,매산동제2투,2921,2271,777,620,572,146,147,1,0,2,0,1,0,0,2,2268,3,650
경기도,수원시팔달구,매산동,매산동제3투,1433,900,338,237,206,51,64,1,0,1,0,0,0,0,0,898,2,533
경기도,수원시팔달구,고등동,관내사전투표,1319,1319,550,323,298,53,85,0,0,3,0,3,1,0,0,1316,3,0
경기도,수원시팔달구,고등동,합계,8344,5379,1957,1479,1332,253,320,8,0,8,0,9,2,1,2,5371,8,2965
경기도,수원시팔달구,고등동,고등동제1투,2256,1080,405,284,274,53,59,1,0,1,0,0,1,0,0,1078,2,1176
경기도,수원시팔달구,고등동,고등동제2투,2036,1324,449,353,356,68,87,2,0,1,0,3,0,0,2,1321,3,712
경기도,수원시팔달구,고등동,고등동제3투,2733,1656,553,519,404,79,89,5,0,3,0,3,0,1,0,1656,0,1077
경기도,수원시팔달구,화서1동,합계,19092,13813,5464,3233,3256,820,919,9,4,14,1,11,7,6,16,13760,53,5279
경기도,수원시팔달구,화서1동,관내사전투표,3074,3074,1317,652,697,173,210,6,1,1,0,2,0,1,1,3061,13,0
경기도,수원시팔달구,화서1동,화서1동제1투,3229,1957,702,504,478,124,134,0,0,2,1,2,2,0,1,1950,7,1272
경기도,수원시팔달구,화서1동,화서1동제2투,3094,1993,698,522,490,116,141,0,0,1,0,3,2,1,6,1980,13,1101
경기도,수원시팔달구,화서1동,화서1동제3투,3454,2249,890,548,523,128,143,1,1,2,0,1,2,2,0,2241,8,1205
경기도,수원시팔달구,화서1동,화서1동제4투,2574,1594,554,500,358,95,77,1,1,1,0,1,0,0,3,1591,3,980
경기도,수원시팔달구,화서1동,화서1동제5투,3667,2946,1303,507,710,184,214,1,1,7,0,2,1,2,5,2937,9,721
경기도,수원시팔달구,화서2동,관내사전투표,3827,3827,1883,575,724,328,293,7,0,2,1,5,0,0,1,3819,8,0
경기도,수원시팔달구,화서2동,합계,20157,16727,7467,3094,3600,1294,1147,21,0,10,5,20,0,8,8,16674,53,3430
경기도,수원시팔달구,화서2동,화서2동제1투,2282,1785,677,423,432,131,110,1,0,0,0,5,0,1,1,1781,4,497
경기도,수원시팔달구,화서2동,화서2동제2투,2527,1881,833,390,383,149,110,1,0,0,1,2,0,1,0,1870,11,646
경기도,수원시팔달구,화서2동,화서2동제3투,2238,1802,784,308,442,125,123,4,0,2,0,3,0,2,2,1795,7,436
경기도,수원시팔달구,화서2동,화서2동제4투,3212,2501,1050,517,563,177,167,3,0,3,3,4,0,0,1,2488,13,711
경기도,수원시팔달구,화서2동,화서2동제5투,2582,2012,849,398,458,157,141,0,0,1,0,1,0,0,1,2006,6,570
경기도,수원시팔달구,화서2동,화서2동제6투,3489,2919,1391,483,598,227,203,5,0,2,0,0,0,4,2,2915,4,570
경기도,수원시팔달구,지동,합계,11714,7813,2665,2349,1847,401,455,15,3,11,3,3,3,4,13,7772,41,3901
경기도,수원시팔달구,지동,관내사전투표,1957,1957,777,532,403,108,119,2,0,1,0,0,2,2,2,1948,9,0
경기도,수원시팔달구,지동,지동제1투,2753,1543,572,390,373,72,115,0,1,3,0,1,0,1,4,1532,11,1210
경기도,수원시팔달구,지동,지동제2투,2714,1647,486,546,408,90,90,4,1,5,3,1,1,1,3,1639,8,1067
경기도,수원시팔달구,지동,지동제3투,2055,1281,363,454,336,52,64,2,1,0,0,1,0,0,1,1274,7,774
경기도,수원시팔달구,지동,지동제4투,2235,1385,467,427,327,79,67,7,0,2,0,0,0,0,3,1379,6,850
경기도,수원시팔달구,우만1동,합계,17347,11738,4546,2761,2794,754,766,14,2,10,2,8,6,10,9,11682,56,5609
경기도,수원시팔달구,우만1동,관내사전투표,2255,2255,996,464,475,149,152,4,1,3,0,2,0,1,1,2248,7,0
경기도,수원시팔달구,우만1동,우만1동제1투,2988,1654,634,372,391,119,127,0,0,1,0,0,1,0,1,1646,8,1334
경기도,수원시팔달구,우만1동,우만1동제2투,3482,2192,836,538,548,115,130,4,0,0,0,2,1,3,3,2180,12,1290
경기도,수원시팔달구,우만1동,우만1동제3투,2751,1869,679,447,462,126,140,0,0,1,1,2,1,2,3,1864,5,882
경기도,수원시팔달구,우만1동,우만1동제4투,2865,1744,675,384,424,120,123,0,0,3,1,1,1,1,0,1733,11,1121
경기도,수원시팔달구,우만1동,우만1동제5투,1501,963,316,302,249,46,27,3,1,2,0,1,1,3,1,952,11,538
경기도,수원시팔달구,우만1동,우만1동제6투,1505,1061,410,254,245,79,67,3,0,0,0,0,1,0,0,1059,2,444
경기도,수원시팔달구,우만2동,관내사전투표,3320,3320,1526,528,666,300,279,5,0,1,0,3,0,2,1,3311,9,0
경기도,수원시팔달구,우만2동,합계,13587,11128,4718,2179,2469,926,765,21,0,3,2,8,1,3,3,11098,30,2459
경기도,수원시팔달구,우만2동,우만2동제1투,2834,1925,800,384,433,154,134,6,0,1,1,3,1,0,1,1918,7,909
경기도,수원시팔달구,우만2동,우만2동제2투,2535,1899,792,391,433,144,125,4,0,1,0,1,0,0,0,1891,8,636
경기도,수원시팔달구,우만2동,우만2동제3투,2512,2016,769,461,482,170,125,4,0,0,1,1,0,0,1,2014,2,496
경기도,수원시팔달구,우만2동,우만2동제4투,2386,1968,831,415,455,158,102,2,0,0,0,0,0,1,0,1964,4,418
경기도,수원시팔달구,인계동,합계,32101,21693,8670,4887,5036,1471,1471,31,3,10,5,11,6,6,20,21627,66,10408
경기도,수원시팔달구,인계동,관내사전투표,4126,4126,1740,951,864,247,294,7,1,3,2,2,0,0,4,4115,11,0
경기도,수원시팔달구,인계동,인계동제1투,3914,2071,669,596,527,140,120,5,0,1,0,1,1,0,0,2060,11,1843
경기도,수원시팔달구,인계동,인계동제2투,4397,2692,1035,594,648,200,194,1,0,3,1,1,3,0,5,2685,7,1705
경기도,수원시팔달구,인계동,인계동제3투,2912,2025,824,446,438,145,153,5,1,1,0,1,2,1,2,2019,6,887
경기도,수원시팔달구,인계동,인계동제4투,3089,2310,914,559,545,159,122,2,0,0,1,2,0,0,1,2305,5,779
경기도,수원시팔달구,인계동,인계동제5투,3551,2894,1318,502,671,217,172,7,0,0,0,0,0,0,0,2887,7,657
경기도,수원시팔달구,인계동,인계동제6투,3974,2246,962,383,531,173,184,3,0,1,0,0,0,1,2,2240,6,1728
경기도,수원시팔달구,인계동,인계동제7투,3155,1632,628,417,368,84,123,0,1,0,1,1,0,3,3,1629,3,1523
경기도,수원시팔달구,인계동,인계동제8투,2983,1697,580,439,444,106,109,1,0,1,0,3,0,1,3,1687,10,1286
경기도,수원시팔달구,잘못 투입·구분된 투표지,,0,0,0,0,0,0,0,0,0,0,0,0,0,0,0,0,0,0
경기도,수원시영통구,합계,,264002,220307,105181,33354,46872,18468,15086,228,23,92,26,117,24,54,124,219649,658,43695
경기도,수원시영통구,거소·선상투표,,355,337,116,50,119,27,10,0,1,1,1,1,1,0,2,329,8,18
경기도,수원시영통구,관외사전투표,,27691,27680,13595,3461,5601,2582,2192,16,9,7,3,15,2,9,29,27521,159,11
경기도,수원시영통구,재외투표,,2310,1851,1152,89,280,99,221,1,0,0,0,0,0,2,1,1845,6,459
경기도,수원시영통구,매탄1동,합계,15217,12099,5136,2409,2727,930,819,20,1,4,3,9,5,4,1,12068,31,3118
경기도,수원시영통구,매탄1동,관내사전투표,3658,3658,1691,667,740,265,275,3,0,2,1,0,3,0,0,3647,11,0
경기도,수원시영통구,매탄1동,매탄1동제1투,1675,1168,481,209,291,93,86,4,0,0,0,1,0,0,0,1165,3,507
경기도,수원시영통구,매탄1동,매탄1동제2투,2031,1578,598,331,395,122,120,4,0,1,1,1,2,0,0,1575,3,453
경기도,수원시영통구,매탄1동,매탄1동제3투,1878,1476,666,269,320,123,93,2,0,0,1,1,0,0,0,1475,1,402
경기도,수원시영통구,매탄1동,매탄1동제4투,2139,1701,782,300,374,147,89,0,0,0,0,1,0,1,1,1695,6,438
경기도,수원시영통구,매탄1동,매탄1동제5투,1928,1321,479,309,338,99,80,5,1,0,0,5,0,1,0,1317,4,607
경기도,수원시영통구,매탄1동,매탄1동제6투,1908,1197,439,324,269,81,76,2,0,1,0,0,0,2,0,1194,3,711
경기도,수원시영통구,매탄2동,합계,12083,9055,3730,1966,2123,626,545,9,1,5,3,8,2,3,10,9031,24,3028
경기도,수원시영통구,매탄2동,관내사전투표,2283,2283,1065,430,468,153,153,1,0,0,0,3,0,1,1,2275,8,0
경기도,수원시영통구,매탄2동,매탄2동제1투,2788,1741,657,436,431,114,87,2,1,0,1,2,0,1,5,1737,4,1047
경기도,수원시영통구,매탄2동,매탄2동제2투,2746,1769,656,422,441,127,108,4,0,2,1,0,1,1,1,1764,5,977
경기도,수원시영통구,매탄2동,매탄2동제3투,2625,1986,781,482,457,135,118,2,0,1,1,2,1,0,2,1982,4,639
경기도,수원시영통구,매탄2동,매탄2동제4투,1641,1276,571,196,326,97,79,0,0,2,0,1,0,0,1,1273,3,365
경기도,수원시영통구,매탄3동,합계,26220,21111,9898,3393,4472,1724,1485,18,1,24,2,14,1,3,16,21051,60,5109
경기도,수원시영통구,매탄3동,관내사전투표,5282,5282,2690,734,1016,426,382,3,0,6,1,4,0,1,6,5269,13,0
경기도,수원시영통구,매탄3동,매탄3동제1투,3616,3001,1461,461,623,250,194,1,0,1,1,2,0,0,2,2996,5,615
경기도,수원시영통구,매탄3동,매탄3동제2투,3194,2349,1139,360,495,190,152,2,0,3,0,1,0,0,0,2342,7,845
경기도,수원시영통구,매탄3동,매탄3동제3투,3103,2396,1112,388,549,189,149,2,0,1,0,0,1,0,1,2392,4,707
경기도,수원시영통구,매탄3동,매탄3동제4투,3006,2303,1074,401,451,195,163,3,0,4,0,4,0,1,3,2299,4,703
경기도,수원시영통구,매탄3동,매탄3동제5투,3080,2205,873,450,555,138,167,2,1,5,0,1,0,0,1,2193,12,875
경기도,수원시영통구,매탄3동,매탄3동제6투,2972,2272,903,472,544,160,175,3,0,4,0,1,0,0,3,2265,7,700
경기도,수원시영통구,매탄3동,매탄3동제7투,1967,1303,646,127,239,176,103,2,0,0,0,1,0,1,0,1295,8,664
경기도,수원시영통구,매탄4동,합계,17232,13175,5587,2503,3001,993,986,17,1,12,2,16,4,3,6,13131,44,4057
경기도,수원시영통구,매탄4동,관내사전투표,2920,2920,1368,464,574,241,244,5,0,2,0,6,1,0,2,2907,13,0
경기도,수원시영통구,매탄4동,매탄4동제1투,2744,1736,705,354,414,113,132,3,1,1,0,2,1,2,2,1730,6,1008
경기도,수원시영통구,매탄4동,매탄4동제2투,2947,2276,1014,425,485,175,168,0,0,1,0,2,1,0,0,2271,5,671
경기도,수원시영통구,매탄4동,매탄4동제3투,2661,1735,676,332,450,133,130,3,0,1,1,2,1,0,0,1729,6,926
경기도,수원시영통구,매탄4동,매탄4동제4투,2893,2240,998,403,499,166,159,2,0,3,0,1,0,1,0,2232,8,653
경기도,수원시영통구,매탄4동,매탄4동제5투,3067,2268,826,525,579,165,153,4,0,4,1,3,0,0,2,2262,6,799
경기도,수원시영통구,원천동,합계,17612,13630,6538,2090,2827,1167,908,20,2,3,1,11,0,4,4,13575,55,3982
경기도,수원시영통구,원천동,관내사전투표,3651,3651,1875,503,714,296,240,2,0,1,0,5,0,2,3,3641,10,0
경기도,수원시영통구,원천동,원천동제1투,3462,2740,1371,376,575,194,204,3,1,0,0,2,0,1,0,2727,13,722
경기도,수원시영통구,원천동,원천동제2투,2406,1523,656,310,327,123,95,2,1,0,1,0,0,0,1,1516,7,883
경기도,수원시영통구,원천동,원천동제3투,3967,2599,1125,424,574,256,194,7,0,2,0,3,0,1,0,2586,13,1368
경기도,수원시영통구,원천동,원천동제4투,1951,1358,626,239,241,145,95,4,0,0,0,1,0,0,0,1351,7,593
경기도,수원시영통구,원천동,원천동제5투,2175,1759,885,238,396,153,80,2,0,0,0,0,0,0,0,1754,5,416
경기도,수원시영통구,영통1동,합계,28684,23884,11742,3434,4914,2065,1594,29,1,10,5,14,1,5,14,23828,56,4800
경기도,수원시영통구,영통1동,관내사전투표,6309,6309,3358,750,1121,550,489,7,1,2,1,5,0,2,7,6293,16,0
경기도,수원시영통구,영통1동,영통1동제1투,2895,2212,1107,298,473,180,141,4,0,0,1,2,0,2,1,2209,3,683
경기도,수원시영통구,영통1동,영통1동제2투,3422,2689,1406,344,565,198,153,10,0,1,0,1,0,0,2,2680,9,733
경기도,수원시영통구,영통1동,영통1동제3투,2901,2326,1107,354,503,203,151,1,0,2,0,1,0,0,1,2323,3,575
경기도,수원시영통구,영통1동,영통1동제4투,3271,2765,1355,404,577,246,171,4,0,1,1,0,0,0,1,2760,5,506
경기도,수원시영통구,영통1동,영통1동제5투,3025,2018,886,349,436,199,134,1,0,2,0,3,1,0,2,2013,5,1007
경기도,수원시영통구,영통1동,영통1동제6투,3892,3165,1364,575,732,295,184,1,0,2,0,1,0,1,0,3155,10,727
경기도,수원시영통구,영통1동,영통1동제7투,2969,2400,1159,360,507,194,171,1,0,0,2,1,0,0,0,2395,5,569
경기도,수원시영통구,영통2동,합계,32697,27962,14138,3737,5565,2414,1958,24,2,6,4,7,4,9,10,27878,84,4735
경기도,수원시영통구,영통2동,관내사전투표,6721,6721,3724,688,1101,614,549,2,1,1,1,3,1,5,4,6694,27,0
경기도,수원시영통구,영통2동,영통2동제1투,2889,2261,1207,236,476,176,158,1,0,1,0,1,0,0,0,2256,5,628
경기도,수원시영통구,영통2동,영통2동제2투,3377,2835,1472,318,604,234,195,5,0,0,0,0,0,0,1,2829,6,542
경기도,수원시영통구,영통2동,영통2동제3투,3320,2616,1383,302,485,235,199,3,0,0,0,2,2,1,0,2612,4,704
경기도,수원시영통구,영통2동,영통2동제4투,2668,2280,1095,381,456,195,145,1,0,0,0,0,1,0,0,2274,6,388
경기도,수원시영통구,영통2동,영통2동제5투,2809,2405,1167,310,573,209,134,2,1,0,0,0,0,2,0,2398,7,404
경기도,수원시영통구,영통2동,영통2동제6투,2337,1894,963,212,381,180,147,3,0,1,1,0,0,1,1,1890,4,443
경기도,수원시영통구,영통2동,영통2동제7투,2872,2263,1099,320,461,208,159,2,0,1,0,0,0,0,2,2252,11,609
경기도,수원시영통구,영통2동,영통2동제8투,3824,3118,1252,753,681,242,171,4,0,2,1,1,0,0,1,3108,10,706
경기도,수원시영통구,영통2동,영통2동제9투,1880,1569,776,217,347,121,101,1,0,0,1,0,0,0,1,1565,4,311
경기도,수원시영통구,태장동,합계,36777,30001,14104,4579,6642,2561,1981,20,0,10,2,11,2,3,17,29932,69,6776
경기도,수원시영통구,태장동,관내사전투표,6895,6894,3475,998,1386,537,461,10,0,2,0,4,0,1,4,6878,16,1
경기도,수원시영통구,태장동,태장동제1투,2798,2120,931,411,448,169,151,1,0,4,0,0,0,1,0,2116,4,678
경기도,수원시영통구,태장동,태장동제2투,2083,1446,750,98,269,207,111,0,0,0,0,1,1,0,3,1440,6,637
경기도,수원시영통구,태장동,태장동제3투,3245,2612,1158,448,637,204,156,2,0,1,1,0,0,0,0,2607,5,633
경기도,수원시영통구,태장동,태장동제4투,2472,1928,835,319,463,149,153,1,0,1,0,1,0,0,1,1923,5,544
경기도,수원시영통구,태장동,태장동제5투,3900,3293,1772,376,665,256,210,0,0,0,0,1,1,1,2,3284,9,607
경기도,수원시영통구,태장동,태장동제6투,3339,2511,1095,403,623,219,164,0,0,1,0,1,0,0,1,2507,4,828
경기도,수원시영통구,태장동,태장동제7투,2123,1619,770,213,366,155,107,1,0,1,0,2,0,0,2,1617,2,504
경기도,수원시영통구,태장동,태장동제8투,3034,2248,891,470,566,179,133,3,0,0,0,0,0,0,0,2242,6,786
경기도,수원시영통구,태장동,태장동제9투,3428,2759,1334,400,601,249,165,2,0,0,0,0,0,0,2,2753,6,669
경기도,수원시영통구,태장동,태장동제10투,3460,2571,1093,443,618,237,170,0,0,0,1,1,0,0,2,2565,6,889
경기도,수원시영통구,광교1동,관내사전투표,6204,6204,3416,687,1140,517,431,3,1,1,0,0,0,0,0,6196,8,0
경기도,수원시영통구,광교1동,합계,30323,25722,12739,3450,5591,2299,1561,27,4,5,0,3,0,5,6,25690,32,4601
경기도,수원시영통구,광교1동,광교1동제1투,2380,1810,936,207,345,195,123,0,1,0,0,0,0,0,1,1808,2,570
경기도,수원시영통구,광교1동,광교1동제2투,2672,2275,1259,206,481,194,132,1,0,0,0,0,0,1,0,2274,1,397
경기도,수원시영통구,광교1동,광교1동제3투,2745,2085,906,346,534,172,119,3,1,0,0,1,0,0,1,2083,2,660
경기도,수원시영통구,광교1동,광교1동제4투,2710,2268,966,374,570,225,123,2,0,1,0,0,0,1,1,2263,5,442
경기도,수원시영통구,광교1동,광교1동제5투,3517,2898,1360,448,701,238,134,8,1,2,0,1,0,0,1,2894,4,619
경기도,수원시영통구,광교1동,광교1동제6투,2017,1513,768,180,309,128,122,0,0,0,0,1,0,1,0,1509,4,504
경기도,수원시영통구,광교1동,광교1동제7투,1606,1360,624,203,325,141,67,0,0,0,0,0,0,0,0,1360,0,246
경기도,수원시영통구,광교1동,광교1동제8투,2132,1709,847,214,388,145,110,3,0,0,0,0,0,0,0,1707,2,423
경기도,수원시영통구,광교1동,광교1동제9투,2393,2018,929,323,471,187,95,4,0,1,0,0,0,2,2,2014,4,375
경기도,수원시영통구,광교1동,광교1동제10투,1947,1582,728,262,327,157,105,3,0,0,0,0,0,0,0,1582,0,365
경기도,수원시영통구,광교2동,합계,16801,13789,6702,2192,3009,981,825,27,0,5,0,8,2,4,8,13763,26,3012
경기도,수원시영통구,광교2동,관내사전투표,3011,3011,1625,377,598,203,188,2,0,2,0,5,0,1,3,3004,7,0
경기도,수원시영통구,광교2동,광교2동제1투,2129,1656,803,292,357,123,67,8,0,2,0,0,0,0,0,1652,4,473
경기도,수원시영통구,광교2동,광교2동제2투,3106,2312,934,535,549,134,145,6,0,0,0,3,1,1,0,2308,4,794
경기도,수원시영통구,광교2동,광교2동제3투,3502,2832,1333,407,658,238,178,7,0,0,0,0,0,1,3,2825,7,670
경기도,수원시영통구,광교2동,광교2동제4투,2738,2166,1027,366,478,151,138,2,0,0,0,0,0,1,2,2165,1,572
경기도,수원시영통구,광교2동,광교2동제5투,2315,1812,980,215,369,132,109,2,0,1,0,0,1,0,0,1809,3,503
경기도,수원시영통구,잘못 투입·구분된 투표지,,0,11,4,1,1,0,1,0,0,0,0,0,0,0,0,7,4,-11
경기도,성남시수정구,합계,,201105,149414,63867,28395,36752,9315,9649,201,27,120,22,253,48,64,129,148842,572,51691
경기도,성남시수정구,거소·선상투표,,326,300,116,49,91,15,7,2,1,1,0,0,2,0,2,286,14,26
경기도,성남시수정구,관외사전투표,,18887,18880,8991,2719,4102,1401,1475,22,4,10,3,23,9,7,27,18793,87,7
경기도,성남시수정구,재외투표,,1203,914,563,64,125,45,105,4,1,0,0,0,0,0,0,907,7,289
경기도,성남시수정구,신흥1동,합계,12104,7821,3241,1533,2099,373,477,23,0,11,0,21,3,3,5,7789,32,4283
경기도,성남시수정구,신흥1동,관내사전투표,2360,2360,1063,386,604,100,171,11,0,5,0,10,0,0,2,2352,8,0
경기도,성남시수정구,신흥1동,신흥1동제1투,2904,1477,603,287,419,73,84,2,0,0,0,2,1,0,1,1472,5,1427
경기도,성남시수정구,신흥1동,신흥1동제2투,2280,1274,520,253,359,67,56,4,0,2,0,4,1,1,1,1268,6,1006
경기도,성남시수정구,신흥1동,신흥1동제3투,2118,1195,466,241,333,57,82,1,0,0,0,4,1,0,1,1186,9,923
경기도,성남시수정구,신흥1동,신흥1동제4투,2442,1515,589,366,384,76,84,5,0,4,0,1,0,2,0,1511,4,927
경기도,성남시수정구,신흥2동,합계,15086,10316,4244,1958,2735,624,652,16,2,13,0,22,2,6,10,10284,32,4770
경기도,성남시수정구,신흥2동,관내사전투표,2424,2424,1078,434,608,136,137,5,2,6,0,8,0,3,5,2422,2,0
경기도,성남시수정구,신흥2동,신흥2동제1투,1916,1086,435,241,271,65,63,1,0,0,0,4,1,2,0,1083,3,830
경기도,성남시수정구,신흥2동,신흥2동제2투,3448,2482,964,500,693,165,145,2,0,1,0,4,0,0,0,2474,8,966
경기도,성남시수정구,신흥2동,신흥2동제3투,3124,1973,811,377,532,100,134,2,0,1,0,0,1,0,3,1961,12,1151
경기도,성남시수정구,신흥2동,신흥2동제4투,2941,1584,607,284,446,101,122,6,0,4,0,5,0,1,2,1578,6,1357
경기도,성남시수정구,신흥2동,신흥2동제5투,1233,767,349,122,185,57,51,0,0,1,0,1,0,0,0,766,1,466
경기도,성남시수정구,신흥3동,합계,9818,6588,2650,1364,1765,367,386,6,0,5,1,10,1,6,6,6567,21,3230
경기도,성남시수정구,신흥3동,관내사전투표,2376,2376,1045,459,564,127,167,1,0,1,0,4,0,2,0,2370,6,0
경기도,성남시수정구,신흥3동,신흥3동제1투,2450,1330,512,273,380,76,71,2,0,2,0,3,0,1,4,1324,6,1120
경기도,성남시수정구,신흥3동,신흥3동제2투,2307,1372,505,296,407,80,70,1,0,2,0,1,1,2,1,1366,6,935
경기도,성남시수정구,신흥3동,신흥3동제3투,2685,1510,588,336,414,84,78,2,0,0,1,2,0,1,1,1507,3,1175
경기도,성남시수정구,태평1동,합계,14223,10008,4357,1948,2427,538,650,8,2,10,0,16,2,5,7,9970,38,4215
경기도,성남시수정구,태평1동,관내사전투표,3036,3036,1411,554,661,169,212,3,1,5,0,4,0,2,1,3023,13,0
경기도,성남시수정구,태평1동,태평1동제1투,3338,2116,902,444,516,114,127,2,0,2,0,5,0,1,1,2114,2,1222
경기도,성남시수정구,태평1동,태평1동제2투,2774,1794,750,359,440,96,128,2,0,1,0,1,1,1,3,1782,12,980
경기도,성남시수정구,태평1동,태평1동제3투,2663,1543,643,316,409,77,89,0,0,0,0,3,0,0,2,1539,4,1120
경기도,성남시수정구,태평1동,태평1동제4투,2412,1519,651,275,401,82,94,1,1,2,0,3,1,1,0,1512,7,893
경기도,성남시수정구,태평2동,관내사전투표,1844,1844,836,303,480,96,112,3,0,1,0,6,0,0,1,1838,6,0
경기도,성남시수정구,태평2동,합계,12455,8297,3447,1572,2273,414,504,10,3,6,1,17,4,2,5,8258,39,4158
경기도,성남시수정구,태평2동,태평2동제1투,2560,1414,620,280,348,68,87,2,0,1,0,2,0,0,0,1408,6,1146
경기도,성남시수정구,태평2동,태평2동제2투,2936,1981,835,378,534,101,116,3,0,1,0,4,0,1,0,1973,8,955
경기도,성남시수정구,태평2동,태평2동제3투,1591,949,387,164,279,43,67,0,0,2,0,0,1,1,0,944,5,642
경기도,성남시수정구,태평2동,태평2동제4투,1321,755,284,163,210,43,45,2,1,0,0,1,1,0,2,752,3,566
경기도,성남시수정구,태평2동,태평2동제5투,2203,1354,485,284,422,63,77,0,2,1,1,4,2,0,2,1343,11,849
경기도,성남시수정구,태평3동,합계,12213,8624,3559,1691,2211,500,563,14,1,8,1,27,1,4,12,8592,32,3589
경기도,성남시수정구,태평3동,관내사전투표,2797,2797,1222,486,702,150,207,0,0,1,0,10,0,2,5,2785,12,0
경기도,성남시수정구,태평3동,태평3동제1투,2362,1544,665,284,370,123,93,1,0,1,0,3,0,0,2,1542,2,818
경기도,성남시수정구,태평3동,태평3동제2투,2202,1327,514,279,382,51,80,6,1,4,1,1,0,0,3,1322,5,875
경기도,성남시수정구,태평3동,태평3동제3투,2427,1361,511,309,341,90,91,4,0,1,0,3,1,2,0,1353,8,1066
경기도,성남시수정구,태평3동,태평3동제4투,2425,1595,647,333,416,86,92,3,0,1,0,10,0,0,2,1590,5,830
경기도,성남시수정구,태평4동,합계,10959,7439,3118,1418,1955,394,476,12,3,6,1,14,5,5,5,7412,27,3520
경기도,성남시수정구,태평4동,관내사전투표,1566,1566,720,267,389,66,109,1,2,1,0,2,2,0,2,1561,5,0
경기도,성남시수정구,태평4동,태평4동제1투,2099,1294,528,256,337,90,68,1,0,1,1,2,1,3,0,1288,6,805
경기도,성남시수정구,태평4동,태평4동제2투,2709,1623,634,330,453,80,108,3,1,1,0,4,0,2,1,1617,6,1086
경기도,성남시수정구,태평4동,태평4동제3투,2249,1345,595,234,347,73,85,5,0,2,0,3,0,0,0,1344,1,904
경기도,성남시수정구,태평4동,태평4동제4투,2336,1611,641,331,429,85,106,2,0,1,0,3,2,0,2,1602,9,725
경기도,성남시수정구,수진1동,합계,11444,7360,3051,1505,1910,348,445,10,1,10,3,21,5,6,7,7322,38,4084
경기도,성남시수정구,수진1동,관내사전투표,2078,2078,937,387,508,87,131,3,1,3,0,8,0,3,3,2071,7,0
경기도,성남시수정구,수진1동,수진1동제1투,2279,1190,441,280,327,54,69,1,0,2,0,6,0,1,1,1182,8,1089
경기도,성남시수정구,수진1동,수진1동제2투,2566,1564,612,340,440,79,71,2,0,2,1,6,4,1,1,1559,5,1002
경기도,성남시수정구,수진1동,수진1동제3투,2252,1202,509,228,310,59,78,2,0,1,0,1,0,0,2,1190,12,1050
경기도,성남시수정구,수진1동,수진1동제4투,2269,1326,552,270,325,69,96,2,0,2,2,0,1,1,0,1320,6,943
경기도,성남시수정구,수진2동,합계,13947,10121,4183,2140,2527,592,610,12,0,3,3,12,3,2,4,10091,30,3826
경기도,성남시수정구,수진2동,관내사전투표,2808,2808,1329,518,635,130,181,3,0,0,1,5,0,0,0,2802,6,0
경기도,성남시수정구,수진2동,수진2동제1투,2558,1464,608,309,349,100,83,3,0,0,0,1,2,0,2,1457,7,1094
경기도,성남시수정구,수진2동,수진2동제2투,2464,1487,631,322,367,76,78,3,0,0,2,0,1,1,0,1481,6,977
경기도,성남시수정구,수진2동,수진2동제3투,1474,863,325,208,233,52,40,0,0,0,0,2,0,0,1,861,2,611
경기도,성남시수정구,수진2동,수진2동제4투,1760,1261,479,263,345,77,92,0,0,0,0,1,0,1,1,1259,2,499
경기도,성남시수정구,수진2동,수진2동제5투,2883,2238,811,520,598,157,136,3,0,3,0,3,0,0,0,2231,7,645
경기도,성남시수정구,단대동,합계,12137,8963,3815,1794,2114,578,580,8,6,4,3,9,5,5,6,8927,36,3174
경기도,성남시수정구,단대동,관내사전투표,1879,1879,895,346,378,121,125,0,2,3,1,3,0,0,1,1875,4,0
경기도,성남시수정구,단대동,단대동제1투,2964,2025,808,424,522,117,141,2,1,0,0,1,1,1,2,2020,5,939
경기도,성남시수정구,단대동,단대동제2투,3338,2554,1100,502,622,178,134,1,0,0,2,1,2,2,2,2546,8,784
경기도,성남시수정구,단대동,단대동제3투,2111,1291,531,247,324,86,88,2,2,1,0,1,1,0,1,1284,7,820
경기도,성남시수정구,단대동,단대동제4투,1845,1214,481,275,268,76,92,3,1,0,0,3,1,2,0,1202,12,631
경기도,성남시수정구,산성동,합계,11448,8140,3614,1492,2017,421,515,14,1,7,1,16,1,4,6,8109,31,3308
경기도,성남시수정구,산성동,관내사전투표,2342,2342,1107,424,526,105,153,4,0,3,0,5,0,2,2,2331,11,0
경기도,성남시수정구,산성동,산성동제1투,2315,1481,632,291,366,76,101,2,0,1,0,4,1,0,2,1476,5,834
경기도,성남시수정구,산성동,산성동제2투,2650,1837,835,304,455,112,116,4,0,2,0,3,0,0,1,1832,5,813
경기도,성남시수정구,산성동,산성동제3투,2327,1315,540,273,355,58,77,3,1,0,0,1,0,2,0,1310,5,1012
경기도,성남시수정구,산성동,산성동제4투,1814,1165,500,200,315,70,68,1,0,1,1,3,0,0,1,1160,5,649
경기도,성남시수정구,양지동,합계,8770,6655,2877,1233,1702,368,403,10,1,5,1,21,0,3,9,6633,22,2115
경기도,성남시수정구,양지동,관내사전투표,2556,2555,1156,465,616,135,154,4,1,1,0,12,0,1,3,2548,7,1
경기도,성남시수정구,양지동,양지동제1투,2436,1607,727,273,408,83,99,1,0,1,1,5,0,1,2,1601,6,829
경기도,성남시수정구,양지동,양지동제2투,2126,1410,575,256,392,83,87,3,0,2,0,3,0,0,3,1404,6,716
경기도,성남시수정구,양지동,양지동제3투,1652,1083,419,239,286,67,63,2,0,1,0,1,0,1,1,1080,3,569
경기도,성남시수정구,복정동,관내사전투표,2277,2277,1213,269,408,177,190,3,0,1,0,4,0,0,2,2267,10,0
경기도,성남시수정구,복정동,합계,9420,7378,3708,1040,1430,575,578,4,1,6,0,6,1,0,4,7353,25,2042
경기도,성남시수정구,복정동,복정동제1투,1935,1354,634,228,264,123,95,1,0,2,0,2,0,0,2,1351,3,581
경기도,성남시수정구,복정동,복정동제2투,288,196,53,65,56,12,6,0,1,1,0,0,0,0,0,194,2,92
경기도,성남시수정구,복정동,복정동제3투,2445,1809,900,249,367,142,143,0,0,0,0,0,1,0,0,1802,7,636
경기도,성남시수정구,복정동,복정동제4투,2475,1742,908,229,335,121,144,0,0,2,0,0,0,0,0,1739,3,733
경기도,성남시수정구,신촌동,관내사전투표,715,715,287,156,161,64,38,0,0,2,0,1,0,0,1,710,5,0
경기도,성남시수정구,신촌동,합계,3063,2411,850,568,606,215,148,5,0,5,3,1,0,1,1,2403,8,652
경기도,성남시수정구,신촌동,신촌동투표소,2348,1696,563,412,445,151,110,5,0,3,3,0,0,1,0,1693,3,652
경기도,성남시수정구,고등동,관내사전투표,337,337,109,106,82,18,19,1,0,0,0,1,0,0,0,336,1,0
경기도,성남시수정구,고등동,합계,1466,1043,301,370,252,60,50,3,0,0,0,1,0,0,1,1038,5,423
경기도,성남시수정구,고등동,고등동투표소,1129,706,192,264,170,42,31,2,0,0,0,0,0,0,1,702,4,423
경기도,성남시수정구,시흥동,관내사전투표,510,510,198,157,89,28,34,0,0,0,0,1,0,0,0,507,3,0
경기도,성남시수정구,시흥동,합계,2516,1910,578,699,413,119,90,1,0,1,0,2,0,0,1,1904,6,606
경기도,성남시수정구,시흥동,시흥동투표소,2006,1400,380,542,324,91,56,1,0,1,0,1,0,0,1,1397,3,606
경기도,성남시수정구,위례동,관내사전투표,4156,4156,1928,719,914,329,247,2,0,2,0,4,1,2,2,4150,6,0
경기도,성남시수정구,위례동,합계,19620,16246,6604,3238,3998,1368,935,17,0,9,1,14,4,5,11,16204,42,3374
경기도,성남시수정구,위례동,위례동제1투,2305,1814,649,444,446,177,87,4,0,1,0,1,1,0,0,1810,4,491
경기도,성남시수정구,위례동,위례동제2투,2798,2281,880,466,576,237,108,4,0,0,0,1,0,0,1,2273,8,517
경기도,성남시수정구,위례동,위례동제3투,2212,1828,926,223,401,139,134,1,0,0,0,0,0,0,0,1824,4,384
경기도,성남시수정구,위례동,위례동제4투,2117,1701,671,317,426,177,99,4,0,0,0,2,0,0,1,1697,4,416
경기도,성남시수정구,위례동,위례동제5투,2031,1647,536,402,437,181,86,0,0,2,0,0,0,1,0,1645,2,384
경기도,성남시수정구,위례동,위례동제6투,2142,1550,524,390,452,72,88,1,0,3,1,4,2,0,5,1542,8,592
경기도,성남시수정구,위례동,위례동제7투,1859,1269,490,277,346,56,86,1,0,1,0,2,0,2,2,1263,6,590
경기도,성남시수정구,잘못 투입·구분된 투표지,,0,0,0,0,0,0,0,0,0,0,0,0,0,0,0,0,0,0
경기도,성남시중원구,합계,,198663,146801,62729,27896,36512,8502,9599,211,36,116,29,355,42,63,142,146232,569,51862
경기도,성남시중원구,거소·선상투표,,354,326,145,38,94,20,15,1,2,2,1,0,1,1,0,320,6,28
경기도,성남시중원구,관외사전투표,,19170,19165,9195,2633,4313,1240,1537,16,5,13,7,48,4,6,30,19047,118,5
경기도,성남시중원구,재외투표,,989,762,470,67,102,23,94,2,0,0,0,0,0,0,1,759,3,227
경기도,성남시중원구,성남동,합계,24348,16983,6945,3578,4356,920,1007,16,4,20,3,32,4,4,19,16908,75,7365
경기도,성남시중원구,성남동,관내사전투표,4810,4810,2120,1046,1089,220,288,2,1,5,1,9,0,2,6,4789,21,0
경기도,성남시중원구,성남동,성남동제1투,3990,2235,924,450,580,120,136,5,0,1,2,6,0,0,1,2225,10,1755
경기도,성남시중원구,성남동,성남동제2투,3963,2635,1068,517,702,153,156,4,2,2,0,8,2,0,6,2620,15,1328
경기도,성남시중원구,성남동,성남동제3투,2958,2120,821,421,595,136,119,3,1,5,0,5,0,0,0,2106,14,838
경기도,성남시중원구,성남동,성남동제4투,2959,1951,755,421,515,113,132,0,0,1,0,3,1,1,3,1945,6,1008
경기도,성남시중원구,성남동,성남동제5투,3796,2157,854,486,559,120,123,2,0,4,0,1,0,1,1,2151,6,1639
경기도,성남시중원구,성남동,성남동제6투,1872,1075,403,237,316,58,53,0,0,2,0,0,1,0,2,1072,3,797
경기도,성남시중원구,중앙동,합계,13360,8885,3612,1839,2323,500,530,18,1,3,2,16,2,6,10,8862,23,4475
경기도,성남시중원구,중앙동,관내사전투표,2413,2413,1056,474,557,143,151,6,0,2,0,9,0,3,4,2405,8,0
경기도,성남시중원구,중앙동,중앙동제1투,2881,1797,700,413,463,104,104,2,1,0,0,4,0,2,0,1793,4,1084
경기도,성남시중원구,중앙동,중앙동제2투,2366,1447,573,301,394,63,103,2,0,0,1,2,0,0,4,1443,4,919
경기도,성남시중원구,중앙동,중앙동제3투,2819,1115,353,275,354,55,68,2,0,1,1,0,1,0,1,1111,4,1704
경기도,성남시중원구,중앙동,중앙동제4투,2881,2113,930,376,555,135,104,6,0,0,0,1,1,1,1,2110,3,768
경기도,성남시중원구,금광1동,합계,9090,6133,2506,1233,1586,328,406,16,0,3,3,22,1,4,5,6113,20,2957
경기도,성남시중원구,금광1동,관내사전투표,1483,1483,658,280,369,67,89,6,0,1,0,3,0,1,0,1474,9,0
경기도,성남시중원구,금광1동,금광1동제1투,1785,843,290,211,220,50,59,3,0,1,0,3,1,0,1,839,4,942
경기도,성남시중원구,금광1동,금광1동제2투,1839,1166,473,236,304,62,79,2,0,0,0,7,0,1,1,1165,1,673
경기도,성남시중원구,금광1동,금광1동제3투,1036,620,245,128,175,26,38,1,0,0,0,1,0,1,2,617,3,416
경기도,성남시중원구,금광1동,금광1동제4투,1144,688,249,155,207,27,42,1,0,0,1,3,0,0,1,686,2,456
경기도,성남시중원구,금광1동,금광1동제5투,1803,1333,591,223,311,96,99,3,0,1,2,5,0,1,0,1332,1,470
경기도,성남시중원구,금광2동,합계,20468,14112,6052,2818,3333,825,941,23,2,13,1,38,6,5,2,14059,53,6356
경기도,성남시중원구,금광2동,관내사전투표,3915,3914,1762,799,821,209,288,9,0,3,0,9,0,2,0,3902,12,1
경기도,성남시중원구,금광2동,금광2동제1투,2810,1628,693,328,391,107,101,0,0,1,0,3,0,1,0,1625,3,1182
경기도,성남시중원구,금광2동,금광2동제2투,2912,1621,706,349,349,97,101,3,0,4,0,5,1,0,0,1615,6,1291
경기도,성남시중원구,금광2동,금광2동제3투,2203,1443,625,265,379,63,86,2,0,1,0,11,3,0,1,1436,7,760
경기도,성남시중원구,금광2동,금광2동제4투,2497,1582,651,265,436,104,111,2,2,0,0,4,0,1,0,1576,6,915
경기도,성남시중원구,금광2동,금광2동제5투,3062,1694,644,382,432,92,117,3,0,3,1,3,1,0,0,1678,16,1368
경기도,성남시중원구,금광2동,금광2동제6투,3069,2230,971,430,525,153,137,4,0,1,0,3,1,1,1,2227,3,839
경기도,성남시중원구,은행1동,합계,8938,6595,2816,1221,1669,360,450,6,5,10,2,18,1,5,9,6572,23,2343
경기도,성남시중원구,은행1동,관내사전투표,2039,2039,933,344,503,89,145,2,3,2,0,3,1,2,5,2032,7,0
경기도,성남시중원구,은행1동,은행1동제1투,2105,1237,483,232,340,70,94,0,0,4,1,2,0,1,1,1228,9,868
경기도,성남시중원구,은행1동,은행1동제2투,2413,1428,634,260,340,76,103,1,1,2,0,5,0,2,2,1426,2,985
경기도,성남시중원구,은행1동,은행1동제3투,2381,1891,766,385,486,125,108,3,1,2,1,8,0,0,1,1886,5,490
경기도,성남시중원구,은행2동,합계,20384,14600,6151,2742,3727,906,933,21,2,14,2,32,4,7,15,14556,44,5784
경기도,성남시중원구,은행2동,관내사전투표,3644,3644,1690,696,799,208,217,4,1,4,2,10,0,1,1,3633,11,0
경기도,성남시중원구,은행2동,은행2동제1투,2485,1318,547,247,344,71,96,2,0,3,0,3,1,0,2,1316,2,1167
경기도,성남시중원구,은행2동,은행2동제2투,2192,1461,603,254,385,101,105,1,0,1,0,3,1,0,5,1459,2,731
경기도,성남시중원구,은행2동,은행2동제3투,2215,1560,662,268,424,99,89,3,0,1,0,4,2,2,2,1556,4,655
경기도,성남시중원구,은행2동,은행2동제4투,1789,1102,442,178,310,78,86,1,0,0,0,2,0,1,1,1099,3,687
경기도,성남시중원구,은행2동,은행2동제5투,1862,1090,435,202,310,61,70,1,0,0,0,3,0,2,1,1085,5,772
경기도,성남시중원구,은행2동,은행2동제6투,3328,2557,1011,505,677,176,166,7,0,3,0,1,0,0,1,2547,10,771
경기도,성남시중원구,은행2동,은행2동제7투,2869,1868,761,392,478,112,104,2,1,2,0,6,0,1,2,1861,7,1001
경기도,성남시중원구,상대원1동,합계,21253,14966,6342,2920,3778,816,954,31,3,8,2,30,4,6,17,14911,55,6287
경기도,성남시중원구,상대원1동,관내사전투표,2737,2737,1253,513,625,140,182,5,0,3,0,5,0,2,2,2730,7,0
경기도,성남시중원구,상대원1동,상대원1동제1투,3910,2257,880,451,602,137,153,6,0,1,0,4,2,1,3,2240,17,1653
경기도,성남시중원구,상대원1동,상대원1동제2투,3511,2119,861,403,564,115,150,5,0,1,1,4,0,0,6,2110,9,1392
경기도,성남시중원구,상대원1동,상대원1동제3투,2165,1289,489,259,374,71,82,1,1,1,0,3,0,1,2,1284,5,876
경기도,성남시중원구,상대원1동,상대원1동제4투,2140,1718,784,339,402,92,88,4,0,1,0,4,0,0,2,1716,2,422
경기도,성남시중원구,상대원1동,상대원1동제5투,2511,1961,875,346,495,102,123,2,1,0,1,8,1,0,1,1955,6,550
경기도,성남시중원구,상대원1동,상대원1동제6투,1488,984,416,208,246,52,53,4,1,0,0,0,1,1,0,982,2,504
경기도,성남시중원구,상대원1동,상대원1동제7투,2791,1901,784,401,470,107,123,4,0,1,0,2,0,1,1,1894,7,890
경기도,성남시중원구,상대원2동,합계,13167,8585,3320,1804,2429,395,528,17,1,10,0,26,2,6,8,8546,39,4582
경기도,성남시중원구,상대원2동,관내사전투표,2708,2708,1132,593,684,107,157,6,0,4,0,10,1,2,4,2700,8,0
경기도,성남시중원구,상대원2동,상대원2동제1투,4164,2225,866,485,619,96,133,5,0,2,0,5,1,1,2,2215,10,1939
경기도,성남시중원구,상대원2동,상대원2동제2투,2155,1262,478,244,351,85,93,1,0,2,0,2,0,0,0,1256,6,893
경기도,성남시중원구,상대원2동,상대원2동제3투,4140,2390,844,482,775,107,145,5,1,2,0,9,0,3,2,2375,15,1750
경기도,성남시중원구,상대원3동,합계,11448,7435,3019,1539,1962,374,439,16,1,11,3,25,5,4,8,7406,29,4013
경기도,성남시중원구,상대원3동,관내사전투표,2121,2121,955,395,524,110,113,2,0,2,0,10,1,1,1,2114,7,0
경기도,성남시중원구,상대원3동,상대원3동제1투,3447,1928,729,435,526,101,110,4,0,2,0,4,3,2,3,1919,9,1519
경기도,성남시중원구,상대원3동,상대원3동제2투,2716,1577,638,311,431,81,96,4,0,4,1,5,0,0,1,1572,5,1139
경기도,성남시중원구,상대원3동,상대원3동제3투,3164,1809,697,398,481,82,120,6,1,3,2,6,1,1,3,1801,8,1355
경기도,성남시중원구,하대원동,합계,16846,13089,5339,2797,3274,764,801,8,2,7,1,33,4,4,8,13042,47,3757
경기도,성남시중원구,하대원동,관내사전투표,3293,3293,1481,655,737,194,188,2,2,3,0,10,3,1,5,3281,12,0
경기도,성남시중원구,하대원동,하대원동제1투,2456,1581,604,345,413,89,115,1,0,0,0,4,0,1,1,1573,8,875
경기도,성남시중원구,하대원동,하대원동제2투,2754,1899,760,387,489,105,144,2,0,1,0,4,0,0,1,1893,6,855
경기도,성남시중원구,하대원동,하대원동제3투,3318,2460,1005,486,648,161,140,1,0,2,0,7,0,0,0,2450,10,858
경기도,성남시중원구,하대원동,하대원동제4투,3234,2616,1012,635,653,151,146,2,0,1,0,8,1,2,0,2611,5,618
경기도,성남시중원구,하대원동,하대원동제5투,1791,1240,477,289,334,64,68,0,0,0,1,0,0,0,1,1234,6,551
경기도,성남시중원구,도촌동,합계,18848,15165,6817,2667,3566,1031,964,20,8,2,2,35,4,5,10,15131,34,3683
경기도,성남시중원구,도촌동,관내사전투표,3494,3494,1649,612,758,234,216,4,1,0,0,9,0,1,1,3485,9,0
경기도,성남시중원구,도촌동,도촌동제1투,2210,1578,644,335,421,87,79,1,0,0,0,6,0,2,0,1575,3,632
경기도,성남시중원구,도촌동,도촌동제2투,2789,2073,877,403,499,136,138,5,2,0,1,2,0,1,1,2065,8,716
경기도,성남시중원구,도촌동,도촌동제3투,2926,2123,898,390,511,151,152,3,1,0,1,7,2,1,2,2119,4,803
경기도,성남시중원구,도촌동,도촌동제4투,3114,2492,1213,365,559,177,169,0,1,2,0,1,1,0,0,2488,4,622
경기도,성남시중원구,도촌동,도촌동제5투,2740,2227,1050,349,506,168,134,7,2,0,0,5,1,0,2,2224,3,513
경기도,성남시중원구,도촌동,도촌동제6투,1575,1178,486,213,312,78,76,0,1,0,0,5,0,0,4,1175,3,397
경기도,성남시중원구,잘못 투입·구분된 투표지,,0,0,0,0,0,0,0,0,0,0,0,0,0,0,0,0,0,0
경기도,성남시분당구,합계,,403060,338076,139853,71332,74040,30351,20415,544,22,96,53,206,35,99,143,337189,887,64984
경기도,성남시분당구,거소·선상투표,,591,552,166,135,177,37,16,1,1,1,0,0,2,0,1,537,15,39
경기도,성남시분당구,관외사전투표,,34589,34570,15709,5523,7360,3188,2508,41,4,11,6,19,7,21,34,34431,139,19
경기도,성남시분당구,재외투표,,6733,5380,2951,462,1006,299,628,20,0,0,0,2,0,1,0,5369,11,1353
경기도,성남시분당구,분당동,관내사전투표,2933,2933,1322,579,562,273,181,1,1,3,1,2,0,3,1,2929,4,0
경기도,성남시분당구,분당동,합계,19213,15432,6258,3446,3375,1319,947,26,2,7,1,7,1,10,2,15401,31,3781
경기도,성남시분당구,분당동,분당동제1투,2820,2134,841,519,449,208,107,6,0,0,0,0,0,0,0,2130,4,686
경기도,성남시분당구,분당동,분당동제2투,2486,2100,918,403,449,186,138,1,0,1,0,1,0,0,0,2097,3,386
경기도,성남시분당구,분당동,분당동제3투,2488,1931,620,591,446,163,99,5,0,2,0,1,0,1,0,1928,3,557
경기도,성남시분당구,분당동,분당동제4투,2711,1912,814,392,436,134,125,7,1,0,0,0,0,0,1,1910,2,799
경기도,성남시분당구,분당동,분당동제5투,2889,2346,883,530,566,205,145,2,0,0,0,2,1,3,0,2337,9,543
경기도,성남시분당구,분당동,분당동제6투,2886,2076,860,432,467,150,152,4,0,1,0,1,0,3,0,2070,6,810
경기도,성남시분당구,수내1동,관내사전투표,3195,3195,1461,659,573,302,185,4,0,0,0,2,0,0,0,3186,9,0
경기도,성남시분당구,수내1동,합계,13686,11206,4242,2728,2426,1137,602,23,0,1,1,3,0,3,1,11167,39,2480
경기도,성남시분당구,수내1동,수내1동제1투,2044,1553,487,432,396,158,73,2,0,0,0,0,0,0,0,1548,5,491
경기도,성남시분당구,수내1동,수내1동제2투,1997,1646,513,471,387,185,76,7,0,0,0,0,0,1,0,1640,6,351
경기도,성남시분당구,수내1동,수내1동제3투,2797,1965,826,395,418,195,113,6,0,1,0,1,0,1,1,1957,8,832
경기도,성남시분당구,수내1동,수내1동제4투,1534,1161,414,301,248,110,78,3,0,0,1,0,0,1,0,1156,5,373
경기도,성남시분당구,수내1동,수내1동제5투,2119,1686,541,470,404,187,77,1,0,0,0,0,0,0,0,1680,6,433
경기도,성남시분당구,수내2동,합계,7463,6379,2333,1443,1497,728,356,5,0,0,2,1,0,1,1,6367,12,1084
경기도,성남시분당구,수내2동,관내사전투표,1813,1813,707,380,412,188,121,0,0,0,0,0,0,0,0,1808,5,0
경기도,성남시분당구,수내2동,수내2동제1투,1894,1487,549,326,357,180,70,0,0,0,1,0,0,1,0,1484,3,407
경기도,성남시분당구,수내2동,수내2동제2투,2338,1910,680,454,451,223,96,2,0,0,0,0,0,0,1,1907,3,428
경기도,성남시분당구,수내2동,수내2동제3투,1418,1169,397,283,277,137,69,3,0,0,1,1,0,0,0,1168,1,249
경기도,성남시분당구,수내3동,합계,10288,8513,3660,1547,1901,817,531,16,1,1,0,3,0,6,4,8487,26,1775
경기도,성남시분당구,수내3동,관내사전투표,2378,2378,1149,368,463,222,159,4,0,1,0,2,0,1,1,2370,8,0
경기도,성남시분당구,수내3동,수내3동제1투,2494,2026,819,376,482,227,112,5,0,0,0,0,0,2,0,2023,3,468
경기도,성남시분당구,수내3동,수내3동제2투,2351,1973,758,431,450,204,119,1,1,0,0,0,0,2,0,1966,7,378
경기도,성남시분당구,수내3동,수내3동제3투,3065,2136,934,372,506,164,141,6,0,0,0,1,0,1,3,2128,8,929
경기도,성남시분당구,정자1동,합계,23318,18529,6366,5194,4022,1884,976,36,0,2,2,2,0,4,3,18491,38,4789
경기도,성남시분당구,정자1동,관내사전투표,4624,4624,2124,880,802,450,351,8,0,0,0,1,0,1,1,4618,6,0
경기도,성남시분당구,정자1동,정자1동제1투,2467,1899,586,586,412,223,84,5,0,1,0,0,0,1,0,1898,1,568
경기도,성남시분당구,정자1동,정자1동제2투,2184,1646,520,414,412,205,89,2,0,0,0,0,0,2,0,1644,2,538
경기도,성남시분당구,정자1동,정자1동제3투,3506,2275,1040,336,470,249,168,4,0,1,0,0,0,0,1,2269,6,1231
경기도,성남시분당구,정자1동,정자1동제4투,2368,1818,393,726,447,172,70,4,0,0,1,0,0,0,0,1813,5,550
경기도,성남시분당구,정자1동,정자1동제5투,2510,1826,670,449,423,175,102,1,0,0,0,0,0,0,1,1821,5,684
경기도,성남시분당구,정자1동,정자1동제6투,3559,2822,683,1097,696,267,66,5,0,0,0,1,0,0,0,2815,7,737
경기도,성남시분당구,정자1동,정자1동제7투,2100,1619,350,706,360,143,46,7,0,0,1,0,0,0,0,1613,6,481
경기도,성남시분당구,정자2동,합계,14333,11837,5305,2251,2467,1001,726,15,1,4,3,13,3,6,5,11800,37,2496
경기도,성남시분당구,정자2동,관내사전투표,3760,3760,1940,559,667,329,243,2,0,3,1,5,0,2,0,3751,9,0
경기도,성남시분당구,정자2동,정자2동제1투,1315,959,473,150,189,78,63,1,1,0,0,0,0,0,0,955,4,356
경기도,성남시분당구,정자2동,정자2동제2투,2039,1547,752,218,305,153,111,0,0,1,1,1,2,1,0,1545,2,492
경기도,성남시분당구,정자2동,정자2동제3투,2023,1346,405,386,418,49,69,3,0,0,0,2,1,3,2,1338,8,677
경기도,성남시분당구,정자2동,정자2동제4투,1661,1314,588,241,274,120,78,1,0,0,0,3,0,0,3,1308,6,347
경기도,성남시분당구,정자2동,정자2동제5투,1615,1356,563,290,277,135,82,4,0,0,1,1,0,0,0,1353,3,259
경기도,성남시분당구,정자2동,정자2동제6투,1920,1555,584,407,337,137,80,4,0,0,0,1,0,0,0,1550,5,365
경기도,성남시분당구,정자3동,합계,11580,9667,4081,1995,2072,876,594,20,1,2,1,3,0,0,4,9649,18,1913
경기도,성남시분당구,정자3동,관내사전투표,2655,2655,1234,507,500,238,160,6,1,0,0,2,0,0,3,2651,4,0
경기도,성남시분당구,정자3동,정자3동제1투,3165,2481,1042,487,565,227,147,10,0,1,0,0,0,0,0,2479,2,684
경기도,성남시분당구,정자3동,정자3동제2투,2569,1962,848,381,427,154,144,1,0,0,0,1,0,0,1,1957,5,607
경기도,성남시분당구,정자3동,정자3동제3투,3191,2569,957,620,580,257,143,3,0,1,1,0,0,0,0,2562,7,622
경기도,성남시분당구,서현1동,합계,23475,19244,7524,4450,4240,1828,1095,34,0,6,7,3,1,7,4,19199,45,4231
경기도,성남시분당구,서현1동,관내사전투표,5535,5535,2464,1111,1088,489,360,5,0,0,3,1,0,2,2,5525,10,0
경기도,성남시분당구,서현1동,서현1동제1투,3751,2470,1044,523,514,220,155,2,0,1,0,0,0,1,0,2460,10,1281
경기도,성남시분당구,서현1동,서현1동제2투,3331,2517,873,604,640,261,124,5,0,1,2,1,1,1,1,2514,3,814
경기도,성남시분당구,서현1동,서현1동제3투,3462,2835,1082,639,665,283,147,7,0,2,1,0,0,1,0,2827,8,627
경기도,성남시분당구,서현1동,서현1동제4투,2307,1851,577,545,451,185,86,1,0,0,0,0,0,0,0,1845,6,456
경기도,성남시분당구,서현1동,서현1동제5투,3377,2742,946,744,615,288,130,12,0,1,0,1,0,0,0,2737,5,635
경기도,성남시분당구,서현1동,서현1동제6투,1712,1294,538,284,267,102,93,2,0,1,1,0,0,2,1,1291,3,418
경기도,성남시분당구,서현2동,합계,14647,12478,5068,2504,2780,1216,853,21,0,2,0,6,0,1,1,12452,26,2169
경기도,성남시분당구,서현2동,관내사전투표,3806,3806,1754,670,748,339,285,4,0,0,0,2,0,0,0,3802,4,0
경기도,성남시분당구,서현2동,서현2동제1투,2912,2301,785,542,565,257,142,5,0,0,0,0,0,0,0,2296,5,611
경기도,성남시분당구,서현2동,서현2동제2투,2596,2160,796,489,514,228,124,4,0,0,0,1,0,0,0,2156,4,436
경기도,성남시분당구,서현2동,서현2동제3투,2694,2173,925,380,489,212,153,5,0,1,0,0,0,0,1,2166,7,521
경기도,성남시분당구,서현2동,서현2동제4투,2639,2038,808,423,464,180,149,3,0,1,0,3,0,1,0,2032,6,601
경기도,성남시분당구,이매1동,합계,18924,15994,6084,3787,3499,1570,939,40,3,4,2,11,2,4,8,15953,41,2930
경기도,성남시분당구,이매1동,관내사전투표,3416,3416,1453,740,689,305,212,7,1,0,0,2,0,0,1,3410,6,0
경기도,성남시분당구,이매1동,이매1동제1투,3405,2728,929,771,597,277,138,2,1,1,0,2,0,0,1,2719,9,677
경기도,성남시분당구,이매1동,이매1동제2투,2746,2310,825,545,553,240,128,4,0,1,0,3,0,2,1,2302,8,436
경기도,성남시분당구,이매1동,이매1동제3투,2122,1777,566,497,404,183,111,12,0,0,1,0,1,0,1,1776,1,345
경기도,성남시분당구,이매1동,이매1동제4투,2408,1997,788,450,433,203,112,3,0,1,1,0,0,1,0,1992,5,411
경기도,성남시분당구,이매1동,이매1동제5투,1957,1658,711,329,320,170,120,3,0,0,0,2,0,0,1,1656,2,299
경기도,성남시분당구,이매1동,이매1동제6투,2870,2108,812,455,503,192,118,9,1,1,0,2,1,1,3,2098,10,762
경기도,성남시분당구,이매2동,합계,10606,9002,3193,2368,2098,838,450,17,1,2,1,4,1,2,7,8982,20,1604
경기도,성남시분당구,이매2동,관내사전투표,2508,2508,1062,538,531,222,141,4,0,0,1,1,1,1,1,2503,5,0
경기도,성남시분당구,이매2동,이매2동제1투,2176,1722,563,442,438,186,85,3,0,1,0,0,0,0,1,1719,3,454
경기도,성남시분당구,이매2동,이매2동제2투,2765,2208,769,592,511,200,115,6,0,1,0,2,0,1,4,2201,7,557
경기도,성남시분당구,이매2동,이매2동제3투,3157,2564,799,796,618,230,109,4,1,0,0,1,0,0,1,2559,5,593
경기도,성남시분당구,야탑1동,합계,15231,12785,5262,2763,2891,1020,753,25,1,4,3,10,2,5,8,12747,38,2446
경기도,성남시분당구,야탑1동,관내사전투표,4116,4116,1969,678,816,316,309,8,1,0,0,0,1,2,3,4103,13,0
경기도,성남시분당구,야탑1동,야탑1동제1투,2180,1376,526,362,281,111,85,5,0,1,1,1,0,0,1,1374,2,804
경기도,성남시분당구,야탑1동,야탑1동제2투,2960,2368,846,603,599,195,101,6,0,1,0,4,1,2,2,2360,8,592
경기도,성남시분당구,야탑1동,야탑1동제3투,2247,1910,699,464,471,178,93,2,0,1,1,0,0,1,0,1910,0,337
경기도,성남시분당구,야탑1동,야탑1동제4투,2080,1763,760,328,432,137,93,1,0,1,0,4,0,0,1,1757,6,317
경기도,성남시분당구,야탑1동,야탑1동제5투,1648,1252,462,328,292,83,72,3,0,0,1,1,0,0,1,1243,9,396
경기도,성남시분당구,야탑2동,합계,13332,11290,4162,2985,2497,985,603,17,2,3,0,5,1,1,7,11268,22,2042
경기도,성남시분당구,야탑2동,관내사전투표,2892,2892,1215,635,572,272,186,1,1,1,0,2,0,0,1,2886,6,0
경기도,성남시분당구,야탑2동,야탑2동제1투,2382,1877,595,591,433,165,79,5,0,0,0,0,0,0,2,1870,7,505
경기도,성남시분당구,야탑2동,야탑2동제2투,3434,2805,927,816,688,227,137,3,1,0,0,0,1,0,2,2802,3,629
경기도,성남시분당구,야탑2동,야탑2동제3투,2745,2213,819,588,474,208,113,4,0,2,0,0,0,0,1,2209,4,532
경기도,성남시분당구,야탑2동,야탑2동제4투,1879,1503,606,355,330,113,88,4,0,0,0,3,0,1,1,1501,2,376
경기도,성남시분당구,야탑3동,합계,22069,17417,7572,3338,4020,1301,1060,13,0,12,5,20,6,8,15,17370,47,4652
경기도,성남시분당구,야탑3동,관내사전투표,3230,3230,1493,568,665,258,210,2,0,6,2,6,5,3,4,3222,8,0
경기도,성남시분당구,야탑3동,야탑3동제1투,3451,2366,1039,449,521,183,150,0,0,1,1,6,0,4,2,2356,10,1085
경기도,성남시분당구,야탑3동,야탑3동제2투,2806,2167,926,423,517,169,124,1,0,2,0,0,0,0,1,2163,4,639
경기도,성남시분당구,야탑3동,야탑3동제3투,2940,2389,1059,428,561,178,152,3,0,1,1,2,0,0,2,2387,2,551
경기도,성남시분당구,야탑3동,야탑3동제4투,2452,1546,555,354,433,96,84,2,0,1,1,2,0,1,3,1532,14,906
경기도,성남시분당구,야탑3동,야탑3동제5투,1981,1548,676,337,331,109,89,2,0,1,0,2,0,0,0,1547,1,433
경기도,성남시분당구,야탑3동,야탑3동제6투,2577,2047,832,449,508,136,113,1,0,0,0,1,0,0,3,2043,4,530
경기도,성남시분당구,야탑3동,야탑3동제7투,2632,2124,992,330,484,172,138,2,0,0,0,1,1,0,0,2120,4,508
경기도,성남시분당구,금곡동,합계,22297,18054,7018,4335,4064,1501,1030,22,0,4,6,18,0,0,6,18004,50,4243
경기도,성남시분당구,금곡동,관내사전투표,4057,4057,1898,770,761,343,268,3,0,0,1,3,0,0,0,4047,10,0
경기도,성남시분당구,금곡동,금곡동제1투,2623,1986,813,389,448,190,137,0,0,0,1,1,0,0,1,1980,6,637
경기도,성남시분당구,금곡동,금곡동제2투,2607,2137,861,460,490,205,111,2,0,1,1,0,0,0,0,2131,6,470
경기도,성남시분당구,금곡동,금곡동제3투,2569,1842,710,419,468,115,111,1,0,2,1,7,0,0,2,1836,6,727
경기도,성남시분당구,금곡동,금곡동제4투,3124,2513,833,719,617,205,119,4,0,0,1,3,0,0,1,2502,11,611
경기도,성남시분당구,금곡동,금곡동제5투,1749,1423,566,303,333,113,98,3,0,1,1,3,0,0,0,1421,2,326
경기도,성남시분당구,금곡동,금곡동제6투,3211,2380,865,570,594,208,129,4,0,0,0,1,0,0,1,2372,8,831
경기도,성남시분당구,금곡동,금곡동제7투,2357,1716,472,705,353,122,57,5,0,0,0,0,0,0,1,1715,1,641
경기도,성남시분당구,구미동,합계,23751,19177,7662,4526,4177,1646,1038,40,0,10,1,18,2,4,7,19131,46,4574
경기도,성남시분당구,구미동,관내사전투표,3912,3912,1785,815,736,333,229,3,0,1,0,1,0,1,2,3906,6,0
경기도,성남시분당구,구미동,구미동제1투,2141,1848,743,402,419,183,83,8,0,2,0,2,0,0,1,1843,5,293
경기도,성남시분당구,구미동,구미동제2투,2678,2199,1002,382,489,185,129,4,0,1,0,1,1,0,1,2195,4,479
경기도,성남시분당구,구미동,구미동제3투,1466,1226,502,285,254,111,69,0,0,1,0,2,0,0,1,1225,1,240
경기도,성남시분당구,구미동,구미동제4투,2218,1473,310,618,328,151,58,2,0,1,0,0,0,1,0,1469,4,745
경기도,성남시분당구,구미동,구미동제5투,2792,2243,867,526,526,184,130,1,0,0,0,5,0,0,0,2239,4,549
경기도,성남시분당구,구미동,구미동제6투,2259,1761,629,480,392,159,86,8,0,1,1,0,0,0,0,1756,5,498
경기도,성남시분당구,구미동,구미동제7투,3326,2366,978,525,503,210,136,7,0,0,0,0,1,0,1,2361,5,960
경기도,성남시분당구,구미동,구미동제8투,2959,2149,846,493,530,130,118,7,0,3,0,7,0,2,1,2137,12,810
경기도,성남시분당구,구미1동,합계,14710,12283,5348,2501,2589,997,791,10,2,2,3,7,0,0,3,12253,30,2427
경기도,성남시분당구,구미1동,관내사전투표,4431,4431,2126,817,833,338,294,5,0,2,2,3,0,0,2,4422,9,0
경기도,성남시분당구,구미1동,구미1동제1투,3481,2386,1032,472,495,190,187,2,0,0,1,1,0,0,1,2381,5,1095
경기도,성남시분당구,구미1동,구미1동제2투,3309,2645,1083,558,622,226,146,1,0,0,0,1,0,0,0,2637,8,664
경기도,성남시분당구,구미1동,구미1동제3투,1614,1262,414,370,277,109,84,0,0,0,0,2,0,0,0,1256,6,352
경기도,성남시분당구,구미1동,구미1동제4투,1875,1559,693,284,362,134,80,2,2,0,0,0,0,0,0,1557,2,316
경기도,성남시분당구,판교동,합계,15586,13272,6033,2521,2799,1187,672,21,0,0,4,5,0,3,6,13251,21,2314
경기도,성남시분당구,판교동,관내사전투표,3271,3271,1577,622,619,259,185,4,0,0,0,2,0,0,0,3268,3,0
경기도,성남시분당구,판교동,판교동제1투,2640,2124,1049,383,387,194,104,2,0,0,1,1,0,1,1,2123,1,516
경기도,성남시분당구,판교동,판교동제2투,3214,2719,1169,498,628,285,124,3,0,0,2,2,0,0,2,2713,6,495
경기도,성남시분당구,판교동,판교동제3투,3472,2832,1120,625,660,273,135,10,0,0,0,0,0,2,0,2825,7,640
경기도,성남시분당구,판교동,판교동제4투,2989,2326,1118,393,505,176,124,2,0,0,1,0,0,0,3,2322,4,663
경기도,성남시분당구,삼평동,합계,17479,14521,6525,2505,3271,1280,847,18,2,5,2,22,3,3,2,14485,36,2958
경기도,성남시분당구,삼평동,관내사전투표,3699,3699,1905,514,691,324,249,1,0,2,0,4,1,2,0,3693,6,0
경기도,성남시분당구,삼평동,삼평동제1투,3345,2661,1241,479,583,203,134,5,0,1,1,8,0,0,0,2655,6,684
경기도,성남시분당구,삼평동,삼평동제2투,2390,1950,915,307,430,206,84,2,1,0,0,0,1,1,1,1948,2,440
경기도,성남시분당구,삼평동,삼평동제3투,3474,2479,980,476,655,157,179,4,1,1,1,9,1,0,1,2465,14,995
경기도,성남시분당구,삼평동,삼평동제4투,4571,3732,1484,729,912,390,201,6,0,1,0,1,0,0,0,3724,8,839
경기도,성남시분당구,백현동,합계,20098,16706,7559,2845,3725,1506,970,25,0,7,1,10,2,4,6,16660,46,3392
경기도,성남시분당구,백현동,관내사전투표,4035,4035,2042,579,798,349,237,9,0,2,0,3,0,2,2,4023,12,0
경기도,성남시분당구,백현동,백현동제1투,3327,2802,1216,511,631,291,138,3,0,0,0,1,0,0,1,2792,10,525
경기도,성남시분당구,백현동,백현동제2투,2910,2336,1110,323,511,234,146,5,0,1,0,2,0,0,0,2332,4,574
경기도,성남시분당구,백현동,백현동제3투,2265,1834,732,379,418,202,96,3,0,0,0,1,0,0,0,1831,3,431
경기도,성남시분당구,백현동,백현동제4투,3060,2217,1074,348,502,145,129,3,0,2,1,1,1,0,2,2208,9,843
경기도,성남시분당구,백현동,백현동제5투,2772,2104,991,379,467,122,132,1,0,2,0,2,1,0,1,2098,6,668
경기도,성남시분당구,백현동,백현동제6투,1729,1378,394,326,398,163,92,1,0,0,0,0,0,2,0,1376,2,351
경기도,성남시분당구,운중동,합계,15103,12506,5136,2723,2689,1162,734,19,1,2,1,4,1,4,4,12480,26,2597
경기도,성남시분당구,운중동,관내사전투표,3308,3308,1531,634,611,301,213,6,1,2,0,2,0,1,1,3303,5,0
경기도,성남시분당구,운중동,운중동제1투,1936,1394,511,377,307,120,70,4,0,0,0,0,1,1,0,1391,3,542
경기도,성남시분당구,운중동,운중동제2투,2265,1759,682,421,384,176,89,1,0,0,0,0,0,0,1,1754,5,506
경기도,성남시분당구,운중동,운중동제3투,2537,1953,715,462,437,206,124,1,0,0,1,0,0,0,1,1947,6,584
경기도,성남시분당구,운중동,운중동제4투,1578,1227,582,205,284,78,72,1,0,0,0,2,0,0,1,1225,2,351
경기도,성남시분당구,운중동,운중동제5투,3479,2865,1115,624,666,281,166,6,0,0,0,0,0,2,0,2860,5,614
경기도,성남시분당구,정자동,합계,13958,11273,4633,2456,2395,1026,696,19,0,4,1,10,1,1,4,11246,27,2685
경기도,성남시분당구,정자동,관내사전투표,1906,1906,845,413,372,158,106,3,0,2,0,2,0,0,1,1902,4,0
경기도,성남시분당구,정자동,정자동제1투,2235,1636,566,424,405,144,87,4,0,0,0,1,0,0,1,1632,4,599
경기도,성남시분당구,정자동,정자동제2투,3112,2561,900,691,506,278,175,3,0,1,0,0,1,0,2,2557,4,551
경기도,성남시분당구,정자동,정자동제3투,2833,2372,1124,364,531,224,121,4,0,0,1,1,0,0,0,2370,2,461
경기도,성남시분당구,정자동,정자동제4투,1993,1401,641,253,277,109,106,3,0,1,0,3,0,1,0,1394,7,592
경기도,성남시분당구,정자동,정자동제5투,1879,1397,557,311,304,113,101,2,0,0,0,3,0,0,0,1391,6,482
경기도,성남시분당구,잘못 투입·구분된 투표지,,0,9,3,1,3,2,0,0,0,0,0,0,0,0,0,9,0,-9
경기도,의정부시,합계,,360255,270404,110580,57027,65003,17254,18284,422,31,155,63,214,81,122,238,269474,930,89851
경기도,의정부시,거소·선상투표,,660,600,228,109,175,36,17,1,2,2,3,1,1,3,2,580,20,60
경기도,의정부시,관외사전투표,,26166,26145,12120,3850,5870,1882,2116,32,6,15,9,23,10,7,52,25992,153,21
경기도,의정부시,재외투표,,2071,1583,960,133,208,68,191,15,0,0,0,1,0,1,0,1577,6,488
경기도,의정부시,의정부1동,합계,17162,10546,3787,2843,2533,560,729,15,3,5,1,5,3,4,10,10498,48,6616
경기도,의정부시,의정부1동,관내사전투표,2462,2462,1046,563,513,135,185,3,0,0,1,1,1,0,2,2450,12,0
경기도,의정부시,의정부1동,의정부1동제1투,3692,1922,631,524,505,113,129,1,0,1,0,0,0,1,3,1908,14,1770
경기도,의정부시,의정부1동,의정부1동제2투,3805,1820,595,513,465,96,141,2,0,0,0,1,0,2,2,1817,3,1985
경기도,의정부시,의정부1동,의정부1동제3투,3816,2207,804,591,519,119,147,3,3,3,0,3,2,1,1,2196,11,1609
경기도,의정부시,의정부1동,의정부1동제4투,3387,2135,711,652,531,97,127,6,0,1,0,0,0,0,2,2127,8,1252
경기도,의정부시,의정부2동,합계,23170,15281,6269,3223,3728,934,1010,23,0,4,1,12,3,7,15,15229,52,7889
경기도,의정부시,의정부2동,관내사전투표,3686,3686,1820,640,712,209,282,6,0,1,1,2,0,1,4,3678,8,0
경기도,의정부시,의정부2동,의정부2동제1투,3466,1865,707,466,463,100,109,3,0,1,0,4,0,0,2,1855,10,1601
경기도,의정부시,의정부2동,의정부2동제2투,3140,1835,621,521,460,104,113,0,0,2,0,0,0,4,4,1829,6,1305
경기도,의정부시,의정부2동,의정부2동제3투,3936,2373,949,498,601,168,139,5,0,0,0,3,1,0,1,2365,8,1563
경기도,의정부시,의정부2동,의정부2동제4투,2390,1370,514,280,387,76,105,0,0,0,0,0,0,1,1,1364,6,1020
경기도,의정부시,의정부2동,의정부2동제5투,3036,1824,718,340,520,118,115,2,0,0,0,1,1,1,2,1818,6,1212
경기도,의정부시,의정부2동,의정부2동제6투,3516,2328,940,478,585,159,147,7,0,0,0,2,1,0,1,2320,8,1188
경기도,의정부시,의정부3동,합계,11288,7345,2847,1770,1731,430,500,8,1,4,2,11,5,7,6,7322,23,3943
경기도,의정부시,의정부3동,관내사전투표,2273,2273,1037,456,471,135,158,2,0,0,1,3,0,3,0,2266,7,0
경기도,의정부시,의정부3동,의정부3동제1투,2803,1412,522,344,350,79,98,1,0,1,1,4,2,1,2,1405,7,1391
경기도,의정부시,의정부3동,의정부3동제2투,3019,1608,515,477,403,87,104,1,1,3,0,1,3,3,3,1601,7,1411
경기도,의정부시,의정부3동,의정부3동제3투,3193,2052,773,493,507,129,140,4,0,0,0,3,0,0,1,2050,2,1141
경기도,의정부시,호원1동,합계,27353,21327,8452,4931,5239,1208,1349,35,1,10,6,12,3,12,12,21270,57,6026
경기도,의정부시,호원1동,관내사전투표,4692,4691,2198,919,932,277,336,8,0,2,1,5,0,1,3,4682,9,1
경기도,의정부시,호원1동,호원1동제1투,3322,2199,857,485,583,120,140,2,0,2,0,0,1,1,0,2191,8,1123
경기도,의정부시,호원1동,호원1동제2투,3080,2522,868,702,610,154,159,11,0,1,3,1,2,2,2,2515,7,558
경기도,의정부시,호원1동,호원1동제3투,2224,1371,510,335,357,77,81,0,1,1,0,0,0,4,0,1366,5,853
경기도,의정부시,호원1동,호원1동제4투,4131,2817,1063,674,709,157,193,5,0,1,1,1,0,1,6,2811,6,1314
경기도,의정부시,호원1동,호원1동제5투,2675,2120,854,458,576,108,113,3,0,0,0,1,0,1,1,2115,5,555
경기도,의정부시,호원1동,호원1동제6투,2462,1951,701,499,515,109,109,5,0,2,1,2,0,0,0,1943,8,511
경기도,의정부시,호원1동,호원1동제7투,3218,2482,967,579,636,140,155,1,0,1,0,1,0,0,0,2480,2,736
경기도,의정부시,호원1동,호원1동제8투,1549,1174,434,280,321,66,63,0,0,0,0,1,0,2,0,1167,7,375
경기도,의정부시,호원2동,관내사전투표,5721,5721,2652,1068,1205,354,398,14,0,5,0,3,0,3,5,5707,14,0
경기도,의정부시,호원2동,합계,28135,22550,9274,4778,5477,1410,1439,49,3,14,3,11,3,10,17,22488,62,5585
경기도,의정부시,호원2동,호원2동제1투,3767,2613,1023,574,668,155,172,5,0,3,1,2,0,0,3,2606,7,1154
경기도,의정부시,호원2동,호원2동제2투,3022,2398,917,508,638,150,160,5,0,2,1,1,0,2,3,2387,11,624
경기도,의정부시,호원2동,호원2동제3투,3665,2657,1028,557,690,164,197,5,0,2,0,2,3,3,0,2651,6,1008
경기도,의정부시,호원2동,호원2동제4투,2993,2205,900,474,533,135,148,6,1,0,0,1,0,0,1,2199,6,788
경기도,의정부시,호원2동,호원2동제5투,2712,2144,829,531,543,127,93,8,1,1,0,1,0,0,2,2136,8,568
경기도,의정부시,호원2동,호원2동제6투,2942,2182,903,469,516,144,140,5,0,1,0,1,0,2,0,2181,1,760
경기도,의정부시,호원2동,호원2동제7투,3313,2630,1022,597,684,181,131,1,1,0,1,0,0,0,3,2621,9,683
경기도,의정부시,장암동,합계,15730,12418,5099,2639,2995,846,749,13,2,13,1,12,2,9,9,12389,29,3312
경기도,의정부시,장암동,관내사전투표,2836,2836,1360,510,566,192,179,2,2,5,0,5,1,3,2,2827,9,0
경기도,의정부시,장암동,장암동제1투,2685,2137,850,473,513,163,125,1,0,3,0,2,0,3,1,2134,3,548
경기도,의정부시,장암동,장암동제2투,2650,1710,617,421,456,98,96,3,0,3,0,0,1,2,2,1699,11,940
경기도,의정부시,장암동,장암동제3투,2358,1644,643,420,384,97,94,0,0,0,0,3,0,0,1,1642,2,714
경기도,의정부시,장암동,장암동제4투,2680,2013,752,438,537,149,127,5,0,1,1,1,0,0,1,2012,1,667
경기도,의정부시,장암동,장암동제5투,235,170,35,67,42,14,11,0,0,0,0,0,0,1,0,170,0,65
경기도,의정부시,장암동,장암동제6투,2286,1908,842,310,497,133,117,2,0,1,0,1,0,0,2,1905,3,378
경기도,의정부시,신곡1동,관내사전투표,4404,4404,2146,734,927,277,290,8,1,2,1,3,1,0,2,4392,12,0
경기도,의정부시,신곡1동,합계,32820,24888,10075,5357,6037,1602,1620,40,2,18,6,18,5,6,18,24804,84,7932
경기도,의정부시,신곡1동,신곡1동제1투,2982,1582,533,405,433,106,82,7,1,2,0,2,1,1,1,1574,8,1400
경기도,의정부시,신곡1동,신곡1동제2투,2734,1911,653,535,487,127,93,3,0,2,0,1,0,0,3,1904,7,823
경기도,의정부시,신곡1동,신곡1동제3투,2802,1742,622,415,457,119,112,2,0,2,0,4,1,1,2,1737,5,1060
경기도,의정부시,신곡1동,신곡1동제4투,3066,2302,889,485,606,156,146,7,0,2,0,1,0,1,1,2294,8,764
경기도,의정부시,신곡1동,신곡1동제5투,3783,2816,1050,694,694,183,169,3,0,1,2,2,0,1,2,2801,15,967
경기도,의정부시,신곡1동,신곡1동제6투,3338,2441,1000,506,586,154,176,1,0,3,0,1,0,0,2,2429,12,897
경기도,의정부시,신곡1동,신곡1동제7투,2876,2298,969,430,569,146,167,0,0,4,1,0,1,1,2,2290,8,578
경기도,의정부시,신곡1동,신곡1동제8투,3462,2647,1153,503,631,157,189,4,0,0,1,1,1,1,1,2642,5,815
경기도,의정부시,신곡1동,신곡1동제9투,3373,2745,1060,650,647,177,196,5,0,0,1,3,0,0,2,2741,4,628
경기도,의정부시,신곡2동,합계,34409,26856,10777,5654,6617,1801,1798,40,2,21,4,25,7,7,24,26777,79,7553
경기도,의정부시,신곡2동,관내사전투표,5874,5874,2665,1057,1311,392,391,12,1,4,0,10,2,1,10,5856,18,0
경기도,의정부시,신곡2동,신곡2동제1투,2707,1759,715,373,418,107,128,5,1,2,0,0,0,1,2,1752,7,948
경기도,의정부시,신곡2동,신곡2동제2투,2512,1885,741,395,489,128,114,4,0,1,1,3,2,0,2,1880,5,627
경기도,의정부시,신곡2동,신곡2동제3투,2533,1901,735,420,499,118,117,2,0,1,0,0,0,1,2,1895,6,632
경기도,의정부시,신곡2동,신곡2동제4투,2613,1992,833,368,478,143,162,0,0,1,0,3,0,1,0,1989,3,621
경기도,의정부시,신곡2동,신곡2동제5투,2912,2180,834,468,548,150,162,3,0,1,0,2,1,2,1,2172,8,732
경기도,의정부시,신곡2동,신곡2동제6투,2540,1908,660,494,483,132,124,5,0,3,2,1,0,0,1,1905,3,632
경기도,의정부시,신곡2동,신곡2동제7투,3603,2490,969,517,638,167,180,1,0,5,1,1,0,1,3,2483,7,1113
경기도,의정부시,신곡2동,신곡2동제8투,3018,2453,984,519,589,179,168,1,0,1,0,2,1,0,2,2446,7,565
경기도,의정부시,신곡2동,신곡2동제9투,2964,2328,917,507,596,173,126,3,0,1,0,0,1,0,0,2324,4,636
경기도,의정부시,신곡2동,신곡2동제10투,3133,2086,724,536,568,112,126,4,0,1,0,3,0,0,1,2075,11,1047
경기도,의정부시,송산1동,합계,25231,18040,7344,3903,4353,1109,1194,25,2,11,6,16,6,7,13,17989,51,7191
경기도,의정부시,송산1동,관내사전투표,3972,3971,1892,722,807,255,268,8,0,2,0,3,3,0,2,3962,9,1
경기도,의정부시,송산1동,송산1동제1투,2657,1933,731,423,501,134,132,2,0,0,0,4,0,1,3,1931,2,724
경기도,의정부시,송산1동,송산1동제2투,2304,1734,692,370,445,100,112,3,0,0,1,1,0,2,1,1727,7,570
경기도,의정부시,송산1동,송산1동제3투,2908,1957,765,409,536,98,126,3,0,2,0,4,2,2,3,1950,7,951
경기도,의정부시,송산1동,송산1동제4투,2559,1859,812,318,474,114,124,2,0,3,3,1,0,0,0,1851,8,700
경기도,의정부시,송산1동,송산1동제5투,2066,1295,527,301,307,71,83,0,1,2,0,1,0,0,1,1294,1,771
경기도,의정부시,송산1동,송산1동제6투,3469,1895,711,454,452,128,137,1,1,0,1,2,1,0,2,1890,5,1574
경기도,의정부시,송산1동,송산1동제7투,3870,2485,986,526,605,169,183,2,0,0,1,0,0,2,1,2475,10,1385
경기도,의정부시,송산1동,송산1동제8투,644,434,86,206,98,24,12,4,0,2,0,0,0,0,0,432,2,210
경기도,의정부시,송산1동,송산1동제9투,782,477,142,174,128,16,17,0,0,0,0,0,0,0,0,477,0,305
경기도,의정부시,송산2동,관내사전투표,6437,6437,3150,948,1349,473,467,7,1,1,1,7,2,4,6,6416,21,0
경기도,의정부시,송산2동,합계,40141,30380,13143,5454,7339,2121,2097,41,3,10,9,24,10,15,22,30288,92,9761
경기도,의정부시,송산2동,송산2동제1투,3429,2153,884,411,546,128,163,5,1,1,0,5,0,1,1,2146,7,1276
경기도,의정부시,송산2동,송산2동제2투,3814,2765,1267,442,651,203,184,3,0,3,0,0,0,0,0,2753,12,1049
경기도,의정부시,송산2동,송산2동제3투,5134,3906,1566,764,993,274,278,4,0,3,4,2,1,1,1,3891,15,1228
경기도,의정부시,송산2동,송산2동제4투,2421,1848,788,344,457,135,113,1,0,0,1,1,1,1,3,1845,3,573
경기도,의정부시,송산2동,송산2동제5투,2904,2033,863,356,514,135,148,5,1,1,0,2,1,2,1,2029,4,871
경기도,의정부시,송산2동,송산2동제6투,3248,2191,888,437,539,136,167,6,0,0,0,2,1,3,3,2182,9,1057
경기도,의정부시,송산2동,송산2동제7투,3583,2600,1075,479,688,189,154,2,0,1,1,2,1,1,2,2595,5,983
경기도,의정부시,송산2동,송산2동제8투,4856,3449,1486,625,829,254,233,3,0,0,1,2,2,1,3,3439,10,1407
경기도,의정부시,송산2동,송산2동제9투,4315,2998,1176,648,773,194,190,5,0,0,1,1,1,1,2,2992,6,1317
경기도,의정부시,자금동,합계,22334,16127,6312,3634,3917,1075,1062,21,1,12,4,12,5,11,11,16077,50,6207
경기도,의정부시,자금동,관내사전투표,3037,3037,1364,552,659,230,211,2,1,1,1,4,0,3,2,3030,7,0
경기도,의정부시,자금동,자금동제1투,3126,1774,599,440,483,94,136,2,0,4,1,1,2,0,2,1764,10,1352
경기도,의정부시,자금동,자금동제2투,3286,2308,872,535,598,145,140,3,0,3,1,1,0,2,3,2303,5,978
경기도,의정부시,자금동,자금동제3투,2571,1619,542,461,415,99,84,3,0,2,0,0,1,1,1,1609,10,952
경기도,의정부시,자금동,자금동제4투,2407,1572,545,442,337,102,138,2,0,1,0,1,0,0,2,1570,2,835
경기도,의정부시,자금동,자금동제5투,3650,2491,959,598,612,164,136,4,0,1,0,5,2,2,0,2483,8,1159
경기도,의정부시,자금동,자금동제6투,4257,3326,1431,606,813,241,217,5,0,0,1,0,0,3,1,3318,8,931
경기도,의정부시,가능1동,관내사전투표,3363,3363,1507,715,739,176,199,7,0,3,1,1,3,1,2,3354,9,0
경기도,의정부시,가능1동,합계,19842,13118,4936,3294,3174,729,855,28,1,5,7,14,7,7,11,13068,50,6724
경기도,의정부시,가능1동,가능1동제1투,3071,1603,546,467,371,83,111,3,0,0,2,5,0,2,1,1591,12,1468
경기도,의정부시,가능1동,가능1동제2투,3348,2219,803,579,526,159,137,2,0,0,1,0,2,0,2,2211,8,1129
경기도,의정부시,가능1동,가능1동제3투,2407,1402,498,343,376,73,97,2,1,0,1,2,0,1,1,1395,7,1005
경기도,의정부시,가능1동,가능1동제4투,2111,1332,482,347,323,72,102,0,0,0,1,0,0,0,1,1328,4,779
경기도,의정부시,가능1동,가능1동제5투,2940,1662,549,443,443,97,106,7,0,1,1,2,2,1,4,1656,6,1278
경기도,의정부시,가능1동,가능1동제6투,2602,1537,551,400,396,69,103,7,0,1,0,4,0,2,0,1533,4,1065
경기도,의정부시,녹양동,합계,17182,12536,5020,2767,3006,814,851,10,0,6,1,11,2,5,8,12501,35,4646
경기도,의정부시,녹양동,관내사전투표,3244,3244,1499,598,681,213,233,4,0,0,0,6,1,1,1,3237,7,0
경기도,의정부시,녹양동,녹양동제1투,3034,1857,649,412,515,132,134,0,0,1,0,0,0,3,1,1847,10,1177
경기도,의정부시,녹양동,녹양동제2투,3309,2321,978,498,545,140,151,1,0,0,1,1,0,0,0,2315,6,988
경기도,의정부시,녹양동,녹양동제3투,2355,1401,466,376,372,83,96,0,0,2,0,0,1,0,2,1398,3,954
경기도,의정부시,녹양동,녹양동제4투,3321,2372,924,526,586,156,162,4,0,2,0,4,0,1,1,2366,6,949
경기도,의정부시,녹양동,녹양동제5투,1919,1341,504,357,307,90,75,1,0,1,0,0,0,0,3,1338,3,578
경기도,의정부시,흥선동,합계,16561,10661,3937,2688,2602,628,707,26,2,5,0,6,9,4,8,10622,39,5900
경기도,의정부시,흥선동,관내사전투표,2319,2319,1003,505,512,122,165,4,0,0,0,1,1,0,0,2313,6,0
경기도,의정부시,흥선동,흥선동제1투,1946,1136,377,329,290,52,75,2,0,0,0,2,2,1,2,1132,4,810
경기도,의정부시,흥선동,흥선동제2투,2420,1573,522,362,433,127,101,14,1,1,0,1,2,1,2,1567,6,847
경기도,의정부시,흥선동,흥선동제3투,2328,1410,547,382,327,63,82,2,0,1,0,0,1,0,0,1405,5,918
경기도,의정부시,흥선동,흥선동제4투,2648,1748,649,414,441,117,114,1,0,1,0,1,0,1,2,1741,7,900
경기도,의정부시,흥선동,흥선동제5투,2803,1219,412,345,306,73,77,1,1,1,0,0,0,0,0,1216,3,1584
경기도,의정부시,흥선동,흥선동제6투,2097,1256,427,351,293,74,93,2,0,1,0,1,3,1,2,1248,8,841
경기도,의정부시,잘못 투입·구분된 투표지,,0,3,0,0,2,1,0,0,0,0,0,0,0,0,0,3,0,-3
경기도,안양시만안구,합계,,215032,167995,70454,35189,38671,10990,11275,257,23,149,32,109,59,55,129,167392,603,47037
경기도,안양시만안구,거소·선상투표,,364,336,120,61,106,21,12,0,0,0,0,1,1,2,3,327,9,28
경기도,안양시만안구,관외사전투표,,17658,17658,8374,2559,3825,1323,1357,26,6,7,4,14,11,7,30,17543,115,0
경기도,안양시만안구,재외투표,,1484,1136,715,62,161,49,133,10,0,0,1,0,0,0,0,1131,5,348
경기도,안양시만안구,안양1동,관내사전투표,2824,2824,1431,413,548,205,208,8,1,1,0,0,0,2,0,2817,7,0
경기도,안양시만안구,안양1동,합계,13550,11108,4730,2208,2545,823,736,27,2,2,4,2,3,2,3,11087,21,2442
경기도,안양시만안구,안양1동,안양1동제1투,2069,1620,651,342,393,117,109,4,0,0,0,1,1,0,1,1619,1,449
경기도,안양시만안구,안양1동,안양1동제2투,3660,3040,1244,585,731,264,201,8,0,0,1,0,1,0,0,3035,5,620
경기도,안양시만안구,안양1동,안양1동제3투,1658,1270,537,268,297,92,69,3,0,0,1,0,0,0,0,1267,3,388
경기도,안양시만안구,안양1동,안양1동제4투,2051,1595,589,394,391,107,102,3,0,1,1,1,0,0,2,1591,4,456
경기도,안양시만안구,안양1동,안양1동제5투,1288,759,278,206,185,38,47,1,1,0,1,0,1,0,0,758,1,529
경기도,안양시만안구,안양2동,합계,17770,12715,5133,3042,2862,730,834,23,2,15,1,6,7,4,12,12671,44,5055
경기도,안양시만안구,안양2동,관내사전투표,3021,3021,1368,656,628,157,193,5,0,1,0,2,1,0,3,3014,7,0
경기도,안양시만안구,안양2동,안양2동제1투,3577,2158,836,543,491,123,148,5,0,4,0,0,0,1,2,2153,5,1419
경기도,안양시만안구,안양2동,안양2동제2투,3432,2412,1027,500,529,162,171,6,0,0,0,2,1,0,3,2401,11,1020
경기도,안양시만안구,안양2동,안양2동제3투,2958,1901,756,469,433,98,125,1,0,4,0,1,3,0,1,1891,10,1057
경기도,안양시만안구,안양2동,안양2동제4투,2856,1925,698,497,480,118,114,1,2,2,1,0,2,1,3,1919,6,931
경기도,안양시만안구,안양2동,안양2동제5투,1926,1298,448,377,301,72,83,5,0,4,0,1,0,2,0,1293,5,628
경기도,안양시만안구,안양3동,합계,14230,10464,4380,2257,2372,692,663,22,1,15,3,8,3,7,6,10429,35,3766
경기도,안양시만안구,안양3동,관내사전투표,2932,2932,1362,574,587,181,203,9,0,1,0,4,1,1,2,2925,7,0
경기도,안양시만안구,안양3동,안양3동제1투,2488,1503,595,332,375,102,81,2,0,3,1,2,2,2,0,1497,6,985
경기도,안양시만안구,안양3동,안양3동제2투,2742,1816,744,370,444,112,130,3,0,3,0,1,0,1,2,1810,6,926
경기도,안양시만안구,안양3동,안양3동제3투,3451,2115,807,496,530,121,134,7,0,6,1,0,0,1,1,2104,11,1336
경기도,안양시만안구,안양3동,안양3동제4투,2617,2098,872,485,436,176,115,1,1,2,1,1,0,2,1,2093,5,519
경기도,안양시만안구,안양4동,관내사전투표,1437,1437,615,324,312,89,92,0,0,1,1,1,0,0,0,1435,2,0
경기도,안양시만안구,안양4동,합계,6227,4660,1797,1196,1079,288,270,7,1,5,2,1,1,1,2,4650,10,1567
경기도,안양시만안구,안양4동,안양4동제1투,2471,1536,571,396,376,81,98,4,1,2,1,0,0,0,1,1531,5,935
경기도,안양시만안구,안양4동,안양4동제2투,2319,1687,611,476,391,118,80,3,0,2,0,0,1,1,1,1684,3,632
경기도,안양시만안구,안양5동,합계,11166,7929,2898,2152,1856,468,496,8,0,8,0,4,4,2,4,7900,29,3237
경기도,안양시만안구,안양5동,관내사전투표,2227,2227,893,621,472,98,128,3,0,4,0,0,0,0,0,2219,8,0
경기도,안양시만안구,안양5동,안양5동제1투,3175,2139,779,552,532,136,119,1,0,3,0,4,2,1,2,2131,8,1036
경기도,안양시만안구,안양5동,안양5동제2투,3086,1996,672,542,475,144,156,2,0,0,0,0,0,0,0,1991,5,1090
경기도,안양시만안구,안양5동,안양5동제3투,2678,1567,554,437,377,90,93,2,0,1,0,0,2,1,2,1559,8,1111
경기도,안양시만안구,안양6동,관내사전투표,2447,2447,1056,535,544,128,165,3,0,4,0,1,1,0,1,2438,9,0
경기도,안양시만안구,안양6동,합계,14613,10498,4148,2515,2464,605,690,14,0,14,1,4,5,3,4,10467,31,4115
경기도,안양시만안구,안양6동,안양6동제1투,3821,2419,928,591,584,147,154,2,0,4,0,1,0,0,2,2413,6,1402
경기도,안양시만안구,안양6동,안양6동제2투,1556,1041,404,291,238,55,47,1,0,2,0,0,1,2,0,1041,0,515
경기도,안양시만안구,안양6동,안양6동제3투,3914,2631,1029,662,582,163,173,4,0,0,1,2,2,1,1,2620,11,1283
경기도,안양시만안구,안양6동,안양6동제4투,2875,1960,731,436,516,112,151,4,0,4,0,0,1,0,0,1955,5,915
경기도,안양시만안구,안양7동,합계,11444,9316,4192,1660,2102,699,616,9,1,6,1,4,1,1,3,9295,21,2128
경기도,안양시만안구,안양7동,관내사전투표,2851,2851,1377,483,573,204,199,5,0,1,1,2,0,0,0,2845,6,0
경기도,안양시만안구,안양7동,안양7동제1투,3576,2825,1200,517,672,220,202,3,0,2,0,0,1,0,2,2819,6,751
경기도,안양시만안구,안양7동,안양7동제2투,3057,2487,1128,438,572,195,142,1,1,2,0,1,0,1,1,2482,5,570
경기도,안양시만안구,안양7동,안양7동제3투,1960,1153,487,222,285,80,73,0,0,1,0,1,0,0,0,1149,4,807
경기도,안양시만안구,안양8동,합계,10168,7495,3008,1684,1754,445,512,11,3,17,4,12,6,5,8,7469,26,2673
경기도,안양시만안구,안양8동,관내사전투표,2536,2536,1107,547,540,144,167,1,3,2,1,7,1,2,3,2525,11,0
경기도,안양시만안구,안양8동,안양8동제1투,2576,1627,610,399,387,85,120,4,0,4,2,4,2,1,3,1621,6,949
경기도,안양시만안구,안양8동,안양8동제2투,3023,2003,801,420,483,135,140,5,0,7,1,0,2,2,1,1997,6,1020
경기도,안양시만안구,안양8동,안양8동제3투,2033,1329,490,318,344,81,85,1,0,4,0,1,1,0,1,1326,3,704
경기도,안양시만안구,안양9동,합계,13730,10232,3944,2369,2552,608,669,18,1,12,2,10,4,2,5,10196,36,3498
경기도,안양시만안구,안양9동,관내사전투표,2538,2538,1016,647,548,132,164,6,1,7,1,5,0,0,2,2529,9,0
경기도,안양시만안구,안양9동,안양9동제1투,1891,1262,444,312,339,70,85,4,0,0,0,2,2,0,1,1259,3,629
경기도,안양시만안구,안양9동,안양9동제2투,2739,1963,761,400,498,147,142,3,0,2,1,1,1,0,1,1957,6,776
경기도,안양시만안구,안양9동,안양9동제3투,2729,1718,663,369,465,98,111,0,0,2,0,1,0,1,1,1711,7,1011
경기도,안양시만안구,안양9동,안양9동제4투,3833,2751,1060,641,702,161,167,5,0,1,0,1,1,1,0,2740,11,1082
경기도,안양시만안구,석수1동,합계,15738,12794,5392,2836,2824,876,786,13,1,4,1,12,1,2,10,12758,36,2944
경기도,안양시만안구,석수1동,관내사전투표,3171,3171,1442,671,606,211,221,5,0,1,0,1,1,0,1,3160,11,0
경기도,안양시만안구,석수1동,석수1동제1투,3447,2456,967,575,581,172,141,5,0,1,0,2,0,1,3,2448,8,991
경기도,안양시만안구,석수1동,석수1동제2투,2735,1816,724,453,399,108,115,1,1,0,1,2,0,0,4,1808,8,919
경기도,안양시만안구,석수1동,석수1동제3투,2466,2071,928,395,456,154,129,0,0,0,0,5,0,1,1,2069,2,395
경기도,안양시만안구,석수1동,석수1동제4투,3919,3280,1331,742,782,231,180,2,0,2,0,2,0,0,1,3273,7,639
경기도,안양시만안구,석수2동,관내사전투표,4343,4343,2015,847,864,277,300,6,0,2,0,5,1,4,3,4324,19,0
경기도,안양시만안구,석수2동,합계,25543,20046,8430,4148,4636,1329,1340,37,1,11,1,12,2,8,14,19969,77,5497
경기도,안양시만안구,석수2동,석수2동제1투,1433,978,385,274,194,50,62,6,0,0,1,1,0,0,1,974,4,455
경기도,안양시만안구,석수2동,석수2동제2투,3293,2427,912,602,604,157,134,1,1,2,0,0,0,2,2,2417,10,866
경기도,안양시만안구,석수2동,석수2동제3투,2247,1539,575,364,369,124,96,2,0,0,0,1,0,0,2,1533,6,708
경기도,안양시만안구,석수2동,석수2동제4투,2492,1988,806,452,466,131,118,5,0,2,0,2,0,0,1,1983,5,504
경기도,안양시만안구,석수2동,석수2동제5투,2281,1536,569,349,399,94,105,7,0,3,0,1,0,1,0,1528,8,745
경기도,안양시만안구,석수2동,석수2동제6투,2660,1743,683,389,427,98,126,3,0,0,0,0,0,0,4,1730,13,917
경기도,안양시만안구,석수2동,석수2동제7투,3601,2876,1307,469,677,207,200,6,0,1,0,0,1,0,1,2869,7,725
경기도,안양시만안구,석수2동,석수2동제8투,3193,2616,1178,402,636,191,199,1,0,1,0,2,0,1,0,2611,5,577
경기도,안양시만안구,석수3동,합계,11151,8447,3621,1649,2022,502,577,5,1,8,2,3,3,3,12,8408,39,2704
경기도,안양시만안구,석수3동,관내사전투표,2180,2180,1003,375,486,105,186,0,1,2,0,2,1,2,4,2167,13,0
경기도,안양시만안구,석수3동,석수3동제1투,3111,2044,836,440,484,136,130,0,0,4,1,0,1,1,1,2034,10,1067
경기도,안양시만안구,석수3동,석수3동제2투,2871,2219,973,417,542,146,125,3,0,0,1,1,1,0,4,2213,6,652
경기도,안양시만안구,석수3동,석수3동제3투,2989,2004,809,417,510,115,136,2,0,2,0,0,0,0,3,1994,10,985
경기도,안양시만안구,박달1동,합계,13628,9804,3987,2149,2364,569,645,13,2,10,2,8,4,4,8,9765,39,3824
경기도,안양시만안구,박달1동,관내사전투표,2730,2730,1186,565,616,164,181,2,2,1,0,3,2,2,1,2725,5,0
경기도,안양시만안구,박달1동,박달1동제1투,3202,1935,772,423,467,97,149,6,0,3,1,2,0,0,2,1922,13,1267
경기도,안양시만안구,박달1동,박달1동제2투,2358,1497,552,388,368,93,82,1,0,2,0,1,1,1,1,1490,7,861
경기도,안양시만안구,박달1동,박달1동제3투,2373,1440,548,328,374,80,95,0,0,0,1,1,1,1,3,1432,8,933
경기도,안양시만안구,박달1동,박달1동제4투,2965,2202,929,445,539,135,138,4,0,4,0,1,0,0,1,2196,6,763
경기도,안양시만안구,박달2동,합계,16568,13357,5585,2642,3147,963,939,14,1,15,3,8,3,2,5,13327,30,3211
경기도,안양시만안구,박달2동,관내사전투표,2907,2907,1332,524,622,210,208,1,0,0,1,3,1,2,0,2904,3,0
경기도,안양시만안구,박달2동,박달2동제1투,2564,1720,700,368,403,128,107,4,0,3,1,1,1,0,0,1716,4,844
경기도,안양시만안구,박달2동,박달2동제2투,2246,1831,725,392,445,128,122,6,1,4,0,1,0,0,2,1826,5,415
경기도,안양시만안구,박달2동,박달2동제3투,2838,2195,884,425,538,180,161,0,0,0,0,0,0,0,1,2189,6,643
경기도,안양시만안구,박달2동,박달2동제4투,3141,2308,984,426,571,141,169,2,0,4,0,1,1,0,1,2300,8,833
경기도,안양시만안구,박달2동,박달2동제5투,2872,2396,960,507,568,176,172,1,0,4,1,2,0,0,1,2392,4,476
경기도,안양시만안구,잘못 투입·구분된 투표지,,0,0,0,0,0,0,0,0,0,0,0,0,0,0,0,0,0,0
경기도,안양시동안구,합계,,277376,230674,101278,43072,51966,17577,15294,298,26,129,30,110,48,51,112,229991,683,46702
경기도,안양시동안구,거소·선상투표,,455,428,143,79,149,29,18,2,0,1,0,0,0,1,1,423,5,27
경기도,안양시동안구,관외사전투표,,23805,23805,11429,3339,5103,1954,1745,29,6,11,4,21,13,6,20,23680,125,0
경기도,안양시동안구,재외투표,,2660,2112,1245,127,348,106,268,12,0,1,0,1,0,0,0,2108,4,548
경기도,안양시동안구,비산1동,합계,18372,15025,6199,3281,3396,1136,921,11,3,5,1,3,6,3,7,14972,53,3347
경기도,안양시동안구,비산1동,관내사전투표,3160,3160,1380,642,642,249,226,3,0,0,0,1,1,1,1,3146,14,0
경기도,안양시동안구,비산1동,비산1동제1투,1832,1054,419,254,238,59,66,1,1,0,1,0,2,1,0,1042,12,778
경기도,안양시동안구,비산1동,비산1동제2투,2233,1561,677,344,355,89,89,2,0,1,0,0,0,0,1,1558,3,672
경기도,안양시동안구,비산1동,비산1동제3투,3600,2936,1307,564,682,179,186,1,0,3,0,1,0,1,3,2927,9,664
경기도,안양시동안구,비산1동,비산1동제4투,3240,2696,936,708,646,254,139,2,1,0,0,0,2,0,0,2688,8,544
경기도,안양시동안구,비산1동,비산1동제5투,2187,1835,701,396,463,155,113,2,0,0,0,1,1,0,1,1833,2,352
경기도,안양시동안구,비산1동,비산1동제6투,2120,1783,779,373,370,151,102,0,1,1,0,0,0,0,1,1778,5,337
경기도,안양시동안구,비산2동,합계,10326,8516,3447,1828,1985,659,537,14,1,7,1,3,1,1,3,8487,29,1810
경기도,안양시동안구,비산2동,관내사전투표,2225,2225,971,445,523,151,118,4,0,2,0,1,0,0,0,2215,10,0
경기도,안양시동안구,비산2동,비산2동제1투,2115,1483,557,359,365,108,82,5,0,2,0,0,0,0,0,1478,5,632
경기도,안양시동안구,비산2동,비산2동제2투,3153,2493,1038,502,560,201,172,4,1,2,1,0,1,1,1,2484,9,660
경기도,안양시동안구,비산2동,비산2동제3투,2833,2315,881,522,537,199,165,1,0,1,0,2,0,0,2,2310,5,518
경기도,안양시동안구,비산3동,합계,18837,14495,5816,3190,3419,1033,935,15,1,8,2,7,3,4,6,14439,56,4342
경기도,안양시동안구,비산3동,관내사전투표,3718,3718,1607,806,795,249,244,3,1,0,0,2,0,0,2,3709,9,0
경기도,안양시동안구,비산3동,비산3동제1투,2574,1921,788,409,420,173,113,5,0,1,1,1,1,0,1,1913,8,653
경기도,안양시동안구,비산3동,비산3동제2투,2387,1810,658,434,459,130,118,4,0,0,0,0,0,2,0,1805,5,577
경기도,안양시동안구,비산3동,비산3동제3투,2667,1703,654,363,445,92,135,1,0,2,0,1,1,1,1,1696,7,964
경기도,안양시동안구,비산3동,비산3동제4투,2286,1607,615,358,422,98,106,2,0,0,0,1,1,0,0,1603,4,679
경기도,안양시동안구,비산3동,비산3동제5투,2506,1821,733,399,427,158,91,0,0,2,0,1,0,0,0,1811,10,685
경기도,안양시동안구,비산3동,비산3동제6투,2699,1915,761,421,451,133,128,0,0,3,1,1,0,1,2,1902,13,784
경기도,안양시동안구,부흥동,관내사전투표,3060,3060,1501,484,635,222,201,5,0,3,0,2,0,0,3,3056,4,0
경기도,안양시동안구,부흥동,합계,13092,11068,5043,1987,2448,817,722,13,0,7,1,4,0,2,3,11047,21,2024
경기도,안양시동안구,부흥동,부흥동제1투,1772,1332,576,255,310,104,83,1,0,1,0,1,0,0,0,1331,1,440
경기도,안양시동안구,부흥동,부흥동제2투,1842,1514,670,264,363,128,84,2,0,0,0,1,0,0,0,1512,2,328
경기도,안양시동안구,부흥동,부흥동제3투,1688,1202,450,268,312,83,77,4,0,2,0,0,0,1,0,1197,5,486
경기도,안양시동안구,부흥동,부흥동제4투,2721,2268,1070,424,461,150,158,1,0,0,0,0,0,0,0,2264,4,453
경기도,안양시동안구,부흥동,부흥동제5투,2009,1692,776,292,367,130,119,0,0,1,1,0,0,1,0,1687,5,317
경기도,안양시동안구,달안동,합계,9646,7846,3783,1248,1640,567,558,12,0,7,2,3,2,2,0,7824,22,1800
경기도,안양시동안구,달안동,관내사전투표,2487,2487,1307,336,474,183,175,3,0,3,1,0,2,0,0,2484,3,0
경기도,안양시동안구,달안동,달안동제1투,2526,1825,809,301,425,141,135,3,0,1,1,0,0,2,0,1818,7,701
경기도,안양시동안구,달안동,달안동제2투,2219,1599,755,287,314,113,124,0,0,0,0,1,0,0,0,1594,5,620
경기도,안양시동안구,달안동,달안동제3투,2414,1935,912,324,427,130,124,6,0,3,0,2,0,0,0,1928,7,479
경기도,안양시동안구,관양1동,관내사전투표,4776,4777,2293,799,1020,301,331,10,0,2,0,2,0,1,5,4764,13,-1
경기도,안양시동안구,관양1동,합계,29256,22603,9411,4701,5238,1532,1531,42,0,15,4,15,5,8,19,22521,82,6653
경기도,안양시동안구,관양1동,관양1동제1투,2996,2022,812,414,490,140,144,6,0,0,1,2,1,1,1,2012,10,974
경기도,안양시동안구,관양1동,관양1동제2투,3487,2646,950,715,589,217,154,5,0,3,0,1,0,1,0,2635,11,841
경기도,안양시동안구,관양1동,관양1동제3투,3077,2158,821,525,524,131,135,5,0,4,0,2,0,0,4,2151,7,919
경기도,안양시동안구,관양1동,관양1동제4투,2830,1927,721,449,467,124,145,2,0,4,1,3,0,0,2,1918,9,903
경기도,안양시동안구,관양1동,관양1동제5투,2847,2054,925,368,470,143,134,4,0,0,1,2,0,0,1,2048,6,793
경기도,안양시동안구,관양1동,관양1동제6투,2654,1911,782,402,456,124,123,9,0,1,0,0,0,2,2,1901,10,743
경기도,안양시동안구,관양1동,관양1동제7투,3270,2576,1018,541,621,186,191,0,0,0,1,2,2,2,2,2566,10,694
경기도,안양시동안구,관양1동,관양1동제8투,3319,2532,1089,488,601,166,174,1,0,1,0,1,2,1,2,2526,6,787
경기도,안양시동안구,관양2동,합계,14896,11600,5091,2218,2701,814,708,20,3,3,2,3,3,4,4,11574,26,3296
경기도,안양시동안구,관양2동,관내사전투표,2575,2575,1234,421,554,176,173,3,0,1,1,3,1,1,1,2569,6,0
경기도,안양시동안구,관양2동,관양2동제1투,2357,1553,657,328,361,86,110,2,0,0,0,0,2,0,1,1547,6,804
경기도,안양시동안구,관양2동,관양2동제2투,2536,1611,691,347,360,109,92,4,1,1,1,0,0,0,0,1606,5,925
경기도,안양시동안구,관양2동,관양2동제3투,1657,1006,426,239,217,58,61,2,1,0,0,0,0,0,1,1005,1,651
경기도,안양시동안구,관양2동,관양2동제4투,2980,2356,934,539,573,175,120,6,0,0,0,0,0,3,1,2351,5,624
경기도,안양시동안구,관양2동,관양2동제5투,2791,2499,1149,344,636,210,152,3,1,1,0,0,0,0,0,2496,3,292
경기도,안양시동안구,부림동,합계,19181,15952,7885,2432,3332,1153,1065,18,2,4,4,11,1,1,4,15912,40,3229
경기도,안양시동안구,부림동,관내사전투표,4706,4705,2549,595,836,372,337,1,1,1,1,2,0,0,0,4695,10,1
경기도,안양시동안구,부림동,부림동제1투,2794,2070,1015,343,441,133,125,2,0,1,0,1,0,0,2,2063,7,724
경기도,안양시동안구,부림동,부림동제2투,2502,2019,953,321,440,171,126,0,0,1,1,1,0,0,0,2014,5,483
경기도,안양시동안구,부림동,부림동제3투,2792,2282,982,451,521,152,156,4,0,1,0,7,0,1,0,2275,7,510
경기도,안양시동안구,부림동,부림동제4투,2670,2152,1093,277,490,145,139,3,0,0,0,0,1,0,1,2149,3,518
경기도,안양시동안구,부림동,부림동제5투,3717,2724,1293,445,604,180,182,8,1,0,2,0,0,0,1,2716,8,993
경기도,안양시동안구,평촌동,합계,11760,10136,4596,1774,2264,779,666,10,2,4,0,3,2,3,8,10111,25,1624
경기도,안양시동안구,평촌동,관내사전투표,3340,3340,1621,513,749,213,222,1,2,1,0,1,0,1,5,3329,11,0
경기도,안양시동안구,평촌동,평촌동제1투,2665,2156,945,392,486,174,149,0,0,1,0,0,2,2,1,2152,4,509
경기도,안양시동안구,평촌동,평촌동제2투,2650,2075,867,449,468,151,124,5,0,1,0,1,0,0,2,2068,7,575
경기도,안양시동안구,평촌동,평촌동제3투,3105,2565,1163,420,561,241,171,4,0,1,0,1,0,0,0,2562,3,540
경기도,안양시동안구,평안동,합계,16869,14641,7136,2181,3096,1192,986,7,1,5,2,5,2,1,3,14617,24,2228
경기도,안양시동안구,평안동,관내사전투표,3838,3838,1977,510,752,315,273,0,0,2,0,1,0,0,1,3831,7,0
경기도,안양시동안구,평안동,평안동제1투,2258,1743,799,292,380,118,145,1,0,2,1,0,1,0,0,1739,4,515
경기도,안양시동안구,평안동,평안동제2투,2699,2246,981,418,515,183,140,3,0,0,1,2,0,0,0,2243,3,453
경기도,안양시동안구,평안동,평안동제3투,2324,1863,903,279,392,146,137,3,0,1,0,0,0,0,1,1862,1,461
경기도,안양시동안구,평안동,평안동제4투,2444,2055,1015,289,431,193,116,0,1,0,0,1,1,0,0,2047,8,389
경기도,안양시동안구,평안동,평안동제5투,3306,2896,1461,393,626,237,175,0,0,0,0,1,0,1,1,2895,1,410
경기도,안양시동안구,귀인동,합계,11364,9805,4206,1788,2308,865,601,8,0,0,1,4,3,2,2,9788,17,1559
경기도,안양시동안구,귀인동,관내사전투표,2371,2371,1101,412,484,200,166,2,0,0,0,0,0,0,0,2365,6,0
경기도,안양시동안구,귀인동,귀인동제1투,2709,2218,856,491,526,225,110,0,0,0,0,3,1,1,2,2215,3,491
경기도,안양시동안구,귀인동,귀인동제2투,3151,2650,1088,528,652,227,147,4,0,0,1,0,1,0,0,2648,2,501
경기도,안양시동안구,귀인동,귀인동제3투,3133,2566,1161,357,646,213,178,2,0,0,0,1,1,1,0,2560,6,567
경기도,안양시동안구,호계1동,합계,8700,6397,2558,1427,1545,432,392,9,1,3,0,6,1,2,9,6385,12,2303
경기도,안양시동안구,호계1동,관내사전투표,1978,1978,864,430,436,95,133,3,0,2,0,2,0,2,4,1971,7,0
경기도,안양시동안구,호계1동,호계1동제1투,1796,1053,403,253,246,82,65,0,1,0,0,0,0,0,2,1052,1,743
경기도,안양시동안구,호계1동,호계1동제2투,2471,1740,677,383,435,137,95,3,0,1,0,4,1,0,2,1738,2,731
경기도,안양시동안구,호계1동,호계1동제3투,1184,809,308,167,199,76,57,0,0,0,0,0,0,0,1,808,1,375
경기도,안양시동안구,호계1동,호계1동제4투,1271,817,306,194,229,42,42,3,0,0,0,0,0,0,0,816,1,454
경기도,안양시동안구,호계2동,합계,18503,15007,6035,3219,3549,1104,985,23,2,26,1,1,4,3,7,14959,48,3496
경기도,안양시동안구,호계2동,관내사전투표,2912,2912,1271,547,658,207,202,7,1,3,1,0,0,0,2,2899,13,0
경기도,안양시동안구,호계2동,호계2동제1투,3436,2390,889,553,593,160,168,5,1,6,0,1,3,1,2,2382,8,1046
경기도,안양시동안구,호계2동,호계2동제2투,2629,2082,704,488,593,152,130,7,0,1,0,0,0,1,0,2076,6,547
경기도,안양시동안구,호계2동,호계2동제3투,3160,2487,1047,511,578,168,166,0,0,4,0,0,0,1,2,2477,10,673
경기도,안양시동안구,호계2동,호계2동제4투,3340,2638,1013,666,599,219,125,0,0,11,0,0,1,0,0,2634,4,702
경기도,안양시동안구,호계2동,호계2동제5투,3026,2498,1111,454,528,198,194,4,0,1,0,0,0,0,1,2491,7,528
경기도,안양시동안구,호계3동,합계,18522,14682,5948,3056,3471,1154,969,12,3,10,3,6,1,4,6,14643,39,3840
경기도,안양시동안구,호계3동,관내사전투표,4001,4001,1719,743,935,308,274,2,0,6,1,2,0,2,1,3993,8,0
경기도,안양시동안구,호계3동,호계3동제1투,3126,2260,912,508,512,182,136,2,0,0,0,0,0,1,1,2254,6,866
경기도,안양시동안구,호계3동,호계3동제2투,3616,2374,892,567,585,153,158,1,1,1,1,0,0,0,4,2363,11,1242
경기도,안양시동안구,호계3동,호계3동제3투,2324,1750,717,364,399,132,129,2,1,0,0,2,1,0,0,1747,3,574
경기도,안양시동안구,호계3동,호계3동제4투,2354,1842,746,376,431,163,111,4,0,2,1,2,0,1,0,1837,5,512
경기도,안양시동안구,호계3동,호계3동제5투,3101,2455,962,498,609,216,161,1,1,1,0,0,0,0,0,2449,6,646
경기도,안양시동안구,범계동,합계,12518,10847,4747,2013,2379,962,696,10,0,2,0,5,1,3,5,10823,24,1671
경기도,안양시동안구,범계동,관내사전투표,3722,3722,1796,529,727,344,307,4,0,1,0,2,0,0,3,3713,9,0
경기도,안양시동안구,범계동,범계동제1투,2441,1870,819,368,409,161,102,1,0,0,0,1,0,2,0,1863,7,571
경기도,안양시동안구,범계동,범계동제2투,2132,1663,832,237,362,136,88,2,0,0,0,0,1,0,1,1659,4,469
경기도,안양시동안구,범계동,범계동제3투,2213,1875,671,486,440,172,100,2,0,1,0,1,0,0,0,1873,2,338
경기도,안양시동안구,범계동,범계동제4투,2010,1717,629,393,441,149,99,1,0,0,0,1,0,1,1,1715,2,293
경기도,안양시동안구,신촌동,관내사전투표,2748,2748,1328,441,578,206,181,9,0,0,0,3,0,0,1,2747,1,0
경기도,안양시동안구,신촌동,합계,10099,8684,3884,1559,1929,687,581,18,0,3,1,5,0,0,2,8669,15,1415
경기도,안양시동안구,신촌동,신촌동제1투,3033,2450,1055,420,585,215,167,3,0,0,0,1,0,0,0,2446,4,583
경기도,안양시동안구,신촌동,신촌동제2투,3014,2395,1076,443,505,184,168,6,0,1,1,1,0,0,0,2385,10,619
경기도,안양시동안구,신촌동,신촌동제3투,1304,1091,425,255,261,82,65,0,0,2,0,0,0,0,1,1091,0,213
경기도,안양시동안구,갈산동,합계,8515,7025,2676,1625,1666,602,410,13,1,7,1,4,0,1,3,7009,16,1490
경기도,안양시동안구,갈산동,관내사전투표,1860,1860,769,418,395,151,120,0,0,2,0,1,0,0,0,1856,4,0
경기도,안양시동안구,갈산동,갈산동제1투,2754,2189,707,542,589,207,127,6,0,1,1,2,0,1,2,2185,4,565
경기도,안양시동안구,갈산동,갈산동제2투,1826,1508,571,400,315,138,75,4,0,1,0,0,0,0,1,1505,3,318
경기도,안양시동안구,갈산동,갈산동제3투,2075,1468,629,265,367,106,88,3,1,3,0,1,0,0,0,1463,5,607
경기도,안양시동안구,잘못 투입·구분된 투표지,,0,0,0,0,0,0,0,0,0,0,0,0,0,0,0,0,0,0
경기도,부천시,합계,,705885,543777,239697,100544,128297,34085,36775,706,94,365,126,395,149,192,417,541842,1935,162108
경기도,부천시,거소·선상투표,,1165,1125,392,186,386,76,34,3,4,1,3,2,2,2,7,1098,27,40
경기도,부천시,관외사전투표,,51722,51684,24969,6833,11427,3763,4120,52,21,22,15,35,31,21,77,51386,298,38
경기도,부천시,재외투표,,4272,3359,2080,237,473,125,417,14,0,1,0,2,0,1,1,3351,8,913
경기도,부천시,심곡2동,합계,15677,10191,4498,1897,2441,555,710,13,3,8,4,8,4,3,8,10152,39,5486
경기도,부천시,심곡2동,관내사전투표,3144,3144,1496,530,653,186,249,4,1,4,0,0,2,2,2,3129,15,0
경기도,부천시,심곡2동,심곡2동제1투,4127,2374,1010,475,599,112,163,1,1,1,1,2,2,1,1,2369,5,1753
경기도,부천시,심곡2동,심곡2동제2투,4407,2530,1087,486,618,152,165,4,0,1,2,2,0,0,0,2517,13,1877
경기도,부천시,심곡2동,심곡2동제3투,3999,2143,905,406,571,105,133,4,1,2,1,4,0,0,5,2137,6,1856
경기도,부천시,심곡1동,합계,11421,7780,3311,1503,1928,423,550,17,0,8,1,7,0,4,7,7759,21,3641
경기도,부천시,심곡1동,관내사전투표,2309,2309,1136,342,509,123,178,5,0,2,1,2,0,0,1,2299,10,0
경기도,부천시,심곡1동,심곡1동제1투,3555,2147,841,499,517,113,164,5,0,1,0,2,0,2,1,2145,2,1408
경기도,부천시,심곡1동,심곡1동제2투,2707,1791,727,341,487,93,118,6,0,3,0,3,0,1,4,1783,8,916
경기도,부천시,심곡1동,심곡1동제3투,2850,1533,607,321,415,94,90,1,0,2,0,0,0,1,1,1532,1,1317
경기도,부천시,심곡3동,합계,10892,7497,3087,1525,1868,443,507,11,1,6,1,10,0,2,10,7471,26,3395
경기도,부천시,심곡3동,관내사전투표,1956,1956,924,349,437,101,129,5,0,3,1,1,0,0,1,1951,5,0
경기도,부천시,심곡3동,심곡3동제1투,3305,1958,706,454,514,132,129,1,0,2,0,4,0,1,5,1948,10,1347
경기도,부천시,심곡3동,심곡3동제2투,2558,1515,599,303,393,89,121,3,1,0,0,1,0,1,1,1512,3,1043
경기도,부천시,심곡3동,심곡3동제3투,3073,2068,858,419,524,121,128,2,0,1,0,4,0,0,3,2060,8,1005
경기도,부천시,원미2동,합계,11451,8028,3202,1707,2157,398,488,12,0,4,0,8,3,6,4,7989,39,3423
경기도,부천시,원미2동,관내사전투표,2088,2088,899,438,518,94,125,2,0,1,0,2,1,2,1,2083,5,0
경기도,부천시,원미2동,원미2동제1투,3242,1855,720,389,528,86,104,2,0,1,0,3,1,1,1,1836,19,1387
경기도,부천시,원미2동,원미2동제2투,3466,2449,974,524,654,135,142,5,0,2,0,3,0,1,1,2441,8,1017
경기도,부천시,원미2동,원미2동제3투,2655,1636,609,356,457,83,117,3,0,0,0,0,1,2,1,1629,7,1019
경기도,부천시,소사동,합계,7712,5437,2294,1200,1301,280,318,8,2,5,1,5,2,3,2,5421,16,2275
경기도,부천시,소사동,관내사전투표,1672,1672,808,340,329,87,95,3,0,1,0,1,0,2,1,1667,5,0
경기도,부천시,소사동,소사동제1투,3119,1910,778,407,512,92,105,4,1,3,1,1,1,0,1,1906,4,1209
경기도,부천시,소사동,소사동제2투,2921,1855,708,453,460,101,118,1,1,1,0,3,1,1,0,1848,7,1066
경기도,부천시,원미1동,합계,14852,10937,4574,2278,2663,585,749,11,3,6,4,9,5,2,5,10894,43,3915
경기도,부천시,원미1동,관내사전투표,3400,3400,1535,668,756,166,245,6,0,2,0,2,1,2,3,3386,14,0
경기도,부천시,원미1동,원미1동제1투,3533,2171,852,477,581,105,140,2,0,1,0,1,1,0,2,2162,9,1362
경기도,부천시,원미1동,원미1동제2투,3646,2290,957,456,563,138,153,2,2,2,1,6,2,0,0,2282,8,1356
경기도,부천시,원미1동,원미1동제3투,2395,1887,787,391,445,122,133,0,0,0,2,0,0,0,0,1880,7,508
경기도,부천시,원미1동,원미1동제4투,1878,1189,443,286,318,54,78,1,1,1,1,0,1,0,0,1184,5,689
경기도,부천시,역곡1동,합계,15212,11939,5337,2312,2803,669,750,9,1,7,1,8,4,4,9,11914,25,3273
경기도,부천시,역곡1동,관내사전투표,3595,3595,1773,594,743,206,262,2,0,1,1,3,0,2,3,3590,5,0
경기도,부천시,역곡1동,역곡1동제1투,3829,2613,1121,547,664,123,148,0,0,1,0,0,1,1,2,2608,5,1216
경기도,부천시,역곡1동,역곡1동제2투,3178,2283,971,473,536,139,148,3,0,4,0,1,1,0,2,2278,5,895
경기도,부천시,역곡1동,역곡1동제3투,2116,1577,685,324,371,86,98,3,0,1,0,2,1,1,1,1573,4,539
경기도,부천시,역곡1동,역곡1동제4투,2494,1871,787,374,489,115,94,1,1,0,0,2,1,0,1,1865,6,623
경기도,부천시,역곡2동,합계,15856,12193,5475,2105,2889,786,831,29,2,4,6,12,4,1,8,12152,41,3663
경기도,부천시,역곡2동,관내사전투표,4035,4035,1956,596,897,234,323,5,0,1,3,3,1,1,2,4022,13,0
경기도,부천시,역곡2동,역곡2동제1투,3940,2650,1130,496,638,186,167,10,2,2,1,3,1,0,4,2640,10,1290
경기도,부천시,역곡2동,역곡2동제2투,4230,3131,1366,585,778,196,179,11,0,1,1,1,1,0,2,3121,10,1099
경기도,부천시,역곡2동,역곡2동제3투,3651,2377,1023,428,576,170,162,3,0,0,1,5,1,0,0,2369,8,1274
경기도,부천시,춘의동,합계,12108,8797,3768,1755,2125,489,586,7,2,8,2,3,4,3,7,8759,38,3311
경기도,부천시,춘의동,관내사전투표,2148,2148,1033,361,458,117,160,3,0,4,1,2,0,0,0,2139,9,0
경기도,부천시,춘의동,춘의동제1투,3279,2122,902,424,502,143,135,0,1,2,0,0,3,0,1,2113,9,1157
경기도,부천시,춘의동,춘의동제2투,2398,1612,605,395,442,59,88,2,1,1,0,1,0,3,3,1600,12,786
경기도,부천시,춘의동,춘의동제3투,4283,2915,1228,575,723,170,203,2,0,1,1,0,1,0,3,2907,8,1368
경기도,부천시,도당동,합계,18877,13265,5565,2632,3326,734,888,15,2,11,1,13,4,6,7,13204,61,5612
경기도,부천시,도당동,관내사전투표,2693,2693,1310,394,615,158,197,2,0,0,1,5,0,0,1,2683,10,0
경기도,부천시,도당동,도당동제1투,4822,3166,1308,578,839,192,213,4,0,4,0,4,0,1,2,3145,21,1656
경기도,부천시,도당동,도당동제2투,3216,2213,916,456,535,139,151,2,0,2,0,1,1,0,1,2204,9,1003
경기도,부천시,도당동,도당동제3투,3318,2242,956,443,543,105,172,4,1,3,0,0,2,3,1,2233,9,1076
경기도,부천시,도당동,도당동제4투,2889,1825,657,478,487,89,97,2,0,2,0,2,1,2,1,1818,7,1064
경기도,부천시,도당동,도당동제5투,1939,1126,418,283,307,51,58,1,1,0,0,1,0,0,1,1121,5,813
경기도,부천시,중동,관내사전투표,2880,2880,1379,515,611,165,187,2,0,5,2,2,0,4,2,2874,6,0
경기도,부천시,중동,합계,18210,13602,5855,2681,3177,891,886,18,1,14,5,5,4,8,14,13559,43,4608
경기도,부천시,중동,중동제1투,3270,1962,747,466,488,114,129,5,1,1,0,0,2,1,4,1958,4,1308
경기도,부천시,중동,중동제2투,2725,2095,969,354,467,161,131,3,0,0,0,2,1,1,0,2089,6,630
경기도,부천시,중동,중동제3투,3243,2226,880,460,573,136,148,3,0,4,0,1,0,1,5,2211,15,1017
경기도,부천시,중동,중동제4투,2736,1754,678,366,454,114,125,4,0,3,1,0,1,1,2,1749,5,982
경기도,부천시,중동,중동제5투,3356,2685,1202,520,584,201,166,1,0,1,2,0,0,0,1,2678,7,671
경기도,부천시,상동,합계,16649,12728,5330,2619,2966,830,880,20,1,7,7,8,5,4,6,12683,45,3921
경기도,부천시,상동,관내사전투표,3836,3836,1766,679,814,252,295,7,0,1,3,4,0,1,1,3823,13,0
경기도,부천시,상동,상동제1투,2963,2205,847,508,556,144,135,5,1,1,2,1,1,0,0,2201,4,758
경기도,부천시,상동,상동제2투,3660,2597,1043,555,606,214,165,4,0,1,0,1,0,1,1,2591,6,1063
경기도,부천시,상동,상동제3투,2801,1859,767,390,449,103,131,2,0,1,1,2,3,1,4,1854,5,942
경기도,부천시,상동,상동제4투,3389,2231,907,487,541,117,154,2,0,3,1,0,1,1,0,2214,17,1158
경기도,부천시,상1동,관내사전투표,5310,5310,2873,697,980,373,346,11,1,3,1,0,1,3,2,5291,19,0
경기도,부천시,상1동,합계,19659,16292,8078,2468,3488,1093,1055,24,1,8,6,2,2,7,3,16235,57,3367
경기도,부천시,상1동,상1동제1투,3517,2777,1325,434,637,188,176,2,0,2,1,0,1,1,1,2768,9,740
경기도,부천시,상1동,상1동제2투,4111,2993,1412,498,651,210,207,2,0,1,0,1,0,0,0,2982,11,1118
경기도,부천시,상1동,상1동제3투,3152,2495,1178,416,574,144,165,4,0,0,3,0,0,1,0,2485,10,657
경기도,부천시,상1동,상1동제4투,3569,2717,1290,423,646,178,161,5,0,2,1,1,0,2,0,2709,8,852
경기도,부천시,중4동,합계,16484,13413,6234,2328,2914,909,936,9,3,6,5,10,3,4,7,13368,45,3071
경기도,부천시,중4동,관내사전투표,4353,4353,2218,686,839,267,306,2,3,1,1,5,2,1,3,4334,19,0
경기도,부천시,중4동,중4동제1투,3774,3005,1172,724,701,211,181,5,0,3,1,0,0,0,0,2998,7,769
경기도,부천시,중4동,중4동제2투,2565,1650,798,271,365,119,85,1,0,1,0,1,1,1,2,1645,5,915
경기도,부천시,중4동,중4동제3투,3105,2339,1122,329,532,155,185,0,0,1,1,3,0,1,1,2330,9,766
경기도,부천시,중4동,중4동제4투,2687,2066,924,318,477,157,179,1,0,0,2,1,0,1,1,2061,5,621
경기도,부천시,약대동,합계,15124,11728,5088,2134,2809,818,795,16,0,8,5,8,2,6,7,11696,32,3396
경기도,부천시,약대동,관내사전투표,3637,3637,1728,600,796,220,267,5,0,1,0,4,0,2,2,3625,12,0
경기도,부천시,약대동,약대동제1투,3939,2628,1065,506,660,171,200,7,0,2,3,1,0,2,3,2620,8,1311
경기도,부천시,약대동,약대동제2투,3833,2755,1142,525,719,186,163,1,0,5,1,2,1,2,2,2749,6,1078
경기도,부천시,약대동,약대동제3투,3715,2708,1153,503,634,241,165,3,0,0,1,1,1,0,0,2702,6,1007
경기도,부천시,중1동,합계,26480,20811,9628,3560,4783,1363,1350,22,0,14,2,23,4,7,12,20768,43,5669
경기도,부천시,중1동,관내사전투표,5302,5302,2631,797,1116,347,388,4,0,1,0,6,0,1,3,5294,8,0
경기도,부천시,중1동,중1동제1투,2870,1930,869,339,467,118,116,3,0,2,1,4,0,2,1,1922,8,940
경기도,부천시,중1동,중1동제2투,2976,2338,1072,370,585,161,144,1,0,3,0,0,0,1,0,2337,1,638
경기도,부천시,중1동,중1동제3투,4235,2569,1231,413,535,168,197,7,0,2,0,3,2,2,3,2563,6,1666
경기도,부천시,중1동,중1동제4투,1963,1635,705,370,380,89,81,2,0,0,0,2,0,0,1,1630,5,328
경기도,부천시,중1동,중1동제5투,2499,2008,807,408,505,144,129,4,0,2,0,1,2,0,1,2003,5,491
경기도,부천시,중1동,중1동제6투,2850,1947,886,333,455,132,127,1,0,2,0,4,0,1,1,1942,5,903
경기도,부천시,중1동,중1동제7투,3785,3082,1427,530,740,204,168,0,0,2,1,3,0,0,2,3077,5,703
경기도,부천시,중2동,합계,22788,17931,7289,3835,4393,1230,1069,21,3,9,4,12,2,7,9,17883,48,4857
경기도,부천시,중2동,관내사전투표,3001,3001,1397,520,643,215,200,3,1,5,0,3,0,2,2,2991,10,0
경기도,부천시,중2동,중2동제1투,3582,2497,1003,523,639,141,173,1,0,2,0,3,0,0,2,2487,10,1085
경기도,부천시,중2동,중2동제2투,2250,1793,631,458,463,148,86,2,0,0,0,1,0,0,1,1790,3,457
경기도,부천시,중2동,중2동제3투,2926,2162,891,456,532,130,138,2,1,1,1,2,1,3,1,2159,3,764
경기도,부천시,중2동,중2동제4투,4905,3803,1499,874,928,257,228,1,1,0,1,1,0,1,1,3792,11,1102
경기도,부천시,중2동,중2동제5투,3127,2385,961,469,630,172,142,7,0,0,0,0,1,0,1,2383,2,742
경기도,부천시,중2동,중2동제6투,2997,2290,907,535,558,167,102,5,0,1,2,2,0,1,1,2281,9,707
경기도,부천시,중3동,합계,19988,15843,7018,2977,3689,1044,1021,17,1,4,6,8,3,5,10,15803,40,4145
경기도,부천시,중3동,관내사전투표,3973,3973,1864,664,862,288,275,4,0,1,1,3,1,0,2,3965,8,0
경기도,부천시,중3동,중3동제1투,3678,2650,1168,497,626,189,160,2,0,2,0,0,0,1,0,2645,5,1028
경기도,부천시,중3동,중3동제2투,3243,2553,969,638,621,162,146,7,0,0,1,0,0,1,3,2548,5,690
경기도,부천시,중3동,중3동제3투,3044,2200,1021,396,484,140,143,0,0,0,1,4,1,3,3,2196,4,844
경기도,부천시,중3동,중3동제4투,3597,2873,1359,451,688,170,192,4,0,0,1,0,0,0,0,2865,8,724
경기도,부천시,중3동,중3동제5투,2453,1594,637,331,408,95,105,0,1,1,2,1,1,0,2,1584,10,859
경기도,부천시,상2동,합계,21454,17706,8634,2617,3946,1275,1148,21,1,5,1,8,3,2,5,17666,40,3748
경기도,부천시,상2동,관내사전투표,4846,4846,2501,665,935,360,361,7,0,1,1,2,1,0,2,4836,10,0
경기도,부천시,상2동,상2동제1투,1973,1506,665,269,367,103,95,5,0,1,0,0,0,0,0,1505,1,467
경기도,부천시,상2동,상2동제2투,3688,2869,1344,485,650,193,188,2,0,0,0,1,1,0,0,2864,5,819
경기도,부천시,상2동,상2동제3투,3983,2935,1312,475,728,236,176,2,0,1,0,1,0,2,1,2934,1,1048
경기도,부천시,상2동,상2동제4투,3267,2662,1226,391,658,197,167,3,1,2,0,3,0,0,1,2649,13,605
경기도,부천시,상2동,상2동제5투,3697,2888,1586,332,608,186,161,2,0,0,0,1,1,0,1,2878,10,809
경기도,부천시,상3동,관내사전투표,5483,5483,2745,769,1143,417,370,8,0,3,1,3,0,2,7,5468,15,0
경기도,부천시,상3동,합계,23795,19929,9033,3397,4588,1561,1240,28,1,6,4,8,4,2,13,19885,44,3866
경기도,부천시,상3동,상3동제1투,3828,2815,1235,492,678,231,163,6,0,0,0,2,0,0,0,2807,8,1013
경기도,부천시,상3동,상3동제2투,3792,3030,1436,460,688,220,213,2,0,0,1,2,1,0,0,3023,7,762
경기도,부천시,상3동,상3동제3투,3563,2793,1118,555,695,253,159,3,0,1,0,0,2,0,2,2788,5,770
경기도,부천시,상3동,상3동제4투,3527,2899,1149,644,679,252,163,5,0,2,0,1,0,0,3,2898,1,628
경기도,부천시,상3동,상3동제5투,3602,2909,1350,477,705,188,172,4,1,0,2,0,1,0,1,2901,8,693
경기도,부천시,심곡본동,관내사전투표,2528,2528,1102,575,537,121,172,4,0,6,0,0,0,1,2,2520,8,0
경기도,부천시,심곡본동,합계,14372,10059,4000,2322,2507,497,642,9,2,15,2,5,1,5,9,10016,43,4313
경기도,부천시,심곡본동,심곡본동제1투,2753,1642,615,372,456,71,115,2,0,2,1,1,0,1,3,1639,3,1111
경기도,부천시,심곡본동,심곡본동제2투,3063,1830,688,457,480,79,96,3,1,4,0,2,0,1,2,1813,17,1233
경기도,부천시,심곡본동,심곡본동제3투,2935,1776,704,388,451,98,123,0,0,2,0,0,0,1,1,1768,8,1159
경기도,부천시,심곡본동,심곡본동제4투,3093,2283,891,530,583,128,136,0,1,1,1,2,1,1,1,2276,7,810
경기도,부천시,심곡본1동,합계,15562,10795,4445,2348,2632,556,694,30,1,13,1,3,3,5,12,10743,52,4767
경기도,부천시,심곡본1동,관내사전투표,3193,3193,1451,654,693,148,218,4,0,1,0,1,1,1,5,3177,16,0
경기도,부천시,심곡본1동,심곡본1동제1투,3609,2043,808,488,529,75,106,7,1,7,0,1,2,3,4,2031,12,1566
경기도,부천시,심곡본1동,심곡본1동제2투,3178,2162,864,482,542,127,126,9,0,0,0,1,0,0,0,2151,11,1016
경기도,부천시,심곡본1동,심곡본1동제3투,3246,1966,774,422,487,118,146,5,0,4,0,0,0,1,1,1958,8,1280
경기도,부천시,심곡본1동,심곡본1동제4투,2336,1431,548,302,381,88,98,5,0,1,1,0,0,0,2,1426,5,905
경기도,부천시,송내1동,합계,18035,14147,6247,2732,3352,869,855,13,4,7,3,6,2,7,5,14102,45,3888
경기도,부천시,송내1동,관내사전투표,3086,3086,1516,491,685,179,195,3,1,1,0,1,1,2,2,3077,9,0
경기도,부천시,송내1동,송내1동제1투,3698,2473,1083,456,588,181,154,2,0,1,1,1,0,1,0,2468,5,1225
경기도,부천시,송내1동,송내1동제2투,2177,1579,673,324,410,62,95,3,2,0,0,0,1,1,1,1572,7,598
경기도,부천시,송내1동,송내1동제3투,2225,1800,730,360,475,113,115,1,0,2,0,0,0,1,0,1797,3,425
경기도,부천시,송내1동,송내1동제4투,3046,2431,1064,505,538,173,135,2,1,1,0,0,0,0,2,2421,10,615
경기도,부천시,송내1동,송내1동제5투,1966,1477,663,323,301,94,84,0,0,1,2,2,0,2,0,1472,5,489
경기도,부천시,송내1동,송내1동제6투,1837,1301,518,273,355,67,77,2,0,1,0,2,0,0,0,1295,6,536
경기도,부천시,송내2동,관내사전투표,3810,3810,1850,579,809,266,288,2,0,3,2,0,1,0,4,3804,6,0
경기도,부천시,송내2동,합계,21430,16555,7124,3139,3865,1144,1169,18,0,9,6,9,5,2,15,16505,50,4875
경기도,부천시,송내2동,송내2동제1투,3124,2081,857,430,529,110,142,2,0,1,0,0,0,0,0,2071,10,1043
경기도,부천시,송내2동,송내2동제2투,2926,1880,709,431,482,111,132,1,0,0,0,4,1,1,1,1873,7,1046
경기도,부천시,송내2동,송내2동제3투,3338,2519,1106,480,558,180,173,5,0,2,2,2,2,0,2,2512,7,819
경기도,부천시,송내2동,송내2동제4투,3589,2628,1085,508,642,179,195,4,0,3,2,2,0,1,2,2623,5,961
경기도,부천시,송내2동,송내2동제5투,2616,1892,744,429,439,114,146,3,0,0,0,1,1,0,3,1880,12,724
경기도,부천시,송내2동,송내2동제6투,2027,1745,773,282,406,184,93,1,0,0,0,0,0,0,3,1742,3,282
경기도,부천시,소사본동,관내사전투표,3185,3185,1344,728,712,157,214,8,1,6,2,1,0,1,0,3174,11,0
경기도,부천시,소사본동,합계,19236,13484,5304,3188,3336,754,797,26,3,11,4,4,5,6,7,13445,39,5752
경기도,부천시,소사본동,소사본동제1투,3026,1903,650,491,550,96,106,0,0,1,0,1,1,2,0,1898,5,1123
경기도,부천시,소사본동,소사본동제2투,2353,1415,535,354,362,72,80,3,1,0,1,0,2,0,2,1412,3,938
경기도,부천시,소사본동,소사본동제3투,2960,1912,718,431,510,108,119,7,1,1,0,1,2,1,2,1901,11,1048
경기도,부천시,소사본동,소사본동제4투,4037,2797,1151,618,654,204,158,2,0,3,0,0,0,1,2,2793,4,1240
경기도,부천시,소사본동,소사본동제5투,3675,2272,906,566,548,117,120,6,0,0,1,1,0,1,1,2267,5,1403
경기도,부천시,소사본3동,합계,24893,19564,8240,4050,4663,1225,1238,25,1,16,3,19,3,8,13,19504,60,5329
경기도,부천시,소사본3동,관내사전투표,4506,4506,2061,869,965,279,293,1,0,5,1,8,2,5,1,4490,16,0
경기도,부천시,소사본3동,소사본3동제1투,2402,1670,601,424,442,96,91,1,1,1,0,1,0,1,3,1662,8,732
경기도,부천시,소사본3동,소사본3동제2투,2587,1817,725,386,453,130,111,1,0,2,1,0,0,1,1,1811,6,770
경기도,부천시,소사본3동,소사본3동제3투,3677,2685,1204,528,592,181,157,4,0,1,0,6,0,0,3,2676,9,992
경기도,부천시,소사본3동,소사본3동제4투,2458,1490,552,357,394,83,94,2,0,1,0,0,0,0,3,1486,4,968
경기도,부천시,소사본3동,소사본3동제5투,2796,2250,979,451,527,130,146,7,0,3,0,1,0,0,0,2244,6,546
경기도,부천시,소사본3동,소사본3동제6투,2797,2228,796,579,544,157,139,2,0,2,1,2,1,0,1,2224,4,569
경기도,부천시,소사본3동,소사본3동제7투,3670,2918,1322,456,746,169,207,7,0,1,0,1,0,1,1,2911,7,752
경기도,부천시,괴안동,합계,16697,12767,5460,2538,2959,807,896,8,1,11,1,15,3,10,8,12717,50,3930
경기도,부천시,괴안동,관내사전투표,3691,3691,1699,670,781,229,284,4,0,4,1,3,2,3,1,3681,10,0
경기도,부천시,괴안동,괴안동제1투,2619,1603,633,359,400,99,98,1,0,1,0,4,0,1,1,1597,6,1016
경기도,부천시,괴안동,괴안동제2투,2555,1713,677,393,412,96,117,2,1,1,0,2,0,2,1,1704,9,842
경기도,부천시,괴안동,괴안동제3투,2671,1806,772,362,419,110,129,0,0,2,0,2,0,0,1,1797,9,865
경기도,부천시,괴안동,괴안동제4투,2148,1503,650,292,341,108,95,0,0,2,0,4,1,4,1,1498,5,645
경기도,부천시,괴안동,괴안동제5투,3013,2451,1029,462,606,165,173,1,0,1,0,0,0,0,3,2440,11,562
경기도,부천시,범박동,합계,24062,19999,9394,3519,4495,1243,1232,20,4,15,2,10,6,5,13,19958,41,4063
경기도,부천시,범박동,관내사전투표,5220,5220,2658,816,1042,349,325,5,1,4,0,3,1,2,2,5208,12,0
경기도,부천시,범박동,범박동제1투,3465,2603,1233,410,625,162,157,3,0,4,1,0,1,1,1,2598,5,862
경기도,부천시,범박동,범박동제2투,2647,2217,971,450,537,123,127,1,1,0,0,2,0,0,1,2213,4,430
경기도,부천시,범박동,범박동제3투,513,324,111,90,84,20,17,0,1,0,0,0,1,0,0,324,0,189
경기도,부천시,범박동,범박동제4투,2603,2073,928,422,455,129,119,9,0,2,0,0,1,1,4,2070,3,530
경기도,부천시,범박동,범박동제5투,2832,2243,942,503,524,132,131,0,0,2,0,1,0,0,4,2239,4,589
경기도,부천시,범박동,범박동제6투,4371,3475,1793,413,780,223,248,1,0,1,1,4,0,0,1,3465,10,896
경기도,부천시,범박동,범박동제7투,2411,1844,758,415,448,105,108,1,1,2,0,0,2,1,0,1841,3,567
경기도,부천시,역곡3동,합계,19216,14342,6281,2861,3320,844,928,28,2,5,3,13,4,4,7,14300,42,4874
경기도,부천시,역곡3동,관내사전투표,3542,3542,1693,631,737,200,258,7,0,0,1,5,1,1,0,3534,8,0
경기도,부천시,역곡3동,역곡3동제1투,2585,1627,668,387,390,79,94,1,0,3,0,0,0,0,1,1623,4,958
경기도,부천시,역곡3동,역곡3동제2투,2944,2048,894,374,480,141,137,7,0,0,0,2,2,0,4,2041,7,896
경기도,부천시,역곡3동,역곡3동제3투,2612,1853,778,363,470,114,114,2,2,1,0,2,1,2,0,1849,4,759
경기도,부천시,역곡3동,역곡3동제4투,2962,2096,842,452,517,127,139,4,0,0,0,3,0,1,1,2086,10,866
경기도,부천시,역곡3동,역곡3동제5투,1628,1111,458,244,268,62,66,6,0,0,1,1,0,0,0,1106,5,517
경기도,부천시,역곡3동,역곡3동제6투,2943,2065,948,410,458,121,120,1,0,1,1,0,0,0,1,2061,4,878
경기도,부천시,성곡동,합계,33793,24975,10820,4762,5970,1473,1721,35,7,24,2,20,9,8,21,24872,103,8818
경기도,부천시,성곡동,관내사전투표,5909,5908,2935,938,1209,334,437,11,0,5,2,7,1,1,3,5883,25,1
경기도,부천시,성곡동,성곡동제1투,3095,1867,736,378,512,108,122,2,1,1,0,0,0,0,2,1862,5,1228
경기도,부천시,성곡동,성곡동제2투,3209,2137,919,400,508,119,164,2,1,5,0,0,0,2,3,2123,14,1072
경기도,부천시,성곡동,성곡동제3투,3029,1975,805,380,497,130,135,3,1,1,0,3,3,0,5,1963,12,1054
경기도,부천시,성곡동,성곡동제4투,2800,1801,733,359,441,106,140,2,1,4,0,0,3,2,2,1793,8,999
경기도,부천시,성곡동,성곡동제5투,2354,1605,675,301,411,98,102,4,0,1,0,1,0,0,3,1596,9,749
경기도,부천시,성곡동,성곡동제6투,2887,1892,728,451,491,87,114,3,2,2,0,3,0,0,3,1884,8,995
경기도,부천시,성곡동,성곡동제7투,1944,1439,599,361,307,86,78,3,1,0,0,2,0,0,0,1437,2,505
경기도,부천시,성곡동,성곡동제8투,2668,1746,707,326,466,95,134,2,0,3,0,1,1,2,0,1737,9,922
경기도,부천시,성곡동,성곡동제9투,2383,1816,741,393,457,116,99,1,0,2,0,0,1,0,0,1810,6,567
경기도,부천시,성곡동,성곡동제10투,3515,2789,1242,475,671,194,196,2,0,0,0,3,0,1,0,2784,5,726
경기도,부천시,고강본동,관내사전투표,3254,3254,1466,587,769,190,215,3,3,6,0,5,0,0,1,3245,9,0
경기도,부천시,고강본동,합계,23264,15976,6658,3094,4068,911,1115,17,6,17,2,19,1,2,18,15928,48,7288
경기도,부천시,고강본동,고강본동제1투,3728,2236,934,438,559,125,166,3,2,2,1,0,0,0,1,2231,5,1492
경기도,부천시,고강본동,고강본동제2투,3132,1889,740,362,511,116,135,1,0,3,0,7,0,1,5,1881,8,1243
경기도,부천시,고강본동,고강본동제3투,3480,2255,887,445,610,130,158,4,1,0,1,1,1,1,5,2244,11,1225
경기도,부천시,고강본동,고강본동제4투,3817,2521,1063,514,617,140,177,1,0,1,0,2,0,0,3,2518,3,1296
경기도,부천시,고강본동,고강본동제5투,3646,2337,1006,420,590,129,170,3,0,3,0,4,0,0,3,2328,9,1309
경기도,부천시,고강본동,고강본동제6투,2207,1484,562,328,412,81,94,2,0,2,0,0,0,0,0,1481,3,723
경기도,부천시,고강1동,관내사전투표,2775,2775,1338,439,621,154,198,2,1,2,0,6,2,0,2,2765,10,0
경기도,부천시,고강1동,합계,13318,9543,4079,1814,2335,549,675,15,1,11,2,13,3,1,9,9507,36,3775
경기도,부천시,고강1동,고강1동제1투,2295,1311,505,295,342,67,91,3,0,1,0,0,0,0,1,1305,6,984
경기도,부천시,고강1동,고강1동제2투,2900,1799,785,325,443,109,127,1,0,2,1,1,0,0,2,1796,3,1101
경기도,부천시,고강1동,고강1동제3투,2482,1753,687,367,441,112,125,4,0,3,0,2,1,1,1,1744,9,729
경기도,부천시,고강1동,고강1동제4투,2866,1905,764,388,488,107,134,5,0,3,1,4,0,0,3,1897,8,961
경기도,부천시,오정동,합계,18298,13473,5679,2615,3279,813,972,15,1,9,2,12,1,7,5,13410,63,4825
경기도,부천시,오정동,관내사전투표,3172,3172,1516,511,687,180,251,6,0,4,1,6,0,0,1,3163,9,0
경기도,부천시,오정동,오정동제1투,3874,2419,1006,472,602,154,168,1,0,1,1,1,1,0,1,2408,11,1455
경기도,부천시,오정동,오정동제2투,4406,3317,1412,615,807,233,225,4,0,4,0,0,0,2,2,3304,13,1089
경기도,부천시,오정동,오정동제3투,3251,2181,853,493,537,121,157,3,1,0,0,0,0,3,0,2168,13,1070
경기도,부천시,오정동,오정동제4투,3271,2155,837,439,582,114,162,0,0,0,0,5,0,2,1,2142,13,1116
경기도,부천시,오정동,오정동제5투,324,229,55,85,64,11,9,1,0,0,0,0,0,0,0,225,4,95
경기도,부천시,원종1동,합계,18636,13133,5619,2565,3176,760,891,24,3,12,2,12,5,4,16,13089,44,5503
경기도,부천시,원종1동,관내사전투표,3099,3099,1535,494,652,170,212,9,0,4,1,2,0,3,6,3088,11,0
경기도,부천시,원종1동,원종1동제1투,3089,1905,754,379,512,101,146,3,1,0,0,2,2,0,1,1901,4,1184
경기도,부천시,원종1동,원종1동제2투,3411,2445,1004,512,598,155,151,0,0,1,0,5,1,1,4,2432,13,966
경기도,부천시,원종1동,원종1동제3투,2937,1900,786,381,457,109,148,3,2,4,1,2,1,0,0,1894,6,1037
경기도,부천시,원종1동,원종1동제4투,3094,1967,780,422,498,116,136,5,0,1,0,1,0,0,4,1963,4,1127
경기도,부천시,원종1동,원종1동제5투,3006,1817,760,377,459,109,98,4,0,2,0,0,1,0,1,1811,6,1189
경기도,부천시,원종2동,합계,18215,12802,5508,2248,3226,754,943,18,4,8,5,14,2,5,12,12747,55,5413
경기도,부천시,원종2동,관내사전투표,2373,2373,1173,352,484,124,205,3,3,2,1,5,1,2,4,2359,14,0
경기도,부천시,원종2동,원종2동제1투,3533,2205,871,424,611,118,162,2,0,1,2,3,0,0,1,2195,10,1328
경기도,부천시,원종2동,원종2동제2투,3468,2369,993,396,596,177,188,6,0,1,0,2,0,0,4,2363,6,1099
경기도,부천시,원종2동,원종2동제3투,2471,1715,724,308,435,119,118,4,0,1,0,0,0,1,0,1710,5,756
경기도,부천시,원종2동,원종2동제4투,2938,1823,786,338,463,105,115,3,0,0,0,3,0,1,1,1815,8,1115
경기도,부천시,원종2동,원종2동제5투,3432,2317,961,430,637,111,155,0,1,3,2,1,1,1,2,2305,12,1115
경기도,부천시,신흥동,합계,15010,9946,4099,1963,2573,546,679,8,1,10,2,7,1,3,9,9901,45,5064
경기도,부천시,신흥동,관내사전투표,1482,1482,727,248,307,71,110,3,1,1,1,2,0,1,2,1474,8,0
경기도,부천시,신흥동,신흥동제1투,2446,1340,528,290,352,82,78,0,0,1,0,0,1,0,1,1333,7,1106
경기도,부천시,신흥동,신흥동제2투,4504,3092,1316,542,809,169,235,3,0,2,1,0,0,1,3,3081,11,1412
경기도,부천시,신흥동,신흥동제3투,2670,1654,644,320,476,89,104,1,0,5,0,3,0,0,3,1645,9,1016
경기도,부천시,신흥동,신흥동제4투,1983,1160,429,283,325,60,56,1,0,0,0,0,0,1,0,1155,5,823
경기도,부천시,신흥동,신흥동제5투,1925,1218,455,280,304,75,96,0,0,1,0,2,0,0,0,1213,5,707
경기도,부천시,잘못 투입·구분된 투표지,,0,2,1,0,1,0,0,0,0,0,0,0,0,0,0,2,0,-2
경기도,광명시,합계,,271716,218795,97959,39081,51958,13835,14345,294,32,139,49,142,45,66,162,218107,688,52921
경기도,광명시,거소·선상투표,,441,418,143,78,126,24,16,1,1,2,1,0,0,3,2,397,21,23
경기도,광명시,관외사전투표,,20650,20648,10061,2659,4635,1502,1566,30,5,18,3,19,4,9,35,20546,102,2
경기도,광명시,재외투표,,1827,1417,843,106,211,64,178,3,0,2,1,0,1,0,1,1410,7,410
경기도,광명시,광명1동,합계,10806,7584,3236,1543,1820,451,465,8,2,6,3,7,1,2,7,7551,33,3222
경기도,광명시,광명1동,관내사전투표,1662,1662,768,313,373,87,106,2,1,1,0,1,0,1,1,1654,8,0
경기도,광명시,광명1동,광명1동제1투,3271,2075,850,401,534,134,131,4,0,1,2,3,0,0,2,2062,13,1196
경기도,광명시,광명1동,광명1동제2투,2905,1870,750,434,467,105,103,1,0,2,0,1,0,0,1,1864,6,1035
경기도,광명시,광명1동,광명1동제3투,2968,1977,868,395,446,125,125,1,1,2,1,2,1,1,3,1971,6,991
경기도,광명시,광명2동,합계,9140,6549,2693,1367,1686,374,385,1,3,6,1,3,2,0,6,6527,22,2591
경기도,광명시,광명2동,관내사전투표,1741,1741,784,331,407,105,104,1,1,0,0,1,0,0,2,1736,5,0
경기도,광명시,광명2동,광명2동제1투,2513,1516,572,349,409,89,82,0,0,4,0,0,1,0,1,1507,9,997
경기도,광명시,광명2동,광명2동제2투,2706,1781,711,378,482,98,101,0,0,1,0,2,0,0,2,1775,6,925
경기도,광명시,광명2동,광명2동제3투,2180,1511,626,309,388,82,98,0,2,1,1,0,1,0,1,1509,2,669
경기도,광명시,광명3동,합계,8713,6414,2629,1388,1655,283,398,13,2,2,1,3,3,2,6,6385,29,2299
경기도,광명시,광명3동,관내사전투표,1872,1872,815,395,431,89,124,3,1,1,0,0,1,2,3,1865,7,0
경기도,광명시,광명3동,광명3동제1투,2475,1531,586,362,400,60,106,5,1,0,0,0,2,0,3,1525,6,944
경기도,광명시,광명3동,광명3동제2투,1863,1227,475,258,352,46,83,3,0,1,0,2,0,0,0,1220,7,636
경기도,광명시,광명3동,광명3동제3투,2503,1784,753,373,472,88,85,2,0,0,1,1,0,0,0,1775,9,719
경기도,광명시,광명4동,합계,12842,9888,4126,2024,2516,544,585,22,1,9,3,8,2,3,7,9850,38,2954
경기도,광명시,광명4동,관내사전투표,2842,2842,1324,491,652,152,190,11,0,3,0,1,1,0,4,2829,13,0
경기도,광명시,광명4동,광명4동제1투,2878,1781,725,376,442,99,118,4,1,2,2,1,1,0,1,1772,9,1097
경기도,광명시,광명4동,광명4동제2투,2675,1806,743,362,483,102,102,2,0,0,0,1,0,0,1,1796,10,869
경기도,광명시,광명4동,광명4동제3투,4447,3459,1334,795,939,191,175,5,0,4,1,5,0,3,1,3453,6,988
경기도,광명시,광명5동,합계,11806,8922,3758,1807,2214,497,576,8,0,7,7,5,1,5,7,8892,30,2884
경기도,광명시,광명5동,관내사전투표,2388,2388,1122,431,515,127,172,2,0,3,3,1,1,3,0,2380,8,0
경기도,광명시,광명5동,광명5동제1투,3229,2078,831,453,555,104,114,2,0,2,2,3,0,1,3,2070,8,1151
경기도,광명시,광명5동,광명5동제2투,3254,2492,1050,483,627,156,163,0,0,1,2,1,0,0,2,2485,7,762
경기도,광명시,광명5동,광명5동제3투,2935,1964,755,440,517,110,127,4,0,1,0,0,0,1,2,1957,7,971
경기도,광명시,광명6동,합계,11536,8838,3674,1818,2267,465,547,15,2,4,1,5,3,1,9,8811,27,2698
경기도,광명시,광명6동,관내사전투표,2062,2062,987,377,456,101,125,6,0,0,0,1,1,0,2,2056,6,0
경기도,광명시,광명6동,광명6동제1투,2545,1946,830,320,531,138,120,0,0,1,0,0,1,0,0,1941,5,599
경기도,광명시,광명6동,광명6동제2투,3867,2716,1072,587,709,139,188,7,2,1,0,2,1,1,1,2710,6,1151
경기도,광명시,광명6동,광명6동제3투,2541,1767,694,383,496,76,98,1,0,2,1,2,0,0,5,1758,9,774
경기도,광명시,광명6동,광명6동제4투,521,347,91,151,75,11,16,1,0,0,0,0,0,0,1,346,1,174
경기도,광명시,광명7동,합계,16362,12116,4952,2426,3192,689,762,20,3,6,2,8,3,3,13,12079,37,4246
경기도,광명시,광명7동,관내사전투표,3128,3128,1389,578,731,190,216,2,3,2,0,2,1,0,4,3118,10,0
경기도,광명시,광명7동,광명7동제1투,2186,1411,555,308,383,79,80,1,0,0,0,1,0,0,2,1409,2,775
경기도,광명시,광명7동,광명7동제2투,1982,1235,466,271,348,68,68,8,0,0,0,0,0,1,1,1231,4,747
경기도,광명시,광명7동,광명7동제3투,2037,1388,577,277,357,85,79,2,0,2,0,1,1,0,2,1383,5,649
경기도,광명시,광명7동,광명7동제4투,1910,1207,463,272,337,54,70,0,0,0,1,0,0,1,3,1201,6,703
경기도,광명시,광명7동,광명7동제5투,2321,1719,661,340,479,119,108,4,0,1,1,3,0,0,0,1716,3,602
경기도,광명시,광명7동,광명7동제6투,2798,2028,841,380,557,94,141,3,0,1,0,1,1,1,1,2021,7,770
경기도,광명시,철산1동,합계,9870,8136,3793,1351,1783,605,545,10,1,4,3,5,0,5,3,8108,28,1734
경기도,광명시,철산1동,관내사전투표,2644,2644,1320,390,533,193,187,4,1,3,1,2,0,2,0,2636,8,0
경기도,광명시,철산1동,철산1동제1투,2787,2164,1012,342,503,152,140,2,0,1,0,2,0,1,1,2156,8,623
경기도,광명시,철산1동,철산1동제2투,1513,1041,435,241,227,70,58,1,0,0,1,0,0,2,1,1036,5,472
경기도,광명시,철산1동,철산1동제3투,2926,2287,1026,378,520,190,160,3,0,0,1,1,0,0,1,2280,7,639
경기도,광명시,철산2동,관내사전투표,2344,2344,1024,435,544,155,170,3,0,1,4,4,1,1,0,2342,2,0
경기도,광명시,철산2동,합계,12322,9192,3971,1754,2187,583,630,13,0,6,5,9,2,1,4,9165,27,3130
경기도,광명시,철산2동,철산2동제1투,3177,2448,1117,449,533,158,171,3,0,4,1,2,0,0,3,2441,7,729
경기도,광명시,철산2동,철산2동제2투,2403,1641,692,306,398,121,117,3,0,0,0,1,0,0,0,1638,3,762
경기도,광명시,철산2동,철산2동제3투,1872,1163,484,248,298,56,67,2,0,0,0,0,1,0,0,1156,7,709
경기도,광명시,철산2동,철산2동제4투,2526,1596,654,316,414,93,105,2,0,1,0,2,0,0,1,1588,8,930
경기도,광명시,철산3동,관내사전투표,5200,5200,2551,766,1100,413,344,5,0,4,1,1,0,2,1,5188,12,0
경기도,광명시,철산3동,합계,26746,22786,10160,4089,5315,1664,1443,28,3,12,2,13,1,6,5,22741,45,3960
경기도,광명시,철산3동,철산3동제1투,2301,1952,834,338,490,147,134,1,0,1,0,3,0,1,0,1949,3,349
경기도,광명시,철산3동,철산3동제2투,2273,1887,792,402,429,135,118,1,1,0,0,1,0,1,1,1881,6,386
경기도,광명시,철산3동,철산3동제3투,1847,1321,569,267,308,65,96,4,1,2,0,3,1,1,0,1317,4,526
경기도,광명시,철산3동,철산3동제4투,3167,2394,1052,478,555,160,138,4,0,1,0,0,0,0,0,2388,6,773
경기도,광명시,철산3동,철산3동제5투,1993,1535,686,300,365,85,88,2,1,2,0,0,0,0,1,1530,5,458
경기도,광명시,철산3동,철산3동제6투,3324,2842,1189,551,697,198,190,7,0,1,1,1,0,1,2,2838,4,482
경기도,광명시,철산3동,철산3동제7투,1833,1567,719,236,372,132,104,0,0,1,0,1,0,0,0,1565,2,266
경기도,광명시,철산3동,철산3동제8투,2323,2005,894,371,482,151,105,1,0,0,0,1,0,0,0,2005,0,318
경기도,광명시,철산3동,철산3동제9투,2485,2083,874,380,517,178,126,3,0,0,0,2,0,0,0,2080,3,402
경기도,광명시,철산4동,합계,11168,9054,4274,1484,2079,552,608,9,1,4,0,6,4,1,7,9029,25,2114
경기도,광명시,철산4동,관내사전투표,2445,2445,1223,362,520,144,184,0,0,0,0,4,3,0,1,2441,4,0
경기도,광명시,철산4동,철산4동제1투,2388,1453,572,318,373,82,93,2,1,2,0,0,0,0,1,1444,9,935
경기도,광명시,철산4동,철산4동제2투,1729,1376,699,191,304,88,86,2,0,0,0,0,1,1,2,1374,2,353
경기도,광명시,철산4동,철산4동제3투,2323,1943,866,362,453,116,134,3,0,2,0,1,0,0,2,1939,4,380
경기도,광명시,철산4동,철산4동제4투,2283,1837,914,251,429,122,111,2,0,0,0,1,0,0,1,1831,6,446
경기도,광명시,하안1동,합계,19472,15952,7295,2812,3770,1002,1000,19,1,1,3,4,6,1,5,15919,33,3520
경기도,광명시,하안1동,관내사전투표,3231,3231,1662,496,666,206,195,1,0,0,1,0,0,0,0,3227,4,0
경기도,광명시,하안1동,하안1동제1투,2197,1614,694,309,407,99,97,4,0,0,1,0,0,0,1,1612,2,583
경기도,광명시,하안1동,하안1동제2투,2843,2240,1001,406,551,125,138,4,0,0,0,3,2,1,1,2232,8,603
경기도,광명시,하안1동,하안1동제3투,3415,2237,848,540,584,122,123,5,0,1,0,1,3,0,1,2228,9,1178
경기도,광명시,하안1동,하안1동제4투,2684,2290,1046,397,557,141,141,2,0,0,0,0,0,0,1,2285,5,394
경기도,광명시,하안1동,하안1동제5투,2552,2128,1033,311,476,161,145,0,1,0,0,0,0,0,1,2128,0,424
경기도,광명시,하안1동,하안1동제6투,2550,2212,1011,353,529,148,161,3,0,0,1,0,1,0,0,2207,5,338
경기도,광명시,하안2동,합계,11496,9235,4434,1418,2068,614,639,16,1,5,1,6,2,2,4,9210,25,2261
경기도,광명시,하안2동,관내사전투표,2463,2463,1287,336,502,163,162,4,1,1,0,1,0,1,0,2458,5,0
경기도,광명시,하안2동,하안2동제1투,1936,1392,609,229,352,104,89,1,0,0,1,0,1,0,2,1388,4,544
경기도,광명시,하안2동,하안2동제2투,2059,1624,766,253,354,104,135,3,0,1,0,2,0,0,0,1618,6,435
경기도,광명시,하안2동,하안2동제3투,2476,1817,854,294,414,115,130,3,0,0,0,2,0,1,0,1813,4,659
경기도,광명시,하안2동,하안2동제4투,2562,1939,918,306,446,128,123,5,0,3,0,1,1,0,2,1933,6,623
경기도,광명시,하안3동,합계,17159,13816,6507,2313,3196,861,842,12,1,12,4,7,3,6,14,13778,38,3343
경기도,광명시,하안3동,관내사전투표,3758,3758,1912,569,815,199,238,1,0,0,1,2,1,4,2,3744,14,0
경기도,광명시,하안3동,하안3동제1투,2786,2069,986,317,493,135,127,0,0,3,0,1,0,0,2,2064,5,717
경기도,광명시,하안3동,하안3동제2투,1627,1178,571,171,281,73,75,1,0,4,0,1,0,1,0,1178,0,449
경기도,광명시,하안3동,하안3동제3투,2183,1700,830,260,380,116,111,0,0,1,1,0,0,0,1,1700,0,483
경기도,광명시,하안3동,하안3동제4투,2284,1853,876,293,405,141,133,2,0,1,0,0,0,0,0,1851,2,431
경기도,광명시,하안3동,하안3동제5투,1861,1555,742,246,366,123,67,6,0,1,1,1,0,0,1,1554,1,306
경기도,광명시,하안3동,하안3동제6투,1378,862,284,244,233,39,48,0,1,0,0,1,1,0,3,854,8,516
경기도,광명시,하안3동,하안3동제7투,1282,841,306,213,223,35,43,2,0,2,1,1,1,1,5,833,8,441
경기도,광명시,하안4동,합계,10161,8628,4292,1176,1927,619,574,16,0,3,1,4,0,3,3,8618,10,1533
경기도,광명시,하안4동,관내사전투표,2661,2661,1399,318,517,222,192,7,0,0,0,1,0,1,0,2657,4,0
경기도,광명시,하안4동,하안4동제1투,2552,2027,950,308,476,148,130,7,0,2,1,1,0,1,1,2025,2,525
경기도,광명시,하안4동,하안4동제2투,2368,1895,923,269,477,103,117,1,0,1,0,2,0,0,1,1894,1,473
경기도,광명시,하안4동,하안4동제3투,2580,2045,1020,281,457,146,135,1,0,0,0,0,0,1,1,2042,3,535
경기도,광명시,소하1동,합계,22576,18501,8496,3175,4329,1185,1186,29,3,17,3,13,2,4,8,18450,51,4075
경기도,광명시,소하1동,관내사전투표,4350,4350,2158,693,917,261,293,4,2,4,1,4,1,0,1,4339,11,0
경기도,광명시,소하1동,소하1동제1투,2628,1935,884,306,477,127,132,4,0,3,0,0,0,0,0,1933,2,693
경기도,광명시,소하1동,소하1동제2투,2157,1757,783,295,420,113,129,2,0,0,0,5,0,0,0,1747,10,400
경기도,광명시,소하1동,소하1동제3투,2519,1976,925,335,444,126,130,3,1,2,0,1,0,1,1,1969,7,543
경기도,광명시,소하1동,소하1동제4투,3129,2311,1089,370,550,141,137,7,0,3,2,1,0,1,3,2304,7,818
경기도,광명시,소하1동,소하1동제5투,2725,2121,927,440,489,135,118,3,0,2,0,0,0,1,0,2115,6,604
경기도,광명시,소하1동,소하1동제6투,1973,1613,718,275,402,114,95,2,0,0,0,1,1,0,1,1609,4,360
경기도,광명시,소하1동,소하1동제7투,3095,2438,1012,461,630,168,152,4,0,3,0,1,0,1,2,2434,4,657
경기도,광명시,소하2동,합계,24629,19233,8236,3764,4584,1178,1335,17,2,12,4,16,5,9,14,19176,57,5396
경기도,광명시,소하2동,관내사전투표,4732,4732,2334,763,959,287,348,4,0,4,1,5,0,3,6,4714,18,0
경기도,광명시,소하2동,소하2동제1투,1605,1021,282,304,305,52,72,0,0,1,0,2,1,0,0,1019,2,584
경기도,광명시,소하2동,소하2동제2투,1997,1379,601,244,347,82,96,5,0,0,0,0,1,0,1,1377,2,618
경기도,광명시,소하2동,소하2동제3투,1983,1309,523,283,329,86,80,0,0,1,0,1,0,2,0,1305,4,674
경기도,광명시,소하2동,소하2동제4투,3303,2514,993,576,624,141,162,0,0,4,1,3,1,1,2,2508,6,789
경기도,광명시,소하2동,소하2동제5투,851,598,263,111,132,49,41,0,0,0,0,0,1,0,1,598,0,253
경기도,광명시,소하2동,소하2동제6투,2839,2019,817,423,498,131,133,1,0,1,2,2,0,2,0,2010,9,820
경기도,광명시,소하2동,소하2동제7투,2451,1906,830,329,481,118,141,3,0,0,0,0,0,0,1,1903,3,545
경기도,광명시,소하2동,소하2동제8투,2413,1938,851,323,467,138,147,2,1,0,0,2,0,1,1,1933,5,475
경기도,광명시,소하2동,소하2동제9투,2455,1817,742,408,442,94,115,2,1,1,0,1,1,0,2,1809,8,638
경기도,광명시,학온동,합계,1994,1468,386,529,398,79,65,4,0,1,0,1,0,0,2,1465,3,526
경기도,광명시,학온동,관내사전투표,314,314,115,93,69,19,17,0,0,0,0,0,0,0,0,313,1,0
경기도,광명시,학온동,학온동제1투,864,586,107,235,177,38,23,2,0,1,0,0,0,0,1,584,2,278
경기도,광명시,학온동,학온동제2투,816,568,164,201,152,22,25,2,0,0,0,1,0,0,1,568,0,248
경기도,광명시,잘못 투입·구분된 투표지,,0,0,0,0,0,0,0,0,0,0,0,0,0,0,0,0,0,0
경기도,평택시,합계,,379547,273677,104574,62827,64057,19321,20128,344,62,225,69,358,118,97,338,272518,1159,105870
경기도,평택시,거소·선상투표,,1269,1233,390,215,371,140,44,2,4,2,1,1,2,0,17,1189,44,36
경기도,평택시,관외사전투표,,27722,27716,12064,4458,6061,2302,2401,29,14,23,11,29,15,4,70,27481,235,6
경기도,평택시,재외투표,,1711,1295,791,93,212,42,135,4,2,0,1,1,0,1,3,1285,10,416
경기도,평택시,팽성읍,합계,23153,14395,4518,4688,3301,942,790,23,1,20,4,14,12,7,20,14340,55,8758
경기도,평택시,팽성읍,관내사전투표,3103,3103,1235,784,657,214,190,4,0,4,1,3,0,2,4,3098,5,0
경기도,평택시,팽성읍,팽성읍제1투,2861,1841,520,595,468,142,100,2,0,0,1,1,1,1,2,1833,8,1020
경기도,평택시,팽성읍,팽성읍제2투,2936,1916,661,533,418,146,136,4,1,4,0,2,2,0,1,1908,8,1020
경기도,평택시,팽성읍,팽성읍제3투,4299,1725,571,498,399,126,111,3,0,1,0,1,2,1,4,1717,8,2574
경기도,평택시,팽성읍,팽성읍제4투,1521,857,230,327,187,46,55,0,0,3,0,1,1,0,1,851,6,664
경기도,평택시,팽성읍,팽성읍제5투,1880,1265,276,562,307,65,36,3,0,3,0,2,2,2,2,1260,5,615
경기도,평택시,팽성읍,팽성읍제6투,1466,867,239,352,172,50,45,1,0,0,1,2,2,0,1,865,2,599
경기도,평택시,팽성읍,팽성읍제7투,2513,1344,367,473,347,74,61,4,0,2,0,1,2,0,4,1335,9,1169
경기도,평택시,팽성읍,팽성읍제8투,2574,1477,419,564,346,79,56,2,0,3,1,1,0,1,1,1473,4,1097
경기도,평택시,안중읍,관내사전투표,4931,4931,2307,809,980,349,445,2,1,1,0,7,0,0,4,4905,26,0
경기도,평택시,안중읍,합계,28563,20608,8787,3863,4566,1344,1871,15,3,11,2,38,7,9,23,20539,69,7955
경기도,평택시,안중읍,안중읍제1투,2468,1290,415,376,336,74,75,1,0,2,0,0,0,0,3,1282,8,1178
경기도,평택시,안중읍,안중읍제2투,3016,1693,489,549,404,104,126,1,0,1,1,4,2,4,1,1686,7,1323
경기도,평택시,안중읍,안중읍제3투,1659,1073,381,244,260,86,90,3,0,1,0,3,1,1,0,1070,3,586
경기도,평택시,안중읍,안중읍제4투,2156,1293,533,265,313,70,93,2,0,3,0,3,2,1,1,1286,7,863
경기도,평택시,안중읍,안중읍제5투,1919,1377,612,240,325,78,111,1,1,0,0,2,0,1,2,1373,4,542
경기도,평택시,안중읍,안중읍제6투,3297,1982,799,420,460,130,167,1,0,0,0,2,0,0,2,1981,1,1315
경기도,평택시,안중읍,안중읍제7투,3801,2932,1380,403,632,174,319,4,0,2,1,7,0,2,5,2929,3,869
경기도,평택시,안중읍,안중읍제8투,2399,1857,883,239,403,130,186,0,1,1,0,6,2,0,0,1851,6,542
경기도,평택시,안중읍,안중읍제9투,2917,2180,988,318,453,149,259,0,0,0,0,4,0,0,5,2176,4,737
경기도,평택시,포승읍,합계,18526,11800,4596,2701,2767,776,825,17,0,14,2,25,9,6,9,11747,53,6726
경기도,평택시,포승읍,관내사전투표,2928,2928,1348,532,602,195,217,2,0,7,0,9,2,2,3,2919,9,0
경기도,평택시,포승읍,포승읍제1투,2263,1193,394,373,280,56,85,1,0,1,0,1,0,0,0,1191,2,1070
경기도,평택시,포승읍,포승읍제2투,1228,756,210,257,193,38,41,3,0,0,1,1,1,1,1,747,9,472
경기도,평택시,포승읍,포승읍제3투,1802,1022,380,260,245,58,68,2,0,2,1,2,1,2,1,1022,0,780
경기도,평택시,포승읍,포승읍제4투,1948,1113,411,308,249,61,68,2,0,4,0,1,0,0,0,1104,9,835
경기도,평택시,포승읍,포승읍제5투,4114,2271,1024,347,551,157,168,4,0,0,0,5,3,1,1,2261,10,1843
경기도,평택시,포승읍,포승읍제6투,1892,1176,371,361,288,53,90,1,0,0,0,4,0,0,1,1169,7,716
경기도,평택시,포승읍,포승읍제7투,2351,1341,458,263,359,158,88,2,0,0,0,2,2,0,2,1334,7,1010
경기도,평택시,진위면,합계,9646,6521,2175,1813,1593,388,461,9,1,8,5,10,4,9,15,6491,30,3125
경기도,평택시,진위면,관내사전투표,1457,1457,552,367,306,76,130,3,0,2,4,2,1,3,2,1448,9,0
경기도,평택시,진위면,진위면제1투,2227,1291,317,470,346,68,70,1,0,1,0,2,3,2,4,1284,7,936
경기도,평택시,진위면,진위면제2투,1368,845,228,319,196,54,42,1,0,1,0,0,0,0,1,842,3,523
경기도,평택시,진위면,진위면제3투,2687,1743,669,385,445,110,117,1,0,3,0,1,0,0,6,1737,6,944
경기도,평택시,진위면,진위면제4투,1907,1185,409,272,300,80,102,3,1,1,1,5,0,4,2,1180,5,722
경기도,평택시,서탄면,관내사전투표,505,505,162,175,110,21,30,1,0,0,0,0,0,1,3,503,2,0
경기도,평택시,서탄면,합계,3240,2186,599,830,522,110,101,2,0,3,0,1,3,1,7,2179,7,1054
경기도,평택시,서탄면,서탄면제1투,1177,742,203,270,197,36,30,1,0,2,0,0,1,0,1,741,1,435
경기도,평택시,서탄면,서탄면제2투,1005,594,140,244,143,37,22,0,0,1,0,0,2,0,2,591,3,411
경기도,평택시,서탄면,서탄면제3투,553,345,94,141,72,16,19,0,0,0,0,1,0,0,1,344,1,208
경기도,평택시,고덕면,합계,8142,5420,1828,1512,1323,346,361,5,2,6,3,8,2,0,4,5400,20,2722
경기도,평택시,고덕면,관내사전투표,839,839,346,195,174,54,61,2,0,1,0,2,1,0,1,837,2,0
경기도,평택시,고덕면,고덕면제1투,505,274,62,113,66,19,12,0,0,0,0,0,0,0,0,272,2,231
경기도,평택시,고덕면,고덕면제2투,1692,1015,226,375,288,64,50,0,0,3,3,1,0,0,0,1010,5,677
경기도,평택시,고덕면,고덕면제3투,3803,2475,1010,505,581,155,203,1,1,2,0,5,1,0,3,2467,8,1328
경기도,평택시,고덕면,고덕면제4투,1303,817,184,324,214,54,35,2,1,0,0,0,0,0,0,814,3,486
경기도,평택시,오성면,합계,5992,4170,1232,1341,1036,246,270,3,0,3,3,7,3,3,5,4152,18,1822
경기도,평택시,오성면,관내사전투표,1296,1296,491,326,299,74,95,1,0,0,1,4,0,0,0,1291,5,0
경기도,평택시,오성면,오성면제1투,2692,1572,453,509,376,103,114,2,0,2,0,3,2,1,2,1567,5,1120
경기도,평택시,오성면,오성면제2투,1495,967,210,375,269,48,53,0,0,1,2,0,0,1,3,962,5,528
경기도,평택시,오성면,오성면제3투,509,335,78,131,92,21,8,0,0,0,0,0,1,1,0,332,3,174
경기도,평택시,현덕면,합계,4945,3362,951,1211,771,195,192,5,1,4,4,2,3,3,5,3347,15,1583
경기도,평택시,현덕면,관내사전투표,874,874,338,221,175,64,64,1,0,2,2,2,1,0,0,870,4,0
경기도,평택시,현덕면,현덕면제1투,1872,1117,302,427,248,63,65,2,0,0,1,0,0,1,2,1111,6,755
경기도,평택시,현덕면,현덕면제2투,928,588,126,256,135,33,30,1,0,1,0,0,2,1,2,587,1,340
경기도,평택시,현덕면,현덕면제3투,1271,783,185,307,213,35,33,1,1,1,1,0,0,1,1,779,4,488
경기도,평택시,중앙동,합계,32885,24190,9207,5496,5738,1817,1712,30,3,15,3,35,8,5,30,24099,91,8695
경기도,평택시,중앙동,관내사전투표,4590,4590,2020,952,886,367,322,6,0,3,1,8,2,1,6,4574,16,0
경기도,평택시,중앙동,중앙동제1투,2536,1289,445,349,312,83,91,1,0,1,1,0,2,0,0,1285,4,1247
경기도,평택시,중앙동,중앙동제2투,1613,934,305,316,194,57,56,1,0,0,0,2,0,0,0,931,3,679
경기도,평택시,중앙동,중앙동제3투,3406,2395,798,633,570,182,194,3,0,0,0,1,0,0,4,2385,10,1011
경기도,평택시,중앙동,중앙동제4투,2853,2073,597,630,537,162,128,4,0,1,0,2,0,1,1,2063,10,780
경기도,평택시,중앙동,중앙동제5투,3099,2319,947,435,566,160,183,3,1,1,0,7,0,0,5,2308,11,780
경기도,평택시,중앙동,중앙동제6투,2865,2057,855,347,527,178,134,1,0,1,0,4,0,1,1,2049,8,808
경기도,평택시,중앙동,중앙동제7투,2782,2199,885,412,555,168,166,2,1,1,1,1,1,0,1,2194,5,583
경기도,평택시,중앙동,중앙동제8투,2947,2109,852,406,543,161,135,2,0,2,0,2,1,0,1,2105,4,838
경기도,평택시,중앙동,중앙동제9투,2953,2065,809,444,495,141,148,4,1,2,0,2,1,1,6,2054,11,888
경기도,평택시,중앙동,중앙동제10투,3241,2160,694,572,553,158,155,3,0,3,0,6,1,1,5,2151,9,1081
경기도,평택시,서정동,합계,23495,14860,5121,3783,3713,992,1088,37,1,18,5,25,6,6,8,14803,57,8635
경기도,평택시,서정동,관내사전투표,3524,3524,1408,811,761,225,281,8,0,5,0,9,0,0,2,3510,14,0
경기도,평택시,서정동,서정동제1투,3994,1898,672,467,493,118,124,4,0,3,2,5,1,0,1,1890,8,2096
경기도,평택시,서정동,서정동제2투,3448,2207,759,578,532,167,147,8,1,0,0,1,1,2,3,2199,8,1241
경기도,평택시,서정동,서정동제3투,2166,1268,367,395,347,67,76,3,0,4,1,3,1,0,1,1265,3,898
경기도,평택시,서정동,서정동제4투,1861,1040,318,332,252,52,71,5,0,2,1,0,1,3,0,1037,3,821
경기도,평택시,서정동,서정동제5투,3241,1829,581,469,496,132,134,0,0,1,0,3,1,1,0,1818,11,1412
경기도,평택시,서정동,서정동제6투,2522,1386,427,355,360,98,127,6,0,3,1,1,1,0,1,1380,6,1136
경기도,평택시,서정동,서정동제7투,2739,1708,589,376,472,133,128,3,0,0,0,3,0,0,0,1704,4,1031
경기도,평택시,송탄동,합계,11118,8424,3223,1893,2003,621,618,8,1,6,0,12,5,2,8,8400,24,2694
경기도,평택시,송탄동,관내사전투표,2012,2012,877,440,400,140,141,2,1,2,0,3,0,0,1,2007,5,0
경기도,평택시,송탄동,송탄동제1투,2595,1583,494,462,395,103,111,1,0,3,0,0,1,1,2,1573,10,1012
경기도,평택시,송탄동,송탄동제2투,2989,2036,697,532,503,145,142,0,0,0,0,8,2,0,3,2032,4,953
경기도,평택시,송탄동,송탄동제3투,3522,2793,1155,459,705,233,224,5,0,1,0,1,2,1,2,2788,5,729
경기도,평택시,지산동,합계,9470,6340,2440,1426,1483,400,531,13,1,6,2,4,3,5,3,6317,23,3130
경기도,평택시,지산동,관내사전투표,2126,2126,887,430,458,134,194,3,0,3,1,3,1,1,0,2115,11,0
경기도,평택시,지산동,지산동제1투,4210,2006,675,530,513,123,145,3,0,1,1,0,1,2,3,1997,9,2204
경기도,평택시,지산동,지산동제2투,3134,2208,878,466,512,143,192,7,1,2,0,1,1,2,0,2205,3,926
경기도,평택시,송북동,합계,17350,12202,4219,3253,2948,785,889,7,4,8,2,7,4,5,16,12147,55,5148
경기도,평택시,송북동,관내사전투표,3172,3172,1238,842,663,188,211,2,2,3,1,2,0,1,6,3159,13,0
경기도,평택시,송북동,송북동제1투,2163,1224,389,343,321,69,91,2,0,1,0,0,0,1,1,1218,6,939
경기도,평택시,송북동,송북동제2투,3254,1897,566,618,460,121,112,0,1,0,1,2,1,3,3,1888,9,1357
경기도,평택시,송북동,송북동제3투,3168,2201,698,621,545,148,170,1,0,0,0,0,1,0,3,2187,14,967
경기도,평택시,송북동,송북동제4투,2585,1688,587,413,420,121,130,1,1,4,0,1,1,0,2,1681,7,897
경기도,평택시,송북동,송북동제5투,3008,2020,741,416,539,138,175,1,0,0,0,2,1,0,1,2014,6,988
경기도,평택시,신장1동,합계,5258,3122,995,845,818,246,193,3,0,5,0,1,2,1,4,3113,9,2136
경기도,평택시,신장1동,관내사전투표,1047,1047,395,273,223,89,61,1,0,2,0,1,0,0,1,1046,1,0
경기도,평택시,신장1동,신장1동제1투,2115,894,235,310,237,53,49,1,0,1,0,0,1,0,1,888,6,1221
경기도,평택시,신장1동,신장1동제2투,2096,1181,365,262,358,104,83,1,0,2,0,0,1,1,2,1179,2,915
경기도,평택시,신장2동,합계,5516,3201,878,1089,824,191,175,7,0,9,0,4,0,2,2,3181,20,2315
경기도,평택시,신장2동,관내사전투표,903,903,284,261,227,57,55,3,0,4,0,3,0,2,1,897,6,0
경기도,평택시,신장2동,신장2동제1투,2496,1117,272,441,279,61,50,4,0,1,0,1,0,0,1,1110,7,1379
경기도,평택시,신장2동,신장2동제2투,2117,1181,322,387,318,73,70,0,0,4,0,0,0,0,0,1174,7,936
경기도,평택시,신평동,합계,18417,12045,4203,3226,2838,821,832,21,4,13,3,22,8,4,7,12002,43,6372
경기도,평택시,신평동,관내사전투표,2643,2643,1037,668,555,168,190,3,2,5,0,5,3,0,2,2638,5,0
경기도,평택시,신평동,신평동제1투,2200,1269,439,356,300,84,73,3,0,3,1,4,0,0,0,1263,6,931
경기도,평택시,신평동,신평동제2투,1833,916,259,309,233,49,56,2,0,1,0,1,0,0,0,910,6,917
경기도,평택시,신평동,신평동제3투,3359,1979,577,630,493,127,122,6,1,2,0,7,2,1,2,1970,9,1380
경기도,평택시,신평동,신평동제4투,3778,2101,771,483,524,142,163,3,1,0,1,1,2,2,1,2094,7,1677
경기도,평택시,신평동,신평동제5투,1716,937,334,221,222,71,75,2,0,1,1,3,1,1,0,932,5,779
경기도,평택시,신평동,신평동제6투,580,395,99,154,97,23,19,0,0,1,0,0,0,0,0,393,2,185
경기도,평택시,신평동,신평동제7투,2308,1805,687,405,414,157,134,2,0,0,0,1,0,0,2,1802,3,503
경기도,평택시,원평동,합계,10112,7038,2537,1847,1666,458,462,8,1,6,3,8,3,4,7,7010,28,3074
경기도,평택시,원평동,관내사전투표,1950,1950,774,453,432,127,145,1,0,3,1,2,0,1,4,1943,7,0
경기도,평택시,원평동,원평동제1투,3077,1638,514,487,424,99,96,2,1,0,1,3,0,2,1,1630,8,1439
경기도,평택시,원평동,원평동제2투,2799,1914,809,391,429,130,141,2,0,2,1,2,0,0,2,1909,5,885
경기도,평택시,원평동,원평동제3투,1633,1133,339,380,266,81,56,2,0,1,0,1,1,1,0,1128,5,500
경기도,평택시,원평동,원평동제4투,653,403,101,136,115,21,24,1,0,0,0,0,2,0,0,400,3,250
경기도,평택시,통복동,합계,4441,3238,1097,981,736,194,200,5,1,1,1,2,0,0,4,3222,16,1203
경기도,평택시,통복동,관내사전투표,1304,1304,541,288,284,72,104,3,0,1,0,1,0,0,2,1296,8,0
경기도,평택시,통복동,통복동제1투,1871,1193,366,372,295,88,63,1,1,0,0,1,0,0,2,1189,4,678
경기도,평택시,통복동,통복동제2투,1266,741,190,321,157,34,33,1,0,0,1,0,0,0,0,737,4,525
경기도,평택시,비전1동,합계,32563,23484,9685,4543,5554,1710,1814,28,6,14,4,28,4,3,21,23414,70,9079
경기도,평택시,비전1동,관내사전투표,3544,3544,1607,655,697,235,317,10,1,1,1,8,0,0,3,3535,9,0
경기도,평택시,비전1동,비전1동제1투,3023,1915,680,496,465,141,120,1,1,2,0,0,1,0,1,1908,7,1108
경기도,평택시,비전1동,비전1동제2투,1592,935,296,331,198,52,52,0,0,1,0,1,0,0,0,931,4,657
경기도,평택시,비전1동,비전1동제3투,2854,2134,764,420,603,185,140,5,0,2,1,1,1,0,1,2123,11,720
경기도,평택시,비전1동,비전1동제4투,1537,1166,394,317,290,77,75,4,0,0,1,1,0,0,1,1160,6,371
경기도,평택시,비전1동,비전1동제5투,1251,856,232,315,196,55,52,0,0,1,0,1,1,0,0,853,3,395
경기도,평택시,비전1동,비전1동제6투,3917,2462,894,551,640,176,179,2,0,2,0,8,0,1,2,2455,7,1455
경기도,평택시,비전1동,비전1동제7투,2860,1951,834,300,493,159,155,1,0,3,0,0,0,1,3,1949,2,909
경기도,평택시,비전1동,비전1동제8투,4167,2545,1169,346,612,192,208,2,1,0,0,3,1,0,2,2536,9,1622
경기도,평택시,비전1동,비전1동제9투,3078,2212,977,355,491,151,213,3,0,2,0,5,0,1,5,2203,9,866
경기도,평택시,비전1동,비전1동제10투,3040,2386,1155,290,551,195,189,0,1,0,0,0,0,0,3,2384,2,654
경기도,평택시,비전1동,비전1동제11투,1700,1378,683,167,318,92,114,0,2,0,1,0,0,0,0,1377,1,322
경기도,평택시,비전2동,합계,42574,32464,13230,6682,7447,2518,2346,37,5,14,7,45,7,11,31,32380,84,10110
경기도,평택시,비전2동,관내사전투표,7956,7956,3582,1410,1593,683,631,6,4,6,5,4,0,2,3,7929,27,0
경기도,평택시,비전2동,비전2동제1투,2303,1499,545,401,375,93,76,4,0,1,0,3,0,0,0,1498,1,804
경기도,평택시,비전2동,비전2동제2투,1988,1327,406,422,317,87,79,4,0,1,0,3,0,1,2,1322,5,661
경기도,평택시,비전2동,비전2동제3투,2471,1455,399,454,393,88,100,2,0,3,1,4,1,2,1,1448,7,1016
경기도,평택시,비전2동,비전2동제4투,2723,1635,611,340,430,117,132,0,0,0,0,0,1,0,3,1634,1,1088
경기도,평택시,비전2동,비전2동제5투,2883,1858,784,341,425,135,149,4,0,0,1,7,0,2,3,1851,7,1025
경기도,평택시,비전2동,비전2동제6투,2111,1580,647,337,363,109,111,3,0,0,0,1,0,3,2,1576,4,531
경기도,평택시,비전2동,비전2동제7투,1886,1434,571,308,326,109,110,2,0,0,0,3,0,0,1,1430,4,452
경기도,평택시,비전2동,비전2동제8투,2825,1990,731,508,483,124,127,6,1,0,0,2,2,1,3,1988,2,835
경기도,평택시,비전2동,비전2동제9투,3910,2868,1181,582,672,211,198,2,0,2,0,7,1,0,2,2858,10,1042
경기도,평택시,비전2동,비전2동제10투,2033,1608,569,409,398,117,109,0,0,0,0,0,1,0,0,1603,5,425
경기도,평택시,비전2동,비전2동제11투,3181,2555,1028,498,608,244,159,4,0,0,0,6,1,0,0,2548,7,626
경기도,평택시,비전2동,비전2동제12투,4118,2914,1325,426,682,237,229,0,0,1,0,3,0,0,7,2910,4,1204
경기도,평택시,비전2동,비전2동제13투,2186,1785,851,246,382,164,136,0,0,0,0,2,0,0,4,1785,0,401
경기도,평택시,세교동,합계,16943,12604,4834,2772,3055,879,962,12,2,9,2,16,6,3,13,12565,39,4339
경기도,평택시,세교동,관내사전투표,3862,3861,1749,683,826,271,306,3,0,1,1,3,1,0,5,3849,12,1
경기도,평택시,세교동,세교동제1투,3449,2315,847,553,582,151,169,1,0,0,0,4,1,1,2,2311,4,1134
경기도,평택시,세교동,세교동제2투,1426,876,261,292,219,46,49,3,0,1,0,0,1,1,0,873,3,550
경기도,평택시,세교동,세교동제3투,596,398,89,167,105,23,11,0,1,2,0,0,0,0,0,398,0,198
경기도,평택시,세교동,세교동제4투,1621,949,269,314,233,56,67,1,0,2,1,1,1,0,3,948,1,672
경기도,평택시,세교동,세교동제5투,2732,1911,736,340,488,158,175,2,0,2,0,2,1,1,2,1907,4,821
경기도,평택시,세교동,세교동제6투,3257,2294,883,423,602,174,185,2,1,1,0,6,1,0,1,2279,15,963
경기도,평택시,청북읍,합계,16496,11759,4974,2266,2711,858,855,14,5,7,1,13,2,3,6,11715,44,4737
경기도,평택시,청북읍,관내사전투표,2163,2163,970,391,455,162,170,2,0,0,0,2,1,0,0,2153,10,0
경기도,평택시,청북읍,청북읍제1투,1816,963,240,420,202,48,41,2,1,1,1,1,0,0,1,958,5,853
경기도,평택시,청북읍,청북읍제2투,1603,940,246,326,245,75,40,0,0,2,0,2,1,0,0,937,3,663
경기도,평택시,청북읍,청북읍제3투,1008,666,155,291,149,34,26,0,0,2,0,0,0,1,2,660,6,342
경기도,평택시,청북읍,청북읍제4투,3095,2060,1021,202,492,147,176,6,0,2,0,6,0,0,0,2052,8,1035
경기도,평택시,청북읍,청북읍제5투,3677,2624,1264,332,622,187,204,3,2,0,0,2,0,1,1,2618,6,1053
경기도,평택시,청북읍,청북읍제6투,3134,2343,1078,304,546,205,198,1,2,0,0,0,0,1,2,2337,6,791
경기도,평택시,잘못 투입·구분된 투표지,,0,0,0,0,0,0,0,0,0,0,0,0,0,0,0,0,0,0
경기도,양주시,합계,,164908,121344,46286,29739,28469,7602,7921,164,34,97,50,105,51,56,158,120732,612,43564
경기도,양주시,거소·선상투표,,639,561,181,64,138,31,15,10,8,3,9,6,4,4,5,478,83,78
경기도,양주시,관외사전투표,,13123,13123,5800,2423,2672,992,1054,20,2,11,1,14,5,3,37,13034,89,0
경기도,양주시,재외투표,,805,638,407,44,95,21,62,6,0,0,0,0,0,0,1,636,2,167
경기도,양주시,백석읍,합계,20841,14348,4713,3961,3779,833,917,17,3,8,6,11,6,8,11,14273,75,6493
경기도,양주시,백석읍,관내사전투표,2904,2904,1113,675,678,198,211,3,1,2,1,2,0,1,2,2887,17,0
경기도,양주시,백석읍,백석읍제1투,3120,1782,556,566,444,92,99,2,0,4,0,1,2,3,1,1770,12,1338
경기도,양주시,백석읍,백석읍제2투,2752,1718,523,515,465,93,99,2,2,1,1,2,1,1,1,1706,12,1034
경기도,양주시,백석읍,백석읍제3투,1937,1183,295,463,302,52,60,2,0,0,1,0,1,0,1,1177,6,754
경기도,양주시,백석읍,백석읍제4투,3399,2250,692,606,648,135,153,2,0,0,2,0,2,0,3,2243,7,1149
경기도,양주시,백석읍,백석읍제5투,2169,1326,419,416,332,66,78,2,0,0,0,3,0,2,1,1319,7,843
경기도,양주시,백석읍,백석읍제6투,2323,1587,560,362,443,100,112,0,0,1,1,1,0,0,0,1580,7,736
경기도,양주시,백석읍,백석읍제7투,2237,1598,555,358,467,97,105,4,0,0,0,2,0,1,2,1591,7,639
경기도,양주시,은현면,관내사전투표,786,786,288,258,156,45,32,2,0,0,1,3,0,1,0,786,0,0
경기도,양주시,은현면,합계,5444,3564,968,1409,775,215,162,3,0,1,3,3,1,4,3,3547,17,1880
경기도,양주시,은현면,은현면제1투,1229,735,174,308,163,47,31,1,0,1,1,0,0,2,2,730,5,494
경기도,양주시,은현면,은현면제2투,1805,1048,276,428,226,69,45,0,0,0,0,0,0,0,0,1044,4,757
경기도,양주시,은현면,은현면제3투,843,504,124,199,123,27,26,0,0,0,1,0,0,1,0,501,3,339
경기도,양주시,은현면,은현면제4투,781,491,106,216,107,27,28,0,0,0,0,0,1,0,1,486,5,290
경기도,양주시,남면,합계,5979,3961,1155,1475,851,223,211,7,2,2,0,1,4,1,8,3940,21,2018
경기도,양주시,남면,관내사전투표,977,977,376,274,193,60,68,0,1,0,0,0,0,0,3,975,2,0
경기도,양주시,남면,남면제1투,2045,1156,313,408,272,76,68,0,1,2,0,0,3,1,1,1145,11,889
경기도,양주시,남면,남면제2투,740,460,104,209,107,18,18,1,0,0,0,0,0,0,1,458,2,280
경기도,양주시,남면,남면제3투,1543,924,249,390,188,44,44,3,0,0,0,1,0,0,1,920,4,619
경기도,양주시,남면,남면제4투,674,444,113,194,91,25,13,3,0,0,0,0,1,0,2,442,2,230
경기도,양주시,광적면,합계,9640,6504,2068,2044,1592,354,361,6,0,7,0,7,4,8,8,6459,45,3136
경기도,양주시,광적면,관내사전투표,2426,2426,835,741,555,128,129,2,0,4,0,4,1,5,3,2407,19,0
경기도,양주시,광적면,광적면제1투,3795,1984,654,554,528,112,114,3,0,1,0,0,0,0,3,1969,15,1811
경기도,양주시,광적면,광적면제2투,1955,1142,352,365,290,59,65,1,0,1,0,1,0,1,1,1136,6,813
경기도,양주시,광적면,광적면제3투,311,210,41,91,49,11,13,0,0,0,0,1,1,1,0,208,2,101
경기도,양주시,광적면,광적면제4투,1153,742,186,293,170,44,40,0,0,1,0,1,2,1,1,739,3,411
경기도,양주시,장흥면,합계,7726,5435,1632,1905,1272,282,276,12,0,4,9,5,2,1,6,5406,29,2291
경기도,양주시,장흥면,관내사전투표,1275,1275,420,396,286,98,60,4,0,0,4,1,0,0,1,1270,5,0
경기도,양주시,장흥면,장흥면제1투,2957,1836,497,710,424,73,107,3,0,1,4,1,2,0,2,1824,12,1121
경기도,양주시,장흥면,장흥면제2투,1204,809,237,279,194,48,44,2,0,1,0,0,0,0,0,805,4,395
경기도,양주시,장흥면,장흥면제3투,2290,1515,478,520,368,63,65,3,0,2,1,3,0,1,3,1507,8,775
경기도,양주시,양주1동,합계,5419,3893,1202,1247,938,221,251,6,0,6,2,2,0,1,7,3883,10,1526
경기도,양주시,양주1동,관내사전투표,1051,1051,423,234,220,74,89,1,0,3,1,1,0,0,2,1048,3,0
경기도,양주시,양주1동,양주1동제1투,1481,915,226,378,226,39,37,1,0,2,1,1,0,0,2,913,2,566
경기도,양주시,양주1동,양주1동제2투,876,617,153,240,146,35,37,2,0,1,0,0,0,0,0,614,3,259
경기도,양주시,양주1동,양주1동제3투,2011,1310,400,395,346,73,88,2,0,0,0,0,0,1,3,1308,2,701
경기도,양주시,양주2동,합계,36224,27015,11609,5521,6207,1692,1746,35,7,23,12,27,11,8,28,26926,89,9209
경기도,양주시,양주2동,관내사전투표,6054,6054,2898,1116,1205,371,420,5,3,1,0,7,1,3,6,6036,18,0
경기도,양주시,양주2동,양주2동제1투,3139,2125,827,469,524,159,132,3,0,1,0,1,2,0,2,2120,5,1014
경기도,양주시,양주2동,양주2동제2투,3354,2342,966,525,545,150,133,5,0,2,1,1,0,1,7,2336,6,1012
경기도,양주시,양주2동,양주2동제3투,3287,2323,966,521,549,131,134,1,1,1,0,5,0,1,4,2314,9,964
경기도,양주시,양주2동,양주2동제4투,2705,1955,821,444,429,112,126,1,0,1,3,5,1,1,2,1946,9,750
경기도,양주시,양주2동,양주2동제5투,3746,2776,1234,522,640,182,175,2,0,6,2,2,2,0,4,2771,5,970
경기도,양주시,양주2동,양주2동제6투,3002,2114,808,520,527,113,121,3,0,5,1,1,1,1,0,2101,13,888
경기도,양주시,양주2동,양주2동제7투,2865,2008,865,386,471,145,123,2,2,0,3,2,0,1,0,2000,8,857
경기도,양주시,양주2동,양주2동제8투,3093,1881,659,475,497,106,121,3,1,2,2,0,2,0,2,1870,11,1212
경기도,양주시,양주2동,양주2동제9투,3004,1979,840,337,498,138,150,5,0,2,0,2,2,0,1,1975,4,1025
경기도,양주시,양주2동,양주2동제10투,1975,1458,725,206,322,85,111,5,0,2,0,1,0,0,0,1457,1,517
경기도,양주시,회천1동,합계,7952,5644,2006,1489,1409,367,334,3,0,3,2,4,0,4,6,5627,17,2308
경기도,양주시,회천1동,관내사전투표,1555,1555,633,342,352,110,106,1,0,0,0,3,0,2,1,1550,5,0
경기도,양주시,회천1동,회천1동제1투,2875,1875,672,466,493,128,107,1,0,0,0,1,0,1,1,1870,5,1000
경기도,양주시,회천1동,회천1동제2투,2639,1671,580,448,424,103,101,1,0,3,1,0,0,1,3,1665,6,968
경기도,양주시,회천1동,회천1동제3투,883,543,121,233,140,26,20,0,0,0,1,0,0,0,1,542,1,340
경기도,양주시,회천2동,합계,21286,14792,5748,3383,3580,901,1047,17,6,11,1,7,9,7,17,14734,58,6494
경기도,양주시,회천2동,관내사전투표,3291,3291,1461,667,671,222,239,4,1,3,0,1,2,1,3,3275,16,0
경기도,양주시,회천2동,회천2동제1투,3259,1932,738,412,504,119,141,5,3,2,0,2,1,0,1,1928,4,1327
경기도,양주시,회천2동,회천2동제2투,3253,1897,707,469,459,126,120,1,0,2,1,0,1,2,3,1891,6,1356
경기도,양주시,회천2동,회천2동제3투,2029,1330,473,307,356,79,100,1,0,1,0,0,2,2,1,1322,8,699
경기도,양주시,회천2동,회천2동제4투,2830,1894,693,464,490,100,133,0,0,2,0,1,1,1,3,1888,6,936
경기도,양주시,회천2동,회천2동제5투,2841,2059,837,476,470,119,136,5,2,1,0,3,0,0,2,2051,8,782
경기도,양주시,회천2동,회천2동제6투,3783,2389,839,588,630,136,178,1,0,0,0,0,2,1,4,2379,10,1394
경기도,양주시,회천3동,합계,20410,15154,6026,3358,3562,1039,1051,12,6,12,3,13,4,3,9,15098,56,5256
경기도,양주시,회천3동,관내사전투표,4142,4142,1862,819,819,297,311,5,1,4,0,2,2,0,3,4125,17,0
경기도,양주시,회천3동,회천3동제1투,2081,1389,489,366,340,99,77,3,1,0,1,1,1,1,2,1381,8,692
경기도,양주시,회천3동,회천3동제2투,3107,2020,826,400,495,140,141,3,0,2,0,3,1,0,1,2012,8,1087
경기도,양주시,회천3동,회천3동제3투,3200,2050,799,438,517,135,147,1,1,2,0,3,0,1,0,2044,6,1150
경기도,양주시,회천3동,회천3동제4투,2185,1624,565,459,399,86,105,0,1,0,0,2,0,0,0,1617,7,561
경기도,양주시,회천3동,회천3동제5투,2626,1759,654,353,453,138,144,0,2,3,1,2,0,1,2,1753,6,867
경기도,양주시,회천3동,회천3동제6투,3069,2170,831,523,539,144,126,0,0,1,1,0,0,0,1,2166,4,899
경기도,양주시,회천4동,관내사전투표,1758,1758,793,321,378,130,121,3,0,2,1,1,0,1,4,1755,3,0
경기도,양주시,회천4동,합계,9420,6712,2771,1416,1599,431,434,10,0,6,2,5,1,4,12,6691,21,2708
경기도,양주시,회천4동,회천4동제1투,2293,1403,539,384,317,71,76,3,0,1,1,0,0,0,4,1396,7,890
경기도,양주시,회천4동,회천4동제2투,3610,2294,900,520,559,144,149,4,0,1,0,4,1,3,2,2287,7,1316
경기도,양주시,회천4동,회천4동제3투,1759,1257,539,191,345,86,88,0,0,2,0,0,0,0,2,1253,4,502
경기도,양주시,잘못 투입·구분된 투표지,,0,0,0,0,0,0,0,0,0,0,0,0,0,0,0,0,0,0
경기도,동두천시,합계,,80335,55487,19444,15733,12808,3201,3662,86,11,50,18,51,21,34,74,55193,294,24848
경기도,동두천시,거소·선상투표,,218,203,50,55,64,7,10,2,0,0,0,1,0,0,2,191,12,15
경기도,동두천시,관외사전투표,,5027,5027,2212,807,1080,413,437,7,3,2,2,4,1,2,13,4983,44,0
경기도,동두천시,재외투표,,387,244,129,28,39,12,32,1,0,2,0,0,0,0,0,243,1,143
경기도,동두천시,생연1동,합계,5872,3688,1201,1219,795,198,237,6,0,7,0,2,2,3,3,3673,15,2184
경기도,동두천시,생연1동,관내사전투표,1020,1020,387,264,223,58,77,1,0,2,0,1,0,1,1,1015,5,0
경기도,동두천시,생연1동,생연1동제1투,3043,1597,474,564,357,86,94,5,0,4,0,1,2,1,0,1588,9,1446
경기도,동두천시,생연1동,생연1동제2투,1809,1071,340,391,215,54,66,0,0,1,0,0,0,1,2,1070,1,738
경기도,동두천시,생연2동,관내사전투표,1292,1292,488,351,283,71,89,1,0,1,1,1,0,1,2,1289,3,0
경기도,동두천시,생연2동,합계,9180,6346,2069,1944,1545,324,391,6,1,9,3,5,4,4,7,6312,34,2834
경기도,동두천시,생연2동,생연2동제1투,1110,622,155,242,159,25,33,0,0,1,0,2,1,1,0,619,3,488
경기도,동두천시,생연2동,생연2동제2투,1679,1028,299,337,281,39,56,0,0,1,0,0,2,1,3,1019,9,651
경기도,동두천시,생연2동,생연2동제3투,1159,688,189,292,140,31,28,1,1,1,0,1,1,0,1,686,2,471
경기도,동두천시,생연2동,생연2동제4투,2285,1588,535,419,416,90,107,4,0,1,2,0,0,1,1,1576,12,697
경기도,동두천시,생연2동,생연2동제5투,1655,1128,403,303,266,68,78,0,0,4,0,1,0,0,0,1123,5,527
경기도,동두천시,중앙동,관내사전투표,1121,1121,378,406,203,52,63,3,0,1,1,3,1,1,2,1114,7,0
경기도,동두천시,중앙동,합계,5190,3237,945,1204,734,145,164,5,2,3,1,5,3,4,4,3219,18,1953
경기도,동두천시,중앙동,중앙동제1투,2425,1221,327,456,308,57,59,1,0,2,0,2,0,1,2,1215,6,1204
경기도,동두천시,중앙동,중앙동제2투,1644,895,240,342,223,36,42,1,2,0,0,0,2,2,0,890,5,749
경기도,동두천시,보산동,관내사전투표,535,535,193,179,99,34,27,1,0,0,1,0,0,1,0,535,0,0
경기도,동두천시,보산동,합계,2861,1709,503,624,395,88,86,1,0,1,2,0,1,2,1,1704,5,1152
경기도,동두천시,보산동,보산동투표소,2326,1174,310,445,296,54,59,0,0,1,1,0,1,1,1,1169,5,1152
경기도,동두천시,불현동,합계,20301,13306,4530,3936,3082,729,884,20,3,7,2,10,2,6,20,13231,75,6995
경기도,동두천시,불현동,관내사전투표,2867,2867,1223,743,535,135,203,5,0,2,0,4,1,3,2,2856,11,0
경기도,동두천시,불현동,불현동제1투,3606,2336,732,708,583,121,165,4,0,1,0,2,0,0,4,2320,16,1270
경기도,동두천시,불현동,불현동제2투,2812,1340,407,432,318,92,81,3,1,0,1,1,0,0,0,1336,4,1472
경기도,동두천시,불현동,불현동제3투,2016,1184,372,354,307,49,87,2,0,1,0,0,0,0,3,1175,9,832
경기도,동두천시,불현동,불현동제4투,3424,2180,714,615,520,150,163,1,1,1,0,0,0,0,2,2167,13,1244
경기도,동두천시,불현동,불현동제5투,3540,2209,779,606,551,128,122,3,0,2,1,1,1,0,3,2197,12,1331
경기도,동두천시,불현동,불현동제6투,1286,744,193,281,175,31,47,2,1,0,0,2,0,2,3,737,7,542
경기도,동두천시,불현동,불현동제7투,750,446,110,197,93,23,16,0,0,0,0,0,0,1,3,443,3,304
경기도,동두천시,송내동,합계,19120,13758,5473,3146,3159,887,987,18,1,12,3,12,2,7,12,13719,39,5362
경기도,동두천시,송내동,관내사전투표,3562,3562,1710,654,685,215,270,5,0,1,1,3,1,1,4,3550,12,0
경기도,동두천시,송내동,송내동제1투,4402,2776,1057,635,676,185,202,2,0,2,0,3,0,3,2,2767,9,1626
경기도,동두천시,송내동,송내동제2투,3123,2245,890,473,544,152,174,4,1,1,0,1,0,0,2,2242,3,878
경기도,동두천시,송내동,송내동제3투,3557,2245,837,561,537,143,153,3,0,1,0,1,1,1,3,2241,4,1312
경기도,동두천시,송내동,송내동제4투,3875,2548,887,662,625,178,168,4,0,7,1,4,0,2,1,2539,9,1327
경기도,동두천시,송내동,송내동제5투,601,382,92,161,92,14,20,0,0,0,1,0,0,0,0,380,2,219
경기도,동두천시,소요동,합계,7542,4956,1450,1749,1154,238,268,17,1,5,5,10,5,2,10,4914,42,2586
경기도,동두천시,소요동,관내사전투표,833,833,309,233,172,49,56,3,0,0,1,5,1,0,0,829,4,0
경기도,동두천시,소요동,소요동제1투,1352,681,199,257,161,32,25,1,0,2,1,0,0,0,1,679,2,671
경기도,동두천시,소요동,소요동제2투,2169,1336,399,436,316,70,94,11,0,2,0,1,0,0,3,1332,4,833
경기도,동두천시,소요동,소요동제3투,548,360,102,154,77,10,13,1,0,0,0,1,0,0,0,358,2,188
경기도,동두천시,소요동,소요동제4투,1508,1025,256,398,266,46,46,0,1,1,1,0,0,1,3,1019,6,483
경기도,동두천시,소요동,소요동제5투,1132,721,185,271,162,31,34,1,0,0,2,3,4,1,3,697,24,411
경기도,동두천시,상패동,관내사전투표,721,721,293,183,147,47,47,1,0,0,0,1,0,0,0,719,2,0
경기도,동두천시,상패동,합계,4637,3013,882,1021,761,160,166,3,0,2,0,2,1,4,2,3004,9,1624
경기도,동두천시,상패동,상패동제1투,2517,1427,369,526,375,71,73,2,0,0,0,0,1,2,2,1421,6,1090
경기도,동두천시,상패동,상패동제2투,753,463,125,161,119,28,27,0,0,1,0,1,0,1,0,463,0,290
경기도,동두천시,상패동,상패동제3투,646,402,95,151,120,14,19,0,0,1,0,0,0,1,0,401,1,244
경기도,동두천시,잘못 투입·구분된 투표지,,0,0,0,0,0,0,0,0,0,0,0,0,0,0,0,0,0,0
경기도,안산시상록구,합계,,305169,226266,98564,39723,55067,14307,16558,272,49,206,51,169,83,75,215,225339,927,78903
경기도,안산시상록구,거소·선상투표,,582,561,204,91,185,36,15,1,1,0,3,2,0,0,1,539,22,21
경기도,안산시상록구,관외사전투표,,23679,23671,11196,2952,5440,1750,1950,51,12,13,8,21,13,9,51,23466,205,8
경기도,안산시상록구,재외투표,,1570,1231,783,69,167,48,157,2,0,0,1,0,0,1,1,1229,2,339
경기도,안산시상록구,일동,합계,21325,14643,6368,2674,3589,803,1081,15,5,16,3,11,7,3,11,14586,57,6682
경기도,안산시상록구,일동,관내사전투표,3940,3940,1932,598,873,214,288,5,2,7,0,2,4,0,3,3928,12,0
경기도,안산시상록구,일동,일동제1투,4342,2448,996,480,629,126,196,2,3,2,0,1,2,2,1,2440,8,1894
경기도,안산시상록구,일동,일동제2투,3879,2401,962,484,640,138,160,2,0,3,1,2,0,0,3,2395,6,1478
경기도,안산시상록구,일동,일동제3투,5094,3253,1378,593,829,181,246,3,0,3,1,2,0,0,2,3238,15,1841
경기도,안산시상록구,일동,일동제4투,4070,2601,1100,519,618,144,191,3,0,1,1,4,1,1,2,2585,16,1469
경기도,안산시상록구,이동,합계,21874,14529,6464,2574,3475,898,1019,9,3,18,1,5,5,3,12,14486,43,7345
경기도,안산시상록구,이동,관내사전투표,3011,3011,1590,395,617,171,218,2,1,8,0,0,0,1,1,3004,7,0
경기도,안산시상록구,이동,이동제1투,2804,1747,684,375,449,105,119,0,1,2,0,1,0,1,2,1739,8,1057
경기도,안산시상록구,이동,이동제2투,3205,1748,762,323,442,90,113,3,0,1,0,2,0,1,3,1740,8,1457
경기도,안산시상록구,이동,이동제3투,3546,1979,836,338,511,132,150,0,0,4,0,1,2,0,2,1976,3,1567
경기도,안산시상록구,이동,이동제4투,2697,1525,686,268,358,110,96,1,1,0,0,0,0,0,2,1522,3,1172
경기도,안산시상록구,이동,이동제5투,4374,2751,1189,515,660,162,206,3,0,1,1,1,2,0,1,2741,10,1623
경기도,안산시상록구,이동,이동제6투,2237,1768,717,360,438,128,117,0,0,2,0,0,1,0,1,1764,4,469
경기도,안산시상록구,사1동,합계,29994,21315,9650,3435,5122,1349,1585,24,2,26,7,22,6,6,13,21247,68,8679
경기도,안산시상록구,사1동,관내사전투표,5357,5357,2647,689,1179,356,444,5,2,7,1,6,0,1,2,5339,18,0
경기도,안산시상록구,사1동,사1동제1투,3083,1789,815,276,435,108,139,1,0,0,1,1,1,1,2,1780,9,1294
경기도,안산시상록구,사1동,사1동제2투,4400,2776,1133,480,763,176,199,3,0,5,0,4,0,3,4,2770,6,1624
경기도,안산시상록구,사1동,사1동제3투,3166,1743,731,294,435,130,142,3,0,0,1,2,0,0,2,1740,3,1423
경기도,안산시상록구,사1동,사1동제4투,2627,2016,871,453,459,114,98,2,0,5,1,0,1,0,1,2005,11,611
경기도,안산시상록구,사1동,사1동제5투,2445,2030,1009,238,470,128,171,5,0,1,0,3,1,0,0,2026,4,415
경기도,안산시상록구,사1동,사1동제6투,3750,2239,981,389,579,120,152,2,0,2,2,3,1,1,1,2233,6,1511
경기도,안산시상록구,사1동,사1동제7투,3004,1935,820,375,450,134,142,1,0,4,0,2,2,0,0,1930,5,1069
경기도,안산시상록구,사1동,사1동제8투,2162,1430,643,241,352,83,98,2,0,2,1,1,0,0,1,1424,6,732
경기도,안산시상록구,사2동,합계,25298,18565,7898,3287,4651,1250,1335,18,1,16,3,19,7,6,13,18504,61,6733
경기도,안산시상록구,사2동,관내사전투표,4264,4264,1951,719,956,288,308,5,0,2,0,4,1,1,5,4240,24,0
경기도,안산시상록구,사2동,사2동제1투,2125,1665,600,358,455,138,104,3,0,0,0,3,0,0,0,1661,4,460
경기도,안산시상록구,사2동,사2동제2투,3006,2237,883,468,551,179,139,0,1,0,2,1,0,2,3,2229,8,769
경기도,안산시상록구,사2동,사2동제3투,2246,1737,678,372,454,119,104,3,0,1,0,1,0,0,1,1733,4,509
경기도,안산시상록구,사2동,사2동제4투,4874,3041,1349,480,773,162,254,3,0,3,1,6,2,1,1,3035,6,1833
경기도,안산시상록구,사2동,사2동제5투,4707,2904,1283,432,751,181,235,1,0,7,0,1,2,0,3,2896,8,1803
경기도,안산시상록구,사2동,사2동제6투,4076,2717,1154,458,711,183,191,3,0,3,0,3,2,2,0,2710,7,1359
경기도,안산시상록구,사3동,합계,13563,10803,4491,2126,2652,813,671,14,0,3,4,4,0,1,5,10784,19,2760
경기도,안산시상록구,사3동,관내사전투표,2680,2680,1243,482,591,185,169,1,0,1,0,3,0,0,0,2675,5,0
경기도,안산시상록구,사3동,사3동제1투,3994,2773,1082,590,652,245,183,4,0,2,1,1,0,0,2,2762,11,1221
경기도,안산시상록구,사3동,사3동제2투,3183,2481,1056,444,641,179,158,0,0,0,0,0,0,0,2,2480,1,702
경기도,안산시상록구,사3동,사3동제3투,3706,2869,1110,610,768,204,161,9,0,0,3,0,0,1,1,2867,2,837
경기도,안산시상록구,본오1동,합계,31055,20262,8798,3507,5084,1151,1513,22,3,21,8,19,13,14,15,20168,94,10793
경기도,안산시상록구,본오1동,관내사전투표,4195,4195,2079,638,922,227,297,5,0,5,2,2,3,0,4,4184,11,0
경기도,안산시상록구,본오1동,본오1동제1투,3596,2174,884,434,555,128,149,0,0,1,1,1,2,1,2,2158,16,1422
경기도,안산시상록구,본오1동,본오1동제2투,3458,2023,871,326,543,106,159,3,0,4,0,2,2,1,0,2017,6,1435
경기도,안산시상록구,본오1동,본오1동제3투,3459,2007,821,374,522,113,157,1,0,1,2,2,1,4,1,1999,8,1452
경기도,안산시상록구,본오1동,본오1동제4투,3338,2058,873,323,567,112,161,4,0,1,0,1,0,2,4,2048,10,1280
경기도,안산시상록구,본오1동,본오1동제5투,3981,2422,1078,403,576,130,196,5,1,4,2,6,2,2,3,2408,14,1559
경기도,안산시상록구,본오1동,본오1동제6투,3446,1941,831,332,493,127,146,0,0,1,0,1,0,1,0,1932,9,1505
경기도,안산시상록구,본오1동,본오1동제7투,3286,1975,866,300,515,110,157,2,1,3,0,3,1,2,1,1961,14,1311
경기도,안산시상록구,본오1동,본오1동제8투,2296,1467,495,377,391,98,91,2,1,1,1,1,2,1,0,1461,6,829
경기도,안산시상록구,본오2동,합계,22854,16825,7352,2974,4187,989,1168,23,7,12,3,21,5,5,20,16766,59,6029
경기도,안산시상록구,본오2동,관내사전투표,3959,3959,2010,542,855,216,302,3,1,5,1,3,1,2,5,3946,13,0
경기도,안산시상록구,본오2동,본오2동제1투,3042,1730,716,316,468,93,121,0,1,1,1,1,0,1,3,1722,8,1312
경기도,안산시상록구,본오2동,본오2동제2투,2654,1595,631,307,450,88,103,1,0,1,0,5,2,1,2,1591,4,1059
경기도,안산시상록구,본오2동,본오2동제3투,4001,2382,1012,433,629,129,157,3,2,3,0,1,2,1,6,2378,4,1619
경기도,안산시상록구,본오2동,본오2동제4투,2448,1866,764,363,484,133,107,4,0,0,0,3,0,0,1,1859,7,582
경기도,안산시상록구,본오2동,본오2동제5투,4144,3212,1389,624,732,205,237,6,2,1,0,5,0,0,2,3203,9,932
경기도,안산시상록구,본오2동,본오2동제6투,2606,2081,830,389,569,125,141,6,1,1,1,3,0,0,1,2067,14,525
경기도,안산시상록구,본오3동,합계,18938,14204,6264,2430,3367,931,1089,26,1,21,2,9,4,6,10,14160,44,4734
경기도,안산시상록구,본오3동,관내사전투표,4429,4429,2172,635,914,284,383,10,0,7,1,4,2,1,2,4415,14,0
경기도,안산시상록구,본오3동,본오3동제1투,2652,1608,655,303,407,99,132,2,0,2,0,1,0,0,2,1603,5,1044
경기도,안산시상록구,본오3동,본오3동제2투,2283,1850,767,312,484,140,127,4,0,3,1,2,1,1,2,1844,6,433
경기도,안산시상록구,본오3동,본오3동제3투,4243,2803,1221,487,698,175,200,5,1,3,0,1,1,0,1,2793,10,1440
경기도,안산시상록구,본오3동,본오3동제4투,3613,2151,907,417,525,140,150,2,0,5,0,0,0,0,1,2147,4,1462
경기도,안산시상록구,본오3동,본오3동제5투,1718,1363,542,276,339,93,97,3,0,1,0,1,0,4,2,1358,5,355
경기도,안산시상록구,부곡동,합계,18246,12612,5183,2304,3302,766,936,6,5,9,1,12,8,3,14,12549,63,5634
경기도,안산시상록구,부곡동,관내사전투표,3090,3090,1476,471,717,173,233,0,1,1,0,0,3,1,1,3077,13,0
경기도,안산시상록구,부곡동,부곡동제1투,4299,2670,1003,576,708,152,195,3,1,4,0,5,2,2,5,2656,14,1629
경기도,안산시상록구,부곡동,부곡동제2투,3819,2240,836,438,651,140,152,2,2,2,0,3,1,0,2,2229,11,1579
경기도,안산시상록구,부곡동,부곡동제3투,3106,2024,866,338,525,129,147,0,0,1,1,0,2,0,2,2011,13,1082
경기도,안산시상록구,부곡동,부곡동제4투,3932,2588,1002,481,701,172,209,1,1,1,0,4,0,0,4,2576,12,1344
경기도,안산시상록구,월피동,관내사전투표,4495,4495,2200,633,1003,249,384,3,1,3,1,2,2,1,4,4486,9,0
경기도,안산시상록구,월피동,합계,33027,23530,10189,4101,5777,1453,1838,17,3,25,4,5,10,9,26,23457,73,9497
경기도,안산시상록구,월피동,월피동제1투,4060,2302,892,441,627,143,178,1,1,6,0,1,1,2,2,2295,7,1758
경기도,안산시상록구,월피동,월피동제2투,4403,2774,1072,572,729,173,200,6,0,2,0,0,1,2,5,2762,12,1629
경기도,안산시상록구,월피동,월피동제3투,3654,2484,1082,470,562,150,202,3,0,3,0,0,1,0,4,2477,7,1170
경기도,안산시상록구,월피동,월피동제4투,3142,2195,994,380,506,137,159,2,0,2,2,1,0,1,2,2186,9,947
경기도,안산시상록구,월피동,월피동제5투,2781,2170,935,363,531,148,178,0,0,1,0,0,1,1,1,2159,11,611
경기도,안산시상록구,월피동,월피동제6투,2997,2360,1056,367,577,173,176,1,0,3,0,0,1,1,2,2357,3,637
경기도,안산시상록구,월피동,월피동제7투,3821,2518,1022,447,688,156,184,1,1,2,0,0,2,1,4,2508,10,1303
경기도,안산시상록구,월피동,월피동제8투,3674,2232,936,428,554,124,177,0,0,3,1,1,1,0,2,2227,5,1442
경기도,안산시상록구,성포동,합계,19926,16196,6858,3196,3830,1086,1116,27,1,13,1,11,2,4,7,16152,44,3730
경기도,안산시상록구,성포동,관내사전투표,3769,3769,1772,631,796,258,291,5,1,1,0,1,0,0,1,3757,12,0
경기도,안산시상록구,성포동,성포동제1투,2285,1696,630,416,424,112,97,1,0,3,0,4,0,1,1,1689,7,589
경기도,안산시상록구,성포동,성포동제2투,3248,2467,1009,500,629,150,160,6,0,2,0,2,0,0,1,2459,8,781
경기도,안산시상록구,성포동,성포동제3투,3179,2516,996,568,623,163,148,7,0,2,0,1,1,2,1,2512,4,663
경기도,안산시상록구,성포동,성포동제4투,3734,2918,1127,651,709,212,200,6,0,2,0,2,0,0,1,2910,8,816
경기도,안산시상록구,성포동,성포동제5투,3711,2830,1324,430,649,191,220,2,0,3,1,1,1,1,2,2825,5,881
경기도,안산시상록구,반월동,합계,15453,11743,4718,2685,2786,685,780,13,4,9,2,8,1,2,7,11700,43,3710
경기도,안산시상록구,반월동,관내사전투표,2837,2837,1274,561,652,136,195,2,1,2,1,0,0,1,1,2826,11,0
경기도,안산시상록구,반월동,반월동제1투,3582,2465,879,581,659,142,181,1,0,3,1,4,0,0,3,2454,11,1117
경기도,안산시상록구,반월동,반월동제2투,3339,2606,1172,507,541,193,176,6,0,0,0,2,0,0,0,2597,9,733
경기도,안산시상록구,반월동,반월동제3투,3034,1936,733,513,468,89,117,3,0,2,0,1,1,0,0,1927,9,1098
경기도,안산시상록구,반월동,반월동제4투,1748,1303,464,359,317,81,72,1,3,0,0,0,0,1,3,1301,2,445
경기도,안산시상록구,반월동,반월동제5투,913,596,196,164,149,44,39,0,0,2,0,1,0,0,0,595,1,317
경기도,안산시상록구,안산동,합계,7785,5575,2148,1318,1453,298,305,4,1,4,0,0,2,3,9,5545,30,2210
경기도,안산시상록구,안산동,관내사전투표,1342,1342,567,296,325,55,83,3,0,2,0,0,1,0,2,1334,8,0
경기도,안산시상록구,안산동,안산동제1투,2893,1860,683,483,482,104,91,0,1,1,0,0,0,1,3,1849,11,1033
경기도,안산시상록구,안산동,안산동제2투,3550,2373,898,539,646,139,131,1,0,1,0,0,1,2,4,2362,11,1177
경기도,안산시상록구,잘못 투입·구분된 투표지,,0,1,0,0,0,1,0,0,0,0,0,0,0,0,0,1,0,-1
경기도,안산시단원구,합계,,252848,187253,80771,33862,45779,11938,13251,206,31,149,48,137,76,68,192,186508,745,65595
경기도,안산시단원구,거소·선상투표,,649,604,179,172,154,31,22,1,0,0,5,3,1,1,5,574,30,45
경기도,안산시단원구,관외사전투표,,19207,19200,8842,2561,4510,1385,1629,23,5,16,5,21,14,12,35,19058,142,7
경기도,안산시단원구,재외투표,,1137,870,544,60,144,23,95,2,0,0,0,0,0,0,1,869,1,267
경기도,안산시단원구,와동,합계,33045,20902,8963,3628,5295,1169,1619,34,4,24,10,15,18,5,25,20809,93,12143
경기도,안산시단원구,와동,관내사전투표,4117,4117,2019,608,891,214,346,8,0,5,0,1,4,0,2,4098,19,0
경기도,안산시단원구,와동,와동제1투,3212,1868,715,344,556,103,132,2,0,2,2,3,4,1,0,1864,4,1344
경기도,안산시단원구,와동,와동제2투,4099,2621,1097,469,684,129,200,11,1,4,0,1,1,1,5,2603,18,1478
경기도,안산시단원구,와동,와동제3투,3674,2463,1005,435,659,164,174,2,2,4,1,2,0,0,5,2453,10,1211
경기도,안산시단원구,와동,와동제4투,3947,2314,944,426,599,150,172,3,0,3,1,2,3,0,3,2306,8,1633
경기도,안산시단원구,와동,와동제5투,3421,1577,633,316,400,89,126,3,0,2,2,1,1,0,1,1574,3,1844
경기도,안산시단원구,와동,와동제6투,2875,1618,702,273,402,94,125,0,1,1,3,2,2,3,3,1611,7,1257
경기도,안산시단원구,와동,와동제7투,4134,2326,942,412,623,128,197,4,0,1,0,1,1,0,5,2314,12,1808
경기도,안산시단원구,와동,와동제8투,3566,1998,906,345,481,98,147,1,0,2,1,2,2,0,1,1986,12,1568
경기도,안산시단원구,고잔1동,합계,16607,12346,5273,2277,2959,777,936,13,2,15,1,18,3,5,17,12296,50,4261
경기도,안산시단원구,고잔1동,관내사전투표,3625,3625,1736,537,794,231,294,3,0,6,0,6,1,1,2,3611,14,0
경기도,안산시단원구,고잔1동,고잔1동제1투,3013,2017,811,404,521,113,146,4,1,2,1,5,2,1,1,2012,5,996
경기도,안산시단원구,고잔1동,고잔1동제2투,2069,1464,562,326,362,97,107,0,0,2,0,1,0,0,1,1458,6,605
경기도,안산시단원구,고잔1동,고잔1동제3투,1941,1243,513,232,302,97,77,3,0,1,0,3,0,2,4,1234,9,698
경기도,안산시단원구,고잔1동,고잔1동제4투,2632,1813,758,357,447,105,130,2,1,1,0,1,0,0,6,1808,5,819
경기도,안산시단원구,고잔1동,고잔1동제5투,3327,2184,893,421,533,134,182,1,0,3,0,2,0,1,3,2173,11,1143
경기도,안산시단원구,고잔2동,합계,16198,12175,5487,2028,2773,870,933,8,1,9,0,9,4,2,7,12131,44,4023
경기도,안산시단원구,고잔2동,관내사전투표,3799,3799,1880,542,787,278,289,5,0,1,0,1,0,0,2,3785,14,0
경기도,안산시단원구,고잔2동,고잔2동제1투,3558,2547,1094,460,602,174,197,1,0,0,0,4,3,1,2,2538,9,1011
경기도,안산시단원구,고잔2동,고잔2동제2투,2452,1320,621,191,311,85,105,1,0,1,0,2,0,1,0,1318,2,1132
경기도,안산시단원구,고잔2동,고잔2동제3투,3024,2178,962,401,490,156,159,0,1,0,0,1,0,0,1,2171,7,846
경기도,안산시단원구,고잔2동,고잔2동제4투,3365,2331,930,434,583,177,183,1,0,7,0,1,1,0,2,2319,12,1034
경기도,안산시단원구,호수동,합계,34702,28186,12277,4907,6971,2043,1848,26,2,9,4,10,5,5,12,28119,67,6516
경기도,안산시단원구,호수동,관내사전투표,5274,5274,2650,708,1100,372,413,4,0,4,1,1,1,3,3,5260,14,0
경기도,안산시단원구,호수동,호수동제1투,2695,2031,934,291,497,166,133,0,0,0,0,1,0,0,3,2025,6,664
경기도,안산시단원구,호수동,호수동제2투,2296,1870,732,406,499,124,102,2,0,0,0,0,0,0,1,1866,4,426
경기도,안산시단원구,호수동,호수동제3투,2948,1838,786,362,439,138,110,1,1,0,0,1,0,0,0,1838,0,1110
경기도,안산시단원구,호수동,호수동제4투,2944,2182,841,478,552,165,135,2,0,0,1,1,0,0,0,2175,7,762
경기도,안산시단원구,호수동,호수동제5투,3449,2795,1215,449,719,226,174,2,0,1,0,2,1,1,1,2791,4,654
경기도,안산시단원구,호수동,호수동제6투,3558,2907,1174,512,811,216,183,5,0,1,1,1,1,0,0,2905,2,651
경기도,안산시단원구,호수동,호수동제7투,3000,2254,955,395,573,156,160,2,0,0,0,0,0,1,3,2245,9,746
경기도,안산시단원구,호수동,호수동제8투,3291,2728,1152,550,639,189,185,2,1,2,0,1,2,0,1,2724,4,563
경기도,안산시단원구,호수동,호수동제9투,2083,1663,628,359,470,104,90,2,0,0,0,2,0,0,0,1655,8,420
경기도,안산시단원구,호수동,호수동제10투,3164,2644,1210,397,672,187,163,4,0,1,1,0,0,0,0,2635,9,520
경기도,안산시단원구,원곡본동,합계,24007,15852,6901,3214,3720,902,990,18,2,8,3,12,7,7,13,15797,55,8155
경기도,안산시단원구,원곡본동,관내사전투표,2320,2320,1177,395,469,117,145,3,0,2,0,3,1,1,1,2314,6,0
경기도,안산시단원구,원곡본동,원곡본동제1투,1576,609,246,188,134,25,11,0,0,0,0,1,0,2,0,607,2,967
경기도,안산시단원구,원곡본동,원곡본동제2투,1421,617,250,194,134,17,14,3,0,0,0,0,0,0,0,612,5,804
경기도,안산시단원구,원곡본동,원곡본동제3투,2792,1336,574,355,279,46,67,2,1,2,0,0,0,1,2,1329,7,1456
경기도,안산시단원구,원곡본동,원곡본동제4투,2572,1865,705,411,476,126,137,3,0,0,0,0,0,0,0,1858,7,707
경기도,안산시단원구,원곡본동,원곡본동제5투,2710,2105,911,395,495,131,160,3,0,0,1,0,2,0,2,2100,5,605
경기도,안산시단원구,원곡본동,원곡본동제6투,2404,1235,510,245,322,65,82,3,0,1,0,0,1,2,0,1231,4,1169
경기도,안산시단원구,원곡본동,원곡본동제7투,2353,1647,703,303,409,101,107,0,0,2,2,5,1,1,3,1637,10,706
경기도,안산시단원구,원곡본동,원곡본동제8투,3113,2047,871,407,497,121,140,0,1,0,0,3,0,0,2,2042,5,1066
경기도,안산시단원구,원곡본동,원곡본동제9투,2746,2071,954,321,505,153,127,1,0,1,0,0,2,0,3,2067,4,675
경기도,안산시단원구,원곡1동,합계,5450,3630,1415,897,929,161,186,3,3,1,3,2,4,1,8,3613,17,1820
경기도,안산시단원구,원곡1동,관내사전투표,1596,1596,664,372,391,67,80,2,1,1,1,2,1,1,4,1587,9,0
경기도,안산시단원구,원곡1동,원곡1동제1투,1584,706,264,192,184,31,31,1,1,0,0,0,0,0,0,704,2,878
경기도,안산시단원구,원곡1동,원곡1동제2투,2270,1328,487,333,354,63,75,0,1,0,2,0,3,0,4,1322,6,942
경기도,안산시단원구,원곡2동,합계,12108,9516,3940,1922,2386,580,626,10,3,2,3,3,1,4,8,9488,28,2592
경기도,안산시단원구,원곡2동,관내사전투표,2382,2382,1086,425,558,131,164,1,1,0,1,1,1,2,1,2372,10,0
경기도,안산시단원구,원곡2동,원곡2동제1투,2602,1894,778,346,496,133,129,2,0,1,0,0,0,1,2,1888,6,708
경기도,안산시단원구,원곡2동,원곡2동제2투,2731,2050,826,450,481,129,151,4,0,0,0,1,0,1,0,2043,7,681
경기도,안산시단원구,원곡2동,원곡2동제3투,2922,2104,811,463,574,131,111,2,1,1,2,0,0,0,5,2101,3,818
경기도,안산시단원구,원곡2동,원곡2동제4투,1471,1086,439,238,277,56,71,1,1,0,0,1,0,0,0,1084,2,385
경기도,안산시단원구,초지동,합계,30330,23403,10472,3752,5715,1646,1658,24,1,18,2,22,6,8,15,23339,64,6927
경기도,안산시단원구,초지동,관내사전투표,5769,5770,2898,791,1163,427,457,2,0,5,0,7,1,3,3,5757,13,-1
경기도,안산시단원구,초지동,초지동제1투,1992,1326,507,266,376,76,89,2,0,3,0,1,0,0,1,1321,5,666
경기도,안산시단원구,초지동,초지동제2투,2089,1696,670,336,437,140,103,0,0,0,1,0,0,0,0,1687,9,393
경기도,안산시단원구,초지동,초지동제3투,2292,1690,725,273,433,129,120,6,0,1,0,0,0,0,0,1687,3,602
경기도,안산시단원구,초지동,초지동제4투,2190,1703,710,249,460,140,136,1,0,1,0,1,0,0,0,1698,5,487
경기도,안산시단원구,초지동,초지동제5투,2019,1323,577,204,352,100,82,2,0,0,1,0,0,0,2,1320,3,696
경기도,안산시단원구,초지동,초지동제6투,2591,1814,756,339,473,109,115,3,0,0,0,6,2,1,3,1807,7,777
경기도,안산시단원구,초지동,초지동제7투,3052,2149,920,401,555,116,134,3,0,1,0,4,2,1,4,2141,8,903
경기도,안산시단원구,초지동,초지동제8투,3108,2294,1055,334,565,161,167,2,0,5,0,0,0,2,1,2292,2,814
경기도,안산시단원구,초지동,초지동제9투,2817,2084,935,319,526,136,159,1,1,0,0,2,1,1,0,2081,3,733
경기도,안산시단원구,초지동,초지동제10투,2411,1554,719,240,375,112,96,2,0,2,0,1,0,0,1,1548,6,857
경기도,안산시단원구,선부1동,합계,10032,7231,3057,1372,1759,446,534,10,2,3,1,5,7,3,8,7207,24,2801
경기도,안산시단원구,선부1동,관내사전투표,1702,1702,804,255,374,121,137,2,0,0,0,2,1,1,0,1697,5,0
경기도,안산시단원구,선부1동,선부1동제1투,2026,1190,475,235,309,69,89,2,0,2,0,0,2,0,2,1185,5,836
경기도,안산시단원구,선부1동,선부1동제2투,1930,1364,533,283,343,83,110,1,1,0,0,1,2,0,4,1361,3,566
경기도,안산시단원구,선부1동,선부1동제3투,2156,1479,651,249,354,85,132,1,0,0,0,1,0,1,1,1475,4,677
경기도,안산시단원구,선부1동,선부1동제4투,2218,1496,594,350,379,88,66,4,1,1,1,1,2,1,1,1489,7,722
경기도,안산시단원구,선부2동,합계,17248,10955,4459,2121,2921,628,723,17,3,19,3,2,4,4,12,10916,39,6293
경기도,안산시단원구,선부2동,관내사전투표,2464,2464,1130,413,606,144,156,2,1,3,1,0,2,1,2,2461,3,0
경기도,안산시단원구,선부2동,선부2동제1투,2756,1429,569,293,400,75,81,1,0,2,0,0,0,0,3,1424,5,1327
경기도,안산시단원구,선부2동,선부2동제2투,2570,1642,651,314,450,96,118,1,0,2,0,0,0,0,2,1634,8,928
경기도,안산시단원구,선부2동,선부2동제3투,3607,2100,800,413,555,144,158,6,1,7,1,0,0,3,4,2092,8,1507
경기도,안산시단원구,선부2동,선부2동제4투,3596,2089,856,392,582,107,130,2,0,4,1,1,2,0,1,2078,11,1507
경기도,안산시단원구,선부2동,선부2동제5투,2255,1231,453,296,328,62,80,5,1,1,0,1,0,0,0,1227,4,1024
경기도,안산시단원구,선부3동,합계,25707,18189,7923,3156,4551,1093,1316,10,2,20,6,12,2,8,21,18120,69,7518
경기도,안산시단원구,선부3동,관내사전투표,3039,3038,1467,492,655,183,220,0,0,2,2,1,0,1,2,3025,13,1
경기도,안산시단원구,선부3동,선부3동제1투,2995,1646,734,247,440,98,112,1,0,0,0,2,1,1,3,1639,7,1349
경기도,안산시단원구,선부3동,선부3동제2투,3126,1774,736,375,459,88,109,1,0,1,0,1,0,1,2,1773,1,1352
경기도,안산시단원구,선부3동,선부3동제3투,3051,1681,708,254,473,96,126,2,1,3,0,1,0,2,4,1670,11,1370
경기도,안산시단원구,선부3동,선부3동제4투,4104,3225,1348,587,835,192,238,3,1,4,0,3,0,0,2,3213,12,879
경기도,안산시단원구,선부3동,선부3동제5투,3128,2173,984,356,523,129,166,1,0,2,0,1,0,3,1,2166,7,955
경기도,안산시단원구,선부3동,선부3동제6투,4034,3031,1250,592,768,182,210,2,0,4,2,1,0,0,6,3017,14,1003
경기도,안산시단원구,선부3동,선부3동제7투,2230,1621,696,253,398,125,135,0,0,4,2,2,1,0,1,1617,4,609
경기도,안산시단원구,대부동,합계,6421,4194,1039,1795,992,184,136,7,1,5,2,3,0,3,5,4172,22,2227
경기도,안산시단원구,대부동,관내사전투표,923,923,270,347,232,36,28,0,0,2,0,1,0,0,1,917,6,0
경기도,안산시단원구,대부동,대부동제1투,1968,1095,282,437,262,55,49,0,0,2,1,1,0,0,0,1089,6,873
경기도,안산시단원구,대부동,대부동제2투,1593,976,199,458,233,52,22,5,0,0,0,1,0,1,0,971,5,617
경기도,안산시단원구,대부동,대부동제3투,1937,1200,288,553,265,41,37,2,1,1,1,0,0,2,4,1195,5,737
경기도,안산시단원구,잘못 투입·구분된 투표지,,0,0,0,0,0,0,0,0,0,0,0,0,0,0,0,0,0,0
경기도,고양시덕양구,합계,,366265,287087,120063,55157,61581,18038,30094,409,37,143,134,194,66,87,172,286175,912,79178
경기도,고양시덕양구,거소·선상투표,,884,825,260,131,255,53,61,5,2,3,2,1,6,2,6,787,38,59
경기도,고양시덕양구,관외사전투표,,32048,32042,14818,4661,6445,2195,3629,32,6,20,22,24,14,8,27,31901,141,6
경기도,고양시덕양구,재외투표,,3145,2466,1468,178,335,109,357,10,1,0,0,0,0,1,1,2460,6,679
경기도,고양시덕양구,주교동,합계,13875,9448,3417,2153,2159,494,1119,20,1,9,2,5,3,4,11,9397,51,4427
경기도,고양시덕양구,주교동,관내사전투표,2632,2632,1105,519,518,159,300,5,0,2,0,2,0,2,5,2617,15,0
경기도,고양시덕양구,주교동,주교동제1투,2251,1349,444,347,325,69,149,1,1,2,1,1,1,1,0,1342,7,902
경기도,고양시덕양구,주교동,주교동제2투,3354,2031,663,486,507,111,239,3,0,0,0,1,1,0,4,2015,16,1323
경기도,고양시덕양구,주교동,주교동제3투,2661,1573,558,354,380,78,191,2,0,1,0,0,1,0,2,1567,6,1088
경기도,고양시덕양구,주교동,주교동제4투,2977,1863,647,447,429,77,240,9,0,4,1,1,0,1,0,1856,7,1114
경기도,고양시덕양구,원신동,합계,13149,10210,4315,1860,2206,604,1168,6,0,5,4,4,1,3,8,10184,26,2939
경기도,고양시덕양구,원신동,관내사전투표,1359,1359,615,237,267,75,159,0,0,1,0,2,0,0,0,1356,3,0
경기도,고양시덕양구,원신동,원신동제1투,1653,1273,513,217,285,99,154,0,0,1,0,0,0,0,0,1269,4,380
경기도,고양시덕양구,원신동,원신동제2투,848,568,138,194,124,42,64,1,0,0,0,0,0,0,3,566,2,280
경기도,고양시덕양구,원신동,원신동제3투,3728,2693,1090,542,616,139,286,3,0,2,1,0,1,2,4,2686,7,1035
경기도,고양시덕양구,원신동,원신동제4투,2470,1994,927,292,420,119,232,0,0,0,1,1,0,0,0,1992,2,476
경기도,고양시덕양구,원신동,원신동제5투,3091,2323,1032,378,494,130,273,2,0,1,2,1,0,1,1,2315,8,768
경기도,고양시덕양구,흥도동,합계,22089,17673,7643,3063,3691,999,2185,15,0,6,9,12,1,3,6,17633,40,4416
경기도,고양시덕양구,흥도동,관내사전투표,2691,2691,1254,389,487,154,393,3,0,0,0,2,0,2,0,2684,7,0
경기도,고양시덕양구,흥도동,흥도동제1투,1140,690,150,257,157,31,92,3,0,0,0,0,0,0,0,690,0,450
경기도,고양시덕양구,흥도동,흥도동제2투,2140,1525,605,340,361,75,135,2,0,0,1,1,1,0,0,1521,4,615
경기도,고양시덕양구,흥도동,흥도동제3투,3866,3011,1288,537,639,141,396,0,0,0,2,2,0,0,1,3006,5,855
경기도,고양시덕양구,흥도동,흥도동제4투,3185,2582,1249,308,492,159,365,0,0,1,0,0,0,0,0,2574,8,603
경기도,고양시덕양구,흥도동,흥도동제5투,988,757,362,93,129,77,93,0,0,0,1,1,0,0,0,756,1,231
경기도,고양시덕양구,흥도동,흥도동제6투,2838,2139,876,418,486,116,224,6,0,3,2,2,0,0,1,2134,5,699
경기도,고양시덕양구,흥도동,흥도동제7투,3176,2519,1009,495,585,157,258,1,0,1,1,3,0,1,2,2513,6,657
경기도,고양시덕양구,흥도동,흥도동제8투,2065,1759,850,226,355,89,229,0,0,1,2,1,0,0,2,1755,4,306
경기도,고양시덕양구,성사1동,합계,19076,14165,5527,2951,3215,807,1537,32,2,17,11,4,7,2,6,14118,47,4911
경기도,고양시덕양구,성사1동,관내사전투표,3434,3434,1529,631,700,187,360,6,0,1,2,3,1,0,1,3421,13,0
경기도,고양시덕양구,성사1동,성사1동제1투,3027,1822,644,431,439,80,206,6,0,4,3,0,2,0,0,1815,7,1205
경기도,고양시덕양구,성사1동,성사1동제2투,3161,1941,667,459,473,113,205,3,0,5,3,1,2,1,1,1933,8,1220
경기도,고양시덕양구,성사1동,성사1동제3투,3255,1946,682,448,465,95,231,7,2,2,0,0,1,0,3,1936,10,1309
경기도,고양시덕양구,성사1동,성사1동제4투,3343,2712,1090,543,644,172,245,7,0,3,1,0,0,1,0,2706,6,631
경기도,고양시덕양구,성사1동,성사1동제5투,2856,2310,915,439,494,160,290,3,0,2,2,0,1,0,1,2307,3,546
경기도,고양시덕양구,성사2동,합계,9318,7367,2905,1613,1509,439,856,5,1,2,5,3,0,2,5,7345,22,1951
경기도,고양시덕양구,성사2동,관내사전투표,1937,1937,862,349,354,121,238,1,0,1,1,3,0,0,2,1932,5,0
경기도,고양시덕양구,성사2동,성사2동제1투,2415,1695,662,377,345,115,187,1,0,0,1,0,0,1,1,1690,5,720
경기도,고양시덕양구,성사2동,성사2동제2투,2454,1811,638,461,377,102,219,2,0,1,0,0,0,1,2,1803,8,643
경기도,고양시덕양구,성사2동,성사2동제3투,2512,1924,743,426,433,101,212,1,1,0,3,0,0,0,0,1920,4,588
경기도,고양시덕양구,효자동,합계,1888,1227,344,385,314,98,72,0,0,3,2,1,0,1,2,1222,5,661
경기도,고양시덕양구,효자동,관내사전투표,335,335,107,75,77,45,26,0,0,2,0,1,0,1,0,334,1,0
경기도,고양시덕양구,효자동,효자동제1투,385,96,19,39,26,6,6,0,0,0,0,0,0,0,0,96,0,289
경기도,고양시덕양구,효자동,효자동제2투,1168,796,218,271,211,47,40,0,0,1,2,0,0,0,2,792,4,372
경기도,고양시덕양구,신도동,합계,15678,12430,5225,2602,2700,765,1053,17,1,6,5,9,2,3,7,12395,35,3248
경기도,고양시덕양구,신도동,관내사전투표,3790,3790,1703,697,756,229,374,8,0,2,1,3,0,1,2,3776,14,0
경기도,고양시덕양구,신도동,신도동제1투,2596,1509,465,514,348,61,108,2,0,1,1,1,0,1,1,1503,6,1087
경기도,고양시덕양구,신도동,신도동제2투,520,354,105,112,84,15,36,0,0,0,1,0,0,0,0,353,1,166
경기도,고양시덕양구,신도동,신도동제3투,1895,1498,612,335,315,112,120,1,0,0,0,0,0,1,0,1496,2,397
경기도,고양시덕양구,신도동,신도동제4투,3123,2568,1202,382,597,186,193,3,0,0,0,1,0,0,1,2565,3,555
경기도,고양시덕양구,신도동,신도동제5투,3754,2711,1138,562,600,162,222,3,1,3,2,4,2,0,3,2702,9,1043
경기도,고양시덕양구,창릉동,합계,9310,7390,3125,1602,1588,482,544,16,0,2,7,1,1,2,5,7375,15,1920
경기도,고양시덕양구,창릉동,관내사전투표,1532,1532,748,257,287,96,136,0,0,2,2,0,0,0,1,1529,3,0
경기도,고양시덕양구,창릉동,창릉동제1투,1425,864,274,273,206,46,57,2,0,0,0,0,0,1,1,860,4,561
경기도,고양시덕양구,창릉동,창릉동제2투,1679,1123,292,425,267,68,55,6,0,0,3,0,0,0,2,1118,5,556
경기도,고양시덕양구,창릉동,창릉동제3투,2043,1598,751,268,331,117,126,2,0,0,1,0,0,1,0,1597,1,445
경기도,고양시덕양구,창릉동,창릉동제4투,2631,2273,1060,379,497,155,170,6,0,0,1,1,1,0,1,2271,2,358
경기도,고양시덕양구,고양동,합계,23806,16964,6251,3856,3787,932,2005,28,3,9,13,10,2,4,3,16903,61,6842
경기도,고양시덕양구,고양동,관내사전투표,4612,4612,1854,973,935,270,552,8,1,4,3,0,0,0,0,4600,12,0
경기도,고양시덕양구,고양동,고양동제1투,2458,1524,489,386,372,86,179,0,0,0,0,4,0,1,1,1518,6,934
경기도,고양시덕양구,고양동,고양동제2투,2902,1743,574,424,401,86,242,2,0,1,3,1,1,1,0,1736,7,1159
경기도,고양시덕양구,고양동,고양동제3투,2986,2037,728,464,463,111,253,2,1,1,0,1,0,0,0,2024,13,949
경기도,고양시덕양구,고양동,고양동제4투,3626,2060,738,481,480,106,229,7,1,1,4,0,0,2,2,2051,9,1566
경기도,고양시덕양구,고양동,고양동제5투,1763,1126,310,390,260,42,112,3,0,2,1,1,1,0,0,1122,4,637
경기도,고양시덕양구,고양동,고양동제6투,2848,1970,777,376,490,98,216,6,0,0,1,2,0,0,0,1966,4,878
경기도,고양시덕양구,고양동,고양동제7투,2611,1892,781,362,386,133,222,0,0,0,1,1,0,0,0,1886,6,719
경기도,고양시덕양구,관산동,합계,26802,18218,6287,4436,4299,846,2202,27,5,15,7,12,7,7,11,18161,57,8584
경기도,고양시덕양구,관산동,관내사전투표,3710,3709,1502,787,766,179,451,7,1,4,2,1,0,1,1,3702,7,1
경기도,고양시덕양구,관산동,관산동제1투,2191,1208,375,292,311,47,175,1,0,0,0,1,0,1,0,1203,5,983
경기도,고양시덕양구,관산동,관산동제2투,2598,1816,576,511,435,75,205,3,1,0,0,1,0,1,2,1810,6,782
경기도,고양시덕양구,관산동,관산동제3투,3792,2603,936,595,604,128,320,2,1,2,1,1,2,1,1,2594,9,1189
경기도,고양시덕양구,관산동,관산동제4투,2689,1712,507,528,407,70,181,1,0,4,1,1,2,1,1,1704,8,977
경기도,고양시덕양구,관산동,관산동제5투,3359,1984,629,501,481,88,266,3,1,2,1,2,1,1,2,1978,6,1375
경기도,고양시덕양구,관산동,관산동제6투,3263,1874,635,407,483,100,230,3,0,1,1,5,1,0,1,1867,7,1389
경기도,고양시덕양구,관산동,관산동제7투,5200,3312,1127,815,812,159,374,7,1,2,1,0,1,1,3,3303,9,1888
경기도,고양시덕양구,능곡동,합계,15161,11087,4241,2580,2530,734,918,20,3,3,5,12,2,5,6,11059,28,4074
경기도,고양시덕양구,능곡동,관내사전투표,3244,3244,1396,653,701,215,256,4,0,1,1,2,0,3,2,3234,10,0
경기도,고양시덕양구,능곡동,능곡동제1투,2647,1667,604,420,390,129,115,4,1,2,0,0,0,0,1,1666,1,980
경기도,고양시덕양구,능곡동,능곡동제2투,2522,1643,618,357,381,124,155,0,0,0,0,1,1,1,1,1639,4,879
경기도,고양시덕양구,능곡동,능곡동제3투,2653,1702,621,390,435,98,141,5,0,0,1,3,1,0,1,1696,6,951
경기도,고양시덕양구,능곡동,능곡동제4투,1553,1063,343,349,211,42,109,2,2,0,1,1,0,0,1,1061,2,490
경기도,고양시덕양구,능곡동,능곡동제5투,2542,1768,659,411,412,126,142,5,0,0,2,5,0,1,0,1763,5,774
경기도,고양시덕양구,화정1동,합계,32198,25777,10427,5049,5335,1754,3035,52,3,2,12,15,5,6,7,25702,75,6421
경기도,고양시덕양구,화정1동,관내사전투표,8467,8466,3743,1378,1601,610,1074,19,2,0,5,5,1,4,2,8444,22,1
경기도,고양시덕양구,화정1동,화정1동제1투,2660,2144,847,382,455,150,298,3,0,0,0,4,0,0,0,2139,5,516
경기도,고양시덕양구,화정1동,화정1동제2투,2733,2055,838,400,430,140,234,5,0,0,2,0,0,0,2,2051,4,678
경기도,고양시덕양구,화정1동,화정1동제3투,2926,2197,913,406,475,149,239,4,0,0,0,1,0,0,2,2189,8,729
경기도,고양시덕양구,화정1동,화정1동제4투,2390,1851,703,383,420,111,221,3,0,2,1,1,0,2,0,1847,4,539
경기도,고양시덕양구,화정1동,화정1동제5투,3093,2402,834,647,510,174,227,2,0,0,0,2,0,0,0,2396,6,691
경기도,고양시덕양구,화정1동,화정1동제6투,2636,1631,629,350,332,102,207,6,0,0,0,0,2,0,0,1628,3,1005
경기도,고양시덕양구,화정1동,화정1동제7투,2246,1309,512,256,287,73,166,3,0,0,3,1,1,0,0,1302,7,937
경기도,고양시덕양구,화정1동,화정1동제8투,2560,2032,696,531,469,130,192,5,0,0,1,1,0,0,0,2025,7,528
경기도,고양시덕양구,화정1동,화정1동제9투,2487,1690,712,316,356,115,177,2,1,0,0,0,1,0,1,1681,9,797
경기도,고양시덕양구,화정2동,합계,24773,20397,9327,3214,4036,1328,2400,12,1,5,7,10,1,3,6,20350,47,4376
경기도,고양시덕양구,화정2동,관내사전투표,4937,4937,2515,614,882,307,600,4,0,1,3,1,0,1,1,4929,8,0
경기도,고양시덕양구,화정2동,화정2동제1투,2985,2089,926,354,417,114,264,4,0,2,0,3,0,0,0,2084,5,896
경기도,고양시덕양구,화정2동,화정2동제2투,3080,2366,1082,363,490,151,269,1,0,0,0,2,0,1,1,2360,6,714
경기도,고양시덕양구,화정2동,화정2동제3투,3120,2385,1044,371,504,177,281,0,0,0,0,1,0,0,1,2379,6,735
경기도,고양시덕양구,화정2동,화정2동제4투,2740,2201,961,418,423,148,243,2,0,0,0,0,0,1,0,2196,5,539
경기도,고양시덕양구,화정2동,화정2동제5투,2896,2373,1045,385,490,160,284,1,1,0,1,1,0,0,0,2368,5,523
경기도,고양시덕양구,화정2동,화정2동제6투,2216,1855,782,358,373,136,200,0,0,0,1,0,0,0,0,1850,5,361
경기도,고양시덕양구,화정2동,화정2동제7투,2799,2191,972,351,457,135,259,0,0,2,2,2,1,0,3,2184,7,608
경기도,고양시덕양구,행주동,합계,16319,10837,4145,2458,2518,679,944,22,0,7,2,11,6,8,11,10811,26,5482
경기도,고양시덕양구,행주동,관내사전투표,2231,2231,946,454,483,139,187,3,0,2,0,5,2,1,3,2225,6,0
경기도,고양시덕양구,행주동,행주동제1투,2310,1186,437,264,291,76,109,2,0,2,0,0,1,1,1,1184,2,1124
경기도,고양시덕양구,행주동,행주동제2투,2790,1647,593,362,396,100,178,2,0,1,0,3,1,3,3,1642,5,1143
경기도,고양시덕양구,행주동,행주동제3투,2772,1610,661,326,369,104,138,6,0,1,0,1,1,2,0,1609,1,1162
경기도,고양시덕양구,행주동,행주동제4투,2772,1781,677,407,426,107,146,4,0,1,2,1,1,1,3,1776,5,991
경기도,고양시덕양구,행주동,행주동제5투,1017,701,177,261,159,38,62,1,0,0,0,0,0,0,0,698,3,316
경기도,고양시덕양구,행주동,행주동제6투,2427,1681,654,384,394,115,124,4,0,0,0,1,0,0,1,1677,4,746
경기도,고양시덕양구,행신1동,관내사전투표,3589,3589,1818,480,678,227,357,12,0,1,0,3,0,2,3,3581,8,0
경기도,고양시덕양구,행신1동,합계,17909,14446,6373,2525,3211,986,1244,25,0,6,2,11,2,2,8,14395,51,3463
경기도,고양시덕양구,행신1동,행신1동제1투,2693,1927,835,345,417,126,179,4,0,1,2,3,0,0,0,1912,15,766
경기도,고양시덕양구,행신1동,행신1동제2투,3094,2396,1015,457,569,149,192,3,0,1,0,0,1,0,2,2389,7,698
경기도,고양시덕양구,행신1동,행신1동제3투,2679,1961,765,391,496,129,164,2,0,1,0,2,1,0,1,1952,9,718
경기도,고양시덕양구,행신1동,행신1동제4투,3009,2327,1002,386,587,181,160,0,0,1,0,2,0,0,1,2320,7,682
경기도,고양시덕양구,행신1동,행신1동제5투,2845,2246,938,466,464,174,192,4,0,1,0,1,0,0,1,2241,5,599
경기도,고양시덕양구,행신2동,합계,26441,21455,9859,3679,4380,1509,1884,27,5,7,8,17,2,11,15,21403,52,4986
경기도,고양시덕양구,행신2동,관내사전투표,6163,6160,3090,886,1102,417,621,5,2,2,3,10,1,3,5,6147,13,3
경기도,고양시덕양구,행신2동,행신2동제1투,3166,2180,857,456,535,146,171,6,0,0,1,0,1,2,2,2177,3,986
경기도,고양시덕양구,행신2동,행신2동제2투,2317,1776,748,344,372,141,159,5,0,1,0,1,0,1,0,1772,4,541
경기도,고양시덕양구,행신2동,행신2동제3투,3259,2494,983,562,539,202,192,2,2,1,1,1,0,1,2,2488,6,765
경기도,고양시덕양구,행신2동,행신2동제4투,2996,2276,1099,327,490,152,199,1,0,0,0,2,0,2,2,2274,2,720
경기도,고양시덕양구,행신2동,행신2동제5투,2934,2227,1051,383,436,143,198,2,0,2,1,0,0,1,0,2217,10,707
경기도,고양시덕양구,행신2동,행신2동제6투,2529,2016,981,296,406,148,168,3,1,1,1,2,0,1,1,2009,7,513
경기도,고양시덕양구,행신2동,행신2동제7투,2681,2033,947,325,447,144,157,3,0,0,1,1,0,0,2,2027,6,648
경기도,고양시덕양구,행신2동,행신2동제8투,396,293,103,100,53,16,19,0,0,0,0,0,0,0,1,292,1,103
경기도,고양시덕양구,행신3동,관내사전투표,6049,6049,3026,885,1115,396,593,8,0,2,3,6,1,0,1,6036,13,0
경기도,고양시덕양구,행신3동,합계,35423,27876,12526,4833,5903,1874,2570,33,3,13,8,25,3,7,10,27808,68,7547
경기도,고양시덕양구,행신3동,행신3동제1투,3596,2629,1203,435,567,177,223,2,0,0,2,6,1,2,1,2619,10,967
경기도,고양시덕양구,행신3동,행신3동제2투,3133,2516,1221,373,542,148,227,1,0,0,0,1,0,1,1,2515,1,617
경기도,고양시덕양구,행신3동,행신3동제3투,3199,2582,1069,477,577,197,245,2,0,0,0,1,0,1,3,2572,10,617
경기도,고양시덕양구,행신3동,행신3동제4투,3054,2500,1100,419,539,187,242,2,0,3,0,1,0,0,0,2493,7,554
경기도,고양시덕양구,행신3동,행신3동제5투,3220,2358,879,554,549,154,210,2,0,1,0,2,0,0,0,2351,7,862
경기도,고양시덕양구,행신3동,행신3동제6투,3603,2303,927,475,523,167,188,4,1,3,0,4,0,1,2,2295,8,1300
경기도,고양시덕양구,행신3동,행신3동제7투,2441,1401,525,299,317,85,163,2,1,2,1,2,0,1,0,1398,3,1040
경기도,고양시덕양구,행신3동,행신3동제8투,3880,2995,1377,506,622,204,274,4,1,0,2,0,0,1,1,2992,3,885
경기도,고양시덕양구,행신3동,행신3동제9투,3248,2543,1199,410,552,159,205,6,0,2,0,2,1,0,1,2537,6,705
경기도,고양시덕양구,화전동,관내사전투표,980,978,358,196,251,86,73,1,0,2,1,1,0,1,1,971,7,2
경기도,고양시덕양구,화전동,합계,4596,3125,1042,855,749,231,210,3,0,3,1,4,1,3,9,3111,14,1471
경기도,고양시덕양구,화전동,화전동제1투,2673,1538,489,450,363,115,103,0,0,1,0,3,1,0,8,1533,5,1135
경기도,고양시덕양구,화전동,화전동제2투,943,609,195,209,135,30,34,2,0,0,0,0,0,2,0,607,2,334
경기도,고양시덕양구,대덕동,합계,2377,1657,536,471,416,120,100,2,0,0,0,3,0,0,2,1650,7,720
경기도,고양시덕양구,대덕동,관내사전투표,481,481,187,128,97,31,32,0,0,0,0,3,0,0,0,478,3,0
경기도,고양시덕양구,대덕동,대덕동제1투,910,512,150,136,153,43,26,1,0,0,0,0,0,0,2,511,1,398
경기도,고양시덕양구,대덕동,대덕동제2투,986,664,199,207,166,46,42,1,0,0,0,0,0,0,0,661,3,322
경기도,고양시덕양구,잘못 투입·구분된 투표지,,0,5,2,2,0,0,1,0,0,0,0,0,0,0,0,5,0,-5
경기도,고양시일산동구,합계,,239470,188297,81622,34980,41166,13989,15308,268,26,87,43,86,24,54,105,187758,539,51173
경기도,고양시일산동구,거소·선상투표,,494,473,205,61,135,19,19,0,2,3,2,0,1,0,3,450,23,21
경기도,고양시일산동구,관외사전투표,,22559,22557,10366,3284,4726,1834,2111,34,6,9,3,11,7,7,21,22419,138,2
경기도,고양시일산동구,재외투표,,2723,2190,1306,151,337,97,284,7,1,0,0,0,0,1,1,2185,5,533
경기도,고양시일산동구,식사동,합계,22118,17533,7177,3513,3932,1419,1422,16,1,7,2,6,0,5,7,17507,26,4585
경기도,고양시일산동구,식사동,관내사전투표,3844,3844,1835,592,716,295,389,4,0,0,0,2,0,2,4,3839,5,0
경기도,고양시일산동구,식사동,식사동제1투,4027,2779,1173,453,702,215,224,2,0,1,0,3,0,0,1,2774,5,1248
경기도,고양시일산동구,식사동,식사동제2투,2732,2129,771,520,512,136,181,1,1,0,1,0,0,0,0,2123,6,603
경기도,고양시일산동구,식사동,식사동제3투,2246,1736,682,380,375,157,134,0,0,2,0,0,0,1,1,1732,4,510
경기도,고양시일산동구,식사동,식사동제4투,2695,2160,910,399,488,196,159,4,0,2,0,0,0,1,0,2159,1,535
경기도,고양시일산동구,식사동,식사동제5투,2807,1947,683,501,465,147,144,1,0,2,0,0,0,1,1,1945,2,860
경기도,고양시일산동구,식사동,식사동제6투,3767,2938,1123,668,674,273,191,4,0,0,1,1,0,0,0,2935,3,829
경기도,고양시일산동구,중산동,합계,31738,23758,9854,4715,5521,1645,1878,29,4,12,5,11,5,2,16,23697,61,7980
경기도,고양시일산동구,중산동,관내사전투표,5736,5736,2527,1036,1204,422,517,4,1,3,0,1,2,0,3,5720,16,0
경기도,고양시일산동구,중산동,중산동제1투,2657,1597,667,313,373,124,113,2,1,0,1,0,0,1,1,1596,1,1060
경기도,고양시일산동구,중산동,중산동제2투,2795,1826,747,335,466,136,129,1,0,2,0,1,1,0,4,1822,4,969
경기도,고양시일산동구,중산동,중산동제3투,3035,2284,837,515,542,184,189,6,1,1,1,1,1,0,2,2280,4,751
경기도,고양시일산동구,중산동,중산동제4투,2731,1777,675,408,413,144,126,2,0,0,0,2,0,1,1,1772,5,954
경기도,고양시일산동구,중산동,중산동제5투,2720,1812,681,474,406,133,111,3,0,0,0,0,0,0,0,1808,4,908
경기도,고양시일산동구,중산동,중산동제6투,3440,2397,909,496,668,121,188,5,0,1,0,0,0,0,2,2390,7,1043
경기도,고양시일산동구,중산동,중산동제7투,4350,3181,1395,589,741,179,251,4,1,2,0,6,1,0,1,3170,11,1169
경기도,고양시일산동구,중산동,중산동제8투,4274,3148,1416,549,708,202,254,2,0,3,3,0,0,0,2,3139,9,1126
경기도,고양시일산동구,정발산동,합계,20090,15332,6497,2954,3395,1100,1289,29,1,7,2,7,0,6,7,15294,38,4758
경기도,고양시일산동구,정발산동,관내사전투표,4184,4184,2028,676,794,275,386,6,0,3,0,3,0,2,3,4176,8,0
경기도,고양시일산동구,정발산동,정발산동제1투,2882,1917,787,355,454,138,167,3,0,2,0,1,0,2,2,1911,6,965
경기도,고양시일산동구,정발산동,정발산동제2투,2588,1769,705,368,428,112,149,2,0,0,1,1,0,0,0,1766,3,819
경기도,고양시일산동구,정발산동,정발산동제3투,2894,2000,857,353,474,140,166,1,1,0,0,0,0,2,1,1995,5,894
경기도,고양시일산동구,정발산동,정발산동제4투,1755,1332,527,283,304,106,103,5,0,0,0,0,0,0,0,1328,4,423
경기도,고양시일산동구,정발산동,정발산동제5투,2875,1948,758,409,451,154,167,3,0,0,0,2,0,0,0,1944,4,927
경기도,고양시일산동구,정발산동,정발산동제6투,2912,2182,835,510,490,175,151,9,0,2,1,0,0,0,1,2174,8,730
경기도,고양시일산동구,풍산동,합계,27653,21719,9784,3809,4848,1471,1705,15,1,14,4,12,1,2,12,21678,41,5934
경기도,고양시일산동구,풍산동,관내사전투표,5917,5917,2924,924,1121,417,504,4,0,3,0,8,0,1,3,5909,8,0
경기도,고양시일산동구,풍산동,풍산동제1투,4412,3054,1347,535,707,221,232,0,0,3,1,1,0,0,1,3048,6,1358
경기도,고양시일산동구,풍산동,풍산동제2투,2652,2054,943,325,447,165,167,2,0,0,0,2,0,0,1,2052,2,598
경기도,고양시일산동구,풍산동,풍산동제3투,2634,1893,730,413,464,125,148,1,0,1,3,1,1,0,0,1887,6,741
경기도,고양시일산동구,풍산동,풍산동제4투,3538,2424,1101,415,601,121,171,3,0,3,0,0,0,1,3,2419,5,1114
경기도,고양시일산동구,풍산동,풍산동제5투,2585,2061,970,329,453,152,151,1,0,0,0,0,0,0,1,2057,4,524
경기도,고양시일산동구,풍산동,풍산동제6투,2694,1956,843,354,472,118,157,2,0,3,0,0,0,0,1,1950,6,738
경기도,고양시일산동구,풍산동,풍산동제7투,3221,2360,926,514,583,152,175,2,1,1,0,0,0,0,2,2356,4,861
경기도,고양시일산동구,백석1동,합계,23955,18804,8499,3140,4077,1486,1491,37,0,6,6,8,1,4,4,18759,45,5151
경기도,고양시일산동구,백석1동,관내사전투표,4289,4289,2204,559,770,329,407,7,0,0,0,2,0,1,0,4279,10,0
경기도,고양시일산동구,백석1동,백석1동제1투,2069,1317,538,263,317,88,100,3,0,2,0,1,0,1,0,1313,4,752
경기도,고양시일산동구,백석1동,백석1동제2투,2621,1966,849,326,489,138,151,9,0,0,0,0,0,0,0,1962,4,655
경기도,고양시일산동구,백석1동,백석1동제3투,2710,2141,991,344,458,178,162,1,0,0,1,1,0,0,0,2136,5,569
경기도,고양시일산동구,백석1동,백석1동제4투,2942,2288,992,448,494,172,168,0,0,1,2,3,0,0,1,2281,7,654
경기도,고양시일산동구,백석1동,백석1동제5투,2932,1974,878,339,439,144,161,8,0,0,0,0,1,0,0,1970,4,958
경기도,고양시일산동구,백석1동,백석1동제6투,2364,1675,690,353,375,127,120,2,0,3,0,0,0,0,2,1672,3,689
경기도,고양시일산동구,백석1동,백석1동제7투,4028,3154,1357,508,735,310,222,7,0,0,3,1,0,2,1,3146,8,874
경기도,고양시일산동구,백석2동,합계,17616,13016,5927,2273,2774,914,1048,13,4,6,5,7,4,6,2,12983,33,4600
경기도,고양시일산동구,백석2동,관내사전투표,3970,3970,2052,579,731,242,341,4,0,1,1,5,3,3,1,3963,7,0
경기도,고양시일산동구,백석2동,백석2동제1투,2733,1932,822,383,439,155,125,1,0,1,1,0,0,0,0,1927,5,801
경기도,고양시일산동구,백석2동,백석2동제2투,2948,2038,832,402,503,128,160,3,1,1,1,0,0,0,0,2031,7,910
경기도,고양시일산동구,백석2동,백석2동제3투,3834,2393,940,505,572,185,171,3,1,2,2,2,0,2,0,2385,8,1441
경기도,고양시일산동구,백석2동,백석2동제4투,4131,2683,1281,404,529,204,251,2,2,1,0,0,1,1,1,2677,6,1448
경기도,고양시일산동구,마두1동,합계,21430,18021,8063,3177,3763,1463,1465,31,1,2,5,1,0,10,8,17989,32,3409
경기도,고양시일산동구,마두1동,관내사전투표,6918,6918,3440,952,1309,544,633,11,0,1,3,1,0,3,4,6901,17,0
경기도,고양시일산동구,마두1동,마두1동제1투,3217,2405,1030,466,551,172,177,3,0,0,1,0,0,2,0,2402,3,812
경기도,고양시일산동구,마두1동,마두1동제2투,3020,2483,1053,479,525,264,153,5,0,0,0,0,0,0,2,2481,2,537
경기도,고양시일산동구,마두1동,마두1동제3투,3072,2208,876,459,511,163,192,1,1,1,1,0,0,1,0,2206,2,864
경기도,고양시일산동구,마두1동,마두1동제4투,2670,2157,969,372,459,180,171,2,0,0,0,0,0,0,0,2153,4,513
경기도,고양시일산동구,마두1동,마두1동제5투,2533,1850,695,449,408,140,139,9,0,0,0,0,0,4,2,1846,4,683
경기도,고양시일산동구,마두2동,합계,12112,10057,4080,2152,2188,863,711,12,0,8,2,5,0,1,6,10028,29,2055
경기도,고양시일산동구,마두2동,관내사전투표,2617,2617,1217,419,545,206,213,6,0,2,0,3,0,1,2,2614,3,0
경기도,고양시일산동구,마두2동,마두2동제1투,2453,1973,736,482,425,179,145,2,0,0,0,1,0,0,0,1970,3,480
경기도,고양시일산동구,마두2동,마두2동제2투,2589,2040,788,484,448,189,116,0,0,5,0,0,0,0,4,2034,6,549
경기도,고양시일산동구,마두2동,마두2동제3투,1684,1168,505,241,241,83,89,2,0,1,0,0,0,0,0,1162,6,516
경기도,고양시일산동구,마두2동,마두2동제4투,2769,2259,834,526,529,206,148,2,0,0,2,1,0,0,0,2248,11,510
경기도,고양시일산동구,장항1동,합계,2540,1809,546,647,428,71,102,1,0,0,0,1,0,0,2,1798,11,731
경기도,고양시일산동구,장항1동,관내사전투표,574,574,221,172,126,21,29,0,0,0,0,0,0,0,0,569,5,0
경기도,고양시일산동구,장항1동,장항1동투표소,1966,1235,325,475,302,50,73,1,0,0,0,1,0,0,2,1229,6,731
경기도,고양시일산동구,장항2동,합계,20464,14153,6360,2643,2901,1121,1058,28,2,2,1,9,0,3,4,14132,21,6311
경기도,고양시일산동구,장항2동,관내사전투표,3875,3875,1874,663,713,296,316,6,1,1,0,2,0,1,0,3873,2,0
경기도,고양시일산동구,장항2동,장항2동제1투,3336,2364,1055,455,528,178,133,6,0,0,0,4,0,0,1,2360,4,972
경기도,고양시일산동구,장항2동,장항2동제2투,2687,2176,733,593,504,201,130,7,0,1,1,1,0,0,0,2171,5,511
경기도,고양시일산동구,장항2동,장항2동제3투,3316,1810,771,335,399,158,137,3,0,0,0,1,0,2,1,1807,3,1506
경기도,고양시일산동구,장항2동,장항2동제4투,3371,1894,917,295,380,131,164,2,0,0,0,0,0,0,2,1891,3,1477
경기도,고양시일산동구,장항2동,장항2동제5투,3879,2034,1010,302,377,157,178,4,1,0,0,1,0,0,0,2030,4,1845
경기도,고양시일산동구,고봉동,합계,13978,8874,2957,2461,2141,486,725,16,3,11,6,8,5,7,12,8838,36,5104
경기도,고양시일산동구,고봉동,관내사전투표,1589,1589,588,434,350,72,127,4,0,1,3,2,1,1,2,1585,4,0
경기도,고양시일산동구,고봉동,고봉동제1투,4496,2469,859,643,589,159,206,0,0,0,0,0,0,2,3,2461,8,2027
경기도,고양시일산동구,고봉동,고봉동제2투,3529,1936,563,655,450,99,129,6,2,6,2,5,3,4,1,1925,11,1593
경기도,고양시일산동구,고봉동,고봉동제3투,4364,2880,947,729,752,156,263,6,1,4,1,1,1,0,6,2867,13,1484
경기도,고양시일산동구,잘못 투입·구분된 투표지,,0,1,1,0,0,0,0,0,0,0,0,0,0,0,0,1,0,-1
경기도,고양시일산서구,합계,,239069,192610,85919,35147,41563,13991,14764,265,23,80,42,88,23,57,105,192067,543,46459
경기도,고양시일산서구,거소·선상투표,,442,426,144,63,160,29,15,2,1,0,0,0,4,0,1,419,7,16
경기도,고양시일산서구,관외사전투표,,21916,21912,10406,3030,4467,1740,2036,26,6,7,5,10,3,5,42,21783,129,4
경기도,고양시일산서구,재외투표,,2692,2129,1303,140,312,85,265,10,1,0,0,4,1,1,0,2122,7,563
경기도,고양시일산서구,일산1동,합계,21401,16311,7154,3149,3623,1041,1252,17,3,8,3,5,1,3,7,16266,45,5090
경기도,고양시일산서구,일산1동,관내사전투표,4569,4569,2086,922,913,283,346,4,0,3,0,0,0,0,3,4560,9,0
경기도,고양시일산서구,일산1동,일산1동제1투,2659,1728,757,313,393,125,137,1,0,0,1,0,0,0,0,1727,1,931
경기도,고양시일산서구,일산1동,일산1동제2투,3068,2074,893,395,503,106,160,3,1,2,1,1,0,1,2,2068,6,994
경기도,고양시일산서구,일산1동,일산1동제3투,2371,1607,677,313,387,101,116,0,1,1,1,4,0,0,1,1602,5,764
경기도,고양시일산서구,일산1동,일산1동제4투,3034,2111,924,384,494,123,176,2,0,1,0,0,0,0,0,2104,7,923
경기도,고양시일산서구,일산1동,일산1동제5투,2979,2220,909,470,491,162,169,6,1,0,0,0,0,2,0,2210,10,759
경기도,고양시일산서구,일산1동,일산1동제6투,2721,2002,908,352,442,141,148,1,0,1,0,0,1,0,1,1995,7,719
경기도,고양시일산서구,일산2동,합계,15978,11922,4754,2662,2727,808,883,15,3,8,7,9,1,4,3,11884,38,4056
경기도,고양시일산서구,일산2동,관내사전투표,2980,2980,1309,572,645,193,239,6,0,1,3,3,0,1,1,2973,7,0
경기도,고양시일산서구,일산2동,일산2동제1투,2413,1566,591,342,378,124,117,1,2,1,1,1,0,0,0,1558,8,847
경기도,고양시일산서구,일산2동,일산2동제2투,3322,2723,1139,551,602,223,198,2,0,1,0,1,1,0,0,2718,5,599
경기도,고양시일산서구,일산2동,일산2동제3투,2333,1647,633,425,385,83,104,2,0,4,1,2,0,1,1,1641,6,686
경기도,고양시일산서구,일산2동,일산2동제4투,1786,968,349,267,219,43,80,3,1,1,0,0,0,0,0,963,5,818
경기도,고양시일산서구,일산2동,일산2동제5투,3144,2038,733,505,498,142,145,1,0,0,2,2,0,2,1,2031,7,1106
경기도,고양시일산서구,일산3동,합계,25940,21752,10461,3330,4508,1703,1657,30,0,7,3,7,1,4,2,21713,39,4188
경기도,고양시일산서구,일산3동,관내사전투표,5532,5532,2958,669,1004,421,451,8,0,4,2,2,1,1,1,5522,10,0
경기도,고양시일산서구,일산3동,일산3동제1투,2374,1751,788,280,383,154,144,0,0,0,0,0,0,1,0,1750,1,623
경기도,고양시일산서구,일산3동,일산3동제2투,3049,2447,1002,483,531,222,202,6,0,0,0,0,0,0,0,2446,1,602
경기도,고양시일산서구,일산3동,일산3동제3투,3050,2433,1162,407,505,160,189,2,0,1,0,2,0,0,1,2429,4,617
경기도,고양시일산서구,일산3동,일산3동제4투,2250,1758,799,304,381,137,130,2,0,0,0,1,0,0,0,1754,4,492
경기도,고양시일산서구,일산3동,일산3동제5투,2961,2456,1260,309,506,198,169,4,0,2,0,1,0,1,0,2450,6,505
경기도,고양시일산서구,일산3동,일산3동제6투,2300,1890,884,310,409,156,123,1,0,0,0,1,0,0,0,1884,6,410
경기도,고양시일산서구,일산3동,일산3동제7투,1982,1550,734,227,362,114,106,3,0,0,0,0,0,0,0,1546,4,432
경기도,고양시일산서구,일산3동,일산3동제8투,2442,1935,874,341,427,141,143,4,0,0,1,0,0,1,0,1932,3,507
경기도,고양시일산서구,탄현동,합계,35364,27549,12630,4534,6132,1976,2138,29,1,8,3,10,3,9,11,27484,65,7815
경기도,고양시일산서구,탄현동,관내사전투표,7509,7509,3674,1084,1519,547,646,10,0,3,1,1,2,2,3,7492,17,0
경기도,고양시일산서구,탄현동,탄현동제1투,2553,1531,625,290,381,100,128,2,0,0,0,1,0,2,0,1529,2,1022
경기도,고양시일산서구,탄현동,탄현동제2투,2132,1553,661,262,404,96,119,1,0,0,2,1,0,0,1,1547,6,579
경기도,고양시일산서구,탄현동,탄현동제3투,3061,2127,947,366,486,142,162,5,0,0,0,1,0,1,0,2110,17,934
경기도,고양시일산서구,탄현동,탄현동제4투,3145,2309,957,455,542,171,174,1,0,1,0,0,0,2,2,2305,4,836
경기도,고양시일산서구,탄현동,탄현동제5투,3987,3034,1412,502,702,221,189,1,0,2,0,0,0,0,1,3030,4,953
경기도,고양시일산서구,탄현동,탄현동제6투,3086,2301,960,447,521,177,185,1,1,1,0,4,0,0,1,2298,3,785
경기도,고양시일산서구,탄현동,탄현동제7투,2945,2063,985,311,463,141,154,4,0,0,0,1,0,1,0,2060,3,882
경기도,고양시일산서구,탄현동,탄현동제8투,2720,1851,864,304,412,119,147,1,0,0,0,0,0,0,1,1848,3,869
경기도,고양시일산서구,탄현동,탄현동제9투,4226,3271,1545,513,702,262,234,3,0,1,0,1,1,1,2,3265,6,955
경기도,고양시일산서구,주엽1동,합계,22260,18398,8175,3627,3846,1382,1253,24,0,14,5,8,0,8,8,18350,48,3862
경기도,고양시일산서구,주엽1동,관내사전투표,5202,5202,2602,832,928,414,394,6,0,4,2,3,0,3,3,5191,11,0
경기도,고양시일산서구,주엽1동,주엽1동제1투,2651,1866,832,370,398,119,135,3,0,2,1,0,0,1,1,1862,4,785
경기도,고양시일산서구,주엽1동,주엽1동제2투,2138,1699,736,355,358,143,99,2,0,0,0,0,0,0,1,1694,5,439
경기도,고양시일산서구,주엽1동,주엽1동제3투,2118,1723,698,355,408,133,117,4,0,1,0,0,0,1,2,1719,4,395
경기도,고양시일산서구,주엽1동,주엽1동제4투,2559,1970,881,353,439,126,155,6,0,2,0,2,0,1,1,1966,4,589
경기도,고양시일산서구,주엽1동,주엽1동제5투,1452,1009,445,189,241,58,71,0,0,0,0,1,0,1,0,1006,3,443
경기도,고양시일산서구,주엽1동,주엽1동제6투,2010,1613,600,422,356,133,91,2,0,2,0,1,0,1,0,1608,5,397
경기도,고양시일산서구,주엽1동,주엽1동제7투,2316,1840,749,445,381,144,112,0,0,0,0,1,0,0,0,1832,8,476
경기도,고양시일산서구,주엽1동,주엽1동제8투,1814,1476,632,306,337,112,79,1,0,3,2,0,0,0,0,1472,4,338
경기도,고양시일산서구,주엽2동,합계,22339,17850,7706,3757,3816,1259,1198,33,2,9,3,3,5,3,9,17803,47,4489
경기도,고양시일산서구,주엽2동,관내사전투표,3970,3969,1929,678,741,284,308,10,0,2,0,0,2,0,2,3956,13,1
경기도,고양시일산서구,주엽2동,주엽2동제1투,2266,1687,675,405,375,131,96,2,1,0,0,0,0,0,0,1685,2,579
경기도,고양시일산서구,주엽2동,주엽2동제2투,2201,1763,821,309,365,140,118,5,0,0,0,0,2,0,0,1760,3,438
경기도,고양시일산서구,주엽2동,주엽2동제3투,1792,1384,596,291,280,116,96,2,0,0,0,1,0,0,0,1382,2,408
경기도,고양시일산서구,주엽2동,주엽2동제4투,2449,1747,711,355,413,113,142,2,0,3,1,0,1,0,1,1742,5,702
경기도,고양시일산서구,주엽2동,주엽2동제5투,2052,1580,586,424,372,109,83,2,0,0,1,0,0,0,0,1577,3,472
경기도,고양시일산서구,주엽2동,주엽2동제6투,2015,1400,574,311,332,73,91,1,1,2,0,0,0,3,2,1390,10,615
경기도,고양시일산서구,주엽2동,주엽2동제7투,2852,2280,950,529,495,164,130,2,0,2,0,0,0,0,3,2275,5,572
경기도,고양시일산서구,주엽2동,주엽2동제8투,2742,2040,864,455,443,129,134,7,0,0,1,2,0,0,1,2036,4,702
경기도,고양시일산서구,대화동,합계,25296,19233,8277,3573,4105,1475,1662,38,2,10,6,18,1,6,12,19185,48,6063
경기도,고양시일산서구,대화동,관내사전투표,4855,4855,2324,703,910,402,476,11,0,5,0,5,0,0,3,4839,16,0
경기도,고양시일산서구,대화동,대화동제1투,3291,2258,906,414,531,180,210,7,0,1,0,2,0,1,2,2254,4,1033
경기도,고양시일산서구,대화동,대화동제2투,2992,2264,1019,394,474,173,183,9,1,1,0,3,0,1,2,2260,4,728
경기도,고양시일산서구,대화동,대화동제3투,3511,2719,1181,519,580,188,234,4,0,1,0,3,1,1,2,2714,5,792
경기도,고양시일산서구,대화동,대화동제4투,1980,1340,507,311,302,110,99,5,0,1,0,1,0,0,1,1337,3,640
경기도,고양시일산서구,대화동,대화동제5투,2583,1691,718,369,347,106,139,1,0,1,1,3,0,0,2,1687,4,892
경기도,고양시일산서구,대화동,대화동제6투,3578,2566,1015,543,611,207,176,1,1,0,5,0,0,0,0,2559,7,1012
경기도,고양시일산서구,대화동,대화동제7투,2506,1540,607,320,350,109,145,0,0,0,0,1,0,3,0,1535,5,966
경기도,고양시일산서구,송포동,합계,13249,10805,4640,2275,2275,821,744,11,0,2,1,5,0,6,4,10784,21,2444
경기도,고양시일산서구,송포동,관내사전투표,3561,3561,1683,624,695,278,272,0,0,0,0,2,0,1,1,3556,5,0
경기도,고양시일산서구,송포동,송포동제1투,3677,2565,819,802,589,170,175,1,0,0,0,0,0,2,1,2559,6,1112
경기도,고양시일산서구,송포동,송포동제2투,3218,2523,1202,438,510,203,154,4,0,1,0,2,0,3,2,2519,4,695
경기도,고양시일산서구,송포동,송포동제3투,2793,2156,936,411,481,170,143,6,0,1,1,1,0,0,0,2150,6,637
경기도,고양시일산서구,송산동,합계,32192,24323,10269,5007,5592,1672,1661,30,4,7,6,9,3,8,6,24274,49,7869
경기도,고양시일산서구,송산동,관내사전투표,4018,4018,1895,736,819,240,308,2,0,2,1,2,0,1,3,4009,9,0
경기도,고양시일산서구,송산동,송산동제1투,2488,1601,640,374,358,113,112,0,1,0,1,2,0,0,0,1601,0,887
경기도,고양시일산서구,송산동,송산동제2투,3596,2284,854,584,547,138,147,5,1,2,1,0,0,0,1,2280,4,1312
경기도,고양시일산서구,송산동,송산동제3투,3444,2566,957,613,617,203,167,2,0,0,0,0,0,0,0,2559,7,878
경기도,고양시일산서구,송산동,송산동제4투,2271,1475,379,567,350,78,89,2,0,1,1,0,0,2,1,1470,5,796
경기도,고양시일산서구,송산동,송산동제5투,3131,2479,1168,399,549,176,180,1,0,0,1,2,0,1,0,2477,2,652
경기도,고양시일산서구,송산동,송산동제6투,3664,2926,1333,460,732,207,178,6,0,1,0,0,1,2,1,2921,5,738
경기도,고양시일산서구,송산동,송산동제7투,3474,2586,1219,409,566,209,172,3,0,1,0,0,1,0,0,2580,6,888
경기도,고양시일산서구,송산동,송산동제8투,3899,3020,1309,577,724,215,175,6,2,0,1,2,0,1,0,3012,8,879
경기도,고양시일산서구,송산동,송산동제9투,2207,1368,515,288,330,93,133,3,0,0,0,1,1,1,0,1365,3,839
경기도,고양시일산서구,잘못 투입·구분된 투표지,,0,0,0,0,0,0,0,0,0,0,0,0,0,0,0,0,0,0
경기도,과천시,합계,,49206,40789,16528,9055,8736,3354,2814,72,8,14,7,17,9,19,29,40662,127,8417
경기도,과천시,거소·선상투표,,120,106,31,26,33,6,3,1,0,1,2,0,0,0,0,103,3,14
경기도,과천시,관외사전투표,,5609,5609,2564,885,1159,480,462,6,2,1,1,5,2,2,6,5575,34,0
경기도,과천시,재외투표,,862,679,398,58,112,30,78,1,0,0,0,0,0,0,1,678,1,183
경기도,과천시,중앙동,합계,5259,4331,1549,1098,946,421,290,3,2,3,0,0,1,1,0,4314,17,928
경기도,과천시,중앙동,관내사전투표,1449,1449,544,344,303,143,109,0,1,0,0,0,0,1,0,1445,4,0
경기도,과천시,중앙동,중앙동제1투,1439,953,349,246,206,80,67,1,0,0,0,0,0,0,0,949,4,486
경기도,과천시,중앙동,중앙동제2투,2371,1929,656,508,437,198,114,2,1,3,0,0,1,0,0,1920,9,442
경기도,과천시,갈현동,합계,8436,7010,2891,1527,1509,619,434,10,0,0,2,1,0,1,5,6999,11,1426
경기도,과천시,갈현동,관내사전투표,1502,1501,715,249,287,132,112,2,0,0,0,1,0,0,0,1498,3,1
경기도,과천시,갈현동,갈현동제1투,830,531,150,188,122,44,22,0,0,0,1,0,0,0,1,528,3,299
경기도,과천시,갈현동,갈현동제2투,820,547,216,132,110,48,37,2,0,0,0,0,0,0,0,545,2,273
경기도,과천시,갈현동,갈현동제3투,2528,2082,867,426,474,186,124,0,0,0,0,0,0,1,2,2080,2,446
경기도,과천시,갈현동,갈현동제4투,2756,2349,943,532,516,209,139,6,0,0,1,0,0,0,2,2348,1,407
경기도,과천시,별양동,합계,8783,7202,2881,1659,1515,646,460,8,0,2,1,3,2,2,7,7186,16,1581
경기도,과천시,별양동,관내사전투표,2286,2286,1060,442,408,201,164,1,0,1,0,2,0,1,2,2282,4,0
경기도,과천시,별양동,별양동제1투,846,566,189,136,149,52,36,1,0,0,0,1,0,0,0,564,2,280
경기도,과천시,별양동,별양동제2투,2011,1437,569,341,322,99,92,4,0,0,1,0,2,0,1,1431,6,574
경기도,과천시,별양동,별양동제3투,1811,1449,584,307,322,131,98,2,0,0,0,0,0,1,2,1447,2,362
경기도,과천시,별양동,별양동제4투,1829,1464,479,433,314,163,70,0,0,1,0,0,0,0,2,1462,2,365
경기도,과천시,부림동,합계,7835,6423,2600,1358,1410,550,460,15,1,2,1,3,0,3,2,6405,18,1412
경기도,과천시,부림동,관내사전투표,1982,1982,852,392,397,176,147,6,0,1,0,1,0,0,1,1973,9,0
경기도,과천시,부림동,부림동제1투,2166,1662,628,367,379,162,118,2,0,1,0,0,0,0,0,1657,5,504
경기도,과천시,부림동,부림동제2투,1735,1423,606,266,301,128,115,2,1,0,1,0,0,0,0,1420,3,312
경기도,과천시,부림동,부림동제3투,1952,1356,514,333,333,84,80,5,0,0,0,2,0,3,1,1355,1,596
경기도,과천시,과천동,관내사전투표,918,918,386,215,170,71,72,2,0,0,0,0,1,0,0,917,1,0
경기도,과천시,과천동,합계,6828,5047,1860,1393,1113,325,315,14,2,1,0,2,1,5,5,5036,11,1781
경기도,과천시,과천동,과천동제1투,1452,987,357,255,230,65,77,0,0,0,0,1,0,0,1,986,1,465
경기도,과천시,과천동,과천동제2투,1758,1235,341,451,291,71,68,5,0,1,0,0,0,1,1,1230,5,523
경기도,과천시,과천동,과천동제3투,900,594,208,191,134,36,20,3,0,0,0,0,0,0,0,592,2,306
경기도,과천시,과천동,과천동제4투,1800,1313,568,281,288,82,78,4,2,0,0,1,0,4,3,1311,2,487
경기도,과천시,문원동,합계,5474,4382,1754,1051,939,277,312,14,1,4,0,3,3,5,3,4366,16,1092
경기도,과천시,문원동,관내사전투표,1186,1186,552,235,226,70,90,4,1,0,0,2,1,1,0,1182,4,0
경기도,과천시,문원동,문원동제1투,1980,1427,563,344,302,102,103,4,0,3,0,0,1,1,1,1424,3,553
경기도,과천시,문원동,문원동제2투,2308,1769,639,472,411,105,119,6,0,1,0,1,1,3,2,1760,9,539
경기도,과천시,잘못 투입·구분된 투표지,,0,0,0,0,0,0,0,0,0,0,0,0,0,0,0,0,0,0
경기도,의왕시,합계,,127577,103913,43869,21218,23602,7575,6902,139,13,54,17,57,18,32,66,103562,351,23664
경기도,의왕시,거소·선상투표,,222,211,65,44,74,7,8,1,2,0,1,1,0,0,0,203,8,11
경기도,의왕시,관외사전투표,,13258,13258,6210,1975,2726,1135,1070,14,1,3,1,6,4,6,15,13166,92,0
경기도,의왕시,재외투표,,1188,934,574,67,134,48,106,4,0,0,0,0,0,0,0,933,1,254
경기도,의왕시,고천동,합계,9873,7756,3025,2061,1631,510,479,10,2,2,2,4,1,5,3,7735,21,2117
경기도,의왕시,고천동,관내사전투표,2591,2591,1097,641,492,157,188,1,0,1,1,2,0,1,1,2582,9,0
경기도,의왕시,고천동,고천동제1투,1720,1025,332,324,254,73,35,2,1,0,1,0,0,2,1,1025,0,695
경기도,의왕시,고천동,고천동제2투,2464,1749,685,467,370,114,108,2,0,0,0,0,0,1,0,1747,2,715
경기도,의왕시,고천동,고천동제3투,3098,2391,911,629,515,166,148,5,1,1,0,2,1,1,1,2381,10,707
경기도,의왕시,부곡동,합계,19912,15169,5921,3470,3598,999,1057,21,1,21,2,7,5,2,7,15111,58,4743
경기도,의왕시,부곡동,관내사전투표,3923,3923,1703,789,856,250,294,4,0,6,1,1,0,1,2,3907,16,0
경기도,의왕시,부곡동,부곡동제1투,2055,1432,517,321,356,119,107,3,0,3,0,0,1,1,2,1430,2,623
경기도,의왕시,부곡동,부곡동제2투,2162,1538,541,388,380,115,103,1,0,1,0,0,1,0,1,1531,7,624
경기도,의왕시,부곡동,부곡동제3투,2348,1516,594,337,370,97,110,0,0,0,0,1,1,0,0,1510,6,832
경기도,의왕시,부곡동,부곡동제4투,2917,2233,910,478,531,150,147,2,0,5,1,0,0,0,0,2224,9,684
경기도,의왕시,부곡동,부곡동제5투,2881,2035,788,484,499,107,140,2,0,1,0,1,1,0,2,2025,10,846
경기도,의왕시,부곡동,부곡동제6투,3626,2492,868,673,606,161,156,9,1,5,0,4,1,0,0,2484,8,1134
경기도,의왕시,오전동,합계,28102,22471,9287,4706,5332,1615,1406,27,2,12,1,13,2,4,17,22424,47,5631
경기도,의왕시,오전동,관내사전투표,4028,4028,1817,771,880,278,252,4,0,2,0,6,1,0,4,4015,13,0
경기도,의왕시,오전동,오전동제1투,2156,1366,518,370,311,85,71,1,0,1,0,0,1,1,1,1360,6,790
경기도,의왕시,오전동,오전동제2투,2569,1871,724,399,476,118,142,4,0,0,0,1,0,2,2,1868,3,698
경기도,의왕시,오전동,오전동제3투,2506,1709,597,425,446,123,108,0,2,3,1,1,0,0,2,1708,1,797
경기도,의왕시,오전동,오전동제4투,2326,1947,747,448,482,142,117,3,0,0,0,2,0,0,1,1942,5,379
경기도,의왕시,오전동,오전동제5투,2730,2197,955,448,515,144,125,5,0,0,0,1,0,0,1,2194,3,533
경기도,의왕시,오전동,오전동제6투,2046,1590,649,353,375,102,102,4,0,0,0,0,0,1,1,1587,3,456
경기도,의왕시,오전동,오전동제7투,3233,2694,1174,522,600,219,165,4,0,0,0,1,0,0,2,2687,7,539
경기도,의왕시,오전동,오전동제8투,3033,2547,1109,418,615,215,176,2,0,4,0,0,0,0,3,2542,5,486
경기도,의왕시,오전동,오전동제9투,1635,1181,443,277,289,98,71,0,0,2,0,0,0,0,0,1180,1,454
경기도,의왕시,오전동,오전동제10투,1840,1341,554,275,343,91,77,0,0,0,0,1,0,0,0,1341,0,499
경기도,의왕시,내손1동,합계,15893,12900,5416,2574,2999,990,830,19,1,4,3,9,2,3,6,12856,44,2993
경기도,의왕시,내손1동,관내사전투표,2836,2836,1341,523,549,199,203,5,0,1,2,1,1,0,2,2827,9,0
경기도,의왕시,내손1동,내손1동제1투,2606,1783,772,307,416,127,146,1,0,1,0,3,0,1,2,1776,7,823
경기도,의왕시,내손1동,내손1동제2투,2466,1991,693,540,475,169,98,5,0,0,0,2,0,1,0,1983,8,475
경기도,의왕시,내손1동,내손1동제3투,2084,1542,673,281,363,122,97,1,0,1,0,2,1,0,0,1541,1,542
경기도,의왕시,내손1동,내손1동제4투,3150,2497,1022,461,644,200,152,4,0,0,0,1,0,0,2,2486,11,653
경기도,의왕시,내손1동,내손1동제5투,2751,2251,915,462,552,173,134,3,1,1,1,0,0,1,0,2243,8,500
경기도,의왕시,내손2동,관내사전투표,4889,4889,2275,893,1013,336,347,7,0,2,1,1,0,1,1,4877,12,0
경기도,의왕시,내손2동,합계,24074,19253,8258,3763,4415,1434,1265,30,3,7,5,7,3,8,5,19203,50,4821
경기도,의왕시,내손2동,내손2동제1투,2806,2318,1124,343,514,186,140,2,0,0,1,0,0,3,0,2313,5,488
경기도,의왕시,내손2동,내손2동제2투,2682,2071,944,361,462,158,133,1,1,2,1,0,0,1,0,2064,7,611
경기도,의왕시,내손2동,내손2동제3투,2544,1736,658,418,418,96,132,5,0,0,0,2,0,1,2,1732,4,808
경기도,의왕시,내손2동,내손2동제4투,2251,1433,556,342,331,103,96,1,1,0,0,1,0,0,0,1431,2,818
경기도,의왕시,내손2동,내손2동제5투,2409,1669,633,377,398,138,107,6,1,0,0,1,0,0,2,1663,6,740
경기도,의왕시,내손2동,내손2동제6투,1689,1114,431,249,284,68,65,2,0,3,1,0,2,0,0,1105,9,575
경기도,의왕시,내손2동,내손2동제7투,2939,2450,1032,449,590,217,151,4,0,0,1,1,0,2,0,2447,3,489
경기도,의왕시,내손2동,내손2동제8투,1865,1573,605,331,405,132,94,2,0,0,0,1,1,0,0,1571,2,292
경기도,의왕시,청계동,합계,15055,11961,5113,2558,2693,837,681,13,1,5,2,10,1,4,13,11931,30,3094
경기도,의왕시,청계동,관내사전투표,2827,2827,1374,553,546,170,175,2,0,2,0,2,0,0,1,2825,2,0
경기도,의왕시,청계동,청계동제1투,1940,1308,466,380,304,92,54,1,0,0,0,1,1,0,1,1300,8,632
경기도,의왕시,청계동,청계동제2투,2010,1555,715,295,321,108,108,1,0,0,0,3,0,1,1,1553,2,455
경기도,의왕시,청계동,청계동제3투,1696,1271,513,254,320,83,84,2,0,0,1,1,0,2,6,1266,5,425
경기도,의왕시,청계동,청계동제4투,3171,2313,903,538,564,172,123,1,0,0,0,1,0,1,1,2304,9,858
경기도,의왕시,청계동,청계동제5투,3411,2687,1142,538,638,212,137,6,1,3,1,2,0,0,3,2683,4,724
경기도,의왕시,잘못 투입·구분된 투표지,,0,0,0,0,0,0,0,0,0,0,0,0,0,0,0,0,0,0
경기도,구리시,합계,,159142,123469,51181,26113,28698,8167,8386,162,14,52,18,85,31,50,82,123039,430,35673
경기도,구리시,거소·선상투표,,213,208,78,25,78,13,8,0,0,0,0,1,0,1,0,204,4,5
경기도,구리시,관외사전투표,,12584,12579,5773,1923,2800,927,1015,12,2,4,2,13,5,4,18,12498,81,5
경기도,구리시,재외투표,,1085,839,514,61,114,39,108,1,0,0,0,0,0,0,0,837,2,246
경기도,구리시,갈매동,합계,10388,7996,3448,1562,1923,530,491,7,0,2,1,4,2,3,2,7975,21,2392
경기도,구리시,갈매동,관내사전투표,2328,2328,1134,397,507,125,150,0,0,1,0,1,1,0,2,2318,10,0
경기도,구리시,갈매동,갈매동제1투,711,395,114,166,89,11,11,0,0,0,0,1,0,2,0,394,1,316
경기도,구리시,갈매동,갈매동제2투,2395,1763,797,285,419,139,119,1,0,0,0,1,0,0,0,1761,2,632
경기도,구리시,갈매동,갈매동제3투,3249,2203,870,491,559,144,125,4,0,1,1,1,0,1,0,2197,6,1046
경기도,구리시,갈매동,갈매동제4투,1705,1307,533,223,349,111,86,2,0,0,0,0,1,0,0,1305,2,398
경기도,구리시,동구동,합계,29395,23832,10162,4860,5404,1620,1630,31,1,15,6,13,4,8,14,23768,64,5563
경기도,구리시,동구동,관내사전투표,4209,4209,2015,726,829,289,322,7,0,3,0,5,0,0,3,4199,10,0
경기도,구리시,동구동,동구동제1투,1611,1036,409,254,230,80,61,0,0,0,0,0,0,0,0,1034,2,575
경기도,구리시,동구동,동구동제2투,1022,658,143,288,146,38,35,0,0,0,0,0,1,0,2,653,5,364
경기도,구리시,동구동,동구동제3투,2936,2273,932,505,527,139,155,3,0,2,0,0,0,2,2,2267,6,663
경기도,구리시,동구동,동구동제4투,2338,1875,836,343,413,151,118,3,0,0,1,0,1,1,0,1867,8,463
경기도,구리시,동구동,동구동제5투,2351,1815,730,391,459,108,118,1,0,1,0,0,0,1,2,1811,4,536
경기도,구리시,동구동,동구동제6투,2379,1811,826,306,415,126,127,6,0,1,0,0,0,0,1,1808,3,568
경기도,구리시,동구동,동구동제7투,2363,1853,750,351,471,121,145,0,0,3,1,2,1,1,1,1847,6,510
경기도,구리시,동구동,동구동제8투,2181,1836,747,407,426,136,108,4,0,1,0,1,0,0,1,1831,5,345
경기도,구리시,동구동,동구동제9투,2523,2008,930,347,446,119,155,1,1,0,1,1,0,2,0,2003,5,515
경기도,구리시,동구동,동구동제10투,3032,2460,1014,547,553,173,158,4,0,0,1,3,0,0,0,2453,7,572
경기도,구리시,동구동,동구동제11투,2450,1998,830,395,489,140,128,2,0,4,2,1,1,1,2,1995,3,452
경기도,구리시,인창동,합계,18641,14359,5964,3053,3267,964,1012,19,3,7,2,11,4,2,5,14313,46,4282
경기도,구리시,인창동,관내사전투표,3181,3181,1505,557,642,221,230,6,1,2,0,4,1,0,1,3170,11,0
경기도,구리시,인창동,인창동제1투,2721,1726,637,429,415,112,122,0,1,2,1,3,0,0,1,1723,3,995
경기도,구리시,인창동,인창동제2투,2818,1930,765,404,490,133,124,1,0,0,0,1,2,1,1,1922,8,888
경기도,구리시,인창동,인창동제3투,2447,1598,550,430,401,78,118,8,1,2,0,1,0,0,1,1590,8,849
경기도,구리시,인창동,인창동제4투,2647,2034,877,390,471,150,141,0,0,0,0,0,0,0,0,2029,5,613
경기도,구리시,인창동,인창동제5투,2195,1773,785,356,360,136,129,2,0,1,0,0,1,0,0,1770,3,422
경기도,구리시,인창동,인창동제6투,2632,2117,845,487,488,134,148,2,0,0,1,2,0,1,1,2109,8,515
경기도,구리시,교문1동,합계,14532,10043,3728,2569,2480,595,584,12,2,2,0,6,4,11,8,10001,42,4489
경기도,구리시,교문1동,관내사전투표,2216,2216,1002,454,473,127,146,0,1,0,0,1,0,0,2,2206,10,0
경기도,구리시,교문1동,교문1동제1투,2757,1609,597,387,403,109,97,1,1,1,0,1,1,1,2,1601,8,1148
경기도,구리시,교문1동,교문1동제2투,2101,1227,424,366,299,56,75,1,0,0,0,1,0,1,0,1223,4,874
경기도,구리시,교문1동,교문1동제3투,2391,1553,518,422,408,93,94,6,0,0,0,0,0,2,2,1545,8,838
경기도,구리시,교문1동,교문1동제4투,2528,1582,505,474,431,74,80,1,0,1,0,3,3,5,1,1578,4,946
경기도,구리시,교문1동,교문1동제5투,1530,1054,389,271,250,70,62,3,0,0,0,0,0,2,1,1048,6,476
경기도,구리시,교문1동,교문1동제6투,1009,802,293,195,216,66,30,0,0,0,0,0,0,0,0,800,2,207
경기도,구리시,교문2동,합계,16281,13174,5392,2794,3060,976,875,25,0,3,3,2,2,3,3,13138,36,3107
경기도,구리시,교문2동,관내사전투표,2407,2407,1107,433,502,188,157,7,0,0,0,1,1,1,1,2398,9,0
경기도,구리시,교문2동,교문2동제1투,2332,1775,793,324,391,142,113,6,0,0,0,0,0,0,0,1769,6,557
경기도,구리시,교문2동,교문2동제2투,2092,1321,506,305,326,93,83,2,0,1,0,0,1,0,0,1317,4,771
경기도,구리시,교문2동,교문2동제3투,2091,1651,652,363,412,107,104,5,0,1,1,1,0,1,1,1648,3,440
경기도,구리시,교문2동,교문2동제4투,2250,1894,730,444,461,131,120,3,0,0,1,0,0,0,0,1890,4,356
경기도,구리시,교문2동,교문2동제5투,2507,1996,753,442,479,167,145,2,0,1,1,0,0,1,1,1992,4,511
경기도,구리시,교문2동,교문2동제6투,2602,2130,851,483,489,148,153,0,0,0,0,0,0,0,0,2124,6,472
경기도,구리시,수택1동,합계,18117,12422,4806,3062,2966,702,788,17,0,7,2,11,1,3,9,12374,48,5695
경기도,구리시,수택1동,관내사전투표,3031,3031,1390,612,664,161,185,2,0,1,0,3,0,1,2,3021,10,0
경기도,구리시,수택1동,수택1동제1투,3576,2097,799,539,515,122,105,2,0,1,1,3,0,1,1,2089,8,1479
경기도,구리시,수택1동,수택1동제2투,2155,1173,371,355,304,64,66,3,0,0,0,3,1,0,2,1169,4,982
경기도,구리시,수택1동,수택1동제3투,2989,1636,561,469,375,91,120,1,0,3,0,0,0,0,0,1620,16,1353
경기도,구리시,수택1동,수택1동제4투,3510,2471,844,674,611,150,179,4,0,0,0,0,0,0,2,2464,7,1039
경기도,구리시,수택1동,수택1동제5투,2856,2014,841,413,497,114,133,5,0,2,1,2,0,1,2,2011,3,842
경기도,구리시,수택2동,합계,19931,13772,5165,3317,3408,807,940,25,2,7,1,16,5,9,14,13716,56,6159
경기도,구리시,수택2동,관내사전투표,2236,2236,931,487,496,119,176,5,0,2,0,6,0,2,2,2226,10,0
경기도,구리시,수택2동,수택2동제1투,2774,1673,614,420,404,97,124,1,0,0,0,5,1,0,4,1670,3,1101
경기도,구리시,수택2동,수택2동제2투,2651,1825,658,476,449,109,121,2,0,0,0,0,0,2,1,1818,7,826
경기도,구리시,수택2동,수택2동제3투,2906,1779,631,499,424,108,99,0,0,2,0,3,1,1,0,1768,11,1127
경기도,구리시,수택2동,수택2동제4투,2099,1350,476,383,345,66,71,0,0,1,0,0,0,0,1,1343,7,749
경기도,구리시,수택2동,수택2동제5투,2744,1842,742,378,474,101,126,5,0,1,0,1,1,0,3,1832,10,902
경기도,구리시,수택2동,수택2동제6투,1613,1020,367,235,263,72,71,5,2,0,0,0,1,1,1,1018,2,593
경기도,구리시,수택2동,수택2동제7투,2908,2047,746,439,553,135,152,7,0,1,1,1,1,3,2,2041,6,861
경기도,구리시,수택3동,합계,17975,14245,6151,2887,3198,994,935,13,4,5,1,8,4,6,9,14215,30,3730
경기도,구리시,수택3동,관내사전투표,4179,4179,1933,716,836,325,338,4,1,4,0,6,1,3,2,4169,10,0
경기도,구리시,수택3동,수택3동제1투,2759,1931,866,324,479,133,126,1,0,0,0,0,0,0,1,1930,1,828
경기도,구리시,수택3동,수택3동제2투,2720,2159,865,556,469,128,132,3,1,0,0,0,1,0,1,2156,3,561
경기도,구리시,수택3동,수택3동제3투,3489,2825,1156,602,690,211,154,2,0,1,0,1,0,1,2,2820,5,664
경기도,구리시,수택3동,수택3동제4투,2614,1519,616,388,333,87,78,1,1,0,1,1,2,2,3,1513,6,1095
경기도,구리시,수택3동,수택3동제5투,2214,1632,715,301,391,110,107,2,1,0,0,0,0,0,0,1627,5,582
경기도,구리시,잘못 투입·구분된 투표지,,0,0,0,0,0,0,0,0,0,0,0,0,0,0,0,0,0,0
경기도,남양주시,합계,,524245,397972,165079,86026,92048,25471,26319,584,67,213,73,210,102,139,306,396637,1335,126273
경기도,남양주시,거소·선상투표,,941,889,306,151,284,60,24,7,4,4,4,1,3,2,6,856,33,52
경기도,남양주시,관외사전투표,,41543,41531,19158,6596,8911,3085,3315,50,11,20,12,29,10,21,56,41274,257,12
경기도,남양주시,재외투표,,3503,2746,1691,196,388,120,320,23,1,2,0,1,0,0,0,2742,4,757
경기도,남양주시,와부읍,합계,49946,39743,15983,9656,8641,2743,2440,67,6,22,6,16,9,18,21,39628,115,10203
경기도,남양주시,와부읍,관내사전투표,7642,7642,3681,1423,1440,496,545,13,1,2,2,4,1,3,7,7618,24,0
경기도,남양주시,와부읍,와부읍제1투,3770,2698,1029,644,638,192,168,4,0,3,0,2,0,2,0,2682,16,1072
경기도,남양주시,와부읍,와부읍제2투,3109,1772,583,572,392,101,105,1,0,2,0,1,1,2,0,1760,12,1337
경기도,남양주시,와부읍,와부읍제3투,2792,2173,831,530,498,150,146,3,1,1,0,1,1,2,1,2165,8,619
경기도,남양주시,와부읍,와부읍제4투,3617,2763,1054,651,659,211,168,7,1,3,0,2,0,1,0,2757,6,854
경기도,남양주시,와부읍,와부읍제5투,934,671,187,283,128,32,34,2,0,2,0,0,0,2,0,670,1,263
경기도,남양주시,와부읍,와부읍제6투,762,550,138,241,106,26,33,1,0,0,1,0,1,0,0,547,3,212
경기도,남양주시,와부읍,와부읍제7투,3234,2585,1041,622,609,159,137,4,1,1,0,1,0,3,2,2580,5,649
경기도,남양주시,와부읍,와부읍제8투,2769,2172,824,566,501,149,120,2,0,3,0,0,1,1,1,2168,4,597
경기도,남양주시,와부읍,와부읍제9투,2111,1462,475,488,304,75,106,6,1,1,2,0,0,0,1,1459,3,649
경기도,남양주시,와부읍,와부읍제10투,2615,2001,842,410,474,122,141,5,0,1,0,0,1,0,2,1998,3,614
경기도,남양주시,와부읍,와부읍제11투,3468,2817,1154,610,610,244,182,5,0,1,0,0,0,1,1,2808,9,651
경기도,남양주시,와부읍,와부읍제12투,654,449,123,199,86,18,22,1,0,0,0,0,0,0,0,449,0,205
경기도,남양주시,와부읍,와부읍제13투,2480,2052,721,608,442,165,105,3,0,0,0,1,1,1,1,2048,4,428
경기도,남양주시,와부읍,와부읍제14투,2963,2271,871,636,488,158,109,4,1,0,0,1,1,0,1,2270,1,692
경기도,남양주시,와부읍,와부읍제15투,2310,1934,810,422,421,165,105,1,0,0,1,1,1,0,1,1928,6,376
경기도,남양주시,와부읍,와부읍제16투,2814,2195,948,458,480,174,118,4,0,1,0,0,0,0,3,2186,9,619
경기도,남양주시,와부읍,와부읍제17투,1902,1536,671,293,365,106,96,1,0,1,0,2,0,0,0,1535,1,366
경기도,남양주시,진접읍,합계,66758,47089,19300,10272,11271,2846,3070,74,4,32,10,19,16,15,30,46959,130,19669
경기도,남양주시,진접읍,관내사전투표,9402,9402,4467,1680,1967,568,655,14,0,3,0,4,3,2,3,9366,36,0
경기도,남양주시,진접읍,진접읍제1투,4568,2674,1045,599,658,153,192,8,2,2,3,1,1,0,2,2666,8,1894
경기도,남양주시,진접읍,진접읍제2투,3578,2335,953,527,573,112,155,7,0,2,0,0,0,2,1,2332,3,1243
경기도,남양주시,진접읍,진접읍제3투,3951,2732,1125,554,671,178,188,3,0,1,0,0,1,0,4,2725,7,1219
경기도,남양주시,진접읍,진접읍제4투,3226,1903,565,643,494,86,101,4,0,2,1,0,0,0,1,1897,6,1323
경기도,남양주시,진접읍,진접읍제5투,2741,1685,601,485,381,119,89,2,1,1,1,1,1,0,0,1682,3,1056
경기도,남양주시,진접읍,진접읍제6투,3854,2388,856,647,575,142,146,2,0,2,1,1,1,3,1,2377,11,1466
경기도,남양주시,진접읍,진접읍제7투,4522,3051,1113,700,807,195,212,5,0,3,0,2,1,2,5,3045,6,1471
경기도,남양주시,진접읍,진접읍제8투,4004,2538,859,707,641,148,165,6,0,3,0,1,0,1,2,2533,5,1466
경기도,남양주시,진접읍,진접읍제9투,3135,1990,604,689,505,81,93,2,0,2,0,2,0,1,1,1980,10,1145
경기도,남양주시,진접읍,진접읍제10투,3568,2622,1193,511,581,159,162,3,0,1,0,4,1,0,3,2618,4,946
경기도,남양주시,진접읍,진접읍제11투,3096,2052,770,476,503,141,140,4,0,3,0,2,1,3,3,2046,6,1044
경기도,남양주시,진접읍,진접읍제12투,5336,3616,1535,699,951,212,196,8,0,2,3,0,1,0,1,3608,8,1720
경기도,남양주시,진접읍,진접읍제13투,3624,2740,1343,376,627,201,186,0,1,1,0,0,1,0,0,2736,4,884
경기도,남양주시,진접읍,진접읍제14투,3897,2780,1256,406,720,195,193,3,0,0,0,0,1,1,1,2776,4,1117
경기도,남양주시,진접읍,진접읍제15투,4256,2581,1015,573,617,156,197,3,0,4,1,1,3,0,2,2572,9,1675
경기도,남양주시,화도읍,합계,75377,51513,20611,11518,12523,2951,3543,58,6,32,13,39,15,17,35,51361,152,23864
경기도,남양주시,화도읍,관내사전투표,10632,10632,4875,1977,2266,608,833,11,1,1,3,7,4,6,9,10601,31,0
경기도,남양주시,화도읍,화도읍제1투,3227,2086,782,470,563,111,148,3,0,0,0,0,0,0,2,2079,7,1141
경기도,남양주시,화도읍,화도읍제2투,3527,2093,809,399,576,127,168,4,0,1,0,0,0,0,5,2089,4,1434
경기도,남양주시,화도읍,화도읍제3투,4295,2609,997,670,656,120,147,1,1,2,1,5,1,1,1,2603,6,1686
경기도,남양주시,화도읍,화도읍제4투,3508,2209,830,528,547,124,155,3,0,4,1,0,1,2,2,2197,12,1299
경기도,남양주시,화도읍,화도읍제5투,4803,2841,997,750,760,145,165,3,1,3,0,2,0,1,1,2828,13,1962
경기도,남양주시,화도읍,화도읍제6투,3426,2134,740,548,577,105,140,3,0,3,1,7,1,1,2,2128,6,1292
경기도,남양주시,화도읍,화도읍제7투,5733,3572,1351,821,928,218,228,7,1,2,2,0,2,0,2,3562,10,2161
경기도,남양주시,화도읍,화도읍제8투,3201,2141,882,456,553,115,121,2,0,2,0,0,2,0,0,2133,8,1060
경기도,남양주시,화도읍,화도읍제9투,2871,1898,737,460,436,125,132,0,0,0,0,2,0,0,2,1894,4,973
경기도,남양주시,화도읍,화도읍제10투,3578,2748,1114,611,678,160,175,3,0,0,1,1,0,1,1,2745,3,830
경기도,남양주시,화도읍,화도읍제11투,2895,2098,915,377,488,162,140,4,0,4,0,2,0,1,0,2093,5,797
경기도,남양주시,화도읍,화도읍제12투,2709,1622,444,634,369,77,83,2,0,2,1,0,1,1,1,1615,7,1087
경기도,남양주시,화도읍,화도읍제13투,1067,686,189,263,175,31,23,0,0,1,0,1,1,0,1,685,1,381
경기도,남양주시,화도읍,화도읍제14투,2922,1827,768,340,435,104,164,0,0,4,0,2,0,0,2,1819,8,1095
경기도,남양주시,화도읍,화도읍제15투,4032,2046,807,432,513,136,146,0,0,1,2,2,0,1,0,2040,6,1986
경기도,남양주시,화도읍,화도읍제16투,3018,1837,757,398,440,92,133,4,1,1,0,3,0,0,1,1830,7,1181
경기도,남양주시,화도읍,화도읍제17투,2711,1763,699,451,402,99,97,3,1,1,0,1,1,1,1,1757,6,948
경기도,남양주시,화도읍,화도읍제18투,3164,1888,722,403,478,126,153,1,0,0,0,2,0,0,0,1885,3,1276
경기도,남양주시,화도읍,화도읍제19투,4058,2783,1196,530,683,166,192,4,0,0,1,2,1,1,2,2778,5,1275
경기도,남양주시,진건읍,합계,21271,14923,5413,3991,3572,907,914,22,4,6,3,8,0,9,16,14865,58,6348
경기도,남양주시,진건읍,관내사전투표,3515,3515,1526,766,728,207,268,1,1,2,1,1,0,0,3,3504,11,0
경기도,남양주시,진건읍,진건읍제1투,3028,1760,595,494,451,92,108,3,0,0,2,2,0,2,2,1751,9,1268
경기도,남양주시,진건읍,진건읍제2투,897,578,157,233,125,27,33,0,0,0,0,0,0,2,0,577,1,319
경기도,남양주시,진건읍,진건읍제3투,1531,973,218,435,234,44,32,1,2,1,0,1,0,0,0,968,5,558
경기도,남양주시,진건읍,진건읍제4투,2755,1835,655,426,479,136,124,3,1,0,0,0,0,1,3,1828,7,920
경기도,남양주시,진건읍,진건읍제5투,3699,2353,868,607,563,165,127,8,0,1,0,1,0,2,3,2345,8,1346
경기도,남양주시,진건읍,진건읍제6투,3752,2653,1025,627,641,182,161,6,0,0,0,3,0,1,2,2648,5,1099
경기도,남양주시,진건읍,진건읍제7투,2094,1256,369,403,351,54,61,0,0,2,0,0,0,1,3,1244,12,838
경기도,남양주시,오남읍,합계,39094,27226,11424,5764,6445,1579,1833,37,2,18,2,15,9,5,21,27154,72,11868
경기도,남양주시,오남읍,관내사전투표,6564,6564,3099,1178,1394,377,480,3,0,2,0,4,1,0,6,6544,20,0
경기도,남양주시,오남읍,오남읍제1투,3507,1807,690,510,417,92,79,8,0,1,1,0,0,0,2,1800,7,1700
경기도,남양주시,오남읍,오남읍제2투,3378,2206,940,461,494,130,164,2,2,4,0,0,1,1,1,2200,6,1172
경기도,남양주시,오남읍,오남읍제3투,4624,2784,957,733,729,167,183,1,0,3,0,2,0,0,3,2778,6,1840
경기도,남양주시,오남읍,오남읍제4투,3485,2080,685,549,588,109,123,2,0,1,1,4,2,1,4,2069,11,1405
경기도,남양주시,오남읍,오남읍제5투,4017,2426,949,549,595,140,174,5,0,1,0,0,0,2,2,2417,9,1591
경기도,남양주시,오남읍,오남읍제6투,3254,2153,892,451,529,120,148,2,0,1,0,1,1,0,1,2146,7,1101
경기도,남양주시,오남읍,오남읍제7투,2379,1698,725,334,421,91,117,6,0,1,0,1,0,0,1,1697,1,681
경기도,남양주시,오남읍,오남읍제8투,3996,2730,1176,560,643,150,183,5,0,4,0,0,4,0,1,2726,4,1266
경기도,남양주시,오남읍,오남읍제9투,3890,2778,1311,439,635,203,182,3,0,0,0,3,0,1,0,2777,1,1112
경기도,남양주시,별내면,합계,15727,11901,4769,2723,2905,706,724,16,6,7,2,6,3,5,5,11877,24,3826
경기도,남양주시,별내면,관내사전투표,2839,2839,1330,493,627,171,201,4,2,1,0,0,1,1,2,2833,6,0
경기도,남양주시,별내면,별내면제1투,1152,620,162,247,156,30,19,2,0,0,0,1,0,0,2,619,1,532
경기도,남양주시,별내면,별내면제2투,2786,2061,852,442,513,122,122,3,1,1,0,2,1,0,0,2059,2,725
경기도,남양주시,별내면,별내면제3투,3099,2087,750,527,561,125,106,5,1,2,1,1,1,2,0,2082,5,1012
경기도,남양주시,별내면,별내면제4투,2856,2125,874,488,485,144,124,1,0,2,0,1,0,1,1,2121,4,731
경기도,남양주시,별내면,별내면제5투,2995,2169,801,526,563,114,152,1,2,1,1,1,0,1,0,2163,6,826
경기도,남양주시,퇴계원면,합계,24515,18638,7275,4392,4463,1213,1163,26,3,10,1,15,4,4,11,18580,58,5877
경기도,남양주시,퇴계원면,관내사전투표,5061,5061,2225,1072,1104,308,306,8,2,2,1,5,1,3,3,5040,21,0
경기도,남양주시,퇴계원면,퇴계원면제1투,3452,2465,891,577,622,176,186,2,1,0,0,1,1,0,1,2458,7,987
경기도,남양주시,퇴계원면,퇴계원면제2투,4137,2631,964,636,666,166,175,8,0,2,0,3,0,1,1,2622,9,1506
경기도,남양주시,퇴계원면,퇴계원면제3투,3970,2592,929,689,625,173,153,3,0,3,0,4,1,0,5,2585,7,1378
경기도,남양주시,퇴계원면,퇴계원면제4투,4694,3468,1315,799,883,243,213,4,0,2,0,2,0,0,0,3461,7,1226
경기도,남양주시,퇴계원면,퇴계원면제5투,3201,2421,951,619,563,147,130,1,0,1,0,0,1,0,1,2414,7,780
경기도,남양주시,수동면,합계,7357,4965,1447,1761,1198,201,236,15,6,2,1,4,5,3,20,4899,66,2392
경기도,남양주시,수동면,관내사전투표,1584,1584,502,552,313,49,85,6,5,1,1,2,5,2,14,1537,47,0
경기도,남양주시,수동면,수동면제1투,3249,1838,522,630,499,77,85,6,1,0,0,1,0,1,5,1827,11,1411
경기도,남양주시,수동면,수동면제2투,2524,1543,423,579,386,75,66,3,0,1,0,1,0,0,1,1535,8,981
경기도,남양주시,조안면,합계,3242,2282,706,880,459,115,107,2,0,1,2,3,0,0,0,2275,7,960
경기도,남양주시,조안면,관내사전투표,486,486,190,160,87,24,21,1,0,0,0,2,0,0,0,485,1,0
경기도,남양주시,조안면,조안면제1투,1354,853,223,359,185,47,33,1,0,1,1,1,0,0,0,851,2,501
경기도,남양주시,조안면,조안면제2투,1402,943,293,361,187,44,53,0,0,0,1,0,0,0,0,939,4,459
경기도,남양주시,호평동,합계,34477,26483,12136,4706,6015,1719,1763,34,3,14,4,19,3,4,16,26436,47,7994
경기도,남양주시,호평동,관내사전투표,6748,6748,3391,1014,1305,502,494,9,0,5,0,8,0,1,4,6733,15,0
경기도,남양주시,호평동,호평동제1투,3199,1851,802,385,446,89,112,4,0,1,1,1,0,0,3,1844,7,1348
경기도,남양주시,호평동,호평동제2투,4296,3126,1358,574,803,182,191,2,0,3,1,3,0,0,1,3118,8,1170
경기도,남양주시,호평동,호평동제3투,4453,3107,1312,646,729,188,218,4,0,1,0,2,2,1,1,3104,3,1346
경기도,남양주시,호평동,호평동제4투,2850,2132,966,421,492,115,131,3,0,0,0,1,0,0,2,2131,1,718
경기도,남양주시,호평동,호평동제5투,3054,2218,1003,416,515,146,133,2,0,0,0,0,0,1,1,2217,1,836
경기도,남양주시,호평동,호평동제6투,2363,1893,884,310,446,121,121,5,0,1,2,0,0,0,1,1891,2,470
경기도,남양주시,호평동,호평동제7투,4085,2903,1271,549,694,193,178,3,3,2,0,2,0,0,3,2898,5,1182
경기도,남양주시,호평동,호평동제8투,3429,2505,1149,391,585,183,185,2,0,1,0,2,1,1,0,2500,5,924
경기도,남양주시,평내동,합계,28822,21908,9862,4158,4848,1443,1472,28,0,4,3,8,11,8,15,21860,48,6914
경기도,남양주시,평내동,관내사전투표,4992,4992,2485,802,940,369,369,10,0,0,0,1,1,2,3,4982,10,0
경기도,남양주시,평내동,평내동제1투,3684,2366,897,638,543,140,125,2,0,1,0,0,0,3,5,2354,12,1318
경기도,남양주시,평내동,평내동제2투,4250,2594,977,617,646,153,177,3,0,0,0,4,2,1,3,2583,11,1656
경기도,남양주시,평내동,평내동제3투,3428,2664,1330,399,608,151,168,0,0,1,0,0,1,0,3,2661,3,764
경기도,남양주시,평내동,평내동제4투,2651,2043,931,354,484,125,138,3,0,0,0,0,5,0,0,2040,3,608
경기도,남양주시,평내동,평내동제5투,4639,3247,1448,618,731,237,197,5,0,0,1,1,0,2,1,3241,6,1392
경기도,남양주시,평내동,평내동제6투,2636,1987,902,361,442,131,142,3,0,1,2,0,1,0,0,1985,2,649
경기도,남양주시,평내동,평내동제7투,2542,2015,892,369,454,137,156,2,0,1,0,2,1,0,0,2014,1,527
경기도,남양주시,금곡동,합계,17834,12560,4556,3405,2945,771,782,20,2,8,4,1,1,8,10,12513,47,5274
경기도,남양주시,금곡동,관내사전투표,2921,2921,1331,594,605,176,198,3,0,1,2,0,0,2,2,2914,7,0
경기도,남양주시,금곡동,금곡동제1투,2299,1414,440,492,324,75,69,3,1,2,0,0,0,1,1,1408,6,885
경기도,남양주시,금곡동,금곡동제2투,2724,1753,581,527,423,96,110,5,0,2,0,0,1,1,1,1747,6,971
경기도,남양주시,금곡동,금곡동제3투,2760,1793,632,470,433,121,124,1,0,2,1,0,0,1,3,1788,5,967
경기도,남양주시,금곡동,금곡동제4투,2333,1406,467,381,386,86,76,4,0,0,0,0,0,0,0,1400,6,927
경기도,남양주시,금곡동,금곡동제5투,4797,3273,1105,941,774,217,205,4,1,1,1,1,0,3,3,3256,17,1524
경기도,남양주시,양정동,합계,4279,3052,905,1062,727,179,158,1,1,1,1,0,0,2,6,3043,9,1227
경기도,남양주시,양정동,관내사전투표,804,804,298,210,188,51,52,0,1,0,0,0,0,1,3,804,0,0
경기도,남양주시,양정동,양정동제1투,2001,1237,310,459,323,78,64,1,0,1,0,0,0,0,0,1236,1,764
경기도,남양주시,양정동,양정동제2투,1474,1011,297,393,216,50,42,0,0,0,1,0,0,1,3,1003,8,463
경기도,남양주시,지금동,합계,12945,9917,4074,2188,2311,654,626,16,2,4,0,5,1,3,4,9888,29,3028
경기도,남양주시,지금동,관내사전투표,1176,1176,517,249,251,69,81,1,1,1,0,0,0,0,1,1171,5,0
경기도,남양주시,지금동,지금동제1투,1094,728,301,187,155,41,39,1,1,1,0,0,0,0,0,726,2,366
경기도,남양주시,지금동,지금동제2투,4108,3101,1237,699,744,218,189,3,0,0,0,0,1,3,1,3095,6,1007
경기도,남양주시,지금동,지금동제3투,3494,2446,882,619,626,150,147,10,0,1,0,2,0,0,1,2438,8,1048
경기도,남양주시,지금동,지금동제4투,3073,2466,1137,434,535,176,170,1,0,1,0,3,0,0,1,2458,8,607
경기도,남양주시,도농동,합계,29631,23655,9207,5762,5429,1617,1482,28,0,15,2,8,4,6,15,23575,80,5976
경기도,남양주시,도농동,관내사전투표,5468,5468,2531,967,1128,386,424,7,0,3,0,2,1,1,3,5453,15,0
경기도,남양주시,도농동,도농동제1투,3468,2102,809,533,469,130,145,1,0,2,0,0,1,0,5,2095,7,1366
경기도,남양주시,도농동,도농동제2투,3883,2828,1154,622,676,175,176,3,0,3,0,2,2,0,4,2817,11,1055
경기도,남양주시,도농동,도농동제3투,4455,3291,1299,754,780,215,224,2,0,5,1,0,0,0,1,3281,10,1164
경기도,남양주시,도농동,도농동제4투,2486,2022,658,615,497,146,88,7,0,0,0,0,0,1,0,2012,10,464
경기도,남양주시,도농동,도농동제5투,3104,2546,928,701,573,184,146,6,0,0,0,1,0,0,0,2539,7,558
경기도,남양주시,도농동,도농동제6투,3627,2896,1010,770,748,190,158,0,0,1,1,3,0,4,1,2886,10,731
경기도,남양주시,도농동,도농동제7투,3140,2502,818,800,558,191,121,2,0,1,0,0,0,0,1,2492,10,638
경기도,남양주시,별내동,합계,46983,36951,16256,6845,8713,2562,2347,60,6,11,3,13,8,9,19,36852,99,10032
경기도,남양주시,별내동,관내사전투표,8548,8548,4369,1324,1637,583,586,12,1,1,1,3,3,3,4,8527,21,0
경기도,남양주시,별내동,별내동제1투,3698,2612,1119,462,692,157,169,3,0,1,0,1,1,0,1,2606,6,1086
경기도,남양주시,별내동,별내동제2투,3199,2465,1084,435,612,180,142,3,0,0,0,2,0,1,0,2459,6,734
경기도,남양주시,별내동,별내동제3투,2393,1772,758,388,402,113,100,0,0,0,0,0,1,1,1,1764,8,621
경기도,남양주시,별내동,별내동제4투,3802,3033,1382,487,769,209,167,3,0,1,1,2,1,0,3,3025,8,769
경기도,남양주시,별내동,별내동제5투,3587,2775,1215,466,717,180,180,5,0,0,0,3,0,0,2,2768,7,812
경기도,남양주시,별내동,별내동제6투,1915,1280,562,240,327,60,83,1,1,0,0,0,0,0,4,1278,2,635
경기도,남양주시,별내동,별내동제7투,2994,2174,815,537,515,158,127,7,0,2,1,0,1,0,1,2164,10,820
경기도,남양주시,별내동,별내동제8투,4039,2899,1188,613,728,178,174,8,0,1,0,0,0,2,1,2893,6,1140
경기도,남양주시,별내동,별내동제9투,2065,1481,573,289,382,122,104,5,1,1,0,0,0,1,1,1479,2,584
경기도,남양주시,별내동,별내동제10투,2388,1802,704,385,451,153,95,8,1,1,0,0,1,0,0,1799,3,586
경기도,남양주시,별내동,별내동제11투,2313,1705,663,363,416,135,120,2,1,2,0,0,0,0,0,1702,3,608
경기도,남양주시,별내동,별내동제12투,3127,2337,980,466,564,147,167,0,1,1,0,1,0,1,1,2329,8,790
경기도,남양주시,별내동,별내동제13투,2915,2068,844,390,501,187,133,3,0,0,0,1,0,0,0,2059,9,847
경기도,남양주시,잘못 투입·구분된 투표지,,0,0,0,0,0,0,0,0,0,0,0,0,0,0,0,0,0,0
경기도,오산시,합계,,161182,118683,52358,21829,27201,7893,8415,117,19,66,36,82,30,35,120,118201,482,42499
경기도,오산시,거소·선상투표,,266,244,91,32,80,18,11,0,0,1,1,0,2,1,1,238,6,22
경기도,오산시,관외사전투표,,13452,13448,6508,1805,2828,1039,1092,13,2,10,7,16,7,5,28,13360,88,4
경기도,오산시,재외투표,,714,547,333,42,84,31,54,0,0,0,0,0,1,0,0,545,2,167
경기도,오산시,중앙동,합계,20769,15645,6564,3259,3517,1084,1095,17,1,13,8,4,4,5,16,15587,58,5124
경기도,오산시,중앙동,관내사전투표,4943,4943,2287,973,985,322,333,6,0,6,3,0,3,1,3,4922,21,0
경기도,오산시,중앙동,중앙동제1투,1578,856,241,318,196,53,38,0,0,0,1,0,0,1,1,849,7,722
경기도,오산시,중앙동,중앙동제2투,2687,1463,440,473,347,99,89,3,0,0,1,0,1,2,2,1457,6,1224
경기도,오산시,중앙동,중앙동제3투,3391,2362,1073,320,590,167,188,4,1,2,3,2,0,0,3,2353,9,1029
경기도,오산시,중앙동,중앙동제4투,2285,1602,628,317,389,112,150,0,0,0,0,0,0,1,4,1601,1,683
경기도,오산시,중앙동,중앙동제5투,3321,2462,952,571,572,193,158,1,0,4,0,1,0,0,0,2452,10,859
경기도,오산시,중앙동,중앙동제6투,2564,1957,943,287,438,138,139,3,0,1,0,1,0,0,3,1953,4,607
경기도,오산시,대원동,합계,45011,33104,14493,5931,7886,2206,2371,27,4,17,3,19,8,10,25,33000,104,11907
경기도,오산시,대원동,관내사전투표,5904,5904,3019,856,1156,389,450,5,0,2,0,6,1,2,4,5890,14,0
경기도,오산시,대원동,대원동제1투,4246,2194,823,524,516,150,167,1,0,0,2,0,1,0,4,2188,6,2052
경기도,오산시,대원동,대원동제2투,1984,1437,556,301,357,111,101,2,0,1,0,0,0,1,1,1431,6,547
경기도,오산시,대원동,대원동제3투,2180,1477,633,291,351,99,92,1,0,1,0,1,0,1,0,1470,7,703
경기도,오산시,대원동,대원동제4투,3878,2373,928,548,563,162,156,3,0,1,0,1,1,1,1,2365,8,1505
경기도,오산시,대원동,대원동제5투,1836,1485,649,252,374,103,103,0,0,0,0,0,0,1,1,1483,2,351
경기도,오산시,대원동,대원동제6투,2361,1859,792,315,441,152,145,3,0,0,0,4,0,0,3,1855,4,502
경기도,오산시,대원동,대원동제7투,3772,2762,1136,493,700,190,224,4,0,1,0,2,1,0,2,2753,9,1010
경기도,오산시,대원동,대원동제8투,2733,1985,901,323,494,120,135,2,1,0,1,0,1,0,2,1980,5,748
경기도,오산시,대원동,대원동제9투,3999,2799,1115,533,753,156,217,2,0,2,0,2,1,2,2,2785,14,1200
경기도,오산시,대원동,대원동제10투,1842,1362,639,181,325,89,118,1,0,3,0,0,0,0,1,1357,5,480
경기도,오산시,대원동,대원동제11투,3757,2977,1405,455,692,222,189,0,1,1,0,1,1,0,2,2969,8,780
경기도,오산시,대원동,대원동제12투,2448,1681,740,265,453,102,110,0,2,2,0,0,0,0,2,1676,5,767
경기도,오산시,대원동,대원동제13투,1976,1422,579,305,342,80,110,0,0,2,0,0,0,1,0,1419,3,554
경기도,오산시,대원동,대원동제14투,2095,1387,578,289,369,81,54,3,0,1,0,2,1,1,0,1379,8,708
경기도,오산시,남촌동,합계,17669,9541,4119,1732,2208,691,714,9,2,3,1,12,2,3,10,9506,35,8128
경기도,오산시,남촌동,관내사전투표,2178,2178,1124,289,425,161,159,3,0,0,1,4,0,0,2,2168,10,0
경기도,오산시,남촌동,남촌동제1투,2324,1442,484,390,377,87,96,0,0,0,0,2,1,1,1,1439,3,882
경기도,오산시,남촌동,남촌동제2투,1821,878,259,277,214,74,44,4,1,0,0,1,0,0,0,874,4,943
경기도,오산시,남촌동,남촌동제3투,2958,1155,535,137,275,94,106,0,0,0,0,0,1,1,2,1151,4,1803
경기도,오산시,남촌동,남촌동제4투,2548,1935,822,362,476,130,138,1,0,1,0,1,0,0,1,1932,3,613
경기도,오산시,남촌동,남촌동제5투,3176,1072,499,157,231,73,95,1,1,2,0,4,0,0,2,1065,7,2104
경기도,오산시,남촌동,남촌동제6투,2664,881,396,120,210,72,76,0,0,0,0,0,0,1,2,877,4,1783
경기도,오산시,신장동,합계,37668,26793,11700,5329,6211,1621,1716,32,8,15,8,22,5,6,21,26694,99,10875
경기도,오산시,신장동,관내사전투표,4810,4810,2510,732,958,270,304,7,0,2,0,5,3,5,0,4796,14,0
경기도,오산시,신장동,신장동제1투,2615,1613,514,504,383,100,89,5,2,1,1,0,0,0,2,1601,12,1002
경기도,오산시,신장동,신장동제2투,2768,1963,774,440,464,125,150,1,0,4,0,0,0,0,2,1960,3,805
경기도,오산시,신장동,신장동제3투,3151,2055,758,490,543,121,123,1,1,3,0,3,1,0,3,2047,8,1096
경기도,오산시,신장동,신장동제4투,3773,2532,916,643,628,157,168,0,0,2,1,1,0,0,4,2520,12,1241
경기도,오산시,신장동,신장동제5투,1870,1322,563,229,340,83,99,1,0,0,1,3,0,0,0,1319,3,548
경기도,오산시,신장동,신장동제6투,3052,1876,779,428,450,90,100,8,2,0,4,0,0,0,0,1861,15,1176
경기도,오산시,신장동,신장동제7투,3557,2240,1005,434,518,123,140,2,0,2,1,2,1,1,3,2232,8,1317
경기도,오산시,신장동,신장동제8투,4265,3053,1403,501,727,208,194,4,0,0,0,3,0,0,3,3043,10,1212
경기도,오산시,신장동,신장동제9투,2787,1928,972,270,416,124,133,2,1,0,0,1,0,0,2,1921,7,859
경기도,오산시,신장동,신장동제10투,2616,1878,842,325,456,123,125,0,0,0,0,3,0,0,0,1874,4,738
경기도,오산시,신장동,신장동제11투,2404,1523,664,333,328,97,91,1,2,1,0,1,0,0,2,1520,3,881
경기도,오산시,세마동,관내사전투표,3152,3152,1540,549,644,187,215,3,1,2,0,3,0,1,1,3146,6,0
경기도,오산시,세마동,합계,13776,11047,4964,2090,2412,747,736,8,2,4,4,6,1,4,6,10984,63,2729
경기도,오산시,세마동,세마동제1투,2225,1360,462,375,303,104,71,0,1,1,0,0,1,1,1,1320,40,865
경기도,오산시,세마동,세마동제2투,2476,1806,742,428,377,122,122,2,0,0,3,2,0,1,0,1799,7,670
경기도,오산시,세마동,세마동제3투,3005,2481,1164,390,571,165,179,3,0,1,1,0,0,1,2,2477,4,524
경기도,오산시,세마동,세마동제4투,2918,2248,1056,348,517,169,149,0,0,0,0,1,0,0,2,2242,6,670
경기도,오산시,초평동,합계,11857,8314,3586,1609,1975,456,626,11,0,3,4,3,0,1,13,8287,27,3543
경기도,오산시,초평동,관내사전투표,2340,2340,1138,410,472,112,194,3,0,1,4,1,0,0,0,2335,5,0
경기도,오산시,초평동,초평동제1투,2095,1173,394,364,276,60,71,4,0,0,0,0,0,0,1,1170,3,922
경기도,오산시,초평동,초평동제2투,2057,1242,501,246,304,78,102,3,0,0,0,0,0,0,3,1237,5,815
경기도,오산시,초평동,초평동제3투,1804,1130,488,210,269,81,72,0,0,0,0,1,0,0,4,1125,5,674
경기도,오산시,초평동,초평동제4투,1631,1182,497,213,296,68,101,0,0,1,0,1,0,0,3,1180,2,449
경기도,오산시,초평동,초평동제5투,1930,1247,568,166,358,57,86,1,0,1,0,0,0,1,2,1240,7,683
경기도,오산시,잘못 투입·구분된 투표지,,0,0,0,0,0,0,0,0,0,0,0,0,0,0,0,0,0,0
경기도,화성시,합계,,493782,386002,176940,69014,84967,26194,25910,401,58,284,81,267,118,141,345,384720,1282,107780
경기도,화성시,거소·선상투표,,818,737,239,92,245,51,30,2,1,5,0,2,3,4,8,682,55,81
경기도,화성시,관외사전투표,,44610,44536,21074,6984,9124,3450,3411,50,12,38,8,30,11,16,63,44271,265,74
경기도,화성시,재외투표,,2772,2182,1375,109,337,91,256,5,0,2,0,1,1,0,0,2177,5,590
경기도,화성시,봉담읍,합계,48686,36250,15671,7049,8410,2293,2547,40,5,42,9,27,10,10,30,36143,107,12436
경기도,화성시,봉담읍,관내사전투표,7857,7857,3770,1413,1607,447,557,7,2,14,4,5,1,2,5,7834,23,0
경기도,화성시,봉담읍,봉담읍제1투,2896,1811,740,341,463,120,137,0,0,1,0,2,0,0,2,1806,5,1085
경기도,화성시,봉담읍,봉담읍제2투,2048,1390,530,281,355,94,115,3,0,3,0,1,0,1,1,1384,6,658
경기도,화성시,봉담읍,봉담읍제3투,2770,1795,547,614,444,79,98,2,0,0,0,2,1,0,4,1791,4,975
경기도,화성시,봉담읍,봉담읍제4투,2899,1706,558,475,457,89,112,5,0,3,0,0,0,1,1,1701,5,1193
경기도,화성시,봉담읍,봉담읍제5투,2349,1567,589,407,340,86,125,2,1,4,1,0,1,2,1,1559,8,782
경기도,화성시,봉담읍,봉담읍제6투,3239,2066,926,411,467,122,124,4,0,0,0,1,0,1,4,2060,6,1173
경기도,화성시,봉담읍,봉담읍제7투,2818,1964,800,374,473,137,169,2,1,0,0,1,1,1,0,1959,5,854
경기도,화성시,봉담읍,봉담읍제8투,3297,2121,923,420,513,130,112,1,0,3,0,3,2,0,4,2111,10,1176
경기도,화성시,봉담읍,봉담읍제9투,3155,2436,1080,436,536,169,200,1,0,0,0,4,1,1,2,2430,6,719
경기도,화성시,봉담읍,봉담읍제10투,4263,3334,1384,636,814,243,225,9,1,7,0,1,1,1,2,3324,10,929
경기도,화성시,봉담읍,봉담읍제11투,3215,2338,1099,384,537,144,162,2,0,2,1,3,1,0,2,2337,1,877
경기도,화성시,봉담읍,봉담읍제12투,4266,3286,1502,530,795,223,218,2,0,2,0,2,0,0,1,3275,11,980
경기도,화성시,봉담읍,봉담읍제13투,2006,1329,585,209,315,106,104,0,0,2,2,0,0,0,1,1324,5,677
경기도,화성시,봉담읍,봉담읍제14투,1608,1250,638,118,294,104,89,0,0,1,1,2,1,0,0,1248,2,358
경기도,화성시,우정읍,합계,13946,9358,3212,2605,2197,520,715,9,2,13,7,15,7,7,16,9325,33,4588
경기도,화성시,우정읍,관내사전투표,2658,2658,1091,572,582,154,240,2,2,1,0,4,1,0,1,2650,8,0
경기도,화성시,우정읍,우정읍제1투,3004,1800,602,476,444,110,151,0,0,2,3,2,1,3,2,1796,4,1204
경기도,화성시,우정읍,우정읍제2투,1925,1139,268,469,294,45,50,1,0,3,1,0,1,1,3,1136,3,786
경기도,화성시,우정읍,우정읍제3투,2437,1330,430,379,329,78,98,1,0,2,3,1,1,0,5,1327,3,1107
경기도,화성시,우정읍,우정읍제4투,1307,866,376,141,186,49,95,4,0,0,0,5,1,2,1,860,6,441
경기도,화성시,우정읍,우정읍제5투,1373,846,264,290,193,43,43,1,0,2,0,1,2,1,2,842,4,527
경기도,화성시,우정읍,우정읍제6투,1242,719,181,278,169,41,38,0,0,3,0,2,0,0,2,714,5,523
경기도,화성시,향남읍,합계,51078,36743,16744,6143,8595,2245,2746,40,4,18,7,53,14,9,25,36643,100,14335
경기도,화성시,향남읍,관내사전투표,7739,7739,3993,1014,1520,479,669,4,2,8,1,13,3,2,5,7713,26,0
경기도,화성시,향남읍,향남읍제1투,2849,1517,554,388,367,104,93,2,1,1,1,1,1,0,1,1514,3,1332
경기도,화성시,향남읍,향남읍제2투,3664,1974,794,424,485,117,138,2,1,0,1,3,1,3,0,1969,5,1690
경기도,화성시,향남읍,향남읍제3투,935,548,128,185,179,32,18,0,0,0,0,1,0,0,2,545,3,387
경기도,화성시,향남읍,향남읍제4투,1272,783,215,293,204,39,26,0,0,0,1,0,0,0,2,780,3,489
경기도,화성시,향남읍,향남읍제5투,2681,1676,602,416,423,94,122,3,0,2,0,3,0,0,2,1667,9,1005
경기도,화성시,향남읍,향남읍제6투,2581,1587,635,365,388,80,102,8,0,0,0,2,1,0,2,1583,4,994
경기도,화성시,향남읍,향남읍제7투,1847,1435,593,273,357,79,122,1,0,0,0,4,0,0,1,1430,5,412
경기도,화성시,향남읍,향남읍제8투,2907,2183,1001,357,554,126,137,2,0,0,0,1,0,1,1,2180,3,724
경기도,화성시,향남읍,향남읍제9투,2447,1874,945,257,418,116,131,1,0,0,0,3,0,0,1,1872,2,573
경기도,화성시,향남읍,향남읍제10투,4354,3177,1490,468,784,175,236,6,0,1,1,1,2,0,4,3168,9,1177
경기도,화성시,향남읍,향남읍제11투,2750,1961,1052,200,408,116,168,1,0,0,0,8,3,1,0,1957,4,789
경기도,화성시,향남읍,향남읍제12투,3226,2037,835,394,526,117,150,2,0,5,0,0,1,1,1,2032,5,1189
경기도,화성시,향남읍,향남읍제13투,1759,1438,732,179,296,97,122,0,0,0,1,6,0,1,2,1436,2,321
경기도,화성시,향남읍,향남읍제14투,2159,1625,828,161,382,111,132,3,0,0,0,2,0,0,0,1619,6,534
경기도,화성시,향남읍,향남읍제15투,2717,2012,910,278,512,151,153,1,0,1,0,2,2,0,1,2011,1,705
경기도,화성시,향남읍,향남읍제16투,2878,1671,740,288,416,104,114,1,0,0,0,1,0,0,0,1664,7,1207
경기도,화성시,향남읍,향남읍제17투,2313,1506,697,203,376,108,113,3,0,0,1,2,0,0,0,1503,3,807
경기도,화성시,매송면,합계,6302,4408,1341,1391,1090,268,252,5,0,14,0,5,2,10,7,4385,23,1894
경기도,화성시,매송면,관내사전투표,1041,1041,356,290,258,57,64,1,0,5,0,1,1,3,0,1036,5,0
경기도,화성시,매송면,매송면제1투,2064,1272,375,428,316,74,68,0,0,1,0,3,0,2,1,1268,4,792
경기도,화성시,매송면,매송면제2투,1484,997,304,306,222,75,70,2,0,6,0,0,1,3,1,990,7,487
경기도,화성시,매송면,매송면제3투,1713,1098,306,367,294,62,50,2,0,2,0,1,0,2,5,1091,7,615
경기도,화성시,비봉면,합계,4826,3421,916,1325,785,185,165,4,0,4,1,8,2,6,3,3404,17,1405
경기도,화성시,비봉면,관내사전투표,962,962,306,309,212,64,58,0,0,2,0,5,0,1,1,958,4,0
경기도,화성시,비봉면,비봉면제1투,2114,1344,368,504,320,67,71,2,0,1,1,1,1,2,1,1339,5,770
경기도,화성시,비봉면,비봉면제2투,1127,706,143,311,172,42,22,2,0,1,0,2,1,3,1,700,6,421
경기도,화성시,비봉면,비봉면제3투,623,409,99,201,81,12,14,0,0,0,0,0,0,0,0,407,2,214
경기도,화성시,마도면,합계,5414,3707,1067,1296,943,173,188,2,2,0,4,1,4,2,7,3689,18,1707
경기도,화성시,마도면,관내사전투표,936,936,335,294,199,49,50,1,0,0,0,1,0,0,2,931,5,0
경기도,화성시,마도면,마도면제1투,2987,1795,482,586,515,92,103,1,1,0,1,0,1,0,4,1786,9,1192
경기도,화성시,마도면,마도면제2투,1491,976,250,416,229,32,35,0,1,0,3,0,3,2,1,972,4,515
경기도,화성시,송산면,합계,8793,5732,1463,2293,1338,296,263,7,2,11,5,6,7,4,8,5703,29,3061
경기도,화성시,송산면,관내사전투표,1491,1491,497,473,319,90,87,3,0,4,0,2,0,1,3,1479,12,0
경기도,화성시,송산면,송산면제1투,4202,2332,570,913,571,127,121,2,2,2,2,3,3,0,4,2320,12,1870
경기도,화성시,송산면,송산면제2투,1222,784,151,398,176,25,24,2,0,5,0,0,3,0,0,784,0,438
경기도,화성시,송산면,송산면제3투,1878,1125,245,509,272,54,31,0,0,0,3,1,1,3,1,1120,5,753
경기도,화성시,서신면,관내사전투표,893,893,295,285,218,44,44,1,0,0,1,2,0,0,0,890,3,0
경기도,화성시,서신면,합계,5730,3625,922,1419,949,134,157,9,0,1,2,7,3,1,3,3607,18,2105
경기도,화성시,서신면,서신면제1투,1676,959,175,421,260,39,46,5,0,0,1,2,2,0,0,951,8,717
경기도,화성시,서신면,서신면제2투,1874,1015,267,387,276,39,36,0,0,1,0,2,0,1,2,1011,4,859
경기도,화성시,서신면,서신면제3투,1287,758,185,326,195,12,31,3,0,0,0,1,1,0,1,755,3,529
경기도,화성시,팔탄면,합계,8778,5870,1854,1872,1472,322,291,4,3,6,1,7,1,4,8,5845,25,2908
경기도,화성시,팔탄면,관내사전투표,1992,1992,758,580,429,102,105,0,1,0,0,2,0,3,2,1982,10,0
경기도,화성시,팔탄면,팔탄면제1투,3410,1930,549,586,545,126,101,2,2,3,0,3,0,0,4,1921,9,1480
경기도,화성시,팔탄면,팔탄면제2투,1515,919,250,324,256,48,38,0,0,2,0,0,0,0,0,918,1,596
경기도,화성시,팔탄면,팔탄면제3투,1861,1029,297,382,242,46,47,2,0,1,1,2,1,1,2,1024,5,832
경기도,화성시,장안면,합계,8255,5203,1558,1654,1311,258,307,11,2,5,2,9,5,6,17,5145,58,3052
경기도,화성시,장안면,관내사전투표,1045,1045,366,293,233,52,81,3,0,1,0,2,0,2,4,1037,8,0
경기도,화성시,장안면,장안면제1투,1794,928,223,344,262,49,40,1,0,0,0,1,1,0,2,923,5,866
경기도,화성시,장안면,장안면제2투,1886,1115,283,365,295,53,61,6,1,2,2,2,2,4,8,1084,31,771
경기도,화성시,장안면,장안면제3투,1116,655,171,265,160,20,28,1,0,1,0,0,2,0,1,649,6,461
경기도,화성시,장안면,장안면제4투,767,511,156,171,128,16,33,0,0,1,0,2,0,0,1,508,3,256
경기도,화성시,장안면,장안면제5투,1647,949,359,216,233,68,64,0,1,0,0,2,0,0,1,944,5,698
경기도,화성시,양감면,합계,3594,2419,684,839,613,128,129,3,0,2,2,2,1,3,3,2409,10,1175
경기도,화성시,양감면,관내사전투표,654,654,246,157,171,37,35,1,0,1,1,1,0,2,0,652,2,0
경기도,화성시,양감면,양감면제1투,1420,861,230,329,204,42,47,2,0,0,1,1,1,0,2,859,2,559
경기도,화성시,양감면,양감면제2투,1520,904,208,353,238,49,47,0,0,1,0,0,0,1,1,898,6,616
경기도,화성시,정남면,합계,9400,6265,1905,2176,1464,333,314,11,2,4,4,7,2,9,10,6241,24,3135
경기도,화성시,정남면,관내사전투표,1298,1298,502,393,268,55,61,5,0,2,0,3,0,2,1,1292,6,0
경기도,화성시,정남면,정남면제1투,2240,1415,380,579,288,76,76,1,1,1,1,2,0,2,2,1409,6,825
경기도,화성시,정남면,정남면제2투,1826,995,249,406,238,50,42,1,1,0,0,1,0,3,2,993,2,831
경기도,화성시,정남면,정남면제3투,2279,1399,362,529,371,75,48,3,0,0,1,0,1,1,2,1393,6,880
경기도,화성시,정남면,정남면제4투,1757,1158,412,269,299,77,87,1,0,1,2,1,1,1,3,1154,4,599
경기도,화성시,동탄면,합계,7051,5618,2821,890,1163,375,341,3,1,2,2,3,3,0,6,5610,8,1433
경기도,화성시,동탄면,관내사전투표,1579,1579,932,176,243,121,98,2,0,0,2,2,0,0,3,1579,0,0
경기도,화성시,동탄면,동탄면제1투,1744,1043,393,268,243,69,62,1,1,0,0,0,1,0,3,1041,2,701
경기도,화성시,동탄면,동탄면제2투,467,327,72,140,80,18,14,0,0,0,0,0,2,0,0,326,1,140
경기도,화성시,동탄면,동탄면제3투,3261,2669,1424,306,597,167,167,0,0,2,0,1,0,0,0,2664,5,592
경기도,화성시,남양읍,관내사전투표,4484,4484,1957,930,946,266,341,5,2,2,1,5,2,1,5,4463,21,0
경기도,화성시,남양읍,합계,21575,14833,5606,3566,3561,912,1049,18,3,10,2,12,5,4,18,14766,67,6742
경기도,화성시,남양읍,남양읍제1투,2457,1443,537,356,332,92,108,3,0,1,0,0,0,0,4,1433,10,1014
경기도,화성시,남양읍,남양읍제2투,4020,2480,815,671,650,160,169,2,0,2,0,2,1,1,2,2475,5,1540
경기도,화성시,남양읍,남양읍제3투,3305,1887,512,672,494,97,94,4,0,0,0,1,1,1,2,1878,9,1418
경기도,화성시,남양읍,남양읍제4투,959,601,126,260,160,25,17,0,0,3,0,1,0,1,2,595,6,358
경기도,화성시,남양읍,남양읍제5투,3086,1844,766,302,466,135,157,2,0,1,1,2,1,0,1,1834,10,1242
경기도,화성시,남양읍,남양읍제6투,3264,2094,893,375,513,137,163,2,1,1,0,1,0,0,2,2088,6,1170
경기도,화성시,진안동,합계,25161,18032,8533,2941,3855,1254,1316,21,3,21,1,7,7,9,15,17983,49,7129
경기도,화성시,진안동,관내사전투표,3599,3599,1842,511,693,245,285,3,0,5,0,3,0,3,0,3590,9,0
경기도,화성시,진안동,진안동제1투,3364,1872,778,379,427,131,136,2,0,2,1,0,2,2,4,1864,8,1492
경기도,화성시,진안동,진안동제2투,2367,1486,680,233,368,103,92,2,0,4,0,0,0,0,0,1482,4,881
경기도,화성시,진안동,진안동제3투,2318,1877,807,375,437,133,108,2,0,1,0,0,2,2,6,1873,4,441
경기도,화성시,진안동,진안동제4투,4202,2821,1339,466,601,207,190,1,2,3,0,0,0,0,3,2812,9,1381
경기도,화성시,진안동,진안동제5투,3862,2786,1345,505,575,155,194,1,0,3,0,1,1,1,1,2782,4,1076
경기도,화성시,진안동,진안동제6투,2431,1965,932,299,426,143,148,8,1,2,0,1,0,0,0,1960,5,466
경기도,화성시,진안동,진안동제7투,3018,1626,810,173,328,137,163,2,0,1,0,2,2,1,1,1620,6,1392
경기도,화성시,병점1동,합계,20243,15780,7383,2547,3532,1119,1104,12,1,6,4,8,4,1,19,15740,40,4463
경기도,화성시,병점1동,관내사전투표,4285,4285,2237,616,835,291,284,1,0,2,0,2,1,0,6,4275,10,0
경기도,화성시,병점1동,병점1동제1투,3402,2561,1162,403,635,157,186,1,0,0,2,2,1,0,2,2551,10,841
경기도,화성시,병점1동,병점1동제2투,2831,2064,912,364,470,143,157,6,0,1,0,2,1,0,2,2058,6,767
경기도,화성시,병점1동,병점1동제3투,2862,1868,821,332,436,137,129,3,0,1,0,2,0,0,3,1864,4,994
경기도,화성시,병점1동,병점1동제4투,3562,2756,1286,413,627,229,193,0,0,0,0,0,0,1,3,2752,4,806
경기도,화성시,병점1동,병점1동제5투,3301,2246,965,419,529,162,155,1,1,2,2,0,1,0,3,2240,6,1055
경기도,화성시,병점2동,합계,17690,14212,7126,2033,3012,946,1005,20,2,14,3,8,4,4,7,14184,28,3478
경기도,화성시,병점2동,관내사전투표,4247,4247,2381,486,764,257,333,6,2,7,0,0,1,1,1,4239,8,0
경기도,화성시,병점2동,병점2동제1투,3348,2427,1185,372,524,169,166,3,0,1,1,0,2,1,1,2425,2,921
경기도,화성시,병점2동,병점2동제2투,3638,2929,1359,486,670,209,191,4,0,1,0,4,0,1,1,2926,3,709
경기도,화성시,병점2동,병점2동제3투,3471,2450,1196,319,580,173,165,4,0,2,0,1,0,1,3,2444,6,1021
경기도,화성시,병점2동,병점2동제4투,2986,2159,1005,370,474,138,150,3,0,3,2,3,1,0,1,2150,9,827
경기도,화성시,반월동,합계,19352,16008,7727,2439,3504,1269,981,12,1,10,3,4,0,5,12,15967,41,3344
경기도,화성시,반월동,관내사전투표,3628,3628,1802,563,714,290,238,1,0,3,0,3,0,1,4,3619,9,0
경기도,화성시,반월동,반월동제1투,2886,2227,973,414,545,154,125,3,0,4,1,0,0,0,2,2221,6,659
경기도,화성시,반월동,반월동제2투,3620,2659,1130,496,605,234,170,5,0,1,1,1,0,3,2,2648,11,961
경기도,화성시,반월동,반월동제3투,2918,2392,1137,401,520,194,130,0,0,1,0,0,0,0,0,2383,9,526
경기도,화성시,반월동,반월동제4투,3429,2833,1497,315,610,222,177,2,1,1,1,0,0,0,2,2828,5,596
경기도,화성시,반월동,반월동제5투,1666,1320,699,135,288,113,82,0,0,0,0,0,0,1,1,1319,1,346
경기도,화성시,반월동,반월동제6투,1205,949,489,115,222,62,59,1,0,0,0,0,0,0,1,949,0,256
경기도,화성시,기배동,합계,10339,8136,3447,1586,1917,533,589,7,1,6,2,6,1,2,11,8108,28,2203
경기도,화성시,기배동,관내사전투표,2568,2568,1204,425,566,164,195,1,0,3,0,2,0,0,3,2563,5,0
경기도,화성시,기배동,기배동제1투,2752,1947,789,405,447,133,151,3,0,2,2,2,0,2,4,1940,7,805
경기도,화성시,기배동,기배동제2투,2452,1802,742,348,450,117,132,1,0,1,0,2,1,0,1,1795,7,650
경기도,화성시,기배동,기배동제3투,2567,1819,712,408,454,119,111,2,1,0,0,0,0,0,3,1810,9,748
경기도,화성시,화산동,합계,16869,11979,4646,2811,2747,803,856,19,3,12,2,13,5,3,12,11932,47,4890
경기도,화성시,화산동,관내사전투표,3368,3368,1516,729,628,210,245,6,0,2,2,4,2,2,3,3349,19,0
경기도,화성시,화산동,화산동제1투,2878,1789,626,477,429,121,116,4,0,5,0,3,0,0,2,1783,6,1089
경기도,화성시,화산동,화산동제2투,3264,2058,735,496,507,153,140,6,1,4,0,4,1,0,4,2051,7,1206
경기도,화성시,화산동,화산동제3투,3564,2366,904,517,587,156,186,2,0,1,0,1,2,0,0,2356,10,1198
경기도,화성시,화산동,화산동제4투,3795,2398,865,592,596,163,169,1,2,0,0,1,0,1,3,2393,5,1397
경기도,화성시,동탄1동,합계,33528,27861,14957,3370,5449,2184,1797,22,0,12,2,4,2,4,7,27810,51,5667
경기도,화성시,동탄1동,관내사전투표,6660,6660,3780,671,1130,542,515,2,0,2,0,1,1,1,2,6647,13,0
경기도,화성시,동탄1동,동탄1동제1투,2160,1727,889,238,362,125,101,3,0,1,0,1,0,0,1,1721,6,433
경기도,화성시,동탄1동,동탄1동제2투,3186,2479,1281,327,517,182,166,0,0,2,0,0,0,0,2,2477,2,707
경기도,화성시,동탄1동,동탄1동제3투,2270,1758,967,203,340,134,107,1,0,1,0,1,0,0,0,1754,4,512
경기도,화성시,동탄1동,동탄1동제4투,3242,2705,1594,273,499,172,154,4,0,1,1,0,0,0,1,2699,6,537
경기도,화성시,동탄1동,동탄1동제5투,2391,2002,1049,275,407,156,108,2,0,0,0,0,0,1,0,1998,4,389
경기도,화성시,동탄1동,동탄1동제6투,2965,2236,1228,244,416,186,157,3,0,2,0,0,0,0,0,2236,0,729
경기도,화성시,동탄1동,동탄1동제7투,2498,2053,1126,229,414,160,115,1,0,0,0,0,0,1,0,2046,7,445
경기도,화성시,동탄1동,동탄1동제8투,3016,2410,1106,404,558,200,135,1,0,3,0,0,0,1,1,2409,1,606
경기도,화성시,동탄1동,동탄1동제9투,2108,1777,920,236,367,124,122,0,0,0,0,1,0,0,0,1770,7,331
경기도,화성시,동탄1동,동탄1동제10투,3032,2054,1017,270,439,203,117,5,0,0,1,0,1,0,0,2053,1,978
경기도,화성시,동탄2동,합계,24333,20348,10747,2594,4189,1475,1256,22,0,4,3,7,1,2,7,20307,41,3985
경기도,화성시,동탄2동,관내사전투표,5725,5724,3195,681,1027,400,400,2,0,2,2,2,1,0,3,5715,9,1
경기도,화성시,동탄2동,동탄2동제1투,3193,2663,1455,320,555,192,130,4,0,0,0,2,0,1,0,2659,4,530
경기도,화성시,동탄2동,동탄2동제2투,2152,1695,907,220,341,121,101,4,0,0,0,0,0,0,0,1694,1,457
경기도,화성시,동탄2동,동탄2동제3투,3225,2592,1445,268,482,197,181,2,0,2,0,2,0,0,1,2580,12,633
경기도,화성시,동탄2동,동탄2동제4투,2984,2526,1170,403,616,184,144,4,0,0,0,0,0,1,0,2522,4,458
경기도,화성시,동탄2동,동탄2동제5투,3151,2040,983,353,460,120,109,5,0,0,1,0,0,0,3,2034,6,1111
경기도,화성시,동탄2동,동탄2동제6투,3903,3108,1592,349,708,261,191,1,0,0,0,1,0,0,0,3103,5,795
경기도,화성시,동탄3동,합계,28211,23283,13047,2442,4645,1598,1447,15,4,8,2,8,9,2,12,23239,44,4928
경기도,화성시,동탄3동,관내사전투표,6460,6460,3823,637,1076,450,445,6,1,5,0,2,1,1,3,6450,10,0
경기도,화성시,동탄3동,동탄3동제1투,3458,2822,1677,218,585,155,178,1,1,0,0,2,1,0,2,2820,2,636
경기도,화성시,동탄3동,동탄3동제2투,3795,2719,1422,358,598,173,156,1,0,1,0,0,3,0,1,2713,6,1076
경기도,화성시,동탄3동,동탄3동제3투,3625,2352,1168,320,540,164,135,4,1,2,1,1,2,1,1,2340,12,1273
경기도,화성시,동탄3동,동탄3동제4투,3524,2846,1516,329,622,209,162,0,0,0,0,0,0,0,2,2840,6,678
경기도,화성시,동탄3동,동탄3동제5투,3853,3110,1708,335,625,244,186,3,1,0,0,1,2,0,2,3107,3,743
경기도,화성시,동탄3동,동탄3동제6투,3496,2974,1733,245,599,203,185,0,0,0,1,2,0,0,1,2969,5,522
경기도,화성시,동탄4동,관내사전투표,8309,8309,4686,893,1592,593,520,6,2,2,1,1,1,2,2,8301,8,0
경기도,화성시,동탄4동,합계,46428,39382,20849,4536,8498,2974,2390,28,4,14,3,7,4,13,11,39331,51,7046
경기도,화성시,동탄4동,동탄4동제1투,3657,2885,1495,329,661,209,178,7,0,0,2,1,0,1,0,2883,2,772
경기도,화성시,동탄4동,동탄4동제2투,3214,2698,1529,209,612,187,152,1,0,0,0,0,0,2,0,2692,6,516
경기도,화성시,동탄4동,동탄4동제3투,2779,2367,1334,207,463,204,151,0,0,1,0,1,0,0,3,2364,3,412
경기도,화성시,동탄4동,동탄4동제4투,3626,2925,1569,345,620,231,147,1,0,1,0,3,0,2,0,2919,6,701
경기도,화성시,동탄4동,동탄4동제5투,3475,2850,1422,325,644,280,171,1,0,1,0,0,0,0,1,2845,5,625
경기도,화성시,동탄4동,동탄4동제6투,2463,2054,1182,203,410,137,119,2,0,0,0,1,0,0,0,2054,0,409
경기도,화성시,동탄4동,동탄4동제7투,1575,1260,652,167,262,82,88,0,0,5,0,0,0,0,1,1257,3,315
경기도,화성시,동탄4동,동탄4동제8투,3029,2543,1346,272,559,197,165,0,0,0,0,0,1,1,0,2541,2,486
경기도,화성시,동탄4동,동탄4동제9투,2157,1760,1010,171,356,114,107,1,0,0,0,0,0,0,1,1760,0,397
경기도,화성시,동탄4동,동탄4동제10투,2558,1800,785,308,441,113,140,6,1,1,0,0,0,2,0,1797,3,758
경기도,화성시,동탄4동,동탄4동제11투,3194,2709,1331,355,648,201,167,0,0,0,0,0,0,1,0,2703,6,485
경기도,화성시,동탄4동,동탄4동제12투,2590,2159,994,349,520,174,114,2,1,1,0,0,2,0,1,2158,1,431
경기도,화성시,동탄4동,동탄4동제13투,3802,3063,1514,403,710,252,171,1,0,2,0,0,0,2,2,3057,6,739
경기도,화성시,잘못 투입·구분된 투표지,,0,74,26,12,22,5,8,0,0,0,0,0,0,1,0,74,0,-74
경기도,시흥시,합계,,322806,239227,103732,43248,58119,14846,17127,301,56,208,58,235,79,80,243,238332,895,83579
경기도,시흥시,거소·선상투표,,541,518,188,59,186,52,13,2,2,0,0,2,0,0,3,507,11,23
경기도,시흥시,관외사전투표,,24208,24202,11273,3345,5563,1807,1909,34,14,9,7,17,12,10,52,24052,150,6
경기도,시흥시,재외투표,,1368,1054,660,56,156,44,132,2,0,1,0,0,0,1,0,1052,2,314
경기도,시흥시,대야동,합계,25747,19170,7786,3970,4774,1157,1288,35,7,19,5,19,5,11,19,19095,75,6577
경기도,시흥시,대야동,관내사전투표,4741,4741,2220,731,1102,296,337,10,1,7,1,4,0,2,5,4716,25,0
경기도,시흥시,대야동,대야동제1투,4293,2537,974,542,643,169,178,3,1,0,1,4,1,0,5,2521,16,1756
경기도,시흥시,대야동,대야동제2투,2544,1658,588,411,470,82,94,1,2,1,0,0,0,0,2,1651,7,886
경기도,시흥시,대야동,대야동제3투,3384,2274,899,494,593,131,142,2,0,2,0,3,1,1,2,2270,4,1110
경기도,시흥시,대야동,대야동제4투,3463,2661,1123,485,669,171,184,8,1,4,2,3,0,3,3,2656,5,802
경기도,시흥시,대야동,대야동제5투,473,335,73,154,75,17,10,3,0,0,1,0,2,0,0,335,0,138
경기도,시흥시,대야동,대야동제6투,1811,1374,549,286,360,85,83,1,1,1,0,2,0,2,0,1370,4,437
경기도,시흥시,대야동,대야동제7투,3745,2724,1093,588,646,162,207,6,1,4,0,2,1,2,1,2713,11,1021
경기도,시흥시,대야동,대야동제8투,1293,866,267,279,216,44,53,1,0,0,0,1,0,1,1,863,3,427
경기도,시흥시,신천동,합계,31334,21424,8588,4629,5339,1200,1447,27,6,12,4,21,7,14,27,21321,103,9910
경기도,시흥시,신천동,관내사전투표,4010,4010,1859,777,858,226,259,3,1,2,0,5,0,2,4,3996,14,0
경기도,시흥시,신천동,신천동제1투,2543,1406,565,286,365,59,117,5,1,1,1,0,2,0,2,1404,2,1137
경기도,시흥시,신천동,신천동제2투,4518,2807,1035,703,705,148,183,1,0,2,1,4,2,1,3,2788,19,1711
경기도,시흥시,신천동,신천동제3투,2580,1574,521,413,443,77,91,6,0,2,1,1,1,2,2,1560,14,1006
경기도,시흥시,신천동,신천동제4투,3583,2240,869,526,554,115,146,2,1,0,0,2,2,2,5,2224,16,1343
경기도,시흥시,신천동,신천동제5투,2961,1879,725,398,511,109,115,3,3,1,0,3,0,1,2,1871,8,1082
경기도,시흥시,신천동,신천동제6투,3035,1925,785,414,468,102,135,2,0,1,1,1,0,4,4,1917,8,1110
경기도,시흥시,신천동,신천동제7투,3839,2789,1148,554,695,190,184,3,0,2,0,3,0,0,2,2781,8,1050
경기도,시흥시,신천동,신천동제8투,4265,2794,1081,558,740,174,217,2,0,1,0,2,0,2,3,2780,14,1471
경기도,시흥시,신현동,관내사전투표,1704,1704,744,375,337,99,124,2,0,1,0,4,1,3,1,1691,13,0
경기도,시흥시,신현동,합계,8828,6544,2328,1764,1559,384,433,6,1,10,0,8,6,8,4,6511,33,2284
경기도,시흥시,신현동,신현동제1투,1814,1234,458,281,294,88,95,2,0,1,0,4,2,3,0,1228,6,580
경기도,시흥시,신현동,신현동제2투,2228,1534,508,426,407,78,107,0,1,2,0,0,0,1,0,1530,4,694
경기도,시흥시,신현동,신현동제3투,2679,1791,555,533,473,109,99,2,0,4,0,0,3,1,2,1781,10,888
경기도,시흥시,신현동,신현동제4투,403,281,63,149,48,10,8,0,0,2,0,0,0,0,1,281,0,122
경기도,시흥시,은행동,합계,21669,16874,7469,2992,3989,1063,1223,12,1,27,3,18,3,3,17,16820,54,4795
경기도,시흥시,은행동,관내사전투표,3941,3941,1930,597,828,232,323,4,0,7,0,6,0,1,3,3931,10,0
경기도,시흥시,은행동,은행동제1투,3177,2053,782,481,501,122,145,3,0,2,0,2,2,1,1,2042,11,1124
경기도,시흥시,은행동,은행동제2투,3725,2425,992,481,605,144,162,3,0,9,3,4,0,1,10,2414,11,1300
경기도,시흥시,은행동,은행동제3투,3307,2615,1238,461,565,165,171,0,0,4,0,2,0,0,0,2606,9,692
경기도,시흥시,은행동,은행동제4투,4156,3222,1437,498,805,232,230,1,1,3,0,3,0,0,2,3212,10,934
경기도,시흥시,은행동,은행동제5투,3363,2618,1090,474,685,168,192,1,0,2,0,1,1,0,1,2615,3,745
경기도,시흥시,매화동,관내사전투표,2051,2051,879,425,452,118,154,4,1,2,0,3,1,0,4,2043,8,0
경기도,시흥시,매화동,합계,10246,7351,2828,1623,1874,425,512,13,3,11,1,14,2,2,9,7317,34,2895
경기도,시흥시,매화동,매화동제1투,3318,2167,835,434,589,148,137,2,0,3,1,2,0,0,3,2154,13,1151
경기도,시흥시,매화동,매화동제2투,2434,1586,555,432,418,76,92,1,0,1,0,4,0,0,2,1581,5,848
경기도,시흥시,매화동,매화동제3투,2443,1547,559,332,415,83,129,6,2,5,0,5,1,2,0,1539,8,896
경기도,시흥시,목감동,합계,14121,10714,4451,2256,2570,650,707,15,0,11,0,12,0,6,8,10686,28,3407
경기도,시흥시,목감동,관내사전투표,2670,2670,1234,471,576,176,193,6,0,3,0,3,0,0,2,2664,6,0
경기도,시흥시,목감동,목감동제1투,2600,1651,573,432,452,81,101,2,0,2,0,4,0,1,0,1648,3,949
경기도,시흥시,목감동,목감동제2투,1308,953,302,296,240,49,59,2,0,1,0,0,0,1,1,951,2,355
경기도,시흥시,목감동,목감동제3투,4046,2844,1113,678,668,164,192,3,0,3,0,2,0,3,5,2831,13,1202
경기도,시흥시,목감동,목감동제4투,3497,2596,1229,379,634,180,162,2,0,2,0,3,0,1,0,2592,4,901
경기도,시흥시,군자동,합계,18725,12769,5081,2738,3254,651,910,22,5,18,4,14,7,1,19,12724,45,5956
경기도,시흥시,군자동,관내사전투표,2686,2686,1191,466,642,140,213,8,1,6,1,4,3,0,2,2677,9,0
경기도,시흥시,군자동,군자동제1투,3842,2258,863,529,584,101,159,1,0,5,0,2,1,0,2,2247,11,1584
경기도,시흥시,군자동,군자동제2투,2660,1622,661,364,384,78,121,0,1,4,0,2,1,0,3,1619,3,1038
경기도,시흥시,군자동,군자동제3투,3411,2249,904,469,580,105,158,8,2,0,0,4,1,0,4,2235,14,1162
경기도,시흥시,군자동,군자동제4투,3614,2337,853,526,645,146,146,5,1,2,3,1,1,0,5,2334,3,1277
경기도,시흥시,군자동,군자동제5투,2512,1617,609,384,419,81,113,0,0,1,0,1,0,1,3,1612,5,895
경기도,시흥시,정왕본동,관내사전투표,3149,3149,1589,446,671,173,231,5,0,6,1,4,2,2,4,3134,15,0
경기도,시흥시,정왕본동,합계,20249,11165,5106,1881,2637,653,772,24,0,13,5,11,8,3,11,11124,41,9084
경기도,시흥시,정왕본동,정왕본동제1투,3330,1268,493,276,329,72,77,6,0,2,1,0,1,0,5,1262,6,2062
경기도,시흥시,정왕본동,정왕본동제2투,3563,1487,717,230,355,82,92,3,0,1,2,0,2,0,1,1485,2,2076
경기도,시흥시,정왕본동,정왕본동제3투,2233,910,404,183,212,41,62,1,0,1,0,2,1,0,0,907,3,1323
경기도,시흥시,정왕본동,정왕본동제4투,2268,899,397,160,212,54,64,5,0,0,0,0,1,0,0,893,6,1369
경기도,시흥시,정왕본동,정왕본동제5투,1929,719,331,112,167,49,56,1,0,1,1,1,0,0,0,719,0,1210
경기도,시흥시,정왕본동,정왕본동제6투,3777,2733,1175,474,691,182,190,3,0,2,0,4,1,1,1,2724,9,1044
경기도,시흥시,정왕1동,합계,21032,13138,5870,2240,3144,774,995,16,3,9,1,8,8,1,11,13080,58,7894
경기도,시흥시,정왕1동,관내사전투표,3376,3376,1684,459,731,207,265,3,1,2,0,1,4,0,3,3360,16,0
경기도,시흥시,정왕1동,정왕1동제1투,2993,1879,811,303,476,110,164,5,0,1,0,1,0,0,1,1872,7,1114
경기도,시흥시,정왕1동,정왕1동제2투,2949,1620,647,333,416,97,114,0,0,0,0,2,1,0,1,1611,9,1329
경기도,시흥시,정왕1동,정왕1동제3투,3115,1373,582,257,353,79,85,1,1,4,0,1,1,1,1,1366,7,1742
경기도,시흥시,정왕1동,정왕1동제4투,2762,1127,488,201,285,60,77,4,0,1,0,1,0,0,4,1121,6,1635
경기도,시흥시,정왕1동,정왕1동제5투,2141,1445,611,295,347,81,100,2,0,1,1,0,1,0,0,1439,6,696
경기도,시흥시,정왕1동,정왕1동제6투,3696,2318,1047,392,536,140,190,1,1,0,0,2,1,0,1,2311,7,1378
경기도,시흥시,정왕2동,합계,23920,17642,7860,2780,4281,1170,1429,21,3,22,6,14,4,4,12,17606,36,6278
경기도,시흥시,정왕2동,관내사전투표,4315,4315,2152,540,911,288,381,7,3,5,1,7,0,2,7,4304,11,0
경기도,시흥시,정왕2동,정왕2동제1투,3145,2191,934,329,576,153,186,1,0,2,1,2,0,1,1,2186,5,954
경기도,시흥시,정왕2동,정왕2동제2투,3387,2491,1043,460,620,173,183,1,0,5,0,2,1,0,2,2490,1,896
경기도,시흥시,정왕2동,정왕2동제3투,4180,2823,1164,524,712,186,221,1,0,4,2,1,2,0,0,2817,6,1357
경기도,시흥시,정왕2동,정왕2동제4투,2878,2060,884,306,539,143,177,1,0,2,0,1,0,0,0,2053,7,818
경기도,시흥시,정왕2동,정왕2동제5투,3282,2075,897,372,510,138,144,7,0,1,0,0,1,0,0,2070,5,1207
경기도,시흥시,정왕2동,정왕2동제6투,2733,1687,786,249,413,89,137,3,0,3,2,1,0,1,2,1686,1,1046
경기도,시흥시,정왕3동,합계,20269,14073,6200,2294,3611,900,979,11,3,7,3,4,3,5,12,14032,41,6196
경기도,시흥시,정왕3동,관내사전투표,3792,3792,1844,499,831,266,323,3,1,2,1,3,2,3,3,3781,11,0
경기도,시흥시,정왕3동,정왕3동제1투,3209,2191,946,340,589,149,152,3,1,2,0,0,0,1,2,2185,6,1018
경기도,시흥시,정왕3동,정왕3동제2투,3373,2418,1054,375,673,140,162,1,0,2,0,0,0,0,3,2410,8,955
경기도,시흥시,정왕3동,정왕3동제3투,4025,2494,1066,440,633,189,153,3,0,0,1,0,0,0,2,2487,7,1531
경기도,시흥시,정왕3동,정왕3동제4투,5870,3178,1290,640,885,156,189,1,1,1,1,1,1,1,2,3169,9,2692
경기도,시흥시,정왕4동,합계,25693,20489,9507,2934,5030,1383,1486,27,2,10,6,20,3,6,13,20427,62,5204
경기도,시흥시,정왕4동,관내사전투표,4627,4627,2399,553,959,313,360,11,0,3,2,7,0,2,1,4610,17,0
경기도,시흥시,정왕4동,정왕4동제1투,3095,2244,992,376,550,157,160,1,0,1,0,0,0,0,2,2239,5,851
경기도,시흥시,정왕4동,정왕4동제2투,2012,1458,582,299,377,106,88,0,0,0,1,0,0,0,0,1453,5,554
경기도,시흥시,정왕4동,정왕4동제3투,2740,2016,890,338,492,126,154,7,0,0,0,1,1,0,1,2010,6,724
경기도,시흥시,정왕4동,정왕4동제4투,2721,1985,932,266,498,134,143,1,0,0,0,3,0,1,1,1979,6,736
경기도,시흥시,정왕4동,정왕4동제5투,2323,1723,729,236,481,120,138,3,0,2,0,3,0,1,2,1715,8,600
경기도,시흥시,정왕4동,정왕4동제6투,2426,1869,885,250,462,134,123,0,1,1,1,3,0,0,1,1861,8,557
경기도,시흥시,정왕4동,정왕4동제7투,3145,2470,1167,300,663,156,167,2,1,1,1,3,2,0,2,2465,5,675
경기도,시흥시,정왕4동,정왕4동제8투,2604,2097,931,316,548,137,153,2,0,2,1,0,0,2,3,2095,2,507
경기도,시흥시,과림동,합계,1837,1294,366,530,295,45,47,4,0,0,1,0,0,1,0,1289,5,543
경기도,시흥시,과림동,관내사전투표,386,386,129,127,93,15,17,2,0,0,0,0,0,1,0,384,2,0
경기도,시흥시,과림동,과림동투표소,1451,908,237,403,202,30,30,2,0,0,1,0,0,0,0,905,3,543
경기도,시흥시,연성동,합계,17366,13579,5997,2456,3149,865,1011,12,1,9,4,14,2,2,10,13532,47,3787
경기도,시흥시,연성동,관내사전투표,2712,2712,1334,423,548,179,211,2,0,2,0,4,0,0,4,2707,5,0
경기도,시흥시,연성동,연성동제1투,3146,2153,962,373,512,139,151,3,0,4,0,1,1,1,1,2148,5,993
경기도,시흥시,연성동,연성동제2투,3586,2741,1099,589,662,166,205,4,0,2,1,3,0,0,1,2732,9,845
경기도,시흥시,연성동,연성동제3투,3628,2801,1276,408,690,179,226,2,1,0,3,1,0,1,0,2787,14,827
경기도,시흥시,연성동,연성동제4투,2559,1825,810,349,444,89,117,0,0,0,0,4,1,0,4,1818,7,734
경기도,시흥시,연성동,연성동제5투,1735,1347,516,314,293,113,101,1,0,1,0,1,0,0,0,1340,7,388
경기도,시흥시,능곡동,합계,11267,8674,3753,1651,2082,547,570,5,2,6,3,18,2,0,6,8645,29,2593
경기도,시흥시,능곡동,관내사전투표,2563,2563,1280,388,527,154,188,1,0,3,1,6,2,0,3,2553,10,0
경기도,시흥시,능곡동,능곡동제1투,3441,2427,932,555,637,154,132,2,0,1,1,5,0,0,2,2421,6,1014
경기도,시흥시,능곡동,능곡동제2투,2605,1795,720,376,448,115,122,2,2,2,0,4,0,0,0,1791,4,810
경기도,시흥시,능곡동,능곡동제3투,2658,1889,821,332,470,124,128,0,0,0,1,3,0,0,1,1880,9,769
경기도,시흥시,월곶동,합계,11961,8525,3703,1619,2170,462,521,4,2,10,2,8,2,2,4,8509,16,3436
경기도,시흥시,월곶동,관내사전투표,2464,2464,1160,410,603,124,150,1,1,6,0,4,0,1,0,2460,4,0
경기도,시흥시,월곶동,월곶동제1투,405,288,69,107,86,14,11,0,0,0,0,0,0,1,0,288,0,117
경기도,시흥시,월곶동,월곶동제2투,3127,1893,773,392,499,99,117,3,0,1,2,0,1,0,2,1889,4,1234
경기도,시흥시,월곶동,월곶동제3투,2476,1703,803,300,386,96,111,0,0,1,0,2,1,0,1,1701,2,773
경기도,시흥시,월곶동,월곶동제4투,3489,2177,898,410,596,129,132,0,1,2,0,2,0,0,1,2171,6,1312
경기도,시흥시,장곡동,합계,12425,10028,4718,1431,2456,614,743,9,1,4,3,13,5,0,6,10003,25,2397
경기도,시흥시,장곡동,관내사전투표,3116,3116,1585,383,700,179,241,1,0,3,0,10,1,0,2,3105,11,0
경기도,시흥시,장곡동,장곡동제1투,3768,2826,1229,472,727,180,202,0,1,0,0,1,2,0,3,2817,9,942
경기도,시흥시,장곡동,장곡동제2투,3208,2371,1128,325,595,145,166,2,0,1,3,1,1,0,1,2368,3,837
경기도,시흥시,장곡동,장곡동제3투,2333,1715,776,251,434,110,134,6,0,0,0,1,1,0,0,1713,2,618
경기도,시흥시,잘못 투입·구분된 투표지,,0,0,0,0,0,0,0,0,0,0,0,0,0,0,0,0,0,0
경기도,군포시,합계,,228831,186084,82551,34784,41883,12884,12595,239,21,150,34,121,37,54,135,185488,596,42747
경기도,군포시,거소·선상투표,,318,296,118,35,99,22,8,2,0,1,0,2,0,0,0,287,9,22
경기도,군포시,관외사전투표,,18477,18477,8892,2469,4033,1398,1479,24,5,5,3,17,5,4,28,18362,115,0
경기도,군포시,재외투표,,1806,1412,905,107,185,52,154,2,0,0,0,0,0,1,0,1406,6,394
경기도,군포시,군포1동,관내사전투표,3496,3496,1496,763,778,204,223,5,0,5,0,1,1,3,4,3483,13,0
경기도,군포시,군포1동,합계,25447,18607,7594,4023,4409,1233,1205,16,1,18,2,12,6,7,20,18546,61,6840
경기도,군포시,군포1동,군포1동제1투,3361,2107,833,504,488,133,127,2,0,0,0,3,1,2,3,2096,11,1254
경기도,군포시,군포1동,군포1동제2투,3222,1830,671,481,439,107,119,1,0,2,0,1,0,0,2,1823,7,1392
경기도,군포시,군포1동,군포1동제3투,3222,2083,812,505,515,132,109,0,0,2,0,2,0,0,3,2080,3,1139
경기도,군포시,군포1동,군포1동제4투,3267,2123,798,455,590,130,129,5,0,3,0,3,2,0,3,2118,5,1144
경기도,군포시,군포1동,군포1동제5투,251,122,46,33,30,5,8,0,0,0,0,0,0,0,0,122,0,129
경기도,군포시,군포1동,군포1동제6투,191,130,33,39,43,9,5,0,0,0,0,0,0,0,0,129,1,61
경기도,군포시,군포1동,군포1동제7투,3741,2960,1182,633,682,216,222,0,0,4,2,1,0,1,4,2947,13,781
경기도,군포시,군포1동,군포1동제8투,4696,3756,1723,610,844,297,263,3,1,2,0,1,2,1,1,3748,8,940
경기도,군포시,군포2동,합계,40213,32978,14676,6096,7471,2219,2305,46,4,24,6,16,7,7,17,32894,84,7235
경기도,군포시,군포2동,관내사전투표,7340,7340,3507,1229,1487,473,586,14,2,7,1,4,3,0,4,7317,23,0
경기도,군포시,군포2동,군포2동제1투,3298,2498,1050,501,578,194,167,3,0,0,1,0,0,0,0,2494,4,800
경기도,군포시,군포2동,군포2동제2투,2884,2032,850,400,498,129,136,5,0,1,0,2,1,0,3,2025,7,852
경기도,군포시,군포2동,군포2동제3투,2893,2195,888,497,529,119,142,4,0,4,1,2,1,2,1,2190,5,698
경기도,군포시,군포2동,군포2동제4투,3682,2938,1279,567,672,200,199,5,1,2,2,1,0,0,1,2929,9,744
경기도,군포시,군포2동,군포2동제5투,2414,2036,997,307,445,160,120,1,0,3,0,0,0,0,3,2036,0,378
경기도,군포시,군포2동,군포2동제6투,2418,1763,676,422,431,106,120,1,0,1,0,0,0,0,0,1757,6,655
경기도,군포시,군포2동,군포2동제7투,3525,2759,1168,530,685,175,177,6,0,1,0,2,1,2,2,2749,10,766
경기도,군포시,군포2동,군포2동제8투,3879,2959,1382,516,669,177,195,3,0,3,1,0,1,0,0,2947,12,920
경기도,군포시,군포2동,군포2동제9투,1848,1540,725,251,324,112,121,1,0,0,0,4,0,0,1,1539,1,308
경기도,군포시,군포2동,군포2동제10투,1160,1003,354,233,254,97,60,1,0,0,0,0,0,1,2,1002,1,157
경기도,군포시,군포2동,군포2동제11투,3185,2625,1269,396,581,204,169,0,1,1,0,1,0,0,0,2622,3,560
경기도,군포시,군포2동,군포2동제12투,1687,1290,531,247,318,73,113,2,0,1,0,0,0,2,0,1287,3,397
경기도,군포시,산본1동,합계,14821,10764,4380,2387,2589,631,693,17,3,8,4,2,3,4,11,10732,32,4057
경기도,군포시,산본1동,관내사전투표,2414,2414,1096,458,528,133,184,4,0,0,1,0,0,0,4,2408,6,0
경기도,군포시,산본1동,산본1동제1투,2869,1863,731,416,459,117,124,3,0,2,2,0,0,1,0,1855,8,1006
경기도,군포시,산본1동,산본1동제2투,1802,1149,454,286,277,62,61,2,0,1,0,0,1,0,0,1144,5,653
경기도,군포시,산본1동,산본1동제3투,2356,1589,596,407,396,78,100,3,1,2,1,1,0,1,2,1588,1,767
경기도,군포시,산본1동,산본1동제4투,2343,1690,692,361,427,103,96,3,1,2,0,0,1,0,2,1688,2,653
경기도,군포시,산본1동,산본1동제5투,3037,2059,811,459,502,138,128,2,1,1,0,1,1,2,3,2049,10,978
경기도,군포시,산본2동,합계,21239,17776,7714,3498,3993,1335,1106,27,3,12,2,14,1,4,9,17718,58,3463
경기도,군포시,산본2동,관내사전투표,3755,3755,1785,676,762,265,244,8,1,4,0,1,0,0,2,3748,7,0
경기도,군포시,산본2동,산본2동제1투,2684,2068,809,464,496,143,142,2,0,1,1,1,0,0,1,2060,8,616
경기도,군포시,산본2동,산본2동제2투,2096,1549,688,284,354,100,107,1,2,1,0,1,1,0,1,1540,9,547
경기도,군포시,산본2동,산본2동제3투,2664,2172,964,357,519,162,154,6,0,2,0,1,0,1,1,2167,5,492
경기도,군포시,산본2동,산본2동제4투,2210,1764,729,356,403,147,114,3,0,1,0,1,0,0,1,1755,9,446
경기도,군포시,산본2동,산본2동제5투,2231,1804,831,313,394,125,121,4,0,2,1,3,0,1,2,1797,7,427
경기도,군포시,산본2동,산본2동제6투,2700,2228,940,486,499,184,108,0,0,1,0,2,0,1,0,2221,7,472
경기도,군포시,산본2동,산본2동제7투,2899,2436,968,562,566,209,116,3,0,0,0,4,0,1,1,2430,6,463
경기도,군포시,금정동,합계,15986,11602,4849,2418,2768,681,795,16,0,8,4,8,5,6,11,11569,33,4384
경기도,군포시,금정동,관내사전투표,3478,3478,1648,593,757,193,255,6,0,2,2,3,1,2,3,3465,13,0
경기도,군포시,금정동,금정동제1투,3208,2164,887,451,519,140,153,1,0,1,1,1,0,1,1,2156,8,1044
경기도,군포시,금정동,금정동제2투,3317,2082,831,457,517,138,128,0,0,0,0,1,2,0,4,2078,4,1235
경기도,군포시,금정동,금정동제3투,3535,2309,869,541,612,128,145,6,0,2,0,0,1,1,1,2306,3,1226
경기도,군포시,금정동,금정동제4투,2448,1569,614,376,363,82,114,3,0,3,1,3,1,2,2,1564,5,879
경기도,군포시,재궁동,합계,17879,14261,6438,2579,3140,1038,980,17,2,9,1,10,0,2,11,14227,34,3618
경기도,군포시,재궁동,관내사전투표,4359,4359,2197,592,866,326,354,1,0,4,1,2,0,0,5,4348,11,0
경기도,군포시,재궁동,재궁동제1투,3004,2182,860,472,560,159,116,3,0,0,0,3,0,0,2,2175,7,822
경기도,군포시,재궁동,재궁동제2투,2846,2005,845,410,438,140,152,5,1,3,0,1,0,0,2,1997,8,841
경기도,군포시,재궁동,재궁동제3투,2830,2077,890,442,462,140,132,1,1,0,0,4,0,0,1,2073,4,753
경기도,군포시,재궁동,재궁동제4투,2722,2097,950,384,466,162,127,2,0,1,0,0,0,2,1,2095,2,625
경기도,군포시,재궁동,재궁동제5투,2118,1541,696,279,348,111,99,5,0,1,0,0,0,0,0,1539,2,577
경기도,군포시,오금동,합계,17459,14712,6816,2494,3248,1077,977,15,1,23,0,9,6,4,8,14678,34,2747
경기도,군포시,오금동,관내사전투표,3798,3798,1959,522,730,300,252,4,0,11,0,2,4,0,0,3784,14,0
경기도,군포시,오금동,오금동제1투,3008,2401,963,568,534,187,141,3,1,0,0,0,1,0,1,2399,2,607
경기도,군포시,오금동,오금동제2투,2983,2411,1091,426,548,183,155,1,0,1,0,0,0,0,1,2406,5,572
경기도,군포시,오금동,오금동제3투,2523,1846,832,302,428,149,121,4,0,1,0,1,1,0,0,1839,7,677
경기도,군포시,오금동,오금동제4투,1962,1613,725,308,371,88,107,0,0,4,0,2,0,4,1,1610,3,349
경기도,군포시,오금동,오금동제5투,3185,2643,1246,368,637,170,201,3,0,6,0,4,0,0,5,2640,3,542
경기도,군포시,수리동,합계,13874,11224,4926,2282,2481,739,721,23,0,7,1,9,1,1,4,11195,29,2650
경기도,군포시,수리동,관내사전투표,2544,2544,1244,464,491,165,171,3,0,0,0,4,0,0,0,2542,2,0
경기도,군포시,수리동,수리동제1투,2108,1640,632,372,392,131,101,6,0,1,0,1,0,0,0,1636,4,468
경기도,군포시,수리동,수리동제2투,2050,1605,613,407,346,124,107,3,0,0,1,0,0,0,0,1601,4,445
경기도,군포시,수리동,수리동제3투,2204,1763,785,318,412,115,119,5,0,0,0,1,0,1,2,1758,5,441
경기도,군포시,수리동,수리동제4투,2436,1927,916,339,436,120,110,3,0,1,0,0,0,0,1,1926,1,509
경기도,군포시,수리동,수리동제5투,2532,1745,736,382,404,84,113,3,0,5,0,3,1,0,1,1732,13,787
경기도,군포시,궁내동,합계,14796,12484,5785,2238,2652,934,805,9,0,12,2,10,0,3,6,12456,28,2312
경기도,군포시,궁내동,관내사전투표,3007,3007,1508,476,619,192,199,2,0,3,0,1,0,0,2,3002,5,0
경기도,군포시,궁내동,궁내동제1투,1867,1370,630,247,315,93,80,1,0,2,1,0,0,0,0,1369,1,497
경기도,군포시,궁내동,궁내동제2투,2400,1928,852,365,397,182,117,1,0,1,0,2,0,1,2,1920,8,472
경기도,군포시,궁내동,궁내동제3투,2639,2161,912,457,464,187,135,1,0,0,1,0,0,1,1,2159,2,478
경기도,군포시,궁내동,궁내동제4투,2776,2292,994,439,521,159,164,2,0,1,0,3,0,0,1,2284,8,484
경기도,군포시,궁내동,궁내동제5투,2107,1726,889,254,336,121,110,2,0,5,0,4,0,1,0,1722,4,381
경기도,군포시,광정동,합계,18918,15339,6744,2941,3488,1120,933,17,1,10,7,7,3,9,9,15289,50,3579
경기도,군포시,광정동,관내사전투표,2890,2890,1515,412,557,199,186,3,0,2,2,1,1,2,1,2881,9,0
경기도,군포시,광정동,광정동제1투,3342,2216,862,520,548,128,130,4,1,1,1,0,2,0,1,2198,18,1126
경기도,군포시,광정동,광정동제2투,2423,1705,784,268,392,129,118,3,0,1,0,2,0,1,2,1700,5,718
경기도,군포시,광정동,광정동제3투,3665,2984,1110,680,734,255,180,5,0,1,1,2,0,1,3,2972,12,681
경기도,군포시,광정동,광정동제4투,1759,1498,630,349,299,138,74,2,0,1,2,0,0,0,0,1495,3,261
경기도,군포시,광정동,광정동제5투,1716,1441,572,321,357,121,64,0,0,2,1,0,0,2,0,1440,1,275
경기도,군포시,광정동,광정동제6투,3123,2605,1271,391,601,150,181,0,0,2,0,2,0,3,2,2603,2,518
경기도,군포시,대야동,합계,7598,6152,2714,1217,1327,405,434,8,1,13,2,5,0,2,1,6129,23,1446
경기도,군포시,대야동,관내사전투표,2021,2021,921,378,423,140,137,2,0,3,1,5,0,0,0,2010,11,0
경기도,군포시,대야동,대야동제1투,2721,2019,886,389,430,142,153,5,1,4,0,0,0,1,1,2012,7,702
경기도,군포시,대야동,대야동제2투,2856,2112,907,450,474,123,144,1,0,6,1,0,0,1,0,2107,5,744
경기도,군포시,잘못 투입·구분된 투표지,,0,0,0,0,0,0,0,0,0,0,0,0,0,0,0,0,0,0
경기도,하남시,합계,,176100,138937,57298,31793,30999,9680,8135,174,17,68,19,109,24,43,86,138445,492,37163
경기도,하남시,거소·선상투표,,206,199,70,46,56,13,7,1,0,0,0,0,0,0,0,193,6,7
경기도,하남시,관외사전투표,,16729,16727,7643,2950,3532,1292,1162,25,5,13,3,5,7,6,19,16662,65,2
경기도,하남시,재외투표,,1308,1040,615,79,164,41,124,12,0,0,1,0,0,1,0,1037,3,268
경기도,하남시,천현동,합계,6004,3913,1205,1345,927,191,197,7,2,3,1,3,1,1,6,3889,24,2091
경기도,하남시,천현동,관내사전투표,875,875,274,293,209,38,49,2,1,0,0,1,0,1,2,870,5,0
경기도,하남시,천현동,천현동제1투,2132,1244,345,461,309,60,58,1,0,0,0,1,0,0,1,1236,8,888
경기도,하남시,천현동,천현동제2투,1761,1044,376,284,267,48,59,3,0,1,0,1,0,0,3,1042,2,717
경기도,하남시,천현동,천현동제3투,1236,750,210,307,142,45,31,1,1,2,1,0,1,0,0,741,9,486
경기도,하남시,신장1동,합계,6370,4635,1665,1264,1068,278,301,8,0,5,1,6,1,5,5,4607,28,1735
경기도,하남시,신장1동,관내사전투표,2032,2032,761,577,434,117,118,3,0,2,0,4,1,1,4,2022,10,0
경기도,하남시,신장1동,신장1동제1투,1766,1035,369,269,235,66,78,3,0,2,1,1,0,3,0,1027,8,731
경기도,하남시,신장1동,신장1동제2투,2572,1568,535,418,399,95,105,2,0,1,0,1,0,1,1,1558,10,1004
경기도,하남시,신장2동,합계,33009,25840,10115,6703,5686,1707,1442,24,2,8,2,14,3,7,17,25730,110,7169
경기도,하남시,신장2동,관내사전투표,6924,6924,3107,1604,1276,468,427,9,0,1,1,3,2,1,3,6902,22,0
경기도,하남시,신장2동,신장2동제1투,2684,1613,618,427,344,95,111,4,0,1,0,4,0,0,1,1605,8,1071
경기도,하남시,신장2동,신장2동제2투,2202,1296,413,382,338,78,74,2,0,0,0,1,0,0,0,1288,8,906
경기도,하남시,신장2동,신장2동제3투,2379,1547,590,356,388,107,95,0,0,0,0,1,0,0,2,1539,8,832
경기도,하남시,신장2동,신장2동제4투,1720,1281,454,365,294,96,60,0,0,0,0,0,0,0,1,1270,11,439
경기도,하남시,신장2동,신장2동제5투,2345,1841,645,591,398,97,94,1,0,1,0,2,1,0,2,1832,9,504
경기도,하남시,신장2동,신장2동제6투,2404,1881,696,512,461,112,88,0,0,1,1,0,0,0,2,1873,8,523
경기도,하남시,신장2동,신장2동제7투,2240,1744,656,488,392,111,87,3,0,0,0,0,0,1,0,1738,6,496
경기도,하남시,신장2동,신장2동제8투,3420,2602,1057,590,613,175,142,4,1,1,0,0,0,3,1,2587,15,818
경기도,하남시,신장2동,신장2동제9투,3740,2851,1064,753,651,221,145,0,0,0,0,3,0,1,4,2842,9,889
경기도,하남시,신장2동,신장2동제10투,2951,2260,815,635,531,147,119,1,1,3,0,0,0,1,1,2254,6,691
경기도,하남시,덕풍1동,합계,13439,9881,3682,2663,2249,632,568,16,0,5,0,10,2,2,6,9835,46,3558
경기도,하남시,덕풍1동,관내사전투표,2938,2938,1189,784,598,168,180,5,0,0,0,4,2,0,1,2931,7,0
경기도,하남시,덕풍1동,덕풍1동제1투,3030,1933,701,496,461,147,104,2,0,0,0,2,0,0,2,1915,18,1097
경기도,하남시,덕풍1동,덕풍1동제2투,2032,1432,515,381,352,87,86,1,0,3,0,0,0,0,1,1426,6,600
경기도,하남시,덕풍1동,덕풍1동제3투,2595,1538,554,467,348,76,77,2,0,1,0,3,0,0,1,1529,9,1057
경기도,하남시,덕풍1동,덕풍1동제4투,2844,2040,723,535,490,154,121,6,0,1,0,1,0,2,1,2034,6,804
경기도,하남시,덕풍2동,합계,15985,11330,4240,2979,2643,705,655,27,1,9,3,15,2,2,8,11289,41,4655
경기도,하남시,덕풍2동,관내사전투표,2952,2952,1252,713,592,188,185,3,0,1,1,4,0,0,2,2941,11,0
경기도,하남시,덕풍2동,덕풍2동제1투,2287,1395,517,384,316,60,102,5,0,0,2,0,1,0,2,1389,6,892
경기도,하남시,덕풍2동,덕풍2동제2투,2191,1326,451,378,312,86,82,3,0,4,0,2,1,0,0,1319,7,865
경기도,하남시,덕풍2동,덕풍2동제3투,1835,1085,383,317,272,57,48,1,1,0,0,1,0,0,2,1082,3,750
경기도,하남시,덕풍2동,덕풍2동제4투,2208,1366,463,367,360,75,78,9,0,2,0,4,0,0,2,1360,6,842
경기도,하남시,덕풍2동,덕풍2동제5투,2484,1667,608,424,420,111,88,5,0,1,0,3,0,2,0,1662,5,817
경기도,하남시,덕풍2동,덕풍2동제6투,2028,1539,566,396,371,128,72,1,0,1,0,1,0,0,0,1536,3,489
경기도,하남시,덕풍3동,합계,19292,14483,5819,3413,3318,990,851,7,1,7,2,18,2,3,4,14435,48,4809
경기도,하남시,덕풍3동,관내사전투표,3395,3395,1587,694,620,233,236,3,0,2,1,5,0,1,1,3383,12,0
경기도,하남시,덕풍3동,덕풍3동제1투,3528,2573,978,609,623,203,145,2,0,3,1,0,0,0,2,2566,7,955
경기도,하남시,덕풍3동,덕풍3동제2투,3535,2570,958,597,681,153,167,0,0,0,0,7,0,1,0,2564,6,965
경기도,하남시,덕풍3동,덕풍3동제3투,2823,1737,680,470,379,91,96,2,1,1,0,3,1,0,1,1725,12,1086
경기도,하남시,덕풍3동,덕풍3동제4투,3161,2218,915,510,495,180,110,0,0,0,0,0,0,1,0,2211,7,943
경기도,하남시,덕풍3동,덕풍3동제5투,2850,1990,701,533,520,130,97,0,0,1,0,3,1,0,0,1986,4,860
경기도,하남시,풍산동,합계,4444,3277,1416,693,724,241,177,4,0,1,1,3,0,0,3,3263,14,1167
경기도,하남시,풍산동,관내사전투표,811,811,357,193,166,52,39,0,0,0,0,1,0,0,1,809,2,0
경기도,하남시,풍산동,풍산동투표소,3633,2466,1059,500,558,189,138,4,0,1,1,2,0,0,2,2454,12,1167
경기도,하남시,감북동,합계,3061,2047,613,784,440,110,81,1,2,2,0,1,1,1,3,2039,8,1014
경기도,하남시,감북동,관내사전투표,522,522,195,175,95,28,26,1,0,0,0,0,0,0,1,521,1,0
경기도,하남시,감북동,감북동투표소,2539,1525,418,609,345,82,55,0,2,2,0,1,1,1,2,1518,7,1014
경기도,하남시,춘궁동,합계,3382,2460,670,1023,527,107,105,1,0,1,1,3,1,1,0,2440,20,922
경기도,하남시,춘궁동,관내사전투표,963,963,294,391,194,28,48,0,0,0,0,3,0,0,0,958,5,0
경기도,하남시,춘궁동,춘궁동투표소,2419,1497,376,632,333,79,57,1,0,1,1,0,1,1,0,1482,15,922
경기도,하남시,초이동,합계,3001,2069,649,673,517,119,86,3,1,2,0,6,0,4,0,2060,9,932
경기도,하남시,초이동,관내사전투표,507,507,199,141,107,29,26,0,0,0,0,3,0,0,0,505,2,0
경기도,하남시,초이동,초이동제1투,1138,677,206,237,169,38,20,0,0,1,0,3,0,1,0,675,2,461
경기도,하남시,초이동,초이동제2투,1356,885,244,295,241,52,40,3,1,1,0,0,0,3,0,880,5,471
경기도,하남시,미사1동,합계,13108,10575,4817,1887,2368,821,633,7,2,3,3,7,1,1,3,10553,22,2533
경기도,하남시,미사1동,관내사전투표,1900,1900,971,324,339,137,119,2,0,1,0,1,0,0,1,1895,5,0
경기도,하남시,미사1동,미사1동제1투,3129,2310,1017,458,525,162,138,4,0,0,1,0,0,1,0,2306,4,819
경기도,하남시,미사1동,미사1동제2투,2580,1819,682,405,456,128,131,0,0,2,2,4,1,0,0,1811,8,761
경기도,하남시,미사1동,미사1동제3투,3143,2569,1170,405,600,236,151,0,1,0,0,1,0,0,1,2565,4,574
경기도,하남시,미사1동,미사1동제4투,2356,1977,977,295,448,158,94,1,1,0,0,1,0,0,1,1976,1,379
경기도,하남시,미사2동,합계,25975,21487,10328,3610,4603,1563,1284,23,1,9,1,14,3,5,11,21455,32,4488
경기도,하남시,미사2동,관내사전투표,6896,6895,3485,1164,1316,480,427,4,0,1,0,3,2,1,2,6885,10,1
경기도,하남시,미사2동,미사2동제1투,2584,1593,519,480,416,76,84,4,0,3,0,0,1,1,1,1585,8,991
경기도,하남시,미사2동,미사2동제2투,2769,2166,1062,300,489,156,144,1,0,3,1,4,0,0,2,2162,4,603
경기도,하남시,미사2동,미사2동제3투,2706,2047,925,306,482,171,152,6,0,1,0,2,0,0,0,2045,2,659
경기도,하남시,미사2동,미사2동제4투,2604,2174,1047,370,471,162,115,2,0,1,0,0,0,1,3,2172,2,430
경기도,하남시,미사2동,미사2동제5투,3473,2775,1346,448,626,218,128,2,0,0,0,3,0,2,1,2774,1,698
경기도,하남시,미사2동,미사2동제6투,986,805,410,124,175,53,41,2,0,0,0,0,0,0,0,805,0,181
경기도,하남시,미사2동,미사2동제7투,3957,3032,1534,418,628,247,193,2,1,0,0,2,0,0,2,3027,5,925
경기도,하남시,위례동,합계,10787,8974,3751,1681,2177,870,462,8,0,0,0,4,0,4,1,8958,16,1813
경기도,하남시,위례동,관내사전투표,2795,2795,1276,481,621,252,160,2,0,0,0,0,0,0,0,2792,3,0
경기도,하남시,위례동,위례동제1투,2467,1926,885,277,481,176,101,0,0,0,0,2,0,0,0,1922,4,541
경기도,하남시,위례동,위례동제2투,2751,2121,719,534,549,226,85,1,0,0,0,0,0,3,0,2117,4,630
경기도,하남시,위례동,위례동제3투,2774,2132,871,389,526,216,116,5,0,0,0,2,0,1,1,2127,5,642
경기도,하남시,잘못 투입·구분된 투표지,,0,0,0,0,0,0,0,0,0,0,0,0,0,0,0,0,0,0
경기도,파주시,합계,,340754,256847,107148,55347,54921,16819,20208,399,52,198,82,224,92,96,259,255845,1002,83907
경기도,파주시,거소·선상투표,,828,786,277,141,227,55,35,0,3,4,3,1,5,1,4,756,30,42
경기도,파주시,관외사전투표,,26250,26242,12199,4206,5267,1954,2329,38,10,17,9,18,13,8,30,26098,144,8
경기도,파주시,재외투표,,2109,1651,1015,115,218,71,220,8,0,0,0,0,0,0,0,1647,4,458
경기도,파주시,문산읍,합계,37173,26018,10060,6454,5458,1711,2041,43,9,25,10,30,5,15,43,25904,114,11155
경기도,파주시,문산읍,관내사전투표,7190,7190,3278,1357,1337,496,638,12,3,8,3,9,0,2,15,7158,32,0
경기도,파주시,문산읍,문산읍제1투,3038,1920,635,627,399,112,126,1,0,4,0,1,0,0,5,1910,10,1118
경기도,파주시,문산읍,문산읍제2투,4230,2719,1169,564,579,157,215,9,2,2,1,4,1,1,2,2706,13,1511
경기도,파주시,문산읍,문산읍제3투,3714,2302,769,603,530,194,179,1,1,0,1,6,2,3,3,2292,10,1412
경기도,파주시,문산읍,문산읍제4투,2170,1203,448,280,290,77,99,5,0,0,0,2,0,2,0,1203,0,967
경기도,파주시,문산읍,문산읍제5투,3409,1927,648,507,445,159,145,4,1,2,1,0,1,2,3,1918,9,1482
경기도,파주시,문산읍,문산읍제6투,878,588,167,246,122,26,16,2,0,2,1,1,0,0,2,585,3,290
경기도,파주시,문산읍,문산읍제7투,1028,665,156,298,144,22,37,0,0,0,0,3,0,0,2,662,3,363
경기도,파주시,문산읍,문산읍제8투,680,403,95,169,85,16,27,2,0,4,0,0,0,2,0,400,3,277
경기도,파주시,문산읍,문산읍제9투,5680,3831,1503,870,822,289,316,3,0,1,2,4,0,1,2,3813,18,1849
경기도,파주시,문산읍,문산읍제10투,1657,1075,323,406,219,42,71,2,1,0,0,0,1,1,3,1069,6,582
경기도,파주시,문산읍,문산읍제11투,3499,2195,869,527,486,121,172,2,1,2,1,0,0,1,6,2188,7,1304
경기도,파주시,조리읍,합계,23691,16895,6030,4604,3864,969,1263,36,1,15,10,11,8,6,19,16836,59,6796
경기도,파주시,조리읍,관내사전투표,3900,3900,1608,925,756,219,346,13,0,3,3,8,1,0,6,3888,12,0
경기도,파주시,조리읍,조리읍제1투,3600,2586,893,733,609,154,175,2,0,2,2,0,1,3,4,2578,8,1014
경기도,파주시,조리읍,조리읍제2투,2021,1349,453,374,336,81,97,0,0,0,1,0,0,1,1,1344,5,672
경기도,파주시,조리읍,조리읍제3투,1953,1283,409,400,324,57,83,4,1,0,0,0,0,1,1,1280,3,670
경기도,파주시,조리읍,조리읍제4투,2964,2127,754,551,487,149,166,7,0,3,1,0,0,0,1,2119,8,837
경기도,파주시,조리읍,조리읍제5투,1679,821,255,268,183,43,59,2,0,1,1,0,1,0,1,814,7,858
경기도,파주시,조리읍,조리읍제6투,3394,2322,905,517,574,147,166,1,0,1,2,3,0,0,2,2318,4,1072
경기도,파주시,조리읍,조리읍제7투,1837,1051,317,373,239,48,58,6,0,2,0,0,3,0,2,1048,3,786
경기도,파주시,조리읍,조리읍제8투,1105,703,206,222,184,38,49,0,0,0,0,0,0,0,0,699,4,402
경기도,파주시,조리읍,조리읍제9투,1238,753,230,241,172,33,64,1,0,3,0,0,2,1,1,748,5,485
경기도,파주시,법원읍,합계,9658,6325,1741,2316,1468,321,351,17,3,9,6,11,9,4,16,6272,53,3333
경기도,파주시,법원읍,관내사전투표,1420,1420,462,421,305,92,103,5,1,2,3,4,2,0,3,1403,17,0
경기도,파주시,법원읍,법원읍제1투,1988,1019,263,377,254,48,60,4,0,2,1,1,0,1,1,1012,7,969
경기도,파주시,법원읍,법원읍제2투,613,442,115,161,86,24,16,3,2,2,2,4,4,2,6,427,15,171
경기도,파주시,법원읍,법원읍제3투,650,465,120,202,96,16,24,1,0,1,0,0,1,0,0,461,4,185
경기도,파주시,법원읍,법원읍제4투,1776,1088,275,410,270,60,63,2,0,2,0,0,0,0,2,1084,4,688
경기도,파주시,법원읍,법원읍제5투,1527,821,197,339,205,38,36,1,0,0,0,0,0,0,2,818,3,706
경기도,파주시,법원읍,법원읍제6투,1684,1070,309,406,252,43,49,1,0,0,0,2,2,1,2,1067,3,614
경기도,파주시,파주읍,합계,11119,7231,2127,2479,1617,406,499,8,3,9,2,4,8,6,15,7183,48,3888
경기도,파주시,파주읍,관내사전투표,1683,1683,590,456,364,96,149,1,0,1,1,2,4,1,3,1668,15,0
경기도,파주시,파주읍,파주읍제1투,3165,1640,434,608,374,90,114,4,0,3,0,0,1,3,4,1635,5,1525
경기도,파주시,파주읍,파주읍제2투,2358,1399,452,433,327,79,91,1,0,1,1,2,1,2,1,1391,8,959
경기도,파주시,파주읍,파주읍제3투,981,583,152,226,137,32,29,1,1,0,0,0,1,0,1,580,3,398
경기도,파주시,파주읍,파주읍제4투,1036,682,182,253,162,35,42,1,0,0,0,0,0,0,2,677,5,354
경기도,파주시,파주읍,파주읍제5투,907,567,138,233,112,29,42,0,0,2,0,0,1,0,3,560,7,340
경기도,파주시,파주읍,파주읍제6투,989,677,179,270,141,45,32,0,2,2,0,0,0,0,1,672,5,312
경기도,파주시,광탄면,관내사전투표,1975,1975,691,575,430,92,165,1,0,1,0,3,0,3,3,1964,11,0
경기도,파주시,광탄면,합계,10196,6792,1914,2311,1576,335,559,14,4,5,4,6,4,10,7,6749,43,3404
경기도,파주시,광탄면,광탄면제1투,2700,1499,417,485,353,83,138,6,1,1,3,1,1,2,0,1491,8,1201
경기도,파주시,광탄면,광탄면제2투,1925,1154,290,437,265,52,90,2,0,1,1,2,0,3,2,1145,9,771
경기도,파주시,광탄면,광탄면제3투,1044,683,139,269,160,33,67,2,1,1,0,0,0,1,0,673,10,361
경기도,파주시,광탄면,광탄면제4투,1397,764,202,273,181,43,57,1,1,0,0,0,1,1,1,761,3,633
경기도,파주시,광탄면,광탄면제5투,1155,717,175,272,187,32,42,2,1,1,0,0,2,0,1,715,2,438
경기도,파주시,탄현면,관내사전투표,1452,1452,685,318,235,60,137,2,0,1,2,0,0,0,0,1440,12,0
경기도,파주시,탄현면,합계,10670,7420,2793,2093,1488,413,559,8,1,11,2,5,2,2,5,7382,38,3250
경기도,파주시,탄현면,탄현면제1투,1569,915,213,362,210,53,66,0,0,1,0,0,1,1,2,909,6,654
경기도,파주시,탄현면,탄현면제2투,1112,703,210,266,139,46,33,1,0,4,0,0,1,0,1,701,2,409
경기도,파주시,탄현면,탄현면제3투,1277,774,209,315,147,39,57,0,0,1,0,0,0,0,1,769,5,503
경기도,파주시,탄현면,탄현면제4투,2145,1407,539,364,301,95,92,3,1,2,0,4,0,0,1,1402,5,738
경기도,파주시,탄현면,탄현면제5투,3115,2169,937,468,456,120,174,2,0,2,0,1,0,1,0,2161,8,946
경기도,파주시,월롱면,관내사전투표,2145,2145,1058,328,349,166,217,4,0,3,1,2,2,3,3,2136,9,0
경기도,파주시,월롱면,합계,10552,7522,3252,1331,1371,654,839,5,1,4,2,11,5,3,13,7491,31,3030
경기도,파주시,월롱면,월롱면제1투,1183,708,186,302,130,32,51,0,0,0,0,2,2,0,2,707,1,475
경기도,파주시,월롱면,월롱면제2투,1639,882,308,240,190,59,79,0,0,0,1,0,1,0,1,879,3,757
경기도,파주시,월롱면,월롱면제3투,1806,1061,336,330,274,43,69,1,1,1,0,1,0,0,1,1057,4,745
경기도,파주시,월롱면,월롱면제4투,1338,851,419,55,165,114,95,0,0,0,0,0,0,0,0,848,3,487
경기도,파주시,월롱면,월롱면제5투,2441,1875,945,76,263,240,328,0,0,0,0,6,0,0,6,1864,11,566
경기도,파주시,적성면,합계,6121,4203,1054,1612,973,283,215,6,1,3,1,5,5,4,8,4170,33,1918
경기도,파주시,적성면,관내사전투표,1114,1114,335,372,234,83,72,1,1,0,0,1,1,1,4,1105,9,0
경기도,파주시,적성면,적성면제1투,2368,1396,354,502,335,107,81,2,0,1,0,2,2,1,1,1388,8,972
경기도,파주시,적성면,적성면제2투,618,419,97,181,99,21,8,2,0,0,1,0,0,0,2,411,8,199
경기도,파주시,적성면,적성면제3투,871,538,106,256,119,26,23,0,0,0,0,0,2,2,0,534,4,333
경기도,파주시,적성면,적성면제4투,570,343,84,156,68,16,14,0,0,1,0,1,0,0,0,340,3,227
경기도,파주시,적성면,적성면제5투,580,393,78,145,118,30,17,1,0,1,0,1,0,0,1,392,1,187
경기도,파주시,파평면,합계,3454,2497,699,969,504,129,158,6,3,2,0,1,3,1,4,2479,18,957
경기도,파주시,파평면,관내사전투표,455,455,179,98,80,41,43,3,1,0,0,1,1,0,1,448,7,0
경기도,파주시,파평면,파평면제1투,454,280,68,134,52,10,15,0,0,0,0,0,0,0,0,279,1,174
경기도,파주시,파평면,파평면제2투,349,245,70,98,51,13,11,0,1,0,0,0,0,0,0,244,1,104
경기도,파주시,파평면,파평면제3투,421,259,48,110,69,15,13,0,0,1,0,0,1,1,1,259,0,162
경기도,파주시,파평면,파평면제4투,819,591,186,211,124,23,38,0,1,1,0,0,0,0,1,585,6,228
경기도,파주시,파평면,파평면제5투,505,358,77,175,73,12,17,1,0,0,0,0,1,0,0,356,2,147
경기도,파주시,파평면,파평면제6투,451,309,71,143,55,15,21,2,0,0,0,0,0,0,1,308,1,142
경기도,파주시,군내면,합계,716,633,238,159,140,39,41,2,1,0,0,0,0,1,3,624,9,83
경기도,파주시,군내면,관내사전투표,333,333,143,51,82,28,18,1,1,0,0,0,0,1,2,327,6,0
경기도,파주시,군내면,군내면투표소,383,300,95,108,58,11,23,1,0,0,0,0,0,0,1,297,3,83
경기도,파주시,진동면,관내사전투표,125,125,46,31,22,15,2,0,1,0,1,2,0,1,2,123,2,0
경기도,파주시,진동면,합계,227,198,68,67,33,16,4,0,1,0,1,2,0,1,2,195,3,29
경기도,파주시,진동면,진동면투표소,102,73,22,36,11,1,2,0,0,0,0,0,0,0,0,72,1,29
경기도,파주시,교하동,관내사전투표,2569,2569,1236,493,450,159,211,3,1,1,0,3,0,2,1,2560,9,0
경기도,파주시,교하동,합계,27327,20515,9338,4102,4264,1238,1444,38,3,8,8,10,2,5,7,20467,48,6812
경기도,파주시,교하동,교하동제1투,2005,1083,311,400,251,52,58,0,0,0,2,0,0,2,1,1077,6,922
경기도,파주시,교하동,교하동제2투,2990,2204,970,532,422,121,148,3,0,1,1,1,1,0,0,2200,4,786
경기도,파주시,교하동,교하동제3투,3453,2302,920,511,568,119,164,4,1,0,1,3,1,0,1,2293,9,1151
경기도,파주시,교하동,교하동제4투,1324,863,288,279,174,53,59,8,0,0,0,0,0,0,0,861,2,461
경기도,파주시,교하동,교하동제5투,2539,1760,821,308,370,111,141,5,0,1,0,0,0,0,0,1757,3,779
경기도,파주시,교하동,교하동제6투,2652,2016,842,434,457,143,127,6,0,3,1,0,0,0,1,2014,2,636
경기도,파주시,교하동,교하동제7투,2343,1846,896,305,371,140,121,4,0,1,2,0,0,1,1,1842,4,497
경기도,파주시,교하동,교하동제8투,2464,2056,1159,225,401,136,129,1,1,1,0,0,0,0,1,2054,2,408
경기도,파주시,교하동,교하동제9투,1906,1529,798,205,317,87,118,1,0,0,1,0,0,0,0,1527,2,377
경기도,파주시,교하동,교하동제10투,3082,2287,1097,410,483,117,168,3,0,0,0,3,0,0,1,2282,5,795
경기도,파주시,운정1동,관내사전투표,8517,8517,4346,1273,1575,557,730,4,0,8,1,7,0,1,3,8505,12,0
경기도,파주시,운정1동,합계,33092,26520,12526,4382,5661,1803,2004,26,1,18,3,25,1,6,19,26475,45,6572
경기도,파주시,운정1동,운정1동제1투,3909,2490,988,551,575,174,181,4,1,0,2,5,0,1,1,2483,7,1419
경기도,파주시,운정1동,운정1동제2투,2147,1783,870,271,384,137,113,1,0,2,0,1,0,0,2,1781,2,364
경기도,파주시,운정1동,운정1동제3투,3041,1965,882,364,432,113,167,1,0,1,0,1,0,1,0,1962,3,1076
경기도,파주시,운정1동,운정1동제4투,3369,2456,1090,455,572,161,165,2,0,2,0,4,0,1,1,2453,3,913
경기도,파주시,운정1동,운정1동제5투,3027,2292,1019,406,530,167,156,2,0,1,0,0,1,1,3,2286,6,735
경기도,파주시,운정1동,운정1동제6투,2585,2115,1061,293,450,142,158,2,0,2,0,2,0,0,2,2112,3,470
경기도,파주시,운정1동,운정1동제7투,3418,2469,1122,398,578,160,189,6,0,2,0,4,0,0,3,2462,7,949
경기도,파주시,운정1동,운정1동제8투,3079,2433,1148,371,565,192,145,4,0,0,0,1,0,1,4,2431,2,646
경기도,파주시,운정2동,합계,24387,19311,9068,3160,4161,1343,1484,23,0,9,4,11,2,4,7,19276,35,5076
경기도,파주시,운정2동,관내사전투표,3492,3492,1966,361,625,210,315,4,0,3,0,1,0,2,2,3489,3,0
경기도,파주시,운정2동,운정2동제1투,2082,1371,533,296,338,90,99,2,0,4,0,2,0,0,1,1365,6,711
경기도,파주시,운정2동,운정2동제2투,1507,1234,596,158,257,117,102,0,0,0,1,1,0,0,1,1233,1,273
경기도,파주시,운정2동,운정2동제3투,1055,842,440,105,166,52,74,0,0,0,0,0,0,0,1,838,4,213
경기도,파주시,운정2동,운정2동제4투,2682,2121,952,351,494,144,174,1,0,1,0,0,0,1,0,2118,3,561
경기도,파주시,운정2동,운정2동제5투,2143,1555,649,332,346,108,111,3,0,0,1,2,0,0,0,1552,3,588
경기도,파주시,운정2동,운정2동제6투,2494,2038,959,331,430,170,142,3,0,0,0,0,0,1,0,2036,2,456
경기도,파주시,운정2동,운정2동제7투,1843,1305,579,248,310,90,76,1,0,0,0,1,0,0,0,1305,0,538
경기도,파주시,운정2동,운정2동제8투,3474,2673,1209,508,566,185,183,7,0,1,1,2,1,0,1,2664,9,801
경기도,파주시,운정2동,운정2동제9투,1596,1292,626,188,296,80,97,0,0,0,1,2,0,0,0,1290,2,304
경기도,파주시,운정2동,운정2동제10투,2019,1388,559,282,333,97,111,2,0,0,0,0,1,0,1,1386,2,631
경기도,파주시,운정3동,합계,38271,28996,13407,4848,6374,1955,2198,45,3,16,5,33,4,9,12,28909,87,9275
경기도,파주시,운정3동,관내사전투표,6316,6316,3341,834,1172,389,521,8,0,3,3,12,0,6,2,6291,25,0
경기도,파주시,운정3동,운정3동제1투,3630,2807,1299,455,638,198,204,0,0,2,0,2,0,2,2,2802,5,823
경기도,파주시,운정3동,운정3동제2투,3816,3052,1499,430,657,242,214,5,0,0,0,1,0,0,1,3049,3,764
경기도,파주시,운정3동,운정3동제3투,4413,2812,1193,568,638,168,216,8,0,2,2,2,2,0,2,2801,11,1601
경기도,파주시,운정3동,운정3동제4투,3409,2431,1009,505,544,161,197,3,1,4,0,1,0,0,1,2426,5,978
경기도,파주시,운정3동,운정3동제5투,3616,2558,1030,502,632,167,199,6,0,3,0,6,1,1,1,2548,10,1058
경기도,파주시,운정3동,운정3동제6투,3705,2488,1186,415,514,165,189,5,0,0,0,7,1,0,0,2482,6,1217
경기도,파주시,운정3동,운정3동제7투,1852,1422,625,274,349,94,74,0,0,1,0,0,0,0,0,1417,5,430
경기도,파주시,운정3동,운정3동제8투,2131,1384,556,287,349,91,92,4,1,0,0,1,0,0,0,1381,3,747
경기도,파주시,운정3동,운정3동제9투,2174,1561,697,268,356,125,97,5,1,1,0,0,0,0,1,1551,10,613
경기도,파주시,운정3동,운정3동제10투,3209,2165,972,310,525,155,195,1,0,0,0,1,0,0,2,2161,4,1044
경기도,파주시,금촌1동,관내사전투표,2514,2514,1082,544,486,171,212,1,0,1,0,4,0,0,4,2505,9,0
경기도,파주시,금촌1동,합계,18009,11647,4167,3176,2614,699,876,17,1,10,4,12,4,5,11,11596,51,6362
경기도,파주시,금촌1동,금촌1동제1투,3340,2056,786,503,463,141,149,2,0,1,2,1,0,1,2,2051,5,1284
경기도,파주시,금촌1동,금촌1동제2투,2044,1298,404,397,327,71,88,1,0,1,0,0,1,1,1,1292,6,746
경기도,파주시,금촌1동,금촌1동제3투,2238,1287,344,476,332,52,68,7,0,1,2,0,0,0,0,1282,5,951
경기도,파주시,금촌1동,금촌1동제4투,2823,1611,510,518,367,97,99,3,1,4,0,1,2,2,2,1606,5,1212
경기도,파주시,금촌1동,금촌1동제5투,2563,1345,455,362,300,88,128,1,0,0,0,3,0,1,0,1338,7,1218
경기도,파주시,금촌1동,금촌1동제6투,2487,1536,586,376,339,79,132,2,0,2,0,3,1,0,2,1522,14,951
경기도,파주시,금촌2동,합계,25316,19464,8660,3458,4135,1354,1700,30,1,25,5,11,7,2,21,19409,55,5852
경기도,파주시,금촌2동,관내사전투표,5243,5243,2569,795,947,360,534,6,0,2,0,1,1,0,10,5225,18,0
경기도,파주시,금촌2동,금촌2동제1투,1893,1298,525,257,291,105,115,0,0,1,1,1,0,0,0,1296,2,595
경기도,파주시,금촌2동,금촌2동제2투,2165,1343,491,292,303,108,129,3,1,4,0,1,2,0,3,1337,6,822
경기도,파주시,금촌2동,금촌2동제3투,2471,1634,658,332,405,99,119,1,0,2,2,2,2,1,3,1626,8,837
경기도,파주시,금촌2동,금촌2동제4투,3020,2234,970,412,495,168,178,4,0,2,0,1,0,0,1,2231,3,786
경기도,파주시,금촌2동,금촌2동제5투,1907,1201,403,346,295,65,77,2,0,3,0,1,1,0,1,1194,7,706
경기도,파주시,금촌2동,금촌2동제6투,2972,2357,1101,417,493,140,184,7,0,4,1,4,0,0,2,2353,4,615
경기도,파주시,금촌2동,금촌2동제7투,2895,2213,1028,335,491,164,181,4,0,7,0,0,0,1,0,2211,2,682
경기도,파주시,금촌2동,금촌2동제8투,2750,1941,915,272,415,145,183,3,0,0,1,0,1,0,1,1936,5,809
경기도,파주시,금촌3동,합계,21588,15980,6515,3363,3508,1071,1389,29,2,8,3,17,5,3,13,15926,54,5608
경기도,파주시,금촌3동,관내사전투표,4786,4786,2149,889,926,339,446,8,1,3,1,6,0,1,4,4773,13,0
경기도,파주시,금촌3동,금촌3동제1투,2577,1735,662,383,368,126,179,1,0,2,0,2,0,2,1,1726,9,842
경기도,파주시,금촌3동,금촌3동제2투,2308,1391,517,293,348,94,130,2,0,0,0,1,0,0,2,1387,4,917
경기도,파주시,금촌3동,금촌3동제3투,2982,1861,747,403,416,131,146,5,0,1,0,2,1,0,2,1854,7,1121
경기도,파주시,금촌3동,금촌3동제4투,3279,2282,900,462,556,160,184,5,0,1,0,3,1,0,1,2273,9,997
경기도,파주시,금촌3동,금촌3동제5투,3221,2326,960,474,535,141,199,4,0,1,1,0,3,0,1,2319,7,895
경기도,파주시,금촌3동,금촌3동제6투,2435,1599,580,459,359,80,105,4,1,0,1,3,0,0,2,1594,5,836
경기도,파주시,잘못 투입·구분된 투표지,,0,1,0,1,0,0,0,0,0,0,0,0,0,0,0,1,0,-1
경기도,여주시,합계,,93145,65695,20474,21581,14545,3936,4387,90,13,72,25,66,40,50,90,65369,326,27450
경기도,여주시,거소·선상투표,,184,170,53,37,59,10,4,0,0,0,0,1,0,0,1,165,5,14
경기도,여주시,관외사전투표,,7706,7706,2932,1626,1762,631,646,14,0,10,2,4,2,3,19,7651,55,0
경기도,여주시,재외투표,,428,320,198,27,48,9,33,3,0,0,0,1,0,0,0,319,1,108
경기도,여주시,점동면,관내사전투표,710,710,258,233,126,41,28,0,1,0,2,3,1,1,0,694,16,0
경기도,여주시,점동면,합계,4027,2821,721,1196,590,135,124,4,2,4,2,6,3,4,1,2792,29,1206
경기도,여주시,점동면,점동면제1투,2174,1305,302,584,288,59,57,3,0,2,0,2,0,2,0,1299,6,869
경기도,여주시,점동면,점동면제2투,663,456,91,219,97,21,21,0,1,1,0,1,1,1,0,454,2,207
경기도,여주시,점동면,점동면제3투,480,350,70,160,79,14,18,1,0,1,0,0,1,0,1,345,5,130
경기도,여주시,가남읍,합계,12175,7955,2415,2539,1906,470,546,9,1,7,5,3,7,9,9,7926,29,4220
경기도,여주시,가남읍,관내사전투표,1410,1410,557,318,321,66,129,3,0,2,0,1,1,2,2,1402,8,0
경기도,여주시,가남읍,가남읍제1투,2397,1281,324,458,312,89,90,0,0,1,1,1,0,2,0,1278,3,1116
경기도,여주시,가남읍,가남읍제2투,1774,1110,292,439,248,55,60,2,0,3,1,0,0,2,1,1103,7,664
경기도,여주시,가남읍,가남읍제3투,1011,632,141,259,162,30,36,0,0,1,0,0,0,1,1,631,1,379
경기도,여주시,가남읍,가남읍제4투,465,283,67,128,56,11,13,4,0,0,0,0,2,0,0,281,2,182
경기도,여주시,가남읍,가남읍제5투,2828,1907,681,496,440,138,140,0,0,0,2,1,0,1,3,1902,5,921
경기도,여주시,가남읍,가남읍제6투,2290,1332,353,441,367,81,78,0,1,0,1,0,4,1,2,1329,3,958
경기도,여주시,능서면,합계,5096,3497,899,1436,755,163,192,5,0,7,4,3,1,2,8,3475,22,1599
경기도,여주시,능서면,관내사전투표,585,585,200,177,113,42,48,0,0,2,1,2,0,0,0,585,0,0
경기도,여주시,능서면,능서면제1투,1829,1104,273,469,269,26,53,0,0,2,0,0,1,0,4,1097,7,725
경기도,여주시,능서면,능서면제2투,1715,1142,273,481,246,56,64,2,0,2,2,1,0,1,3,1131,11,573
경기도,여주시,능서면,능서면제3투,967,666,153,309,127,39,27,3,0,1,1,0,0,1,1,662,4,301
경기도,여주시,흥천면,관내사전투표,466,466,140,160,107,28,28,3,0,0,0,0,0,0,0,466,0,0
경기도,여주시,흥천면,합계,3986,2726,594,1197,638,144,120,8,0,1,2,3,2,3,2,2714,12,1260
경기도,여주시,흥천면,흥천면제1투,2058,1297,255,576,319,79,48,4,0,1,1,1,2,1,1,1288,9,761
경기도,여주시,흥천면,흥천면제2투,1462,963,199,461,212,37,44,1,0,0,1,2,0,2,1,960,3,499
경기도,여주시,금사면,관내사전투표,422,422,94,196,85,18,24,0,0,0,0,0,0,1,1,419,3,0
경기도,여주시,금사면,합계,2423,1751,322,887,377,73,65,3,1,5,0,1,1,4,2,1741,10,672
경기도,여주시,금사면,금사면제1투,1308,870,136,473,185,32,26,3,1,5,0,1,1,2,1,866,4,438
경기도,여주시,금사면,금사면제2투,693,459,92,218,107,23,15,0,0,0,0,0,0,1,0,456,3,234
경기도,여주시,산북면,합계,2028,1519,383,661,313,71,73,0,0,3,1,1,2,2,2,1512,7,509
경기도,여주시,산북면,관내사전투표,434,434,131,184,77,14,24,0,0,0,0,1,0,0,0,431,3,0
경기도,여주시,산북면,산북면투표소,1594,1085,252,477,236,57,49,0,0,3,1,0,2,2,2,1081,4,509
경기도,여주시,대신면,합계,6025,3939,899,1745,888,182,182,7,0,2,1,6,4,2,3,3921,18,2086
경기도,여주시,대신면,관내사전투표,669,668,211,238,133,37,38,2,0,0,1,1,1,0,1,663,5,1
경기도,여주시,대신면,대신면제1투,2049,1202,206,563,323,45,49,4,0,2,0,3,1,0,0,1196,6,847
경기도,여주시,대신면,대신면제2투,1587,991,255,447,187,42,54,0,0,0,0,0,0,1,1,987,4,596
경기도,여주시,대신면,대신면제3투,988,609,111,285,143,40,24,0,0,0,0,2,1,0,1,607,2,379
경기도,여주시,대신면,대신면제4투,732,469,116,212,102,18,17,1,0,0,0,0,1,1,0,468,1,263
경기도,여주시,북내면,관내사전투표,472,472,156,159,81,34,32,2,1,0,2,1,1,0,1,470,2,0
경기도,여주시,북내면,합계,4092,2653,642,1089,596,134,149,8,1,3,3,2,4,4,4,2639,14,1439
경기도,여주시,북내면,북내면제1투,2169,1314,320,543,283,54,99,4,0,1,0,0,1,2,2,1309,5,855
경기도,여주시,북내면,북내면제2투,929,529,99,236,143,30,9,2,0,2,0,1,1,2,1,526,3,400
경기도,여주시,북내면,북내면제3투,522,338,67,151,89,16,9,0,0,0,1,0,1,0,0,334,4,184
경기도,여주시,강천면,합계,3171,2201,574,957,445,86,93,0,2,3,0,6,3,6,6,2181,20,970
경기도,여주시,강천면,관내사전투표,431,431,158,146,71,21,27,0,0,1,0,1,0,0,2,427,4,0
경기도,여주시,강천면,강천면제1투,861,541,124,249,119,20,17,0,0,0,0,1,0,3,2,535,6,320
경기도,여주시,강천면,강천면제2투,705,429,111,189,95,15,14,0,0,1,0,1,1,1,0,428,1,276
경기도,여주시,강천면,강천면제3투,528,351,85,160,68,11,12,0,2,1,0,3,2,0,1,345,6,177
경기도,여주시,강천면,강천면제4투,646,449,96,213,92,19,23,0,0,0,0,0,0,2,1,446,3,197
경기도,여주시,여흥동,합계,17065,11456,3848,3543,2414,725,813,13,2,12,4,9,7,4,17,11411,45,5609
경기도,여주시,여흥동,관내사전투표,3317,3317,1312,864,616,228,271,3,1,2,1,2,0,0,6,3306,11,0
경기도,여주시,여흥동,여흥동제1투,2014,945,248,358,200,64,62,1,0,1,0,1,0,1,4,940,5,1069
경기도,여주시,여흥동,여흥동제2투,2056,1340,439,387,321,79,104,1,0,2,1,0,1,0,1,1336,4,716
경기도,여주시,여흥동,여흥동제3투,2577,1551,443,567,318,96,111,3,0,0,1,1,1,2,2,1545,6,1026
경기도,여주시,여흥동,여흥동제4투,1560,1024,297,348,225,72,66,2,1,2,0,0,3,0,0,1016,8,536
경기도,여주시,여흥동,여흥동제5투,3804,2154,746,626,485,124,150,0,0,5,0,4,2,1,4,2147,7,1650
경기도,여주시,여흥동,여흥동제6투,1737,1125,363,393,249,62,49,3,0,0,1,1,0,0,0,1121,4,612
경기도,여주시,중앙동,합계,13902,9455,3187,2744,2058,628,754,8,1,11,1,9,2,4,10,9417,38,4447
경기도,여주시,중앙동,관내사전투표,2291,2291,899,573,424,158,219,1,0,3,0,0,1,3,2,2283,8,0
경기도,여주시,중앙동,중앙동제1투,2286,1308,336,536,253,76,86,1,1,6,0,1,0,0,4,1300,8,978
경기도,여주시,중앙동,중앙동제2투,3206,1970,646,546,481,138,140,4,0,0,1,1,1,1,2,1961,9,1236
경기도,여주시,중앙동,중앙동제3투,3420,2239,840,531,501,162,189,2,0,2,0,4,0,0,1,2232,7,1181
경기도,여주시,중앙동,중앙동제4투,2699,1647,466,558,399,94,120,0,0,0,0,3,0,0,1,1641,6,1052
경기도,여주시,오학동,합계,10837,7526,2807,1897,1696,475,593,8,3,4,0,11,2,3,6,7505,21,3311
경기도,여주시,오학동,관내사전투표,2276,2276,957,484,481,151,182,2,1,0,0,5,1,2,4,2270,6,0
경기도,여주시,오학동,오학동제1투,1756,1083,347,374,218,56,83,0,0,1,0,1,0,1,0,1081,2,673
경기도,여주시,오학동,오학동제2투,3270,1976,696,505,475,122,163,5,0,1,0,2,1,0,0,1970,6,1294
경기도,여주시,오학동,오학동제3투,3535,2191,807,534,522,146,165,1,2,2,0,3,0,0,2,2184,7,1344
경기도,여주시,잘못 투입·구분된 투표지,,0,0,0,0,0,0,0,0,0,0,0,0,0,0,0,0,0,0
경기도,이천시,합계,,167583,121841,44109,33301,26695,7913,8489,145,29,93,35,89,63,69,171,121201,640,45742
경기도,이천시,거소·선상투표,,501,469,139,94,97,30,20,2,3,7,3,3,2,4,3,407,62,32
경기도,이천시,관외사전투표,,13137,13132,5584,2199,2876,1188,1112,14,2,5,1,11,4,4,36,13036,96,5
경기도,이천시,재외투표,,747,595,364,36,96,15,81,0,0,0,0,0,0,0,1,593,2,152
경기도,이천시,장호원읍,관내사전투표,1649,1649,673,452,321,93,92,0,1,1,0,0,2,2,3,1640,9,0
경기도,이천시,장호원읍,합계,11696,7967,2302,3070,1725,414,374,8,2,6,0,1,5,7,16,7930,37,3729
경기도,이천시,장호원읍,장호원읍제1투,2117,1216,288,533,266,60,55,4,0,2,0,0,0,0,3,1211,5,901
경기도,이천시,장호원읍,장호원읍제2투,1771,1053,273,453,227,48,43,0,0,2,0,1,1,0,1,1049,4,718
경기도,이천시,장호원읍,장호원읍제3투,891,602,143,294,113,26,18,2,0,0,0,0,0,1,2,599,3,289
경기도,이천시,장호원읍,장호원읍제4투,988,658,108,372,137,18,18,0,1,0,0,0,0,2,1,657,1,330
경기도,이천시,장호원읍,장호원읍제5투,947,644,148,247,163,56,21,1,0,1,0,0,1,0,0,638,6,303
경기도,이천시,장호원읍,장호원읍제6투,545,362,78,155,96,17,12,0,0,0,0,0,0,0,3,361,1,183
경기도,이천시,장호원읍,장호원읍제7투,2788,1783,591,564,402,96,115,1,0,0,0,0,1,2,3,1775,8,1005
경기도,이천시,부발읍,관내사전투표,3325,3324,1473,675,699,203,248,2,0,1,1,2,3,1,2,3310,14,1
경기도,이천시,부발읍,합계,24961,17696,7344,3948,3866,1125,1280,13,4,13,4,11,10,5,21,17644,52,7265
경기도,이천시,부발읍,부발읍제1투,3858,2111,668,624,509,134,152,1,1,6,0,1,1,3,4,2104,7,1747
경기도,이천시,부발읍,부발읍제2투,1880,1102,269,437,278,56,52,0,1,1,0,2,1,0,0,1097,5,778
경기도,이천시,부발읍,부발읍제3투,501,335,71,155,75,19,12,1,0,0,0,0,0,0,0,333,2,166
경기도,이천시,부발읍,부발읍제4투,2910,2013,793,454,480,113,154,3,0,0,3,4,0,0,2,2006,7,897
경기도,이천시,부발읍,부발읍제5투,3135,2063,765,493,496,156,140,0,0,1,0,0,0,1,6,2058,5,1072
경기도,이천시,부발읍,부발읍제6투,2916,2136,1013,381,431,146,150,2,2,4,0,0,2,0,2,2133,3,780
경기도,이천시,부발읍,부발읍제7투,1208,942,574,64,132,63,101,2,0,0,0,1,1,0,2,940,2,266
경기도,이천시,부발읍,부발읍제8투,2749,1607,598,423,372,91,113,1,0,0,0,1,1,0,3,1603,4,1142
경기도,이천시,부발읍,부발읍제9투,2479,2063,1120,242,394,144,158,1,0,0,0,0,1,0,0,2060,3,416
경기도,이천시,신둔면,관내사전투표,1569,1569,629,398,337,87,106,1,0,1,0,1,0,0,4,1564,5,0
경기도,이천시,신둔면,합계,8963,6308,2032,2051,1484,327,347,8,2,9,0,3,1,2,10,6276,32,2655
경기도,이천시,신둔면,신둔면제1투,2714,1658,509,536,393,96,107,1,0,2,0,1,1,0,3,1649,9,1056
경기도,이천시,신둔면,신둔면제2투,3034,2002,616,678,482,99,98,5,1,6,0,1,0,2,1,1989,13,1032
경기도,이천시,신둔면,신둔면제3투,1646,1079,278,439,272,45,36,1,1,0,0,0,0,0,2,1074,5,567
경기도,이천시,백사면,관내사전투표,1133,1133,386,378,221,64,76,0,0,0,0,2,1,1,0,1129,4,0
경기도,이천시,백사면,합계,7803,5157,1628,1749,1152,278,306,8,1,5,3,5,1,3,1,5140,17,2646
경기도,이천시,백사면,백사면제1투,3494,2036,567,752,481,106,108,6,1,2,1,3,0,1,0,2028,8,1458
경기도,이천시,백사면,백사면제2투,3176,1988,675,619,450,108,122,2,0,3,2,0,0,1,1,1983,5,1188
경기도,이천시,호법면,합계,4721,3255,844,1338,674,177,191,10,2,0,1,4,2,3,1,3247,8,1466
경기도,이천시,호법면,관내사전투표,994,994,311,380,188,56,50,1,0,0,0,3,0,0,0,989,5,0
경기도,이천시,호법면,호법면제1투,2706,1578,384,630,354,91,102,8,1,0,0,1,1,2,1,1575,3,1128
경기도,이천시,호법면,호법면제2투,1021,683,149,328,132,30,39,1,1,0,1,0,1,1,0,683,0,338
경기도,이천시,마장면,합계,7699,5274,1506,1805,1224,362,301,6,2,2,2,2,5,2,8,5227,47,2425
경기도,이천시,마장면,관내사전투표,1720,1720,588,477,374,142,115,3,2,1,1,0,0,1,3,1707,13,0
경기도,이천시,마장면,마장면제1투,2594,1532,418,540,352,111,87,3,0,0,1,2,1,0,3,1518,14,1062
경기도,이천시,마장면,마장면제2투,1937,1103,282,407,290,66,47,0,0,0,0,0,2,0,2,1096,7,834
경기도,이천시,마장면,마장면제3투,1448,919,218,381,208,43,52,0,0,1,0,0,2,1,0,906,13,529
경기도,이천시,대월면,합계,10583,7506,3031,1777,1581,409,635,13,2,6,2,7,3,4,4,7474,32,3077
경기도,이천시,대월면,관내사전투표,2353,2353,1131,417,429,147,213,1,1,1,1,1,0,0,2,2344,9,0
경기도,이천시,대월면,대월면제1투,2403,1402,397,523,309,60,94,6,0,1,1,0,0,2,2,1395,7,1001
경기도,이천시,대월면,대월면제2투,1043,657,115,305,173,25,30,2,0,0,0,0,0,0,0,650,7,386
경기도,이천시,대월면,대월면제3투,2401,1342,459,323,326,76,136,1,1,3,0,6,2,2,0,1335,7,1059
경기도,이천시,대월면,대월면제4투,2383,1752,929,209,344,101,162,3,0,1,0,0,1,0,0,1750,2,631
경기도,이천시,모가면,관내사전투표,809,809,240,236,183,51,72,0,1,1,1,1,0,1,4,791,18,0
경기도,이천시,모가면,합계,3983,2823,672,1146,654,137,158,4,1,4,4,2,4,4,7,2797,26,1160
경기도,이천시,모가면,모가면제1투,1941,1208,284,508,289,50,63,3,0,1,1,0,1,2,2,1204,4,733
경기도,이천시,모가면,모가면제2투,1233,806,148,402,182,36,23,1,0,2,2,1,3,1,1,802,4,427
경기도,이천시,설성면,합계,4092,2787,673,1180,597,155,135,0,0,6,0,1,3,3,6,2759,28,1305
경기도,이천시,설성면,관내사전투표,637,637,184,251,132,30,31,0,0,2,0,0,1,0,3,634,3,0
경기도,이천시,설성면,설성면제1투,1230,737,175,302,166,40,46,0,0,0,0,1,0,3,2,735,2,493
경기도,이천시,설성면,설성면제2투,949,621,154,277,109,31,24,0,0,4,0,0,1,0,0,600,21,328
경기도,이천시,설성면,설성면제3투,1276,792,160,350,190,54,34,0,0,0,0,0,1,0,1,790,2,484
경기도,이천시,율면,합계,2454,1711,490,639,396,76,88,3,0,2,0,1,0,2,6,1703,8,743
경기도,이천시,율면,관내사전투표,519,519,170,174,110,29,26,2,0,0,0,0,0,1,2,514,5,0
경기도,이천시,율면,율면투표소,1935,1192,320,465,286,47,62,1,0,2,0,1,0,1,4,1189,3,743
경기도,이천시,창전동,합계,14942,9922,3164,3114,2119,667,749,12,2,9,6,5,8,9,19,9883,39,5020
경기도,이천시,창전동,관내사전투표,2838,2838,1225,580,542,208,246,2,0,2,1,1,4,2,6,2819,19,0
경기도,이천시,창전동,창전동제1투,3138,1770,455,663,404,99,133,3,1,2,2,0,0,1,2,1765,5,1368
경기도,이천시,창전동,창전동제2투,2392,1295,375,477,252,76,100,2,1,2,0,0,2,2,4,1293,2,1097
경기도,이천시,창전동,창전동제3투,2215,1310,353,494,288,94,67,1,0,2,1,2,2,3,1,1308,2,905
경기도,이천시,창전동,창전동제4투,2269,1474,411,497,335,108,107,4,0,0,1,2,0,0,4,1469,5,795
경기도,이천시,창전동,창전동제5투,2090,1235,345,403,298,82,96,0,0,1,1,0,0,1,2,1229,6,855
경기도,이천시,증포동,합계,30393,22518,9471,4512,5022,1617,1729,22,5,7,6,20,6,6,18,22441,77,7875
경기도,이천시,증포동,관내사전투표,5595,5595,2654,994,1094,387,431,2,1,1,0,6,1,2,2,5575,20,0
경기도,이천시,증포동,증포동제1투,3068,2061,824,411,485,171,151,1,2,0,2,4,0,1,1,2053,8,1007
경기도,이천시,증포동,증포동제2투,2609,1565,483,467,409,92,93,1,0,0,2,0,1,1,2,1551,14,1044
경기도,이천시,증포동,증포동제3투,3937,2699,1157,494,619,195,218,1,0,2,0,1,0,0,3,2690,9,1238
경기도,이천시,증포동,증포동제4투,2236,1542,664,283,356,103,119,5,1,1,1,1,1,0,1,1536,6,694
경기도,이천시,증포동,증포동제5투,3193,2132,858,489,445,162,167,3,0,0,0,0,1,1,3,2129,3,1061
경기도,이천시,증포동,증포동제6투,2675,1916,747,424,444,149,142,3,0,0,1,2,1,0,1,1914,2,759
경기도,이천시,증포동,증포동제7투,2554,1785,749,338,397,122,167,2,0,1,0,3,0,0,0,1779,6,769
경기도,이천시,증포동,증포동제8투,2743,1851,753,337,447,137,161,2,1,2,0,3,0,1,1,1845,6,892
경기도,이천시,증포동,증포동제9투,1783,1372,582,275,326,99,80,2,0,0,0,0,1,0,4,1369,3,411
경기도,이천시,중리동,합계,11855,8292,2696,2741,1779,507,485,7,0,8,3,5,7,8,9,8255,37,3563
경기도,이천시,중리동,관내사전투표,2929,2929,1087,905,566,152,187,4,0,3,1,2,4,4,0,2915,14,0
경기도,이천시,중리동,중리동제1투,2225,1115,334,420,234,48,67,1,0,2,0,0,1,1,2,1110,5,1110
경기도,이천시,중리동,중리동제2투,2265,1365,394,471,323,83,82,1,0,1,1,1,0,0,3,1360,5,900
경기도,이천시,중리동,중리동제3투,1986,1326,445,395,301,113,65,1,0,2,0,0,0,1,0,1323,3,660
경기도,이천시,중리동,중리동제4투,2450,1557,436,550,355,111,84,0,0,0,1,2,2,2,4,1547,10,893
경기도,이천시,관고동,합계,9053,6429,2169,1902,1353,429,498,15,1,4,0,8,2,3,5,6389,40,2624
경기도,이천시,관고동,관내사전투표,2520,2520,1054,590,453,178,214,6,0,1,0,6,0,0,2,2504,16,0
경기도,이천시,관고동,관고동제1투,2501,1497,432,483,336,100,127,2,1,1,0,1,1,2,1,1487,10,1004
경기도,이천시,관고동,관고동제2투,2307,1366,392,477,314,87,83,5,0,0,0,0,1,1,1,1361,5,941
경기도,이천시,관고동,관고동제3투,1725,1046,291,352,250,64,74,2,0,2,0,1,0,0,1,1037,9,679
경기도,이천시,잘못 투입·구분된 투표지,,0,0,0,0,0,0,0,0,0,0,0,0,0,0,0,0,0,0
경기도,용인시처인구,합계,,184406,134872,50423,33153,32027,8707,9227,152,32,80,44,98,57,59,164,134223,649,49534
경기도,용인시처인구,거소·선상투표,,416,390,145,76,108,19,11,2,2,2,1,0,0,1,3,370,20,26
경기도,용인시처인구,관외사전투표,,15594,15592,6586,2758,3428,1322,1299,17,3,12,6,8,9,4,28,15480,112,2
경기도,용인시처인구,재외투표,,1026,801,473,77,108,43,91,2,0,1,0,0,0,1,0,796,5,225
경기도,용인시처인구,포곡읍,합계,25466,17931,7035,4055,4300,1127,1251,21,4,7,8,16,7,8,21,17860,71,7535
경기도,용인시처인구,포곡읍,관내사전투표,4061,4061,1865,742,841,283,293,6,0,2,1,6,0,1,3,4043,18,0
경기도,용인시처인구,포곡읍,포곡읍제1투,3068,1732,636,450,433,87,108,1,1,2,1,0,0,1,4,1724,8,1336
경기도,용인시처인구,포곡읍,포곡읍제2투,1242,913,358,248,191,54,53,5,0,0,0,2,0,0,0,911,2,329
경기도,용인시처인구,포곡읍,포곡읍제3투,1765,1212,389,331,328,69,88,0,0,1,0,2,0,1,2,1211,1,553
경기도,용인시처인구,포곡읍,포곡읍제4투,3823,2392,876,573,580,149,184,3,1,0,4,1,3,1,6,2381,11,1431
경기도,용인시처인구,포곡읍,포곡읍제5투,824,558,93,269,153,23,16,1,0,0,0,0,1,0,0,556,2,266
경기도,용인시처인구,포곡읍,포곡읍제6투,3290,2107,846,408,524,146,167,1,1,1,2,1,1,0,0,2098,9,1183
경기도,용인시처인구,포곡읍,포곡읍제7투,3662,2270,846,555,575,124,146,2,1,0,0,2,2,3,3,2259,11,1392
경기도,용인시처인구,포곡읍,포곡읍제8투,3731,2686,1126,479,675,192,196,2,0,1,0,2,0,1,3,2677,9,1045
경기도,용인시처인구,모현면,합계,18806,13121,4824,3316,3272,767,846,13,0,4,4,5,4,7,14,13076,45,5685
경기도,용인시처인구,모현면,관내사전투표,2417,2417,1012,530,522,157,176,2,0,1,0,2,1,1,3,2407,10,0
경기도,용인시처인구,모현면,모현면제1투,3228,2154,863,460,568,109,139,1,0,1,0,1,2,1,3,2148,6,1074
경기도,용인시처인구,모현면,모현면제2투,2299,1406,394,487,366,61,91,1,0,0,1,0,0,0,1,1402,4,893
경기도,용인시처인구,모현면,모현면제3투,3005,2141,855,510,523,123,116,4,0,0,0,1,0,1,1,2134,7,864
경기도,용인시처인구,모현면,모현면제4투,3295,2119,708,605,539,121,128,3,0,1,1,0,0,1,3,2110,9,1176
경기도,용인시처인구,모현면,모현면제5투,2259,1399,445,375,380,89,96,1,0,0,0,0,0,3,1,1390,9,860
경기도,용인시처인구,모현면,모현면제6투,2303,1485,547,349,374,107,100,1,0,1,2,1,1,0,2,1485,0,818
경기도,용인시처인구,남사면,합계,5409,3754,1050,1365,955,179,166,3,2,1,1,1,4,5,5,3737,17,1655
경기도,용인시처인구,남사면,관내사전투표,738,738,256,239,159,39,38,0,1,0,0,0,0,0,2,734,4,0
경기도,용인시처인구,남사면,남사면제1투,1245,787,199,292,226,34,29,2,0,0,0,0,0,0,2,784,3,458
경기도,용인시처인구,남사면,남사면제2투,790,499,116,194,120,29,33,0,1,1,0,0,1,2,0,497,2,291
경기도,용인시처인구,남사면,남사면제3투,1186,819,225,299,216,34,37,0,0,0,0,1,3,0,0,815,4,367
경기도,용인시처인구,남사면,남사면제4투,1450,911,254,341,234,43,29,1,0,0,1,0,0,3,1,907,4,539
경기도,용인시처인구,이동면,관내사전투표,2048,2048,912,497,381,120,106,4,0,2,0,2,2,2,6,2034,14,0
경기도,용인시처인구,이동면,합계,15507,10341,3688,2864,2506,575,594,15,1,9,2,8,6,5,20,10293,48,5166
경기도,용인시처인구,이동면,이동면제1투,3131,1940,675,517,494,108,126,1,0,4,0,0,2,0,4,1931,9,1191
경기도,용인시처인구,이동면,이동면제2투,700,449,93,200,129,14,6,1,0,0,1,0,0,3,1,448,1,251
경기도,용인시처인구,이동면,이동면제3투,1155,742,190,290,187,34,31,3,0,0,1,1,0,0,2,739,3,413
경기도,용인시처인구,이동면,이동면제4투,4011,2526,802,761,632,149,162,1,0,1,0,2,1,0,4,2515,11,1485
경기도,용인시처인구,이동면,이동면제5투,4462,2636,1016,599,683,150,163,5,1,2,0,3,1,0,3,2626,10,1826
경기도,용인시처인구,원삼면,합계,6231,4435,1207,1662,1036,242,239,11,3,2,3,3,3,3,5,4419,16,1796
경기도,용인시처인구,원삼면,관내사전투표,965,965,310,324,213,47,65,1,0,0,1,1,1,0,1,964,1,0
경기도,용인시처인구,원삼면,원삼면제1투,1475,921,205,372,243,55,37,2,1,1,0,0,1,1,0,918,3,554
경기도,용인시처인구,원삼면,원삼면제2투,1257,906,242,340,211,43,57,5,0,1,0,1,1,0,2,903,3,351
경기도,용인시처인구,원삼면,원삼면제3투,1780,1200,339,445,257,74,69,2,2,0,1,1,0,2,2,1194,6,580
경기도,용인시처인구,원삼면,원삼면제4투,754,443,111,181,112,23,11,1,0,0,1,0,0,0,0,440,3,311
경기도,용인시처인구,백암면,합계,7405,4990,1351,1806,1175,287,262,9,4,12,5,6,7,6,10,4940,50,2415
경기도,용인시처인구,백암면,관내사전투표,1131,1131,418,312,248,74,67,1,0,2,0,0,1,0,1,1124,7,0
경기도,용인시처인구,백암면,백암면제1투,1573,918,213,370,217,60,51,0,0,3,0,0,0,0,0,914,4,655
경기도,용인시처인구,백암면,백암면제2투,813,557,121,239,134,28,25,2,0,0,1,2,1,2,0,555,2,256
경기도,용인시처인구,백암면,백암면제3투,1092,656,134,273,156,35,46,0,1,1,0,2,1,1,2,652,4,436
경기도,용인시처인구,백암면,백암면제4투,1409,899,245,310,220,41,32,2,3,4,4,2,4,3,4,874,25,510
경기도,용인시처인구,백암면,백암면제5투,1387,829,220,302,200,49,41,4,0,2,0,0,0,0,3,821,8,558
경기도,용인시처인구,양지면,합계,13525,9339,3246,2619,2209,578,586,14,2,6,4,9,6,3,13,9295,44,4186
경기도,용인시처인구,양지면,관내사전투표,2574,2574,1063,558,603,163,166,1,0,1,0,4,0,1,4,2564,10,0
경기도,용인시처인구,양지면,양지면제1투,3533,2135,671,660,501,137,150,2,1,1,1,0,3,0,2,2129,6,1398
경기도,용인시처인구,양지면,양지면제2투,2401,1553,487,515,357,91,83,6,0,0,0,1,1,0,3,1544,9,848
경기도,용인시처인구,양지면,양지면제3투,1630,1097,315,401,241,58,60,3,1,0,1,3,2,0,2,1087,10,533
경기도,용인시처인구,양지면,양지면제4투,3387,1980,710,485,507,129,127,2,0,4,2,1,0,2,2,1971,9,1407
경기도,용인시처인구,중앙동,합계,18909,13462,4939,3429,3107,919,942,8,1,12,1,9,3,7,15,13392,70,5447
경기도,용인시처인구,중앙동,관내사전투표,3518,3518,1486,730,707,284,280,2,1,2,0,3,1,1,5,3502,16,0
경기도,용인시처인구,중앙동,중앙동제1투,1926,1042,336,346,208,58,84,0,0,3,1,0,0,0,2,1038,4,884
경기도,용인시처인구,중앙동,중앙동제2투,1347,852,310,268,182,41,45,1,0,0,0,0,0,1,0,848,4,495
경기도,용인시처인구,중앙동,중앙동제3투,1494,1030,323,314,253,59,72,0,0,2,0,1,1,0,1,1026,4,464
경기도,용인시처인구,중앙동,중앙동제4투,1920,1148,388,279,309,92,68,0,0,1,0,0,0,1,1,1139,9,772
경기도,용인시처인구,중앙동,중앙동제5투,2065,1392,504,363,344,74,93,2,0,2,0,3,0,1,1,1387,5,673
경기도,용인시처인구,중앙동,중앙동제6투,3844,2418,856,579,603,177,180,2,0,1,0,0,0,1,3,2402,16,1426
경기도,용인시처인구,중앙동,중앙동제7투,2795,2062,736,550,501,134,120,1,0,1,0,2,1,2,2,2050,12,733
경기도,용인시처인구,역삼동,합계,22329,16867,6705,3648,3987,1173,1236,16,2,3,2,14,4,3,10,16803,64,5462
경기도,용인시처인구,역삼동,관내사전투표,4716,4716,2059,884,1002,357,376,5,0,1,1,6,0,1,5,4697,19,0
경기도,용인시처인구,역삼동,역삼동제1투,1930,1206,387,330,333,61,88,1,0,0,0,0,0,0,0,1200,6,724
경기도,용인시처인구,역삼동,역삼동제2투,3185,2027,762,455,519,142,132,3,0,0,0,4,2,1,0,2020,7,1158
경기도,용인시처인구,역삼동,역삼동제3투,3144,2119,726,495,572,166,143,1,0,1,1,1,1,0,3,2110,9,1025
경기도,용인시처인구,역삼동,역삼동제4투,2658,1949,736,515,432,114,136,5,1,0,0,0,0,0,1,1940,9,709
경기도,용인시처인구,역삼동,역삼동제5투,4341,3251,1403,635,756,216,225,1,0,1,0,1,1,1,1,3241,10,1090
경기도,용인시처인구,역삼동,역삼동제6투,2355,1599,632,334,373,117,136,0,1,0,0,2,0,0,0,1595,4,756
경기도,용인시처인구,유림동,합계,22773,15987,6405,3402,3915,982,1168,13,6,6,3,14,3,5,14,15936,51,6786
경기도,용인시처인구,유림동,관내사전투표,2995,2995,1413,510,666,181,204,3,0,2,0,2,1,0,3,2985,10,0
경기도,용인시처인구,유림동,유림동제1투,2860,1574,521,435,423,83,105,1,1,0,1,0,0,1,0,1571,3,1286
경기도,용인시처인구,유림동,유림동제2투,3006,2203,941,471,489,117,166,0,4,0,1,2,1,1,4,2197,6,803
경기도,용인시처인구,유림동,유림동제3투,2450,1535,480,465,397,84,92,3,1,0,0,1,1,1,1,1526,9,915
경기도,용인시처인구,유림동,유림동제4투,4136,2423,867,564,614,150,214,1,0,1,0,4,0,1,2,2418,5,1713
경기도,용인시처인구,유림동,유림동제5투,3809,2669,1122,482,661,176,207,3,0,1,0,3,0,1,3,2659,10,1140
경기도,용인시처인구,유림동,유림동제6투,3517,2588,1061,475,665,191,180,2,0,2,1,2,0,0,1,2580,8,929
경기도,용인시처인구,동부동,합계,11010,7862,2769,2076,1921,494,536,8,2,3,4,5,1,1,6,7826,36,3148
경기도,용인시처인구,동부동,관내사전투표,2023,2023,845,443,432,123,164,1,0,1,2,1,0,0,1,2013,10,0
경기도,용인시처인구,동부동,동부동제1투,3249,2119,707,563,547,153,135,4,0,0,0,0,1,0,3,2113,6,1130
경기도,용인시처인구,동부동,동부동제2투,4186,2652,951,658,688,155,172,3,1,1,1,4,0,1,1,2636,16,1534
경기도,용인시처인구,동부동,동부동제3투,1552,1068,266,412,254,63,65,0,1,1,1,0,0,0,1,1064,4,484
경기도,용인시처인구,잘못 투입·구분된 투표지,,0,0,0,0,0,0,0,0,0,0,0,0,0,0,0,0,0,0
경기도,용인시수지구,합계,,268809,225513,95325,50229,47125,18555,13042,375,16,69,20,94,19,45,89,225003,510,43296
경기도,용인시수지구,거소·선상투표,,374,352,121,56,134,18,8,1,0,1,1,0,1,0,1,342,10,22
경기도,용인시수지구,관외사전투표,,26482,26461,12257,4200,5463,2378,1950,29,4,9,0,17,4,7,19,26337,124,21
경기도,용인시수지구,재외투표,,4043,3212,1828,283,560,148,362,13,0,3,0,0,0,1,2,3200,12,831
경기도,용인시수지구,풍덕천1동,합계,28390,23038,10259,4557,4896,1811,1385,43,0,15,0,13,4,5,7,22995,43,5352
경기도,용인시수지구,풍덕천1동,관내사전투표,6943,6943,3273,1272,1330,574,456,7,0,3,0,4,0,3,2,6924,19,0
경기도,용인시수지구,풍덕천1동,풍덕천1동제1투,3349,1978,872,387,403,160,138,8,0,1,0,2,0,0,2,1973,5,1371
경기도,용인시수지구,풍덕천1동,풍덕천1동제2투,2900,1996,745,518,467,131,120,5,0,2,0,1,1,0,1,1991,5,904
경기도,용인시수지구,풍덕천1동,풍덕천1동제3투,3986,3234,1500,576,764,215,155,10,0,6,0,2,1,1,0,3230,4,752
경기도,용인시수지구,풍덕천1동,풍덕천1동제4투,3060,2420,1014,480,567,206,142,2,0,1,0,1,1,1,1,2416,4,640
경기도,용인시수지구,풍덕천1동,풍덕천1동제5투,2883,2251,1033,421,460,178,152,3,0,0,0,1,0,0,1,2249,2,632
경기도,용인시수지구,풍덕천1동,풍덕천1동제6투,2628,2104,830,504,465,181,116,2,0,1,0,2,1,0,0,2102,2,524
경기도,용인시수지구,풍덕천1동,풍덕천1동제7투,2641,2112,992,399,440,166,106,6,0,1,0,0,0,0,0,2110,2,529
경기도,용인시수지구,풍덕천2동,관내사전투표,5156,5156,2635,792,937,385,374,6,1,3,1,2,0,0,2,5138,18,0
경기도,용인시수지구,풍덕천2동,합계,25408,21172,9723,3890,4367,1777,1295,34,3,8,3,10,1,2,8,21121,51,4236
경기도,용인시수지구,풍덕천2동,풍덕천2동제1투,2268,1923,858,401,390,149,115,4,0,0,0,2,0,0,1,1920,3,345
경기도,용인시수지구,풍덕천2동,풍덕천2동제2투,1973,1315,544,265,297,114,82,2,0,0,0,1,1,0,2,1308,7,658
경기도,용인시수지구,풍덕천2동,풍덕천2동제3투,2731,2272,960,468,488,200,140,7,0,0,2,2,0,0,0,2267,5,459
경기도,용인시수지구,풍덕천2동,풍덕천2동제4투,2379,1720,870,267,327,131,114,4,0,0,0,3,0,0,1,1717,3,659
경기도,용인시수지구,풍덕천2동,풍덕천2동제5투,2850,2287,1103,303,520,206,142,4,0,2,0,0,0,1,2,2283,4,563
경기도,용인시수지구,풍덕천2동,풍덕천2동제6투,2611,2162,995,367,466,203,123,2,0,2,0,0,0,1,0,2159,3,449
경기도,용인시수지구,풍덕천2동,풍덕천2동제7투,2201,1757,812,327,377,135,100,1,1,0,0,0,0,0,0,1753,4,444
경기도,용인시수지구,풍덕천2동,풍덕천2동제8투,3239,2580,946,700,565,254,105,4,1,1,0,0,0,0,0,2576,4,659
경기도,용인시수지구,신봉동,합계,25269,20849,8239,5401,4311,1738,1051,38,0,6,2,7,1,4,10,20808,41,4420
경기도,용인시수지구,신봉동,관내사전투표,4921,4921,2245,1090,907,355,295,7,0,2,1,2,0,2,3,4909,12,0
경기도,용인시수지구,신봉동,신봉동제1투,1917,1482,674,278,294,135,92,3,0,2,0,0,1,0,0,1479,3,435
경기도,용인시수지구,신봉동,신봉동제2투,2249,1845,837,337,397,177,94,2,0,0,0,0,0,0,1,1845,0,404
경기도,용인시수지구,신봉동,신봉동제3투,3598,2901,1083,813,640,216,134,1,0,1,0,3,0,0,1,2892,9,697
경기도,용인시수지구,신봉동,신봉동제4투,2985,2360,855,683,461,235,113,9,0,0,1,0,0,0,0,2357,3,625
경기도,용인시수지구,신봉동,신봉동제5투,4142,3064,967,1058,641,239,141,8,0,0,0,0,0,0,3,3057,7,1078
경기도,용인시수지구,신봉동,신봉동제6투,3181,2466,898,703,555,204,92,5,0,1,0,0,0,1,1,2460,6,715
경기도,용인시수지구,신봉동,신봉동제7투,2276,1810,680,439,416,177,90,3,0,0,0,2,0,1,1,1809,1,466
경기도,용인시수지구,죽전1동,관내사전투표,7409,7409,3516,1503,1404,540,418,4,0,2,1,5,2,4,1,7400,9,0
경기도,용인시수지구,죽전1동,합계,39090,32072,14219,6830,6550,2609,1724,34,2,10,6,16,3,10,6,32019,53,7018
경기도,용인시수지구,죽전1동,죽전1동제1투,3298,2351,1027,482,494,196,134,7,1,0,1,2,0,1,2,2347,4,947
경기도,용인시수지구,죽전1동,죽전1동제2투,3482,2721,1233,522,564,227,160,3,0,0,0,1,1,0,1,2712,9,761
경기도,용인시수지구,죽전1동,죽전1동제3투,3315,2688,1238,546,545,225,130,1,0,0,0,0,0,0,0,2685,3,627
경기도,용인시수지구,죽전1동,죽전1동제4투,3390,2617,1050,630,545,214,162,6,0,3,2,1,0,0,0,2613,4,773
경기도,용인시수지구,죽전1동,죽전1동제5투,3288,2703,1241,511,581,206,156,1,0,0,1,2,0,1,0,2700,3,585
경기도,용인시수지구,죽전1동,죽전1동제6투,3263,2601,1022,675,560,241,97,0,0,2,0,0,0,1,0,2598,3,662
경기도,용인시수지구,죽전1동,죽전1동제7투,2799,2146,811,609,434,167,109,3,1,2,1,2,0,2,1,2142,4,653
경기도,용인시수지구,죽전1동,죽전1동제8투,3102,2359,1003,504,533,191,117,2,0,0,0,3,0,0,1,2354,5,743
경기도,용인시수지구,죽전1동,죽전1동제9투,3233,2480,1133,491,485,230,132,4,0,0,0,0,0,0,0,2475,5,753
경기도,용인시수지구,죽전1동,죽전1동제10투,2511,1997,945,357,405,172,109,3,0,1,0,0,0,1,0,1993,4,514
경기도,용인시수지구,죽전2동,합계,13406,10953,4869,2163,2310,929,633,14,1,2,1,5,0,1,4,10932,21,2453
경기도,용인시수지구,죽전2동,관내사전투표,2363,2363,1137,433,427,207,149,3,0,0,0,2,0,0,0,2358,5,0
경기도,용인시수지구,죽전2동,죽전2동제1투,3122,2358,1041,470,508,178,147,5,0,1,0,1,0,0,1,2352,6,764
경기도,용인시수지구,죽전2동,죽전2동제2투,2652,2042,887,394,451,191,114,1,0,1,0,1,0,0,0,2040,2,610
경기도,용인시수지구,죽전2동,죽전2동제3투,2669,2125,846,471,490,193,114,3,0,0,0,1,0,0,2,2120,5,544
경기도,용인시수지구,죽전2동,죽전2동제4투,2600,2065,958,395,434,160,109,2,1,0,1,0,0,1,1,2062,3,535
경기도,용인시수지구,동천동,합계,25130,20756,8596,4730,4379,1652,1281,37,1,4,4,12,1,7,13,20717,39,4374
경기도,용인시수지구,동천동,관내사전투표,5617,5617,2581,1127,1070,430,377,6,0,0,3,6,1,0,4,5605,12,0
경기도,용인시수지구,동천동,동천동제1투,3225,2373,999,515,496,191,157,6,0,0,0,2,0,2,0,2368,5,852
경기도,용인시수지구,동천동,동천동제2투,1336,960,367,240,208,62,77,3,0,0,0,0,0,0,1,958,2,376
경기도,용인시수지구,동천동,동천동제3투,2639,2132,867,498,460,171,126,5,0,0,0,1,0,0,1,2129,3,507
경기도,용인시수지구,동천동,동천동제4투,3690,2911,1319,521,607,234,205,8,1,1,0,1,0,2,5,2904,7,779
경기도,용인시수지구,동천동,동천동제5투,1597,1206,427,381,247,69,74,2,0,1,1,0,0,1,1,1204,2,391
경기도,용인시수지구,동천동,동천동제6투,1911,1482,675,253,337,118,93,2,0,1,0,2,0,0,0,1481,1,429
경기도,용인시수지구,동천동,동천동제7투,2282,1815,667,469,416,164,94,1,0,0,0,0,0,0,0,1811,4,467
경기도,용인시수지구,동천동,동천동제8투,2833,2260,694,726,538,213,78,4,0,1,0,0,0,2,1,2257,3,573
경기도,용인시수지구,상현1동,합계,30360,24600,10271,5448,5363,2059,1354,38,1,2,0,6,0,3,11,24556,44,5760
경기도,용인시수지구,상현1동,관내사전투표,4184,4184,2027,699,813,344,281,7,0,0,0,1,0,1,2,4175,9,0
경기도,용인시수지구,상현1동,상현1동제1투,2821,2201,865,551,481,188,106,2,0,0,0,2,0,0,1,2196,5,620
경기도,용인시수지구,상현1동,상현1동제2투,3048,2394,946,542,589,196,113,1,1,0,0,1,0,0,0,2389,5,654
경기도,용인시수지구,상현1동,상현1동제3투,2955,2390,954,566,540,192,126,6,0,0,0,0,0,1,1,2386,4,565
경기도,용인시수지구,상현1동,상현1동제4투,2269,1772,569,611,352,151,83,3,0,0,0,2,0,0,1,1772,0,497
경기도,용인시수지구,상현1동,상현1동제5투,2304,1789,697,461,387,145,91,4,0,0,0,0,0,0,1,1786,3,515
경기도,용인시수지구,상현1동,상현1동제6투,2239,1781,537,537,448,172,79,4,0,0,0,0,0,1,0,1778,3,458
경기도,용인시수지구,상현1동,상현1동제7투,3404,2606,1009,642,570,218,155,3,0,1,0,0,0,0,2,2600,6,798
경기도,용인시수지구,상현1동,상현1동제8투,3642,2811,1386,366,647,244,161,3,0,0,0,0,0,0,1,2808,3,831
경기도,용인시수지구,상현1동,상현1동제9투,3494,2672,1281,473,536,209,159,5,0,1,0,0,0,0,2,2666,6,822
경기도,용인시수지구,상현2동,합계,23983,20240,8320,4977,4174,1562,1122,22,3,5,2,2,3,1,5,20198,42,3743
경기도,용인시수지구,상현2동,관내사전투표,6285,6284,2705,1507,1234,461,353,5,1,1,0,0,1,0,1,6269,15,1
경기도,용인시수지구,상현2동,상현2동제1투,3071,2250,937,537,451,190,123,5,1,0,1,0,0,0,2,2247,3,821
경기도,용인시수지구,상현2동,상현2동제2투,2874,2251,874,615,459,171,122,2,0,1,1,1,1,0,0,2247,4,623
경기도,용인시수지구,상현2동,상현2동제3투,2409,1854,679,488,430,160,89,1,0,0,0,0,0,1,0,1848,6,555
경기도,용인시수지구,상현2동,상현2동제4투,2864,2300,972,581,459,168,114,2,0,1,0,0,0,0,0,2297,3,564
경기도,용인시수지구,상현2동,상현2동제5투,3144,2508,1025,588,542,191,148,4,0,0,0,0,1,0,1,2500,8,636
경기도,용인시수지구,상현2동,상현2동제6투,3336,2793,1128,661,599,221,173,3,1,2,0,1,0,0,1,2790,3,543
경기도,용인시수지구,성복동,합계,26874,21808,6623,7694,4618,1874,877,72,1,4,1,6,1,4,3,21778,30,5066
경기도,용인시수지구,성복동,관내사전투표,5794,5794,1947,2016,1073,491,230,24,0,0,0,1,0,2,0,5784,10,0
경기도,용인시수지구,성복동,성복동제1투,2785,2191,596,849,455,177,107,4,0,0,0,0,0,0,0,2188,3,594
경기도,용인시수지구,성복동,성복동제2투,3269,2586,621,1110,529,209,102,10,0,1,0,0,0,0,1,2583,3,683
경기도,용인시수지구,성복동,성복동제3투,2192,1598,354,724,331,138,44,3,0,0,0,0,0,2,0,1596,2,594
경기도,용인시수지구,성복동,성복동제4투,2379,1755,566,551,378,163,83,6,0,0,1,0,0,0,1,1749,6,624
경기도,용인시수지구,성복동,성복동제5투,2830,2089,559,852,443,159,67,2,1,1,0,2,1,0,0,2087,2,741
경기도,용인시수지구,성복동,성복동제6투,3840,2892,959,799,715,279,122,14,0,2,0,1,0,0,0,2891,1,948
경기도,용인시수지구,성복동,성복동제7투,3785,2903,1021,793,694,258,122,9,0,0,0,2,0,0,1,2900,3,882
경기도,용인시수지구,잘못 투입·구분된 투표지,,0,0,0,0,0,0,0,0,0,0,0,0,0,0,0,0,0,0
경기도,용인시기흥구,합계,,319811,261414,116017,53405,55393,18992,16026,411,13,111,45,141,41,61,112,260768,646,58397
경기도,용인시기흥구,거소·선상투표,,428,402,133,69,149,20,17,3,1,1,1,0,0,1,1,396,6,26
경기도,용인시기흥구,관외사전투표,,32179,32174,15281,5043,6627,2577,2370,40,1,19,8,13,7,7,32,32025,149,5
경기도,용인시기흥구,재외투표,,3464,2798,1697,195,423,143,318,5,0,0,1,2,1,1,1,2787,11,666
경기도,용인시기흥구,신갈동,합계,27184,21403,9231,4489,4858,1420,1276,30,2,10,3,18,5,6,7,21355,48,5781
경기도,용인시기흥구,신갈동,관내사전투표,5125,5125,2373,975,1098,313,329,9,1,1,0,9,0,3,3,5114,11,0
경기도,용인시기흥구,신갈동,신갈동제1투,2506,1404,467,417,334,94,75,2,0,2,2,0,1,0,0,1394,10,1102
경기도,용인시기흥구,신갈동,신갈동제2투,2613,1797,680,431,415,143,120,3,0,0,0,2,0,1,0,1795,2,816
경기도,용인시기흥구,신갈동,신갈동제3투,2594,1663,640,353,467,80,108,3,0,1,0,2,1,0,1,1656,7,931
경기도,용인시기흥구,신갈동,신갈동제4투,2725,2116,943,366,494,160,142,0,0,5,0,0,0,0,1,2111,5,609
경기도,용인시기흥구,신갈동,신갈동제5투,2903,2237,876,557,489,173,126,6,0,0,0,1,2,1,0,2231,6,666
경기도,용인시기흥구,신갈동,신갈동제6투,2447,2019,1012,303,426,145,129,3,0,0,0,0,0,0,0,2018,1,428
경기도,용인시기흥구,신갈동,신갈동제7투,3866,2993,1286,661,697,180,158,1,1,0,0,4,0,0,1,2989,4,873
경기도,용인시기흥구,신갈동,신갈동제8투,2405,2049,954,426,438,132,89,3,0,1,1,0,1,1,1,2047,2,356
경기도,용인시기흥구,영덕동,관내사전투표,3928,3927,2221,510,668,259,249,5,0,0,0,4,0,2,1,3919,8,1
경기도,용인시기흥구,영덕동,합계,28914,23055,11138,3825,4764,1728,1493,33,1,11,1,12,3,7,4,23020,35,5859
경기도,용인시기흥구,영덕동,영덕동제1투,3082,2205,792,617,510,152,127,3,0,1,0,1,0,0,0,2203,2,877
경기도,용인시기흥구,영덕동,영덕동제2투,1821,1472,654,294,306,110,101,1,0,1,0,1,2,0,0,1470,2,349
경기도,용인시기흥구,영덕동,영덕동제3투,2511,1996,914,344,444,151,132,3,0,1,0,1,0,0,0,1990,6,515
경기도,용인시기흥구,영덕동,영덕동제4투,2558,1929,841,325,477,149,128,3,1,2,0,0,0,0,1,1927,2,629
경기도,용인시기흥구,영덕동,영덕동제5투,4741,3567,1669,620,736,308,222,5,0,1,0,2,0,1,1,3565,2,1174
경기도,용인시기흥구,영덕동,영덕동제6투,4166,3472,1795,488,665,279,229,5,0,2,0,0,1,2,1,3467,5,694
경기도,용인시기흥구,영덕동,영덕동제7투,3525,2299,1020,424,525,142,167,8,0,3,1,3,0,2,0,2295,4,1226
경기도,용인시기흥구,영덕동,영덕동제8투,2582,2188,1232,203,433,178,138,0,0,0,0,0,0,0,0,2184,4,394
경기도,용인시기흥구,구갈동,합계,19459,14931,6546,2881,3217,1075,1102,28,0,6,3,14,5,4,3,14884,47,4528
경기도,용인시기흥구,구갈동,관내사전투표,3159,3159,1581,489,552,237,279,4,0,1,1,3,1,1,0,3149,10,0
경기도,용인시기흥구,구갈동,구갈동제1투,2525,1570,687,303,328,117,123,3,0,0,0,0,1,2,0,1564,6,955
경기도,용인시기흥구,구갈동,구갈동제2투,2486,1643,658,340,384,118,130,3,0,0,0,3,1,0,1,1638,5,843
경기도,용인시기흥구,구갈동,구갈동제3투,2575,1772,715,377,435,104,116,11,0,3,0,2,1,1,0,1765,7,803
경기도,용인시기흥구,구갈동,구갈동제4투,2548,2016,855,420,420,146,165,1,0,1,1,2,0,0,0,2011,5,532
경기도,용인시기흥구,구갈동,구갈동제5투,2956,2200,910,457,539,153,122,5,0,0,1,3,1,0,1,2192,8,756
경기도,용인시기흥구,구갈동,구갈동제6투,1549,1259,607,223,266,85,74,0,0,1,0,0,0,0,0,1256,3,290
경기도,용인시기흥구,구갈동,구갈동제7투,1661,1312,533,272,293,115,93,1,0,0,0,1,0,0,1,1309,3,349
경기도,용인시기흥구,상갈동,합계,31903,24990,10862,5365,5376,1670,1557,34,1,12,3,24,7,5,10,24926,64,6913
경기도,용인시기흥구,상갈동,관내사전투표,4457,4457,2133,812,862,282,336,6,0,2,1,3,2,1,4,4444,13,0
경기도,용인시기흥구,상갈동,상갈동제1투,2807,1884,794,356,437,156,134,0,0,0,0,3,0,0,0,1880,4,923
경기도,용인시기흥구,상갈동,상갈동제2투,3133,2038,969,320,467,143,122,5,0,0,0,3,0,1,2,2032,6,1095
경기도,용인시기흥구,상갈동,상갈동제3투,2512,2053,885,435,434,159,128,1,0,0,0,1,1,0,2,2046,7,459
경기도,용인시기흥구,상갈동,상갈동제4투,1519,1017,390,246,246,69,51,3,0,1,0,3,1,1,0,1011,6,502
경기도,용인시기흥구,상갈동,상갈동제5투,1935,1481,608,404,299,94,70,2,1,0,0,0,0,0,0,1478,3,454
경기도,용인시기흥구,상갈동,상갈동제6투,2195,1715,724,362,391,122,102,5,0,2,0,1,0,0,0,1709,6,480
경기도,용인시기흥구,상갈동,상갈동제7투,3302,2620,943,789,565,167,144,1,0,2,1,2,0,1,0,2615,5,682
경기도,용인시기흥구,상갈동,상갈동제8투,2234,1790,728,431,390,124,109,3,0,1,0,0,0,0,0,1786,4,444
경기도,용인시기흥구,상갈동,상갈동제9투,2909,2057,860,459,455,136,134,3,0,1,0,4,0,1,1,2054,3,852
경기도,용인시기흥구,상갈동,상갈동제10투,2162,1800,1001,212,368,100,111,1,0,1,0,2,2,0,0,1798,2,362
경기도,용인시기흥구,상갈동,상갈동제11투,2738,2078,827,539,462,118,116,4,0,2,1,2,1,0,1,2073,5,660
경기도,용인시기흥구,기흥동,합계,15962,11815,4737,2820,2773,788,615,28,0,5,3,5,4,3,3,11784,31,4147
경기도,용인시기흥구,기흥동,관내사전투표,2800,2800,1260,592,602,179,137,13,0,2,2,1,0,0,0,2788,12,0
경기도,용인시기흥구,기흥동,기흥동제1투,2634,1735,635,395,465,127,100,0,0,1,0,0,2,1,1,1727,8,899
경기도,용인시기흥구,기흥동,기흥동제2투,2711,1987,928,360,463,123,103,1,0,0,1,1,0,1,1,1982,5,724
경기도,용인시기흥구,기흥동,기흥동제3투,887,534,129,248,100,37,16,3,0,0,0,0,1,0,0,534,0,353
경기도,용인시기흥구,기흥동,기흥동제4투,3345,2185,886,506,507,134,141,4,0,0,0,2,1,1,1,2183,2,1160
경기도,용인시기흥구,기흥동,기흥동제5투,3585,2574,899,719,636,188,118,7,0,2,0,1,0,0,0,2570,4,1011
경기도,용인시기흥구,서농동,합계,15954,13075,6568,1834,2602,1137,882,18,1,7,1,2,0,2,2,13056,19,2879
경기도,용인시기흥구,서농동,관내사전투표,3584,3584,2001,416,611,275,265,5,0,2,1,1,0,1,0,3578,6,0
경기도,용인시기흥구,서농동,서농동제1투,916,548,250,47,90,99,62,0,0,0,0,0,0,0,0,548,0,368
경기도,용인시기흥구,서농동,서농동제2투,2120,1736,740,334,372,174,108,2,0,1,0,0,0,0,1,1732,4,384
경기도,용인시기흥구,서농동,서농동제3투,1951,1473,589,333,326,133,86,0,0,2,0,0,0,1,0,1470,3,478
경기도,용인시기흥구,서농동,서농동제4투,2808,1909,869,327,446,142,121,1,1,0,0,0,0,0,0,1907,2,899
경기도,용인시기흥구,서농동,서농동제5투,2573,2146,1190,208,430,174,135,5,0,1,0,1,0,0,0,2144,2,427
경기도,용인시기흥구,서농동,서농동제6투,2002,1679,929,169,327,140,105,5,0,1,0,0,0,0,1,1677,2,323
경기도,용인시기흥구,구성동,합계,28623,22898,9096,6225,4771,1495,1168,37,0,14,3,9,3,7,14,22842,56,5725
경기도,용인시기흥구,구성동,관내사전투표,5569,5569,2235,1516,1053,408,319,7,0,3,1,7,0,0,3,5552,17,0
경기도,용인시기흥구,구성동,구성동제1투,2890,2045,593,796,396,143,105,1,0,0,1,0,1,0,3,2039,6,845
경기도,용인시기흥구,구성동,구성동제2투,3047,2307,807,762,491,149,84,4,0,1,0,0,0,3,1,2302,5,740
경기도,용인시기흥구,구성동,구성동제3투,3247,2313,918,622,491,134,132,3,0,3,1,0,0,0,2,2306,7,934
경기도,용인시기흥구,구성동,구성동제4투,2910,2405,908,737,504,146,96,3,0,3,0,1,0,1,2,2401,4,505
경기도,용인시기흥구,구성동,구성동제5투,1700,1391,609,342,287,86,61,2,0,0,0,0,1,1,0,1389,2,309
경기도,용인시기흥구,구성동,구성동제6투,3457,2619,1270,468,568,155,141,6,0,1,0,1,1,1,1,2613,6,838
경기도,용인시기흥구,구성동,구성동제7투,3089,2282,884,560,535,149,141,3,0,2,0,0,0,0,1,2275,7,807
경기도,용인시기흥구,구성동,구성동제8투,2714,1967,872,422,446,125,89,8,0,1,0,0,0,1,1,1965,2,747
경기도,용인시기흥구,마북동,합계,22848,18484,6890,5258,3903,1405,936,28,3,8,2,7,2,1,2,18445,39,4364
경기도,용인시기흥구,마북동,관내사전투표,4386,4386,1807,1162,857,314,228,4,0,2,0,3,1,0,0,4378,8,0
경기도,용인시기흥구,마북동,마북동제1투,2663,1798,652,534,388,130,79,6,2,0,1,0,0,0,0,1792,6,865
경기도,용인시기흥구,마북동,마북동제2투,2720,2059,658,731,424,139,99,4,0,0,0,0,0,1,1,2057,2,661
경기도,용인시기흥구,마북동,마북동제3투,2809,2165,862,463,547,155,122,4,0,0,0,2,0,0,1,2156,9,644
경기도,용인시기흥구,마북동,마북동제4투,2704,2190,648,797,460,186,91,2,0,1,1,0,0,0,0,2186,4,514
경기도,용인시기흥구,마북동,마북동제5투,2766,2218,957,474,469,191,117,1,0,3,0,1,0,0,0,2213,5,548
경기도,용인시기흥구,마북동,마북동제6투,2068,1580,539,487,337,127,80,5,1,0,0,1,1,0,0,1578,2,488
경기도,용인시기흥구,마북동,마북동제7투,2732,2088,767,610,421,163,120,2,0,2,0,0,0,0,0,2085,3,644
경기도,용인시기흥구,동백동,합계,50536,41238,19978,7121,8509,3006,2413,68,3,10,6,24,2,6,17,41163,75,9298
경기도,용인시기흥구,동백동,관내사전투표,7220,7220,3827,1119,1267,512,458,13,0,3,2,3,0,2,2,7208,12,0
경기도,용인시기흥구,동백동,동백동제1투,1884,1487,674,315,311,105,72,0,0,3,0,1,0,0,0,1481,6,397
경기도,용인시기흥구,동백동,동백동제2투,3177,2633,1353,350,545,205,163,6,0,0,0,1,0,1,1,2625,8,544
경기도,용인시기흥구,동백동,동백동제3투,2924,2198,986,460,457,153,131,3,0,0,0,1,0,1,2,2194,4,726
경기도,용인시기흥구,동백동,동백동제4투,3147,2472,1246,366,521,169,153,7,0,0,1,0,0,0,4,2467,5,675
경기도,용인시기흥구,동백동,동백동제5투,3033,2358,1146,424,494,146,136,4,1,1,0,2,0,0,0,2354,4,675
경기도,용인시기흥구,동백동,동백동제6투,3288,2535,1330,329,499,207,161,7,0,0,0,1,0,0,1,2535,0,753
경기도,용인시기흥구,동백동,동백동제7투,2541,2055,1042,303,451,137,112,2,0,0,0,3,0,0,0,2050,5,486
경기도,용인시기흥구,동백동,동백동제8투,2951,2429,1108,442,518,212,141,1,0,1,0,2,0,1,1,2427,2,522
경기도,용인시기흥구,동백동,동백동제9투,4102,3015,1334,613,651,238,166,4,0,0,1,0,0,0,1,3008,7,1087
경기도,용인시기흥구,동백동,동백동제10투,1974,1630,817,254,353,104,92,0,0,0,0,2,0,0,1,1623,7,344
경기도,용인시기흥구,동백동,동백동제11투,2149,1713,842,236,383,133,110,5,0,0,0,0,0,0,0,1709,4,436
경기도,용인시기흥구,동백동,동백동제12투,3376,2568,1128,537,571,172,146,5,0,0,1,3,1,1,1,2566,2,808
경기도,용인시기흥구,동백동,동백동제13투,2624,2060,974,383,413,155,125,4,0,1,0,1,0,0,0,2056,4,564
경기도,용인시기흥구,동백동,동백동제14투,2693,2133,954,426,489,151,103,2,1,0,0,2,0,0,1,2129,4,560
경기도,용인시기흥구,동백동,동백동제15투,3453,2732,1217,564,586,207,144,5,1,1,1,2,1,0,2,2731,1,721
경기도,용인시기흥구,상하동,합계,17588,13884,5926,2908,3159,972,833,32,0,3,6,8,1,4,9,13861,23,3704
경기도,용인시기흥구,상하동,관내사전투표,3278,3278,1579,609,635,228,208,8,0,1,1,1,0,1,2,3273,5,0
경기도,용인시기흥구,상하동,상하동제1투,3373,2371,989,455,574,192,152,5,0,0,1,0,0,0,1,2369,2,1002
경기도,용인시기흥구,상하동,상하동제2투,3162,2377,902,549,602,160,146,4,0,1,1,4,0,2,1,2372,5,785
경기도,용인시기흥구,상하동,상하동제3투,2666,2081,889,475,450,133,118,10,0,0,1,1,0,0,1,2078,3,585
경기도,용인시기흥구,상하동,상하동제4투,3092,2184,911,501,507,124,130,2,0,1,1,1,0,0,2,2180,4,908
경기도,용인시기흥구,상하동,상하동제5투,2017,1593,656,319,391,135,79,3,0,0,1,1,1,1,2,1589,4,424
경기도,용인시기흥구,보정동,합계,24769,20267,7934,5372,4262,1556,1046,27,0,5,4,3,1,7,7,20224,43,4502
경기도,용인시기흥구,보정동,관내사전투표,4208,4208,2007,837,755,334,258,4,0,2,0,0,1,2,1,4201,7,0
경기도,용인시기흥구,보정동,보정동제1투,3567,2516,1036,550,567,217,137,3,0,1,1,1,0,0,1,2514,2,1051
경기도,용인시기흥구,보정동,보정동제2투,3430,2767,619,1241,605,185,98,9,0,0,0,0,0,2,0,2759,8,663
경기도,용인시기흥구,보정동,보정동제3투,3992,3196,1191,912,658,236,184,3,0,0,1,1,0,1,0,3187,9,796
경기도,용인시기흥구,보정동,보정동제4투,3037,2400,946,606,527,199,107,3,0,0,1,0,0,1,1,2391,9,637
경기도,용인시기흥구,보정동,보정동제5투,2522,1987,706,572,460,145,95,2,0,2,0,0,0,0,2,1984,3,535
경기도,용인시기흥구,보정동,보정동제6투,2675,2206,1066,371,464,173,124,3,0,0,0,1,0,0,2,2204,2,469
경기도,용인시기흥구,보정동,보정동제7투,1338,987,363,283,226,67,43,0,0,0,1,0,0,1,0,984,3,351
경기도,용인시기흥구,잘못 투입·구분된 투표지,,0,0,0,0,0,0,0,0,0,0,0,0,0,0,0,0,0,0
경기도,안성시,합계,,148171,106490,39380,26693,25193,6427,7651,158,36,94,33,137,38,65,114,106019,471,41681
경기도,안성시,거소·선상투표,,221,209,65,32,66,20,9,2,2,1,0,0,0,1,1,199,10,12
경기도,안성시,관외사전투표,,10978,10978,4769,1835,2357,903,964,15,8,10,2,13,6,7,20,10909,69,0
경기도,안성시,재외투표,,675,507,310,42,69,17,65,2,0,0,0,0,0,1,0,506,1,168
경기도,안성시,공도읍,합계,38122,26649,11228,5080,6363,1700,2043,37,4,22,6,29,9,7,27,26555,94,11473
경기도,안성시,공도읍,관내사전투표,5264,5264,2593,803,1058,344,421,4,0,6,2,8,2,1,6,5248,16,0
경기도,안성시,공도읍,공도읍제1투,1870,1095,268,464,255,42,48,0,1,0,1,4,0,2,2,1087,8,775
경기도,안성시,공도읍,공도읍제2투,1927,1242,501,247,332,69,86,0,0,1,0,0,1,0,2,1239,3,685
경기도,안성시,공도읍,공도읍제3투,2159,1333,515,349,317,63,79,2,0,1,0,0,0,1,0,1327,6,826
경기도,안성시,공도읍,공도읍제4투,3866,2164,811,467,552,127,185,6,0,1,2,1,1,1,3,2157,7,1702
경기도,안성시,공도읍,공도읍제5투,3471,2438,983,448,585,202,196,8,1,3,0,1,0,0,1,2428,10,1033
경기도,안성시,공도읍,공도읍제6투,2941,1909,795,344,482,113,158,1,0,2,1,1,0,0,3,1900,9,1032
경기도,안성시,공도읍,공도읍제7투,4118,2475,868,583,661,140,195,8,0,3,0,5,2,0,1,2466,9,1643
경기도,안성시,공도읍,공도읍제8투,3473,2294,980,385,578,159,176,3,0,3,0,2,0,0,2,2288,6,1179
경기도,안성시,공도읍,공도읍제9투,1932,1348,577,229,340,95,92,1,0,2,0,2,0,2,3,1343,5,584
경기도,안성시,공도읍,공도읍제10투,3211,2164,929,348,545,149,175,3,1,0,0,1,2,0,1,2154,10,1047
경기도,안성시,공도읍,공도읍제11투,3890,2923,1408,413,658,197,232,1,1,0,0,4,1,0,3,2918,5,967
경기도,안성시,보개면,합계,5011,3514,1030,1198,842,197,205,5,0,5,2,9,1,6,2,3502,12,1497
경기도,안성시,보개면,관내사전투표,953,953,388,246,185,67,59,2,0,1,0,1,0,2,0,951,2,0
경기도,안성시,보개면,보개면제1투,1197,696,205,219,189,33,41,1,0,0,0,2,0,2,0,692,4,501
경기도,안성시,보개면,보개면제2투,749,467,110,177,118,26,25,0,0,4,0,4,0,1,0,465,2,282
경기도,안성시,보개면,보개면제3투,1295,867,237,284,227,49,62,2,0,0,2,1,0,1,0,865,2,428
경기도,안성시,보개면,보개면제4투,817,531,90,272,123,22,18,0,0,0,0,1,1,0,2,529,2,286
경기도,안성시,금광면,합계,6243,4410,1664,1158,1004,238,297,9,2,5,0,5,0,4,7,4393,17,1833
경기도,안성시,금광면,관내사전투표,752,752,348,141,154,42,62,1,0,0,0,1,0,0,2,751,1,0
경기도,안성시,금광면,금광면제1투,1303,823,220,280,215,44,46,6,1,2,0,0,0,0,3,817,6,480
경기도,안성시,금광면,금광면제2투,651,441,117,169,110,20,20,1,1,0,0,1,0,0,0,439,2,210
경기도,안성시,금광면,금광면제3투,636,407,120,145,111,13,11,0,0,2,0,1,0,1,2,406,1,229
경기도,안성시,금광면,금광면제4투,545,352,77,135,90,24,18,1,0,0,0,2,0,2,0,349,3,193
경기도,안성시,금광면,금광면제5투,2356,1635,782,288,324,95,140,0,0,1,0,0,0,1,0,1631,4,721
경기도,안성시,서운면,합계,3280,2297,670,816,528,118,140,4,0,1,0,5,0,2,2,2286,11,983
경기도,안성시,서운면,관내사전투표,790,790,307,243,153,32,48,0,0,1,0,3,0,0,1,788,2,0
경기도,안성시,서운면,서운면제1투,1291,725,185,281,161,39,50,1,0,0,0,2,0,0,1,720,5,566
경기도,안성시,서운면,서운면제2투,553,379,66,164,103,20,20,3,0,0,0,0,0,2,0,378,1,174
경기도,안성시,서운면,서운면제3투,646,403,112,128,111,27,22,0,0,0,0,0,0,0,0,400,3,243
경기도,안성시,미양면,합계,5429,3596,1179,1098,858,166,233,9,4,3,3,6,7,5,2,3573,23,1833
경기도,안성시,미양면,관내사전투표,842,842,348,200,176,39,62,0,3,1,2,3,3,0,1,838,4,0
경기도,안성시,미양면,미양면제1투,1538,930,267,330,223,42,53,4,0,0,0,0,1,4,0,924,6,608
경기도,안성시,미양면,미양면제2투,1977,1167,421,311,283,59,78,1,0,0,1,3,1,1,1,1160,7,810
경기도,안성시,미양면,미양면제3투,1072,657,143,257,176,26,40,4,1,2,0,0,2,0,0,651,6,415
경기도,안성시,대덕면,합계,12378,8005,3095,1818,1938,497,590,17,3,3,2,8,1,6,7,7985,20,4373
경기도,안성시,대덕면,관내사전투표,1947,1947,895,350,429,116,142,6,1,1,1,1,0,1,0,1943,4,0
경기도,안성시,대덕면,대덕면제1투,1644,894,252,320,232,32,54,0,0,1,0,0,0,0,0,891,3,750
경기도,안성시,대덕면,대덕면제2투,1524,971,293,290,262,59,54,1,1,0,0,1,1,3,0,965,6,553
경기도,안성시,대덕면,대덕면제3투,3579,1534,546,408,383,86,99,3,0,0,0,2,0,1,4,1532,2,2045
경기도,안성시,대덕면,대덕면제4투,3684,2659,1109,450,632,204,241,7,1,1,1,4,0,1,3,2654,5,1025
경기도,안성시,양성면,합계,4551,3092,778,1179,776,145,164,4,1,5,3,6,3,2,4,3070,22,1459
경기도,안성시,양성면,관내사전투표,818,818,252,278,190,42,48,0,0,2,0,1,1,1,2,817,1,0
경기도,안성시,양성면,양성면제1투,1450,843,219,319,202,40,52,2,0,0,2,1,0,1,0,838,5,607
경기도,안성시,양성면,양성면제2투,1000,676,125,278,189,40,37,0,0,1,0,0,0,0,0,670,6,324
경기도,안성시,양성면,양성면제3투,1283,755,182,304,195,23,27,2,1,2,1,4,2,0,2,745,10,528
경기도,안성시,원곡면,합계,3825,2600,806,848,637,153,128,3,0,3,0,2,2,3,3,2588,12,1225
경기도,안성시,원곡면,관내사전투표,551,551,201,168,104,39,29,1,0,3,0,1,0,0,1,547,4,0
경기도,안성시,원곡면,원곡면제1투,1771,1038,258,373,287,58,53,1,0,0,0,1,1,0,1,1033,5,733
경기도,안성시,원곡면,원곡면제2투,912,610,262,129,150,35,32,0,0,0,0,0,0,1,1,610,0,302
경기도,안성시,원곡면,원곡면제3투,591,401,85,178,96,21,14,1,0,0,0,0,1,2,0,398,3,190
경기도,안성시,일죽면,합계,6450,4339,1212,1568,1103,213,190,7,2,6,2,1,3,4,5,4316,23,2111
경기도,안성시,일죽면,관내사전투표,999,999,337,306,234,60,50,3,0,1,0,1,0,1,1,994,5,0
경기도,안성시,일죽면,일죽면제1투,1655,989,298,331,248,53,49,0,0,3,1,0,2,0,2,987,2,666
경기도,안성시,일죽면,일죽면제2투,1441,871,246,328,200,35,50,2,2,2,0,0,0,1,0,866,5,570
경기도,안성시,일죽면,일죽면제3투,1407,879,216,350,232,43,25,2,0,0,1,0,1,2,1,873,6,528
경기도,안성시,일죽면,일죽면제4투,948,601,115,253,189,22,16,0,0,0,0,0,0,0,1,596,5,347
경기도,안성시,죽산면,합계,6075,4103,1152,1466,1012,187,226,9,1,3,3,4,1,7,1,4072,31,1972
경기도,안성시,죽산면,관내사전투표,1290,1290,434,399,265,60,102,6,0,2,2,2,0,2,1,1275,15,0
경기도,안성시,죽산면,죽산면제1투,2515,1538,377,618,385,72,66,2,1,1,1,1,1,2,0,1527,11,977
경기도,안성시,죽산면,죽산면제2투,1511,834,238,294,223,38,33,1,0,0,0,0,0,3,0,830,4,677
경기도,안성시,죽산면,죽산면제3투,759,441,103,155,139,17,25,0,0,0,0,1,0,0,0,440,1,318
경기도,안성시,삼죽면,합계,2931,1986,581,672,492,117,102,3,0,4,0,3,0,0,2,1976,10,945
경기도,안성시,삼죽면,관내사전투표,528,528,220,142,99,34,26,1,0,0,0,3,0,0,1,526,2,0
경기도,안성시,삼죽면,삼죽면제1투,1513,915,214,356,247,47,43,0,0,3,0,0,0,0,1,911,4,598
경기도,안성시,삼죽면,삼죽면제2투,890,543,147,174,146,36,33,2,0,1,0,0,0,0,0,539,4,347
경기도,안성시,고삼면,관내사전투표,548,548,213,134,131,31,30,1,0,0,1,3,1,1,0,546,2,0
경기도,안성시,고삼면,합계,1968,1484,484,464,364,72,77,2,0,3,1,3,2,2,3,1477,7,484
경기도,안성시,고삼면,고삼면제1투,946,624,165,228,160,29,33,0,0,3,0,0,0,1,2,621,3,322
경기도,안성시,고삼면,고삼면제2투,474,312,106,102,73,12,14,1,0,0,0,0,1,0,1,310,2,162
경기도,안성시,안성1동,합계,10305,7469,2464,2282,1716,397,520,13,2,8,4,14,0,3,8,7431,38,2836
경기도,안성시,안성1동,관내사전투표,2447,2447,950,651,484,137,200,1,0,2,1,5,0,0,3,2434,13,0
경기도,안성시,안성1동,안성1동제1투,1644,1030,293,340,263,53,71,3,0,1,0,0,0,0,2,1026,4,614
경기도,안성시,안성1동,안성1동제2투,2043,1412,454,420,346,83,91,3,1,1,2,5,0,0,1,1407,5,631
경기도,안성시,안성1동,안성1동제3투,2416,1510,470,502,358,64,92,5,0,3,0,3,0,1,1,1499,11,906
경기도,안성시,안성1동,안성1동제4투,1755,1070,297,369,265,60,66,1,1,1,1,1,0,2,1,1065,5,685
경기도,안성시,안성2동,관내사전투표,2915,2915,1271,570,619,164,263,2,0,1,0,8,1,0,2,2901,14,0
경기도,안성시,안성2동,합계,14348,9991,3769,2357,2389,591,799,10,2,6,4,15,3,2,7,9954,37,4357
경기도,안성시,안성2동,안성2동제1투,3280,1991,639,592,491,113,140,3,0,0,0,3,1,0,1,1983,8,1289
경기도,안성시,안성2동,안성2동제2투,3979,2236,783,555,566,130,182,0,2,4,2,1,0,1,3,2229,7,1743
경기도,안성시,안성2동,안성2동제3투,3411,2330,897,498,590,152,177,5,0,1,1,3,1,0,1,2326,4,1081
경기도,안성시,안성2동,안성2동제4투,763,519,179,142,123,32,37,0,0,0,1,0,0,1,0,515,4,244
경기도,안성시,안성3동,관내사전투표,2878,2878,1294,496,590,190,281,1,1,1,1,5,0,0,2,2862,16,0
경기도,안성시,안성3동,합계,15381,11261,4124,2780,2679,696,899,7,5,6,1,14,0,3,13,11227,34,4120
경기도,안성시,안성3동,안성3동제1투,1554,1029,333,284,254,63,86,0,0,2,0,1,0,2,3,1028,1,525
경기도,안성시,안성3동,안성3동제2투,1597,1144,418,263,289,77,94,0,0,0,0,2,0,0,0,1143,1,453
경기도,안성시,안성3동,안성3동제3투,1440,970,276,334,254,50,49,2,0,0,0,0,0,0,0,965,5,470
경기도,안성시,안성3동,안성3동제4투,2300,1500,479,449,387,68,103,2,1,0,0,1,0,0,1,1491,9,800
경기도,안성시,안성3동,안성3동제5투,2548,1699,633,399,417,115,128,0,1,3,0,2,0,0,1,1699,0,849
경기도,안성시,안성3동,안성3동제6투,1383,840,253,263,210,47,63,1,1,0,0,0,0,0,1,839,1,543
경기도,안성시,안성3동,안성3동제7투,1681,1201,438,292,278,86,95,1,1,0,0,3,0,1,5,1200,1,480
경기도,안성시,잘못 투입·구분된 투표지,,0,0,0,0,0,0,0,0,0,0,0,0,0,0,0,0,0,0
경기도,김포시,합계,,290415,225075,93697,48490,51081,15614,14517,309,41,131,53,152,58,69,160,224372,703,65340
경기도,김포시,거소·선상투표,,397,368,126,65,110,26,15,0,1,0,0,0,2,2,1,348,20,29
경기도,김포시,관외사전투표,,23246,23240,10522,3961,4946,1723,1830,36,12,11,11,18,8,8,31,23117,123,6
경기도,김포시,재외투표,,1994,1570,942,118,239,67,192,7,0,0,0,0,0,0,0,1565,5,424
경기도,김포시,통진읍,합계,20753,13620,4386,4088,3276,874,854,17,7,11,4,6,4,6,15,13548,72,7133
경기도,김포시,통진읍,관내사전투표,3298,3298,1248,827,703,221,245,5,5,6,3,1,1,4,6,3275,23,0
경기도,김포시,통진읍,통진읍제1투,1981,1419,455,458,336,79,82,1,0,1,0,0,0,1,2,1415,4,562
경기도,김포시,통진읍,통진읍제2투,1574,885,242,305,222,58,54,0,0,0,0,0,0,0,0,881,4,689
경기도,김포시,통진읍,통진읍제3투,3032,1861,580,563,464,130,103,3,0,3,0,2,0,0,2,1850,11,1171
경기도,김포시,통진읍,통진읍제4투,1376,889,207,372,206,52,46,1,0,1,0,0,0,0,0,885,4,487
경기도,김포시,통진읍,통진읍제5투,1743,1066,294,353,270,65,71,2,0,0,0,0,1,0,2,1058,8,677
경기도,김포시,통진읍,통진읍제6투,2744,1621,437,535,434,102,99,2,0,0,1,3,1,0,1,1615,6,1123
경기도,김포시,통진읍,통진읍제7투,1808,913,283,288,220,57,55,2,1,0,0,0,0,1,0,907,6,895
경기도,김포시,통진읍,통진읍제8투,3197,1668,640,387,421,110,99,1,1,0,0,0,1,0,2,1662,6,1529
경기도,김포시,고촌읍,합계,19040,14850,5682,3950,3160,1096,879,18,2,4,3,7,4,5,9,14819,31,4190
경기도,김포시,고촌읍,관내사전투표,4043,4043,1770,950,756,293,247,3,1,2,1,2,2,0,2,4029,14,0
경기도,김포시,고촌읍,고촌읍제1투,2377,1676,592,494,376,113,98,0,0,0,0,0,0,0,0,1673,3,701
경기도,김포시,고촌읍,고촌읍제2투,1504,1013,237,444,223,59,45,1,1,1,0,0,0,0,1,1012,1,491
경기도,김포시,고촌읍,고촌읍제3투,3486,2582,964,689,563,200,148,5,0,0,0,0,0,3,3,2575,7,904
경기도,김포시,고촌읍,고촌읍제4투,3054,1930,696,528,461,123,108,2,0,1,1,3,0,2,1,1926,4,1124
경기도,김포시,고촌읍,고촌읍제5투,2176,1697,721,379,369,131,89,1,0,0,1,2,2,0,0,1695,2,479
경기도,김포시,고촌읍,고촌읍제6투,2400,1909,702,466,412,177,144,6,0,0,0,0,0,0,2,1909,0,491
경기도,김포시,양촌읍,합계,19826,13207,4835,3458,3261,779,765,13,3,19,7,10,3,5,13,13171,36,6619
경기도,김포시,양촌읍,관내사전투표,3348,3348,1348,804,759,198,207,2,1,5,4,4,1,0,4,3337,11,0
경기도,김포시,양촌읍,양촌읍제1투,4049,2047,656,636,528,99,118,1,0,2,0,1,1,1,2,2045,2,2002
경기도,김포시,양촌읍,양촌읍제2투,2099,1325,437,370,359,73,72,4,1,3,0,1,1,0,2,1323,2,774
경기도,김포시,양촌읍,양촌읍제3투,1104,697,180,245,190,44,32,0,1,1,1,2,0,1,0,697,0,407
경기도,김포시,양촌읍,양촌읍제4투,3091,1950,753,412,530,122,118,2,0,4,1,0,0,0,2,1944,6,1141
경기도,김포시,양촌읍,양촌읍제5투,451,283,81,114,71,5,11,0,0,0,0,0,0,0,0,282,1,168
경기도,김포시,양촌읍,양촌읍제6투,261,171,40,63,38,14,13,1,0,0,0,0,0,1,0,170,1,90
경기도,김포시,양촌읍,양촌읍제7투,769,492,121,189,121,29,25,0,0,2,0,1,0,2,0,490,2,277
경기도,김포시,양촌읍,양촌읍제8투,2728,1661,695,342,389,115,106,2,0,1,1,1,0,0,1,1653,8,1067
경기도,김포시,양촌읍,양촌읍제9투,1926,1233,524,283,276,80,63,1,0,1,0,0,0,0,2,1230,3,693
경기도,김포시,대곶면,합계,8212,5249,1430,1882,1305,312,257,11,2,6,4,3,2,4,6,5224,25,2963
경기도,김포시,대곶면,관내사전투표,1180,1180,408,361,265,66,67,1,0,2,2,1,2,1,4,1180,0,0
경기도,김포시,대곶면,대곶면제1투,2514,1360,350,484,372,74,63,3,0,0,1,0,0,2,0,1349,11,1154
경기도,김포시,대곶면,대곶면제2투,1661,1015,257,401,231,64,48,0,1,2,1,1,0,0,1,1007,8,646
경기도,김포시,대곶면,대곶면제3투,1021,606,152,218,149,36,42,4,1,0,0,0,0,1,0,603,3,415
경기도,김포시,대곶면,대곶면제4투,852,499,135,184,123,28,25,2,0,0,0,0,0,0,0,497,2,353
경기도,김포시,대곶면,대곶면제5투,984,589,128,234,165,44,12,1,0,2,0,1,0,0,1,588,1,395
경기도,김포시,월곶면,합계,4963,3320,873,1248,754,223,160,9,3,5,3,6,1,2,8,3295,25,1643
경기도,김포시,월곶면,관내사전투표,1029,1029,336,329,220,68,54,2,0,2,1,4,0,0,4,1020,9,0
경기도,김포시,월곶면,월곶면제1투,1104,610,146,228,168,37,20,3,2,1,0,0,0,0,1,606,4,494
경기도,김포시,월곶면,월곶면제2투,489,324,73,132,70,19,20,0,0,0,2,1,0,1,1,319,5,165
경기도,김포시,월곶면,월곶면제3투,497,304,50,151,62,24,15,0,0,0,0,0,0,0,0,302,2,193
경기도,김포시,월곶면,월곶면제4투,1844,1053,268,408,234,75,51,4,1,2,0,1,1,1,2,1048,5,791
경기도,김포시,하성면,합계,7277,4875,1298,1814,1212,249,259,3,0,4,2,3,4,5,5,4858,17,2402
경기도,김포시,하성면,관내사전투표,1446,1446,461,450,356,88,76,0,0,2,0,2,1,0,3,1439,7,0
경기도,김포시,하성면,하성면제1투,2256,1215,324,439,294,61,87,2,0,0,1,1,1,1,1,1212,3,1041
경기도,김포시,하성면,하성면제2투,1005,656,152,264,185,31,21,0,0,0,0,0,1,1,0,655,1,349
경기도,김포시,하성면,하성면제3투,932,558,143,240,125,20,23,1,0,0,1,0,1,1,1,556,2,374
경기도,김포시,하성면,하성면제4투,1098,661,135,286,169,26,40,0,0,2,0,0,0,1,0,659,2,437
경기도,김포시,하성면,하성면제5투,540,339,83,135,83,23,12,0,0,0,0,0,0,1,0,337,2,201
경기도,김포시,김포본동,합계,36092,27327,10731,6272,6429,1903,1806,40,0,15,3,23,5,8,10,27245,82,8765
경기도,김포시,김포본동,관내사전투표,4820,4820,2037,1134,974,321,323,6,0,1,2,2,0,2,4,4806,14,0
경기도,김포시,김포본동,김포본동제1투,2713,1606,584,404,414,82,113,3,0,0,0,2,1,0,0,1603,3,1107
경기도,김포시,김포본동,김포본동제2투,1052,736,270,192,184,47,38,0,0,2,0,0,0,0,1,734,2,316
경기도,김포시,김포본동,김포본동제3투,1311,750,238,259,169,49,29,1,0,1,0,2,0,0,0,748,2,561
경기도,김포시,김포본동,김포본동제4투,1793,1126,384,307,272,88,65,1,0,3,0,2,0,1,1,1124,2,667
경기도,김포시,김포본동,김포본동제5투,2735,2046,754,487,480,162,148,1,0,2,0,3,0,0,1,2038,8,689
경기도,김포시,김포본동,김포본동제6투,2575,1863,689,459,457,125,113,4,0,0,0,4,1,0,1,1853,10,712
경기도,김포시,김포본동,김포본동제7투,2349,1699,631,386,449,95,121,2,0,1,0,4,1,2,0,1692,7,650
경기도,김포시,김포본동,김포본동제8투,1403,1060,444,215,261,64,72,0,0,2,0,0,1,1,0,1060,0,343
경기도,김포시,김포본동,김포본동제9투,2880,2124,811,507,503,142,146,7,0,0,0,0,1,1,0,2118,6,756
경기도,김포시,김포본동,김포본동제10투,3377,2643,1095,549,603,200,178,3,0,2,0,2,0,1,0,2633,10,734
경기도,김포시,김포본동,김포본동제11투,3042,2379,978,479,575,172,164,4,0,1,0,1,0,0,1,2375,4,663
경기도,김포시,김포본동,김포본동제12투,4010,2883,1098,652,704,221,192,6,0,0,0,1,0,0,1,2875,8,1127
경기도,김포시,김포본동,김포본동제13투,2032,1592,718,242,384,135,104,2,0,0,1,0,0,0,0,1586,6,440
경기도,김포시,장기본동,합계,23154,18206,8234,3355,4046,1350,1125,23,1,4,0,6,6,2,15,18167,39,4948
경기도,김포시,장기본동,관내사전투표,4286,4286,1986,832,905,278,259,5,0,2,0,1,1,1,3,4273,13,0
경기도,김포시,장기본동,장기본동제1투,2380,1783,575,554,421,141,84,3,0,0,0,0,0,0,2,1780,3,597
경기도,김포시,장기본동,장기본동제2투,3008,1978,713,492,479,162,112,6,1,0,0,4,0,0,1,1970,8,1030
경기도,김포시,장기본동,장기본동제3투,1543,1079,450,210,268,76,70,0,0,0,0,0,2,0,1,1077,2,464
경기도,김포시,장기본동,장기본동제4투,3267,2381,1184,302,530,199,155,3,0,0,0,0,1,1,4,2379,2,886
경기도,김포시,장기본동,장기본동제5투,2482,1915,987,261,407,131,121,1,0,1,0,0,1,0,2,1912,3,567
경기도,김포시,장기본동,장기본동제6투,3219,2518,1305,330,502,205,171,0,0,1,0,0,0,0,1,2515,3,701
경기도,김포시,장기본동,장기본동제7투,2969,2266,1034,374,534,158,153,5,0,0,0,1,1,0,1,2261,5,703
경기도,김포시,사우동,합계,18770,14286,5853,3009,3225,1034,1036,16,1,8,4,22,2,4,11,14225,61,4484
경기도,김포시,사우동,관내사전투표,5945,5944,2620,1068,1257,466,482,8,1,2,1,13,1,1,4,5924,20,1
경기도,김포시,사우동,사우동제1투,2740,1436,544,374,312,88,101,2,0,1,3,3,0,1,1,1430,6,1304
경기도,김포시,사우동,사우동제2투,2384,1417,523,334,372,71,105,0,0,1,0,2,1,1,1,1411,6,967
경기도,김포시,사우동,사우동제3투,3126,2389,957,543,534,180,158,2,0,2,0,2,0,0,3,2381,8,737
경기도,김포시,사우동,사우동제4투,1645,1027,388,247,256,71,54,0,0,1,0,0,0,1,1,1019,8,618
경기도,김포시,사우동,사우동제5투,2930,2073,821,443,494,158,136,4,0,1,0,2,0,0,1,2060,13,857
경기도,김포시,풍무동,합계,35496,28573,12379,5765,6468,1953,1823,52,3,13,7,27,2,10,9,28511,62,6923
경기도,김포시,풍무동,관내사전투표,6235,6235,3068,1047,1208,414,462,10,0,2,2,8,1,1,1,6224,11,0
경기도,김포시,풍무동,풍무동제1투,2542,1749,749,372,407,116,93,5,2,1,0,0,0,0,1,1746,3,793
경기도,김포시,풍무동,풍무동제2투,1546,1101,368,321,279,70,55,3,0,1,0,2,0,0,1,1100,1,445
경기도,김포시,풍무동,풍무동제3투,2936,2215,800,600,505,159,135,7,0,2,0,0,0,0,1,2209,6,721
경기도,김포시,풍무동,풍무동제4투,2395,1753,739,346,439,113,109,0,0,1,1,2,0,2,1,1753,0,642
경기도,김포시,풍무동,풍무동제5투,2487,1961,778,453,436,136,140,4,0,2,1,2,1,1,1,1955,6,526
경기도,김포시,풍무동,풍무동제6투,2494,1876,722,394,491,125,128,1,0,1,0,3,0,2,1,1868,8,618
경기도,김포시,풍무동,풍무동제7투,3357,2645,1179,527,592,148,170,5,1,1,2,7,0,1,1,2634,11,712
경기도,김포시,풍무동,풍무동제8투,2720,2027,798,522,450,131,117,3,0,0,1,0,0,0,0,2022,5,693
경기도,김포시,풍무동,풍무동제9투,2885,2203,1055,326,481,170,155,5,0,0,0,2,0,2,1,2197,6,682
경기도,김포시,풍무동,풍무동제10투,1271,945,316,259,259,69,38,1,0,1,0,0,0,1,0,944,1,326
경기도,김포시,풍무동,풍무동제11투,4628,3863,1807,598,921,302,221,8,0,1,0,1,0,0,0,3859,4,765
경기도,김포시,장기동,합계,30708,24247,11296,4225,5298,1766,1541,25,3,14,0,7,4,2,12,24193,54,6461
경기도,김포시,장기동,관내사전투표,6265,6265,3212,970,1153,457,438,7,1,2,0,3,0,2,5,6250,15,0
경기도,김포시,장기동,장기동제1투,3100,2290,1064,388,514,146,161,4,0,7,0,1,0,0,0,2285,5,810
경기도,김포시,장기동,장기동제2투,2882,2197,939,430,534,168,117,3,0,0,0,0,0,0,1,2192,5,685
경기도,김포시,장기동,장기동제3투,2403,1489,559,395,351,89,81,1,0,1,0,1,2,0,2,1482,7,914
경기도,김포시,장기동,장기동제4투,2600,2085,975,340,451,166,143,1,1,1,0,1,1,0,1,2081,4,515
경기도,김포시,장기동,장기동제5투,3550,2680,1102,590,599,197,182,3,0,0,0,0,0,0,1,2674,6,870
경기도,김포시,장기동,장기동제6투,3259,1943,844,403,460,118,110,2,0,1,0,0,0,0,2,1940,3,1316
경기도,김포시,장기동,장기동제7투,2158,1657,756,283,374,135,103,0,0,1,0,1,1,0,0,1654,3,501
경기도,김포시,장기동,장기동제8투,2258,1819,921,214,432,147,99,1,1,0,0,0,0,0,0,1815,4,439
경기도,김포시,장기동,장기동제9투,2233,1822,924,212,430,143,107,3,0,1,0,0,0,0,0,1820,2,411
경기도,김포시,구래동,합계,23418,18019,8482,3006,4133,1141,1163,23,2,13,4,7,8,2,8,17992,27,5399
경기도,김포시,구래동,관내사전투표,4309,4308,2283,594,842,266,300,5,0,1,2,1,2,0,2,4298,10,1
경기도,김포시,구래동,구래동제1투,1817,1294,516,228,344,116,84,1,0,1,0,1,1,0,0,1292,2,523
경기도,김포시,구래동,구래동제2투,3598,2519,1124,415,627,177,166,3,0,0,0,0,0,1,1,2514,5,1079
경기도,김포시,구래동,구래동제3투,2692,1821,739,416,459,88,102,4,0,3,2,2,1,0,1,1817,4,871
경기도,김포시,구래동,구래동제4투,2448,1869,895,289,455,100,119,7,0,1,0,1,1,0,0,1868,1,579
경기도,김포시,구래동,구래동제5투,2778,2154,1126,292,446,144,144,0,0,0,0,0,0,0,2,2154,0,624
경기도,김포시,구래동,구래동제6투,3566,2564,1248,353,622,166,162,2,2,4,0,2,1,0,1,2563,1,1002
경기도,김포시,구래동,구래동제7투,2210,1490,551,419,338,84,86,1,0,3,0,0,2,1,1,1486,4,720
경기도,김포시,운양동,합계,17069,14118,6628,2274,3219,1118,812,16,1,4,1,7,3,4,7,14094,24,2951
경기도,김포시,운양동,관내사전투표,4367,4367,2181,653,854,363,293,3,1,1,0,2,1,1,3,4356,11,0
경기도,김포시,운양동,운양동제1투,1282,947,384,212,228,72,48,1,0,0,0,1,0,0,0,946,1,335
경기도,김포시,운양동,운양동제2투,1274,801,343,177,177,50,49,1,0,0,0,1,0,1,0,799,2,473
경기도,김포시,운양동,운양동제3투,3566,2672,1152,518,648,200,138,5,0,1,1,3,0,1,1,2668,4,894
경기도,김포시,운양동,운양동제4투,1963,1566,794,167,387,123,90,0,0,0,0,0,0,1,1,1563,3,397
경기도,김포시,운양동,운양동제5투,1945,1587,739,234,395,133,82,1,0,1,0,0,2,0,0,1587,0,358
경기도,김포시,운양동,운양동제6투,2672,2178,1035,313,530,177,112,5,0,1,0,0,0,0,2,2175,3,494
경기도,김포시,잘못 투입·구분된 투표지,,0,0,0,0,0,0,0,0,0,0,0,0,0,0,0,0,0,0
경기도,광주시,합계,,268162,199221,80175,45030,46829,12629,12860,274,36,101,44,181,68,61,219,198507,714,68941
경기도,광주시,거소·선상투표,,484,458,166,64,114,30,12,6,2,1,2,1,2,6,4,410,48,26
경기도,광주시,관외사전투표,,27677,27677,12856,4557,5693,2085,2190,33,5,16,6,30,13,8,49,27541,136,0
경기도,광주시,재외투표,,1648,1303,818,81,202,57,134,5,0,0,0,1,1,0,1,1300,3,345
경기도,광주시,오포읍,합계,65037,46641,19572,9798,10917,3141,2908,60,8,18,12,36,7,13,42,46532,109,18396
경기도,광주시,오포읍,관내사전투표,6281,6281,3046,1093,1314,386,409,8,0,4,2,3,2,0,6,6273,8,0
경기도,광주시,오포읍,오포읍제1투,1589,1100,406,263,276,79,68,2,0,1,0,1,0,0,3,1099,1,489
경기도,광주시,오포읍,오포읍제2투,4447,3104,1244,619,801,213,203,3,2,0,2,4,2,2,4,3099,5,1343
경기도,광주시,오포읍,오포읍제3투,2980,1933,794,425,441,146,117,2,0,0,0,4,0,0,0,1929,4,1047
경기도,광주시,오포읍,오포읍제4투,2094,1488,577,316,395,85,100,3,1,1,0,1,0,2,2,1483,5,606
경기도,광주시,오포읍,오포읍제5투,3185,2121,744,528,572,134,125,2,0,3,1,1,0,2,2,2114,7,1064
경기도,광주시,오포읍,오포읍제6투,4320,2930,1274,621,653,188,175,3,0,2,1,0,0,0,2,2919,11,1390
경기도,광주시,오포읍,오포읍제7투,2678,1867,796,359,438,154,110,3,0,0,0,1,0,0,2,1863,4,811
경기도,광주시,오포읍,오포읍제8투,3584,2670,1192,483,610,189,188,1,0,0,0,3,0,0,2,2668,2,914
경기도,광주시,오포읍,오포읍제9투,4096,2891,1152,709,624,193,196,10,0,0,1,3,0,0,1,2889,2,1205
경기도,광주시,오포읍,오포읍제10투,4700,3063,1090,801,782,176,186,6,2,1,2,1,1,1,2,3051,12,1637
경기도,광주시,오포읍,오포읍제11투,6368,4312,1995,752,954,319,261,5,1,0,0,4,1,3,3,4298,14,2056
경기도,광주시,오포읍,오포읍제12투,2389,1779,727,392,457,108,84,4,0,1,0,2,0,1,1,1777,2,610
경기도,광주시,오포읍,오포읍제13투,2371,1809,787,325,445,111,121,4,0,1,0,3,0,1,4,1802,7,562
경기도,광주시,오포읍,오포읍제14투,3283,1947,652,545,500,122,117,0,0,2,1,2,0,1,0,1942,5,1336
경기도,광주시,오포읍,오포읍제15투,4051,2778,1161,608,621,202,162,1,2,2,1,2,1,0,5,2768,10,1273
경기도,광주시,오포읍,오포읍제16투,4458,2994,1297,584,688,218,195,1,0,0,1,1,0,0,2,2987,7,1464
경기도,광주시,오포읍,오포읍제17투,2163,1574,638,375,346,118,91,2,0,0,0,0,0,0,1,1571,3,589
경기도,광주시,초월읍,합계,30274,21990,8570,5294,5333,1287,1335,40,7,14,5,14,6,7,22,21934,56,8284
경기도,광주시,초월읍,관내사전투표,5011,5011,2319,912,1105,298,338,13,1,2,1,3,1,1,6,5000,11,0
경기도,광주시,초월읍,초월읍제1투,4099,2587,923,679,680,137,148,3,1,1,1,2,3,2,3,2583,4,1512
경기도,광주시,초월읍,초월읍제2투,2620,1904,793,382,474,120,122,3,1,1,0,0,0,0,1,1897,7,716
경기도,광주시,초월읍,초월읍제3투,2722,1929,735,445,504,125,108,2,0,0,0,1,0,1,1,1922,7,793
경기도,광주시,초월읍,초월읍제4투,4349,3009,1138,713,747,193,191,12,1,2,0,3,0,1,2,3003,6,1340
경기도,광주시,초월읍,초월읍제5투,2527,1537,457,565,356,70,76,0,0,5,0,0,0,1,2,1532,5,990
경기도,광주시,초월읍,초월읍제6투,3587,2243,805,639,520,138,120,2,1,3,2,2,1,0,3,2236,7,1344
경기도,광주시,초월읍,초월읍제7투,1700,1078,281,414,257,58,64,0,0,0,0,2,1,0,0,1077,1,622
경기도,광주시,초월읍,초월읍제8투,3659,2692,1119,545,690,148,168,5,2,0,1,1,0,1,4,2684,8,967
경기도,광주시,곤지암읍,합계,17938,12179,4143,3549,2900,733,711,27,1,10,6,5,7,5,17,12114,65,5759
경기도,광주시,곤지암읍,관내사전투표,2875,2875,1192,659,614,177,209,5,0,4,3,0,1,0,2,2866,9,0
경기도,광주시,곤지암읍,곤지암읍제1투,3430,2180,768,562,559,142,123,5,0,0,0,2,2,1,6,2170,10,1250
경기도,광주시,곤지암읍,곤지암읍제2투,3294,1846,559,608,458,111,90,5,0,2,0,0,0,0,5,1838,8,1448
경기도,광주시,곤지암읍,곤지암읍제3투,2068,1291,318,511,314,68,64,4,0,1,1,1,1,0,1,1284,7,777
경기도,광주시,곤지암읍,곤지암읍제4투,2203,1362,321,595,291,61,58,6,1,2,2,1,3,3,0,1344,18,841
경기도,광주시,곤지암읍,곤지암읍제5투,4068,2625,985,614,664,174,167,2,0,1,0,1,0,1,3,2612,13,1443
경기도,광주시,도척면,관내사전투표,1214,1214,485,302,291,65,58,5,0,0,0,1,0,0,1,1208,6,0
경기도,광주시,도척면,합계,7060,4940,1593,1577,1212,264,243,10,2,1,1,3,3,1,5,4915,25,2120
경기도,광주시,도척면,도척면제1투,2647,1649,545,502,417,79,87,4,1,1,0,0,2,1,4,1643,6,998
경기도,광주시,도척면,도척면제2투,1957,1289,374,415,342,86,63,1,1,0,1,0,1,0,0,1284,5,668
경기도,광주시,도척면,도척면제3투,1242,788,189,358,162,34,35,0,0,0,0,2,0,0,0,780,8,454
경기도,광주시,퇴촌면,합계,10375,7333,2335,2399,1820,358,362,10,2,3,1,8,1,5,6,7310,23,3042
경기도,광주시,퇴촌면,관내사전투표,1734,1734,665,462,407,90,97,2,0,1,0,3,0,1,1,1729,5,0
경기도,광주시,퇴촌면,퇴촌면제1투,2740,1758,496,635,454,71,86,4,1,0,1,1,0,1,2,1752,6,982
경기도,광주시,퇴촌면,퇴촌면제2투,2706,1753,572,558,455,66,88,1,0,2,0,1,0,3,2,1748,5,953
경기도,광주시,퇴촌면,퇴촌면제3투,3195,2088,602,744,504,131,91,3,1,0,0,3,1,0,1,2081,7,1107
경기도,광주시,남종면,합계,1339,998,211,503,188,45,44,1,0,0,1,0,0,0,1,994,4,341
경기도,광주시,남종면,관내사전투표,241,241,79,77,54,17,14,0,0,0,0,0,0,0,0,241,0,0
경기도,광주시,남종면,남종면제1투,564,384,71,214,72,14,11,0,0,0,0,0,0,0,0,382,2,180
경기도,광주시,남종면,남종면제2투,319,225,30,139,39,6,7,1,0,0,1,0,0,0,1,224,1,94
경기도,광주시,남종면,남종면제3투,215,148,31,73,23,8,12,0,0,0,0,0,0,0,0,147,1,67
경기도,광주시,남한산성면,합계,2316,1745,596,588,379,78,89,4,0,0,0,2,1,0,0,1737,8,571
경기도,광주시,남한산성면,관내사전투표,377,377,178,85,76,14,22,1,0,0,0,0,0,0,0,376,1,0
경기도,광주시,남한산성면,남한산성면제1투,667,422,101,194,85,20,18,1,0,0,0,0,0,0,0,419,3,245
경기도,광주시,남한산성면,남한산성면제2투,654,521,201,150,114,21,30,0,0,0,0,1,1,0,0,518,3,133
경기도,광주시,남한산성면,남한산성면제3투,618,425,116,159,104,23,19,2,0,0,0,1,0,0,0,424,1,193
경기도,광주시,경안동,합계,30007,21143,8256,4719,5158,1425,1406,31,3,12,4,24,9,4,17,21068,75,8864
경기도,광주시,경안동,관내사전투표,4712,4712,2058,892,1030,322,363,4,1,3,0,6,1,1,8,4689,23,0
경기도,광주시,경안동,경안동제1투,1753,1156,381,341,278,70,76,0,0,1,0,2,3,0,1,1153,3,597
경기도,광주시,경안동,경안동제2투,2340,1364,478,342,366,88,76,1,0,1,1,1,2,1,1,1358,6,976
경기도,광주시,경안동,경안동제3투,1472,710,201,264,173,31,34,2,1,0,0,1,0,0,1,708,2,762
경기도,광주시,경안동,경안동제4투,3523,2180,772,511,555,159,157,5,1,3,1,2,1,0,1,2168,12,1343
경기도,광주시,경안동,경안동제5투,5277,3706,1519,750,902,271,233,9,0,2,1,8,2,1,0,3698,8,1571
경기도,광주시,경안동,경안동제6투,4846,2992,1200,646,736,188,201,2,0,1,0,2,0,0,3,2979,13,1854
경기도,광주시,경안동,경안동제7투,3583,2717,1058,639,662,194,152,6,0,0,0,2,0,0,1,2714,3,866
경기도,광주시,경안동,경안동제8투,2501,1606,589,334,456,102,114,2,0,1,1,0,0,1,1,1601,5,895
경기도,광주시,송정동,합계,42269,29887,11544,7010,7253,1888,1954,30,3,22,5,34,14,5,35,29797,90,12382
경기도,광주시,송정동,관내사전투표,5937,5937,2597,1292,1214,361,432,6,1,5,2,10,1,0,4,5925,12,0
경기도,광주시,송정동,송정동제1투,3699,2335,920,462,632,143,160,1,0,1,0,5,0,0,2,2326,9,1364
경기도,광주시,송정동,송정동제2투,3258,2515,886,645,599,199,164,3,0,2,0,2,1,0,3,2504,11,743
경기도,광주시,송정동,송정동제3투,3329,2258,754,641,606,114,125,2,1,5,0,3,0,0,2,2253,5,1071
경기도,광주시,송정동,송정동제4투,2924,1831,609,591,398,121,88,0,0,1,1,1,5,0,6,1821,10,1093
경기도,광주시,송정동,송정동제5투,2487,1611,581,420,384,95,112,4,0,4,0,1,2,1,2,1606,5,876
경기도,광주시,송정동,송정동제6투,4658,2856,1074,695,696,187,180,4,0,0,0,1,0,0,8,2845,11,1802
경기도,광주시,송정동,송정동제7투,5030,3316,1265,717,866,209,232,4,0,0,1,9,3,1,3,3310,6,1714
경기도,광주시,송정동,송정동제8투,3994,2369,883,553,602,154,163,1,1,0,1,0,0,1,3,2362,7,1625
경기도,광주시,송정동,송정동제9투,2133,1624,672,341,420,90,91,0,0,1,0,0,1,2,0,1618,6,509
경기도,광주시,송정동,송정동제10투,1631,1322,549,228,346,101,89,2,0,1,0,1,0,0,2,1319,3,309
경기도,광주시,송정동,송정동제11투,3189,1913,754,425,490,114,118,3,0,2,0,1,1,0,0,1908,5,1276
경기도,광주시,광남동,합계,31738,22927,9515,4891,5660,1238,1472,17,3,4,1,23,4,7,20,22855,72,8811
경기도,광주시,광남동,관내사전투표,4991,4991,2404,878,1083,231,369,5,1,0,0,5,1,2,5,4984,7,0
경기도,광주시,광남동,광남동제1투,2570,1706,618,393,463,106,114,0,0,0,0,1,0,0,2,1697,9,864
경기도,광주시,광남동,광남동제2투,3836,2990,1260,622,723,176,187,3,0,0,0,3,0,1,5,2980,10,846
경기도,광주시,광남동,광남동제3투,4117,2572,965,628,684,122,155,3,0,0,0,3,1,0,2,2563,9,1545
경기도,광주시,광남동,광남동제4투,4059,2428,918,583,615,142,146,1,1,3,0,7,0,1,2,2419,9,1631
경기도,광주시,광남동,광남동제5투,3239,2079,759,528,535,110,131,2,1,0,0,1,1,2,1,2071,8,1160
경기도,광주시,광남동,광남동제6투,2638,2062,903,397,499,121,138,0,0,0,0,0,1,0,0,2059,3,576
경기도,광주시,광남동,광남동제7투,1417,1142,476,253,278,76,56,0,0,0,0,0,0,0,0,1139,3,275
경기도,광주시,광남동,광남동제8투,2513,1526,580,372,394,79,83,2,0,0,1,2,0,1,2,1516,10,987
경기도,광주시,광남동,광남동제9투,2358,1431,632,237,386,75,93,1,0,1,0,1,0,0,1,1427,4,927
경기도,광주시,잘못 투입·구분된 투표지,,0,0,0,0,0,0,0,0,0,0,0,0,0,0,0,0,0,0
경기도,포천시,합계,,128917,90620,27632,28030,22505,5781,5529,114,29,69,36,108,46,62,134,90075,545,38297
경기도,포천시,거소·선상투표,,453,427,114,81,126,26,19,1,3,7,1,5,0,1,5,389,38,26
경기도,포천시,관외사전투표,,9391,9391,3801,1895,2064,746,751,11,2,2,3,5,5,4,31,9320,71,0
경기도,포천시,재외투표,,504,384,202,40,62,14,61,1,0,0,0,1,1,0,0,382,2,120
경기도,포천시,소흘읍,합계,34314,23598,8227,6222,5864,1555,1506,19,7,15,8,30,6,11,26,23496,102,10716
경기도,포천시,소흘읍,관내사전투표,5960,5960,2366,1433,1278,390,431,3,2,6,3,7,1,2,9,5931,29,0
경기도,포천시,소흘읍,소흘읍제1투,3743,1939,606,578,507,122,102,5,0,0,0,6,0,0,0,1926,13,1804
경기도,포천시,소흘읍,소흘읍제2투,1523,969,252,354,274,50,32,3,0,0,0,0,0,0,2,967,2,554
경기도,포천시,소흘읍,소흘읍제3투,2145,1566,443,577,370,95,73,0,0,1,0,2,0,0,0,1561,5,579
경기도,포천시,소흘읍,소흘읍제4투,1968,1175,300,466,293,51,55,1,1,0,1,0,1,0,1,1170,5,793
경기도,포천시,소흘읍,소흘읍제5투,3476,2421,849,549,687,167,151,0,0,0,0,4,0,3,1,2411,10,1055
경기도,포천시,소흘읍,소흘읍제6투,3119,1817,639,463,463,117,126,0,2,1,1,1,0,1,1,1815,2,1302
경기도,포천시,소흘읍,소흘읍제7투,2549,1449,553,346,353,105,77,1,1,1,2,1,1,3,2,1446,3,1100
경기도,포천시,소흘읍,소흘읍제8투,2907,1752,567,488,413,137,132,1,0,1,0,0,0,1,3,1743,9,1155
경기도,포천시,소흘읍,소흘읍제9투,3232,2208,808,454,588,166,162,4,1,3,0,5,3,1,3,2198,10,1024
경기도,포천시,소흘읍,소흘읍제10투,2561,1628,607,323,460,104,120,0,0,2,0,3,0,0,1,1620,8,933
경기도,포천시,소흘읍,소흘읍제11투,1131,714,237,191,178,51,45,1,0,0,1,1,0,0,3,708,6,417
경기도,포천시,군내면,관내사전투표,863,863,248,284,184,58,55,2,1,1,1,6,0,2,0,842,21,0
경기도,포천시,군내면,합계,5185,3527,831,1330,900,224,176,9,2,1,2,8,2,6,1,3492,35,1658
경기도,포천시,군내면,군내면제1투,1772,985,200,390,266,67,52,2,0,0,0,1,0,3,0,981,4,787
경기도,포천시,군내면,군내면제2투,933,618,168,218,166,39,20,0,0,0,0,1,0,0,0,612,6,315
경기도,포천시,군내면,군내면제3투,1617,1061,215,438,284,60,49,5,1,0,1,0,2,1,1,1057,4,556
경기도,포천시,내촌면,합계,4269,2882,735,1204,663,119,115,3,0,2,0,4,1,2,4,2852,30,1387
경기도,포천시,내촌면,관내사전투표,695,695,254,217,146,31,37,1,0,0,0,2,0,0,1,689,6,0
경기도,포천시,내촌면,내촌면제1투,2029,1196,263,527,299,55,45,2,0,1,0,1,0,0,0,1193,3,833
경기도,포천시,내촌면,내촌면제2투,614,362,72,163,95,16,13,0,0,0,0,0,1,0,0,360,2,252
경기도,포천시,내촌면,내촌면제3투,931,629,146,297,123,17,20,0,0,1,0,1,0,2,3,610,19,302
경기도,포천시,가산면,합계,6808,4431,1183,1628,1118,244,214,6,1,5,4,1,4,5,4,4417,14,2377
경기도,포천시,가산면,관내사전투표,1148,1148,395,373,244,72,53,2,0,0,1,0,1,2,1,1144,4,0
경기도,포천시,가산면,가산면제1투,2433,1352,353,497,347,79,68,0,1,1,1,0,2,1,0,1350,2,1081
경기도,포천시,가산면,가산면제2투,1740,1045,247,383,304,43,52,3,0,1,2,0,1,2,1,1039,6,695
경기도,포천시,가산면,가산면제3투,1487,886,188,375,223,50,41,1,0,3,0,1,0,0,2,884,2,601
경기도,포천시,신북면,합계,10034,6539,1690,2364,1654,367,379,12,2,5,1,10,4,9,10,6507,32,3495
경기도,포천시,신북면,관내사전투표,1453,1453,487,420,342,84,97,2,0,1,1,4,0,2,4,1444,9,0
경기도,포천시,신북면,신북면제1투,1746,1053,265,382,271,61,65,1,1,1,0,0,1,0,1,1049,4,693
경기도,포천시,신북면,신북면제2투,2851,1544,387,582,382,78,93,4,0,1,0,4,3,1,2,1537,7,1307
경기도,포천시,신북면,신북면제3투,1500,991,202,411,269,56,37,4,1,1,0,0,0,4,0,985,6,509
경기도,포천시,신북면,신북면제4투,797,500,86,248,132,12,15,0,0,1,0,0,0,2,2,498,2,297
경기도,포천시,신북면,신북면제5투,1687,998,263,321,258,76,72,1,0,0,0,2,0,0,1,994,4,689
경기도,포천시,창수면,합계,1952,1418,318,604,350,66,55,3,2,2,1,5,0,1,2,1409,9,534
경기도,포천시,창수면,관내사전투표,303,303,101,111,59,12,15,0,1,0,0,0,0,1,0,300,3,0
경기도,포천시,창수면,창수면제1투,915,615,110,297,157,25,15,3,1,1,0,4,0,0,0,613,2,300
경기도,포천시,창수면,창수면제2투,734,500,107,196,134,29,25,0,0,1,1,1,0,0,2,496,4,234
경기도,포천시,영중면,합계,4483,3072,749,1206,739,184,161,4,0,3,2,6,4,1,3,3062,10,1411
경기도,포천시,영중면,관내사전투표,697,697,224,211,149,55,51,0,0,0,0,4,0,0,0,694,3,0
경기도,포천시,영중면,영중면제1투,833,540,129,232,125,22,25,3,0,1,0,1,2,0,0,540,0,293
경기도,포천시,영중면,영중면제2투,1534,920,219,374,233,50,39,0,0,0,1,0,1,0,1,918,2,614
경기도,포천시,영중면,영중면제3투,551,393,67,168,104,22,24,1,0,1,1,0,0,1,0,389,4,158
경기도,포천시,영중면,영중면제4투,868,522,110,221,128,35,22,0,0,1,0,1,1,0,2,521,1,346
경기도,포천시,일동면,합계,8258,5480,1392,1956,1446,334,275,7,2,3,2,8,3,3,10,5441,39,2778
경기도,포천시,일동면,관내사전투표,1250,1250,411,353,300,89,78,2,1,0,0,2,0,1,3,1240,10,0
경기도,포천시,일동면,일동면제1투,2003,1079,277,387,291,52,58,2,0,3,0,2,0,0,1,1073,6,924
경기도,포천시,일동면,일동면제2투,388,253,39,128,61,11,8,2,0,0,0,0,0,0,2,251,2,135
경기도,포천시,일동면,일동면제3투,1135,712,152,296,200,34,25,0,0,0,0,1,0,0,1,709,3,423
경기도,포천시,일동면,일동면제4투,2159,1362,312,468,378,108,76,1,1,0,2,3,1,0,3,1353,9,797
경기도,포천시,일동면,일동면제5투,563,378,99,118,110,28,15,0,0,0,0,0,2,0,0,372,6,185
경기도,포천시,일동면,일동면제6투,760,446,102,206,106,12,15,0,0,0,0,0,0,2,0,443,3,314
경기도,포천시,이동면,관내사전투표,920,920,275,266,230,92,42,0,1,1,0,0,1,1,2,911,9,0
경기도,포천시,이동면,합계,4912,3452,904,1194,937,237,139,3,2,2,2,2,2,2,6,3432,20,1460
경기도,포천시,이동면,이동면제1투,1359,809,206,318,195,57,29,0,0,0,0,0,0,1,2,808,1,550
경기도,포천시,이동면,이동면제2투,657,398,80,160,119,17,16,1,1,1,0,1,0,0,0,396,2,259
경기도,포천시,이동면,이동면제3투,689,453,110,185,126,17,9,2,0,0,1,0,0,0,1,451,2,236
경기도,포천시,이동면,이동면제4투,1287,872,233,265,267,54,43,0,0,0,1,1,1,0,1,866,6,415
경기도,포천시,영북면,합계,7397,4996,1224,1771,1354,304,262,3,1,8,2,6,3,8,9,4955,41,2401
경기도,포천시,영북면,관내사전투표,1220,1220,383,312,305,100,96,0,0,0,0,1,1,2,3,1203,17,0
경기도,포천시,영북면,영북면제1투,1879,1024,225,426,276,44,32,1,0,4,0,1,0,1,3,1013,11,855
경기도,포천시,영북면,영북면제2투,640,435,89,204,103,16,18,0,0,0,0,0,0,1,2,433,2,205
경기도,포천시,영북면,영북면제3투,1461,925,230,257,291,87,51,1,1,1,0,1,0,1,1,922,3,536
경기도,포천시,영북면,영북면제4투,237,144,27,55,50,6,4,0,0,2,0,0,0,0,0,144,0,93
경기도,포천시,영북면,영북면제5투,988,622,139,240,162,33,35,1,0,1,2,2,1,1,0,617,5,366
경기도,포천시,영북면,영북면제6투,451,294,57,129,84,6,13,0,0,0,0,1,1,1,0,292,2,157
경기도,포천시,영북면,영북면제7투,521,332,74,148,83,12,13,0,0,0,0,0,0,1,0,331,1,189
경기도,포천시,관인면,합계,2620,1862,459,710,479,101,95,3,0,3,1,0,4,0,0,1855,7,758
경기도,포천시,관인면,관내사전투표,473,473,137,146,118,29,35,1,0,2,1,0,3,0,0,472,1,0
경기도,포천시,관인면,관인면제1투,1271,784,199,296,202,45,37,2,0,1,0,0,0,0,0,782,2,487
경기도,포천시,관인면,관인면제2투,467,326,78,137,78,20,13,0,0,0,0,0,0,0,0,326,0,141
경기도,포천시,관인면,관인면제3투,409,279,45,131,81,7,10,0,0,0,0,0,1,0,0,275,4,130
경기도,포천시,화현면,합계,2172,1544,335,651,369,86,79,6,1,0,0,2,0,2,3,1534,10,628
경기도,포천시,화현면,관내사전투표,408,408,108,154,86,30,28,0,0,0,0,1,0,0,0,407,1,0
경기도,포천시,화현면,화현면제1투,1264,810,169,348,201,45,32,5,1,0,0,0,0,1,1,803,7,454
경기도,포천시,화현면,화현면제2투,500,326,58,149,82,11,19,1,0,0,0,1,0,1,2,324,2,174
경기도,포천시,포천동,합계,14831,10541,3221,3152,2550,729,790,15,2,7,6,10,1,5,12,10500,41,4290
경기도,포천시,포천동,관내사전투표,2981,2981,1089,737,645,222,253,7,1,0,1,6,0,2,3,2966,15,0
경기도,포천시,포천동,포천동제1투,3125,2071,653,660,492,123,128,3,0,1,1,0,0,0,2,2063,8,1054
경기도,포천시,포천동,포천동제2투,1769,1024,242,387,273,53,59,2,0,1,2,0,0,1,1,1021,3,745
경기도,포천시,포천동,포천동제3투,2609,1672,441,518,455,122,122,0,1,2,1,2,0,1,1,1666,6,937
경기도,포천시,포천동,포천동제4투,3269,2150,618,616,538,169,191,3,0,2,1,1,0,1,3,2143,7,1119
경기도,포천시,포천동,포천동제5투,1078,643,178,234,147,40,37,0,0,1,0,1,1,0,2,641,2,435
경기도,포천시,선단동,합계,11334,7076,2247,2022,1830,445,452,8,2,4,1,5,6,2,8,7032,44,4258
경기도,포천시,선단동,관내사전투표,1666,1666,642,405,356,135,107,2,1,1,0,1,0,0,3,1653,13,0
경기도,포천시,선단동,선단동제1투,3442,1953,608,501,538,135,153,1,1,1,0,1,2,1,1,1943,10,1489
경기도,포천시,선단동,선단동제2투,1147,728,186,294,174,33,34,2,0,0,0,0,0,0,2,725,3,419
경기도,포천시,선단동,선단동제3투,1221,670,166,240,189,23,40,0,0,2,0,0,1,1,1,663,7,551
경기도,포천시,선단동,선단동제4투,3858,2059,645,582,573,119,118,3,0,0,1,3,3,0,1,2048,11,1799
경기도,포천시,잘못 투입·구분된 투표지,,0,0,0,0,0,0,0,0,0,0,0,0,0,0,0,0,0,0
경기도,연천군,합계,,38909,28675,8384,9557,6805,1901,1581,41,10,28,21,21,18,33,50,28450,225,10234
경기도,연천군,거소·선상투표,,327,317,103,53,91,25,18,3,1,0,0,0,0,1,2,297,20,10
경기도,연천군,관외사전투표,,3345,3345,1376,673,706,295,257,1,1,0,1,2,0,1,8,3321,24,0
경기도,연천군,재외투표,,150,113,69,7,21,5,8,3,0,0,0,0,0,0,0,113,0,37
경기도,연천군,연천읍,합계,6249,4586,1280,1481,1142,321,269,7,2,4,6,9,2,3,12,4538,48,1663
경기도,연천군,연천읍,관내사전투표,1130,1130,392,244,256,114,82,3,0,0,2,4,1,0,6,1104,26,0
경기도,연천군,연천읍,연천읍제1투,1336,875,216,336,217,43,55,1,0,1,1,2,0,1,0,873,2,461
경기도,연천군,연천읍,연천읍제2투,1109,791,205,318,193,26,33,0,0,2,1,1,1,1,3,784,7,318
경기도,연천군,연천읍,연천읍제3투,1402,910,279,225,230,102,64,2,1,0,1,1,0,0,0,905,5,492
경기도,연천군,연천읍,연천읍제4투,217,159,41,54,51,6,5,0,0,0,0,0,0,0,0,157,2,58
경기도,연천군,연천읍,연천읍제5투,1055,721,147,304,195,30,30,1,1,1,1,1,0,1,3,715,6,334
경기도,연천군,전곡읍,합계,14443,10017,3028,3138,2450,708,589,12,3,6,8,5,5,6,12,9970,47,4426
경기도,연천군,전곡읍,관내사전투표,2427,2427,906,548,514,243,183,4,2,1,1,1,1,2,4,2410,17,0
경기도,연천군,전곡읍,전곡읍제1투,2043,1092,279,422,277,60,44,0,0,1,0,1,1,1,2,1088,4,951
경기도,연천군,전곡읍,전곡읍제2투,843,549,143,226,127,25,25,0,1,0,0,1,0,0,0,548,1,294
경기도,연천군,전곡읍,전곡읍제3투,3059,1926,583,631,454,119,119,7,0,2,2,0,2,0,2,1921,5,1133
경기도,연천군,전곡읍,전곡읍제4투,1141,759,214,214,217,71,36,0,0,0,3,0,1,1,1,758,1,382
경기도,연천군,전곡읍,전곡읍제5투,1969,1328,350,435,362,89,81,0,0,1,1,0,0,1,2,1322,6,641
경기도,연천군,전곡읍,전곡읍제6투,310,209,58,85,44,12,7,0,0,0,1,0,0,0,0,207,2,101
경기도,연천군,전곡읍,전곡읍제7투,208,136,32,59,31,5,5,0,0,0,0,1,0,0,0,133,3,72
경기도,연천군,전곡읍,전곡읍제8투,365,233,58,91,60,10,13,0,0,0,0,0,0,0,0,232,1,132
경기도,연천군,전곡읍,전곡읍제9투,2078,1358,405,427,364,74,76,1,0,1,0,1,0,1,1,1351,7,720
경기도,연천군,군남면,합계,2842,1999,460,803,528,95,70,5,0,6,0,2,2,7,2,1980,19,843
경기도,연천군,군남면,관내사전투표,256,256,74,71,75,16,11,1,0,0,0,1,0,0,0,249,7,0
경기도,연천군,군남면,군남면제1투,680,437,81,191,116,17,20,2,0,1,0,0,0,4,1,433,4,243
경기도,연천군,군남면,군남면제2투,442,313,74,128,84,14,8,0,0,3,0,0,1,0,0,312,1,129
경기도,연천군,군남면,군남면제3투,421,284,57,127,77,8,10,0,0,1,0,0,0,2,1,283,1,137
경기도,연천군,군남면,군남면제4투,870,595,155,246,143,25,18,2,0,1,0,0,1,1,0,592,3,275
경기도,연천군,군남면,군남면제5투,173,114,19,40,33,15,3,0,0,0,0,1,0,0,0,111,3,59
경기도,연천군,청산면,합계,3419,2334,523,1066,479,125,106,1,0,6,1,0,4,7,5,2323,11,1085
경기도,연천군,청산면,관내사전투표,399,399,123,113,93,44,16,0,0,2,0,0,1,2,1,395,4,0
경기도,연천군,청산면,청산면제1투,1605,984,212,514,165,43,42,0,0,1,1,0,0,1,3,982,2,621
경기도,연천군,청산면,청산면제2투,869,575,112,273,121,24,33,0,0,1,0,0,2,3,1,570,5,294
경기도,연천군,청산면,청산면제3투,546,376,76,166,100,14,15,1,0,2,0,0,1,1,0,376,0,170
경기도,연천군,백학면,합계,2252,1569,381,627,361,89,81,3,0,3,1,3,1,3,3,1556,13,683
경기도,연천군,백학면,관내사전투표,279,279,95,88,58,16,18,0,0,0,0,3,0,0,0,278,1,0
경기도,연천군,백학면,백학면제1투,1210,780,174,318,193,42,43,0,0,0,1,0,0,1,2,774,6,430
경기도,연천군,백학면,백학면제2투,763,510,112,221,110,31,20,3,0,3,0,0,1,2,1,504,6,253
경기도,연천군,미산면,관내사전투표,208,208,72,68,37,15,11,0,0,0,1,0,0,1,1,206,2,0
경기도,연천군,미산면,합계,1429,1003,241,403,264,48,36,2,0,0,1,0,2,1,2,1000,3,426
경기도,연천군,미산면,미산면투표소,1221,795,169,335,227,33,25,2,0,0,0,0,2,0,1,794,1,426
경기도,연천군,왕징면,합계,977,761,208,295,173,37,29,4,1,1,1,0,0,2,1,752,9,216
경기도,연천군,왕징면,관내사전투표,189,189,60,45,59,10,9,2,0,0,0,0,0,0,0,185,4,0
경기도,연천군,왕징면,왕징면제1투,346,246,65,114,53,8,3,0,0,1,0,0,0,0,1,245,1,100
경기도,연천군,왕징면,왕징면제2투,169,129,32,50,23,6,12,2,0,0,1,0,0,1,0,127,2,40
경기도,연천군,왕징면,왕징면제3투,273,197,51,86,38,13,5,0,1,0,0,0,0,1,0,195,2,76
경기도,연천군,신서면,합계,2670,1989,544,750,469,113,80,0,1,1,2,0,2,1,3,1966,23,681
경기도,연천군,신서면,관내사전투표,562,562,200,162,107,51,25,0,1,0,0,0,0,1,0,547,15,0
경기도,연천군,신서면,신서면제1투,1261,839,213,336,200,42,35,0,0,1,2,0,1,0,2,832,7,422
경기도,연천군,신서면,신서면제2투,139,93,15,42,32,3,1,0,0,0,0,0,0,0,0,93,0,46
경기도,연천군,신서면,신서면제3투,239,177,37,90,42,2,5,0,0,0,0,0,0,0,1,177,0,62
경기도,연천군,신서면,신서면제4투,469,318,79,120,88,15,14,0,0,0,0,0,1,0,0,317,1,151
경기도,연천군,중면,합계,197,163,49,44,32,17,16,0,1,1,0,0,0,1,0,161,2,34
경기도,연천군,중면,관내사전투표,74,74,22,14,18,8,9,0,1,0,0,0,0,1,0,73,1,0
경기도,연천군,중면,중면투표소,123,89,27,30,14,9,7,0,0,1,0,0,0,0,0,88,1,34
경기도,연천군,장남면,합계,609,479,122,217,89,23,22,0,0,0,0,0,0,0,0,473,6,130
경기도,연천군,장남면,관내사전투표,77,77,23,37,13,2,2,0,0,0,0,0,0,0,0,77,0,0
경기도,연천군,장남면,장남면투표소,532,402,99,180,76,21,20,0,0,0,0,0,0,0,0,396,6,130
경기도,연천군,잘못 투입·구분된 투표지,,0,0,0,0,0,0,0,0,0,0,0,0,0,0,0,0,0,0
경기도,양평군,합계,,95097,71056,21329,24800,15653,4216,4194,157,14,52,26,31,34,77,86,70669,387,24041
경기도,양평군,거소·선상투표,,299,282,86,60,68,21,13,2,0,1,0,1,3,1,4,260,22,17
경기도,양평군,관외사전투표,,9577,9573,3694,2367,1989,724,699,13,3,4,3,3,3,6,11,9519,54,4
경기도,양평군,재외투표,,728,565,351,35,86,15,77,0,0,0,0,0,0,0,1,565,0,163
경기도,양평군,양평읍,합계,22224,15876,4955,5220,3434,1046,1060,31,2,12,3,6,5,13,17,15804,72,6348
경기도,양평군,양평읍,관내사전투표,4363,4363,1646,1173,844,313,346,7,0,3,0,3,3,1,6,4345,18,0
경기도,양평군,양평읍,양평읍제1투,2396,1429,381,499,318,107,108,6,0,3,1,0,0,1,3,1427,2,967
경기도,양평군,양평읍,양평읍제2투,2584,1680,478,585,379,115,111,3,0,0,0,0,0,0,2,1673,7,904
경기도,양평군,양평읍,양평읍제3투,1144,721,151,333,151,39,40,3,0,0,0,0,0,0,1,718,3,423
경기도,양평군,양평읍,양평읍제4투,1141,736,152,332,154,43,32,2,1,0,0,0,1,2,2,721,15,405
경기도,양평군,양평읍,양평읍제5투,3013,1846,537,655,422,111,98,3,1,1,1,0,0,4,0,1833,13,1167
경기도,양평군,양평읍,양평읍제6투,1469,990,241,380,231,81,51,0,0,2,0,0,0,2,0,988,2,479
경기도,양평군,양평읍,양평읍제7투,3224,2173,713,686,482,118,154,2,0,3,1,3,0,2,1,2165,8,1051
경기도,양평군,양평읍,양평읍제8투,2890,1938,656,577,453,119,120,5,0,0,0,0,1,1,2,1934,4,952
경기도,양평군,강상면,합계,6368,4603,1398,1616,991,268,282,15,1,3,0,1,0,6,7,4588,15,1765
경기도,양평군,강상면,관내사전투표,1234,1234,418,407,213,84,103,1,0,2,0,0,0,0,1,1229,5,0
경기도,양평군,강상면,강상면제1투,2559,1737,554,577,384,106,98,3,0,0,0,1,0,3,4,1730,7,822
경기도,양평군,강상면,강상면제2투,1607,983,270,372,232,39,58,8,0,0,0,0,0,2,1,982,1,624
경기도,양평군,강상면,강상면제3투,968,649,156,260,162,39,23,3,1,1,0,0,0,1,1,647,2,319
경기도,양평군,강하면,합계,3465,2529,658,1061,580,119,76,15,0,1,0,0,2,1,4,2517,12,936
경기도,양평군,강하면,관내사전투표,716,716,238,247,153,35,33,4,0,0,0,0,0,1,0,711,5,0
경기도,양평군,강하면,강하면제1투,1528,975,237,423,248,41,18,4,0,1,0,0,1,0,2,975,0,553
경기도,양평군,강하면,강하면제2투,1221,838,183,391,179,43,25,7,0,0,0,0,1,0,2,831,7,383
경기도,양평군,양서면,합계,9030,6490,1927,2325,1432,355,385,14,1,3,3,8,2,5,6,6466,24,2540
경기도,양평군,양서면,관내사전투표,1926,1926,644,662,383,114,111,2,0,0,0,2,1,0,3,1922,4,0
경기도,양평군,양서면,양서면제1투,2489,1718,478,638,392,90,94,7,0,1,1,2,1,3,1,1708,10,771
경기도,양평군,양서면,양서면제2투,970,676,166,271,159,28,43,2,1,1,0,2,0,1,1,675,1,294
경기도,양평군,양서면,양서면제3투,2705,1545,478,478,369,101,106,3,0,0,2,2,0,1,1,1541,4,1160
경기도,양평군,양서면,양서면제4투,940,625,161,276,129,22,31,0,0,1,0,0,0,0,0,620,5,315
경기도,양평군,옥천면,합계,5837,4294,1238,1550,992,240,237,7,1,2,2,3,2,5,0,4279,15,1543
경기도,양평군,옥천면,관내사전투표,1352,1352,455,407,284,89,106,3,0,0,1,1,1,0,0,1347,5,0
경기도,양평군,옥천면,옥천면제1투,1599,1029,306,359,244,52,57,0,1,1,1,1,1,1,0,1024,5,570
경기도,양평군,옥천면,옥천면제2투,1083,709,167,299,170,41,25,3,0,0,0,0,0,1,0,706,3,374
경기도,양평군,옥천면,옥천면제3투,982,668,169,295,154,31,17,0,0,0,0,0,0,1,0,667,1,314
경기도,양평군,옥천면,옥천면제4투,821,536,141,190,140,27,32,1,0,1,0,1,0,2,0,535,1,285
경기도,양평군,서종면,관내사전투표,1073,1073,404,342,200,45,72,2,0,0,1,0,0,0,0,1066,7,0
경기도,양평군,서종면,합계,6176,4414,1371,1619,924,225,239,10,0,0,2,0,1,2,1,4394,20,1762
경기도,양평군,서종면,서종면제1투,2247,1419,468,489,294,77,81,3,0,0,1,0,1,0,0,1414,5,828
경기도,양평군,서종면,서종면제2투,664,462,146,175,96,18,23,1,0,0,0,0,0,0,0,459,3,202
경기도,양평군,서종면,서종면제3투,800,545,153,217,107,33,28,4,0,0,0,0,0,2,0,544,1,255
경기도,양평군,서종면,서종면제4투,385,245,48,116,60,11,8,0,0,0,0,0,0,0,1,244,1,140
경기도,양평군,서종면,서종면제5투,1007,670,152,280,167,41,27,0,0,0,0,0,0,0,0,667,3,337
경기도,양평군,단월면,합계,2922,2114,473,926,468,114,81,10,1,1,0,1,3,8,1,2087,27,808
경기도,양평군,단월면,관내사전투표,570,570,158,206,119,35,24,3,1,1,0,0,0,1,1,549,21,0
경기도,양평군,단월면,단월면제1투,919,612,147,267,133,34,21,4,0,0,0,1,1,3,0,611,1,307
경기도,양평군,단월면,단월면제2투,854,546,105,256,124,26,24,3,0,0,0,0,2,3,0,543,3,308
경기도,양평군,단월면,단월면제3투,379,254,37,134,59,16,6,0,0,0,0,0,0,1,0,253,1,125
경기도,양평군,단월면,단월면제4투,200,132,26,63,33,3,6,0,0,0,0,0,0,0,0,131,1,68
경기도,양평군,청운면,합계,3060,2145,464,941,500,121,69,6,1,3,1,2,1,7,3,2119,26,915
경기도,양평군,청운면,관내사전투표,459,459,117,179,105,29,26,1,0,0,0,0,0,0,0,457,2,0
경기도,양평군,청운면,청운면제1투,1068,680,138,314,152,39,18,2,0,2,0,0,1,2,1,669,11,388
경기도,양평군,청운면,청운면제2투,479,317,64,138,87,8,8,1,0,0,1,0,0,2,1,310,7,162
경기도,양평군,청운면,청운면제3투,501,314,72,134,82,14,8,0,0,0,0,0,0,1,0,311,3,187
경기도,양평군,청운면,청운면제4투,553,375,73,176,74,31,9,2,1,1,0,2,0,2,1,372,3,178
경기도,양평군,양동면,합계,3704,2567,557,1126,608,104,119,7,1,7,4,0,3,7,8,2551,16,1137
경기도,양평군,양동면,관내사전투표,482,482,145,192,94,11,37,1,0,0,1,0,0,0,0,481,1,0
경기도,양평군,양동면,양동면제1투,1455,948,196,428,229,39,37,2,1,4,2,0,0,1,3,942,6,507
경기도,양평군,양동면,양동면제2투,675,412,87,176,98,20,20,2,0,0,0,0,1,2,3,409,3,263
경기도,양평군,양동면,양동면제3투,651,436,69,228,100,16,12,2,0,2,0,0,0,3,1,433,3,215
경기도,양평군,양동면,양동면제4투,441,289,60,102,87,18,13,0,0,1,1,0,2,1,1,286,3,152
경기도,양평군,지평면,합계,5294,3720,897,1513,889,181,190,5,1,1,4,2,5,5,4,3697,23,1574
경기도,양평군,지평면,관내사전투표,849,849,246,296,186,60,53,1,0,0,1,0,1,1,0,845,4,0
경기도,양평군,지평면,지평면제1투,882,540,125,238,120,22,32,1,0,0,0,0,0,0,0,538,2,342
경기도,양평군,지평면,지평면제2투,735,485,109,202,127,17,27,0,0,0,1,0,0,1,0,484,1,250
경기도,양평군,지평면,지평면제3투,601,394,77,184,99,8,15,1,0,1,0,0,2,2,0,389,5,207
경기도,양평군,지평면,지평면제4투,747,484,99,224,119,20,15,0,1,0,0,1,2,0,1,482,2,263
경기도,양평군,지평면,지평면제5투,790,503,134,184,124,23,28,0,0,0,2,0,0,0,3,498,5,287
경기도,양평군,지평면,지평면제6투,690,465,107,185,114,31,20,2,0,0,0,1,0,1,0,461,4,225
경기도,양평군,용문면,합계,12530,9056,2563,3314,2040,531,503,16,2,9,3,4,0,8,18,9011,45,3474
경기도,양평군,용문면,관내사전투표,2320,2320,811,646,476,175,182,3,0,3,1,1,0,2,4,2304,16,0
경기도,양평군,용문면,용문면제1투,2806,1811,481,689,411,100,108,2,0,1,0,0,0,1,6,1799,12,995
경기도,양평군,용문면,용문면제2투,1755,1155,283,518,240,50,48,5,0,4,1,0,0,1,2,1152,3,600
경기도,양평군,용문면,용문면제3투,1733,1082,299,351,261,107,55,2,0,1,1,1,0,0,2,1080,2,651
경기도,양평군,용문면,용문면제4투,1189,783,167,336,212,32,25,0,2,0,0,1,0,0,2,777,6,406
경기도,양평군,용문면,용문면제5투,1506,1052,329,355,251,44,63,1,0,0,0,0,0,4,2,1049,3,454
경기도,양평군,용문면,용문면제6투,598,422,80,232,81,16,9,1,0,0,0,1,0,0,0,420,2,176
경기도,양평군,용문면,용문면제7투,623,431,113,187,108,7,13,2,0,0,0,0,0,0,0,430,1,192
경기도,양평군,개군면,합계,3883,2828,697,1127,652,152,164,6,0,5,1,0,4,3,1,2812,16,1055
경기도,양평군,개군면,관내사전투표,725,725,218,227,164,47,58,1,0,1,0,0,1,1,0,718,7,0
경기도,양평군,개군면,개군면제1투,1227,797,160,329,216,51,34,1,0,1,0,0,1,1,1,795,2,430
경기도,양평군,개군면,개군면제2투,1158,797,223,309,164,39,55,2,0,0,1,0,0,0,0,793,4,361
경기도,양평군,개군면,개군면제3투,773,509,96,262,108,15,17,2,0,3,0,0,2,1,0,506,3,264
경기도,양평군,잘못 투입·구분된 투표지,,0,0,0,0,0,0,0,0,0,0,0,0,0,0,0,0,0,0
경기도,가평군,합계,,53480,38897,10873,13865,9089,2231,2103,99,25,48,36,45,50,50,74,38588,309,14583
경기도,가평군,거소·선상투표,,462,416,131,62,112,18,20,4,5,4,7,3,1,3,7,377,39,46
경기도,가평군,관외사전투표,,4576,4576,1696,1080,1057,345,331,5,1,4,1,2,4,4,8,4538,38,0
경기도,가평군,재외투표,,258,195,112,12,40,7,24,0,0,0,0,0,0,0,0,195,0,63
경기도,가평군,가평읍,합계,15162,10728,3127,3819,2402,628,629,19,1,12,9,3,6,8,16,10679,49,4434
경기도,가평군,가평읍,관내사전투표,2434,2434,949,635,481,159,182,8,0,3,3,1,3,0,2,2426,8,0
경기도,가평군,가평읍,가평읍제1투,2676,1639,438,587,386,110,106,0,0,1,0,0,0,2,2,1632,7,1037
경기도,가평군,가평읍,가평읍제2투,2215,1470,385,541,344,92,90,3,1,2,3,0,0,0,4,1465,5,745
경기도,가평군,가평읍,가평읍제3투,3013,2033,608,712,457,112,125,1,0,2,1,0,0,2,5,2025,8,980
경기도,가평군,가평읍,가평읍제4투,1555,995,298,386,202,57,40,2,0,0,0,1,1,2,2,991,4,560
경기도,가평군,가평읍,가평읍제5투,959,644,122,276,183,25,28,0,0,2,1,0,1,2,0,640,4,315
경기도,가평군,가평읍,가평읍제6투,844,552,117,220,147,34,28,0,0,2,1,0,0,0,1,550,2,292
경기도,가평군,가평읍,가평읍제7투,842,560,123,275,111,24,18,3,0,0,0,0,1,0,0,555,5,282
경기도,가평군,가평읍,가평읍제8투,624,401,87,187,91,15,12,2,0,0,0,1,0,0,0,395,6,223
경기도,가평군,설악면,관내사전투표,1091,1091,349,367,254,47,65,1,0,0,0,0,3,1,2,1089,2,0
경기도,가평군,설악면,합계,6760,4706,1134,1896,1183,224,208,12,0,2,2,2,8,6,9,4686,20,2054
경기도,가평군,설악면,설악면제1투,1946,1151,243,477,307,54,50,4,0,0,1,0,1,1,3,1141,10,795
경기도,가평군,설악면,설악면제2투,855,575,110,263,157,23,15,2,0,0,0,0,0,2,1,573,2,280
경기도,가평군,설악면,설악면제3투,957,645,137,279,173,22,27,1,0,1,1,0,1,0,1,643,2,312
경기도,가평군,설악면,설악면제4투,457,307,77,125,67,22,11,1,0,0,0,0,1,0,0,304,3,150
경기도,가평군,설악면,설악면제5투,1454,937,218,385,225,56,40,3,0,1,0,2,2,2,2,936,1,517
경기도,가평군,청평면,관내사전투표,1587,1587,616,451,319,82,98,5,0,0,1,4,1,2,2,1581,6,0
경기도,가평군,청평면,합계,11200,7838,2237,2972,1776,368,390,22,2,6,5,12,6,5,7,7808,30,3362
경기도,가평군,청평면,청평면제1투,3202,2009,537,769,439,106,127,6,1,2,2,5,1,2,1,1998,11,1193
경기도,가평군,청평면,청평면제2투,1456,970,185,518,197,33,28,1,1,0,0,2,0,1,1,967,3,486
경기도,가평군,청평면,청평면제3투,315,197,54,90,41,4,5,0,0,0,0,0,0,0,1,195,2,118
경기도,가평군,청평면,청평면제4투,3112,2008,607,680,497,105,96,7,0,3,2,1,3,0,2,2003,5,1104
경기도,가평군,청평면,청평면제5투,416,287,57,140,71,13,6,0,0,0,0,0,0,0,0,287,0,129
경기도,가평군,청평면,청평면제6투,676,489,119,181,146,18,19,2,0,1,0,0,1,0,0,487,2,187
경기도,가평군,청평면,청평면제7투,436,291,62,143,66,7,11,1,0,0,0,0,0,0,0,290,1,145
경기도,가평군,상면,합계,4346,3031,680,1257,745,172,122,9,1,6,1,2,3,6,6,3010,21,1315
경기도,가평군,상면,관내사전투표,570,570,180,173,116,56,31,4,0,3,0,1,1,0,1,566,4,0
경기도,가평군,상면,상면제1투,1133,780,171,332,189,42,28,4,0,3,1,0,1,2,3,776,4,353
경기도,가평군,상면,상면제2투,950,604,135,256,162,28,19,0,0,0,0,0,0,1,1,602,2,346
경기도,가평군,상면,상면제3투,392,247,30,122,64,14,14,0,0,0,0,0,1,0,0,245,2,145
경기도,가평군,상면,상면제4투,813,526,100,244,130,22,16,1,1,0,0,0,0,2,1,517,9,287
경기도,가평군,상면,상면제5투,488,304,64,130,84,10,14,0,0,0,0,1,0,1,0,304,0,184
경기도,가평군,북면,합계,3245,2322,523,994,567,110,98,3,1,2,1,5,0,4,2,2310,12,923
경기도,가평군,북면,관내사전투표,465,465,124,165,111,25,29,1,1,1,1,1,0,1,0,460,5,0
경기도,가평군,북면,북면제1투,1148,779,147,379,174,44,29,2,0,0,0,1,0,1,0,777,2,369
경기도,가평군,북면,북면제2투,606,392,89,164,104,16,16,0,0,0,0,0,0,1,0,390,2,214
경기도,가평군,북면,북면제3투,637,421,110,156,113,18,21,0,0,0,0,0,0,1,0,419,2,216
경기도,가평군,북면,북면제4투,389,265,53,130,65,7,3,0,0,1,0,3,0,0,2,264,1,124
경기도,가평군,조종면,합계,7471,5084,1233,1772,1207,359,281,25,14,12,10,16,22,14,19,4984,100,2387
경기도,가평군,조종면,관내사전투표,1282,1282,371,347,303,133,79,7,1,3,2,5,3,0,4,1258,24,0
경기도,가평군,조종면,조종면제1투,1585,1024,239,393,250,72,60,1,0,1,0,1,2,2,1,1022,2,561
경기도,가평군,조종면,조종면제2투,989,633,141,250,167,39,26,2,0,0,0,2,0,0,0,627,6,356
경기도,가평군,조종면,조종면제3투,1150,643,158,187,175,66,49,0,0,0,0,0,1,2,2,640,3,507
경기도,가평군,조종면,조종면제4투,1485,835,211,244,173,31,34,12,13,8,8,8,16,7,11,776,59,650
경기도,가평군,조종면,조종면제5투,509,343,49,184,74,8,18,3,0,0,0,0,0,2,1,339,4,166
경기도,가평군,조종면,조종면제6투,471,324,64,167,65,10,15,0,0,0,0,0,0,1,0,322,2,147
경기도,가평군,잘못 투입·구분된 투표지,,0,1,0,1,0,0,0,0,0,0,0,0,0,0,0,1,0,-1
강원도,합계,,,1287173,955885,324768,284909,206840,65278,62389,1426,252,787,321,876,570,870,1350,950636,5249,331288
강원도,춘천시,합계,,229286,175879,66874,43494,38684,12402,12758,251,27,104,62,103,60,110,187,175116,763,53407
강원도,춘천시,거소·선상투표,,647,620,185,128,188,37,28,7,3,2,1,5,3,1,3,591,29,27
강원도,춘천시,관외사전투표,,15294,15287,7091,2188,2993,1390,1419,20,4,9,7,9,3,8,31,15172,115,7
강원도,춘천시,재외투표,,1226,965,588,86,119,33,133,2,0,0,0,1,0,0,0,962,3,261
강원도,춘천시,신북읍,합계,7104,5259,1588,1698,1229,328,320,8,1,7,1,4,6,8,12,5210,49,1845
강원도,춘천시,신북읍,관내사전투표,1496,1496,589,346,323,100,102,3,1,2,0,2,0,2,3,1473,23,0
강원도,춘천시,신북읍,신북읍제1투,1384,927,233,332,234,63,54,1,0,1,1,0,0,1,2,922,5,457
강원도,춘천시,신북읍,신북읍제2투,2206,1478,444,490,334,95,90,4,0,1,0,1,3,2,5,1469,9,728
강원도,춘천시,신북읍,신북읍제3투,1217,836,207,315,201,51,51,0,0,0,0,0,2,1,1,829,7,381
강원도,춘천시,신북읍,신북읍제4투,801,522,115,215,137,19,23,0,0,3,0,1,1,2,1,517,5,279
강원도,춘천시,동면,합계,12197,9181,3509,2128,2222,637,608,15,0,4,5,3,3,6,7,9147,34,3016
강원도,춘천시,동면,관내사전투표,1298,1297,570,238,278,89,109,6,0,2,0,0,0,3,1,1296,1,1
강원도,춘천시,동면,동면제1투,2722,2138,883,441,515,162,131,1,0,1,0,0,0,0,0,2134,4,584
강원도,춘천시,동면,동면제2투,1106,684,171,247,196,35,26,1,0,0,2,2,0,1,0,681,3,422
강원도,춘천시,동면,동면제3투,229,143,22,73,36,4,1,1,0,0,1,1,2,0,0,141,2,86
강원도,춘천시,동면,동면제4투,3186,2269,877,511,542,153,163,4,0,1,1,0,0,2,3,2257,12,917
강원도,춘천시,동면,동면제5투,3656,2650,986,618,655,194,178,2,0,0,1,0,1,0,3,2638,12,1006
강원도,춘천시,동산면,합계,1284,930,235,369,216,50,42,3,0,3,1,1,1,4,0,925,5,354
강원도,춘천시,동산면,관내사전투표,198,198,79,63,27,11,17,0,0,0,1,0,0,0,0,198,0,0
강원도,춘천시,동산면,동산면제1투,636,420,74,198,109,20,10,3,0,2,0,0,0,2,0,418,2,216
강원도,춘천시,동산면,동산면제2투,450,312,82,108,80,19,15,0,0,1,0,1,1,2,0,309,3,138
강원도,춘천시,신동면,합계,2418,1820,519,600,429,110,125,4,3,2,1,0,1,0,4,1798,22,598
강원도,춘천시,신동면,관내사전투표,653,653,240,154,145,48,55,2,1,0,1,0,1,0,1,648,5,0
강원도,춘천시,신동면,신동면투표소,1765,1167,279,446,284,62,70,2,2,2,0,0,0,0,3,1150,17,598
강원도,춘천시,동내면,합계,11720,8755,3372,2201,1882,588,630,13,3,6,6,5,4,2,7,8719,36,2965
강원도,춘천시,동내면,관내사전투표,1960,1960,887,412,357,133,148,5,2,1,3,2,0,1,4,1955,5,0
강원도,춘천시,동내면,동내면제1투,2717,1756,615,515,396,109,104,0,0,2,0,2,0,0,1,1744,12,961
강원도,춘천시,동내면,동내면제2투,2093,1408,391,482,343,77,97,3,1,1,1,0,1,1,0,1398,10,685
강원도,춘천시,동내면,동내면제3투,3060,2232,898,487,485,172,176,4,0,0,1,1,1,0,1,2226,6,828
강원도,춘천시,동내면,동내면제4투,1890,1399,581,305,301,97,105,1,0,2,1,0,2,0,1,1396,3,491
강원도,춘천시,남면,합계,962,715,157,306,186,29,24,1,0,2,0,1,1,2,2,711,4,247
강원도,춘천시,남면,관내사전투표,192,192,55,65,51,11,8,0,0,1,0,0,0,0,0,191,1,0
강원도,춘천시,남면,남면투표소,770,523,102,241,135,18,16,1,0,1,0,1,1,2,2,520,3,247
강원도,춘천시,남산면,합계,3178,2277,627,859,544,113,106,3,0,0,0,1,1,4,7,2265,12,901
강원도,춘천시,남산면,관내사전투표,514,514,209,124,110,28,37,2,0,0,0,0,0,1,0,511,3,0
강원도,춘천시,남산면,남산면제1투,1462,953,234,411,220,44,34,0,0,0,0,0,1,1,2,947,6,509
강원도,춘천시,남산면,남산면제2투,597,392,96,144,113,18,16,1,0,0,0,0,0,0,2,390,2,205
강원도,춘천시,남산면,남산면제3투,605,418,88,180,101,23,19,0,0,0,0,1,0,2,3,417,1,187
강원도,춘천시,서면,합계,3490,2447,678,933,547,141,121,2,0,1,0,0,3,3,5,2434,13,1043
강원도,춘천시,서면,관내사전투표,606,606,232,169,112,42,44,1,0,1,0,0,1,1,1,604,2,0
강원도,춘천시,서면,서면제1투,882,608,160,242,133,41,23,0,0,0,0,0,0,2,1,602,6,274
강원도,춘천시,서면,서면제2투,1323,860,221,344,208,39,42,1,0,0,0,0,0,0,3,858,2,463
강원도,춘천시,서면,서면제3투,679,373,65,178,94,19,12,0,0,0,0,0,2,0,0,370,3,306
강원도,춘천시,사북면,합계,2137,1556,382,557,405,104,71,0,0,2,1,6,2,4,4,1538,18,581
강원도,춘천시,사북면,관내사전투표,276,276,99,57,64,34,18,0,0,0,0,0,0,0,0,272,4,0
강원도,춘천시,사북면,사북면제1투,660,465,103,189,121,26,20,0,0,0,1,0,0,1,1,462,3,195
강원도,춘천시,사북면,사북면제2투,295,215,40,84,63,8,15,0,0,0,0,2,0,0,0,212,3,80
강원도,춘천시,사북면,사북면제3투,906,600,140,227,157,36,18,0,0,2,0,4,2,3,3,592,8,306
강원도,춘천시,북산면,합계,792,581,121,263,136,27,26,0,0,0,0,0,1,1,3,578,3,211
강원도,춘천시,북산면,관내사전투표,214,214,61,77,53,13,8,0,0,0,0,0,1,0,0,213,1,0
강원도,춘천시,북산면,북산면제1투,420,253,46,118,58,13,15,0,0,0,0,0,0,0,2,252,1,167
강원도,춘천시,북산면,북산면제2투,158,114,14,68,25,1,3,0,0,0,0,0,0,1,1,113,1,44
강원도,춘천시,소양동,합계,8505,6376,2441,1671,1384,435,400,8,0,2,1,6,2,3,5,6358,18,2129
강원도,춘천시,소양동,관내사전투표,2054,2054,915,467,362,159,141,2,0,0,0,2,0,0,0,2048,6,0
강원도,춘천시,소양동,소양동제1투,1705,1145,362,341,283,75,70,2,0,1,0,4,0,1,2,1141,4,560
강원도,춘천시,소양동,소양동제2투,3748,2679,1031,668,616,177,167,4,0,1,1,0,2,2,2,2671,8,1069
강원도,춘천시,소양동,소양동제3투,998,498,133,195,123,24,22,0,0,0,0,0,0,0,1,498,0,500
강원도,춘천시,교동,합계,3637,2759,969,718,608,231,203,10,0,1,2,3,0,3,0,2748,11,878
강원도,춘천시,교동,관내사전투표,1196,1196,467,216,283,117,100,3,0,0,0,3,0,1,0,1190,6,0
강원도,춘천시,교동,교동투표소,2441,1563,502,502,325,114,103,7,0,1,2,0,0,2,0,1558,5,878
강원도,춘천시,조운동,합계,3369,2423,879,687,487,144,201,6,0,0,1,1,0,5,4,2415,8,946
강원도,춘천시,조운동,관내사전투표,1119,1119,485,226,199,74,127,3,0,0,1,1,0,1,1,1118,1,0
강원도,춘천시,조운동,조운동투표소,2250,1304,394,461,288,70,74,3,0,0,0,0,0,4,3,1297,7,946
강원도,춘천시,약사명동,합계,3729,2785,957,835,612,148,199,4,1,2,0,2,1,5,8,2774,11,944
강원도,춘천시,약사명동,관내사전투표,1140,1140,471,238,245,73,103,0,0,2,0,1,1,2,3,1139,1,0
강원도,춘천시,약사명동,약사명동투표소,2589,1645,486,597,367,75,96,4,1,0,0,1,0,3,5,1635,10,944
강원도,춘천시,근화동,합계,5619,3884,1308,1153,881,240,266,6,0,2,1,4,2,4,3,3870,14,1735
강원도,춘천시,근화동,관내사전투표,1060,1060,413,246,234,65,88,3,0,0,1,1,1,2,1,1055,5,0
강원도,춘천시,근화동,근화동제1투,2522,1728,592,525,391,103,109,2,0,0,0,1,0,0,1,1724,4,794
강원도,춘천시,근화동,근화동제2투,2037,1096,303,382,256,72,69,1,0,2,0,2,1,2,1,1091,5,941
강원도,춘천시,후평1동,합계,11055,8028,2771,2269,1792,509,610,12,1,8,2,4,6,5,8,7997,31,3027
강원도,춘천시,후평1동,관내사전투표,2981,2981,1210,703,575,214,252,5,1,3,0,1,2,1,2,2969,12,0
강원도,춘천시,후평1동,후평1동제1투,2705,1719,564,485,402,109,140,2,0,0,1,2,2,2,0,1709,10,986
강원도,춘천시,후평1동,후평1동제2투,2730,1619,487,538,396,79,107,1,0,2,0,1,1,1,2,1615,4,1111
강원도,춘천시,후평1동,후평1동제3투,2639,1709,510,543,419,107,111,4,0,3,1,0,1,1,4,1704,5,930
강원도,춘천시,후평2동,합계,10329,7814,2987,1884,1736,602,558,8,1,3,5,2,2,2,7,7797,17,2515
강원도,춘천시,후평2동,관내사전투표,3526,3526,1470,779,733,284,242,4,0,1,1,1,1,0,3,3519,7,0
강원도,춘천시,후평2동,후평2동제1투,1652,1019,341,301,230,73,69,1,0,0,0,0,0,1,0,1016,3,633
강원도,춘천시,후평2동,후평2동제2투,2752,1715,592,455,405,122,125,2,0,2,3,1,1,0,3,1711,4,1037
강원도,춘천시,후평2동,후평2동제3투,2399,1554,584,349,368,123,122,1,1,0,1,0,0,1,1,1551,3,845
강원도,춘천시,후평3동,합계,14026,10008,3536,2553,2337,744,753,14,1,9,3,5,1,4,6,9966,42,4018
강원도,춘천시,후평3동,관내사전투표,2258,2258,1011,410,450,182,187,5,0,3,0,3,1,1,1,2254,4,0
강원도,춘천시,후평3동,후평3동제1투,3396,2368,763,657,580,180,175,3,1,2,1,0,0,1,1,2364,4,1028
강원도,춘천시,후평3동,후평3동제2투,807,426,125,133,102,33,26,0,0,0,0,0,0,0,0,419,7,381
강원도,춘천시,후평3동,후평3동제3투,2491,1528,538,395,363,103,115,1,0,0,1,2,0,1,3,1522,6,963
강원도,춘천시,후평3동,후평3동제4투,1471,980,262,299,239,91,80,1,0,0,1,0,0,0,0,973,7,491
강원도,춘천시,후평3동,후평3동제5투,3603,2448,837,659,603,155,170,4,0,4,0,0,0,1,1,2434,14,1155
강원도,춘천시,효자1동,합계,4692,3661,1429,944,731,236,287,5,0,3,0,1,1,2,3,3642,19,1031
강원도,춘천시,효자1동,관내사전투표,1570,1570,741,302,264,95,153,0,0,0,0,1,1,1,2,1560,10,0
강원도,춘천시,효자1동,효자1동투표소,3122,2091,688,642,467,141,134,5,0,3,0,0,0,1,1,2082,9,1031
강원도,춘천시,효자2동,합계,10090,7033,2465,1945,1551,473,520,13,2,6,5,3,2,4,2,6991,42,3057
강원도,춘천시,효자2동,관내사전투표,1878,1878,857,326,333,163,184,1,0,2,0,0,0,0,1,1867,11,0
강원도,춘천시,효자2동,효자2동제1투,2056,1236,363,386,321,69,75,6,0,1,1,1,1,3,1,1228,8,820
강원도,춘천시,효자2동,효자2동제2투,1899,1271,415,398,298,78,72,1,0,1,1,0,1,1,0,1266,5,628
강원도,춘천시,효자2동,효자2동제3투,2025,1289,415,421,269,74,94,3,0,2,2,2,0,0,0,1282,7,736
강원도,춘천시,효자2동,효자2동제4투,2232,1359,415,414,330,89,95,2,2,0,1,0,0,0,0,1348,11,873
강원도,춘천시,효자3동,합계,4431,3270,1200,826,748,219,253,6,0,3,2,0,2,2,3,3264,6,1161
강원도,춘천시,효자3동,관내사전투표,1254,1254,534,265,233,98,114,3,0,1,0,0,0,1,2,1251,3,0
강원도,춘천시,효자3동,효자3동투표소,3177,2016,666,561,515,121,139,3,0,2,2,0,2,1,1,2013,3,1161
강원도,춘천시,석사동,관내사전투표,4614,4614,2296,749,804,347,386,3,0,1,1,2,0,2,3,4594,20,0
강원도,춘천시,석사동,합계,27394,20941,8709,4533,4492,1503,1564,23,2,11,3,8,3,8,12,20871,70,6453
강원도,춘천시,석사동,석사동제1투,2505,1754,613,508,387,111,122,0,0,3,0,0,1,1,1,1747,7,751
강원도,춘천시,석사동,석사동제2투,2223,1337,434,396,319,79,93,2,0,0,0,1,0,1,1,1326,11,886
강원도,춘천시,석사동,석사동제3투,1690,1120,430,258,235,96,94,2,0,1,0,0,0,0,2,1118,2,570
강원도,춘천시,석사동,석사동제4투,3010,2383,944,517,545,185,174,2,0,1,0,1,1,1,1,2372,11,627
강원도,춘천시,석사동,석사동제5투,2357,1719,730,337,375,130,132,4,1,2,1,1,0,1,2,1716,3,638
강원도,춘천시,석사동,석사동제6투,3918,2968,1180,654,681,199,240,5,0,0,1,0,1,0,1,2962,6,950
강원도,춘천시,석사동,석사동제7투,2017,1277,376,420,323,67,83,1,0,2,0,0,0,1,1,1274,3,740
강원도,춘천시,석사동,석사동제8투,1810,1434,676,228,310,114,103,0,0,0,0,2,0,0,0,1433,1,376
강원도,춘천시,석사동,석사동제9투,3250,2335,1030,466,513,175,137,4,1,1,0,1,0,1,0,2329,6,915
강원도,춘천시,퇴계동,합계,30258,23455,9415,5289,5197,1686,1714,24,2,6,4,20,5,7,23,23392,63,6803
강원도,춘천시,퇴계동,관내사전투표,3951,3951,1810,688,775,297,361,4,0,2,0,2,0,2,4,3945,6,0
강원도,춘천시,퇴계동,퇴계동제1투,3349,2297,862,538,543,183,161,2,0,0,0,1,0,0,1,2291,6,1052
강원도,춘천시,퇴계동,퇴계동제2투,1837,1296,454,350,325,87,74,0,1,0,0,1,0,1,0,1293,3,541
강원도,춘천시,퇴계동,퇴계동제3투,2003,1508,601,336,341,111,108,3,0,1,0,0,0,0,3,1504,4,495
강원도,춘천시,퇴계동,퇴계동제4투,2306,1842,690,445,426,143,125,1,0,0,0,2,1,0,1,1834,8,464
강원도,춘천시,퇴계동,퇴계동제5투,1411,1090,431,290,227,62,73,0,0,0,1,0,0,0,1,1085,5,321
강원도,춘천시,퇴계동,퇴계동제6투,2364,1855,672,490,406,148,131,2,0,0,1,0,1,1,1,1853,2,509
강원도,춘천시,퇴계동,퇴계동제7투,3501,2501,973,601,575,171,160,5,1,0,1,4,1,0,2,2494,7,1000
강원도,춘천시,퇴계동,퇴계동제8투,2896,2063,814,420,482,162,174,2,0,0,0,1,1,0,4,2060,3,833
강원도,춘천시,퇴계동,퇴계동제9투,1834,1454,640,299,336,76,89,0,0,0,0,4,0,2,2,1448,6,380
강원도,춘천시,퇴계동,퇴계동제10투,2940,2078,799,506,456,135,166,2,0,1,0,5,0,0,3,2073,5,862
강원도,춘천시,퇴계동,퇴계동제11투,1866,1520,669,326,305,111,92,3,0,2,1,0,1,1,1,1512,8,346
강원도,춘천시,강남동,합계,14929,11743,4590,2944,2454,847,828,18,0,3,5,5,2,6,10,11712,31,3186
강원도,춘천시,강남동,관내사전투표,4196,4196,1890,901,773,304,308,4,0,0,3,0,0,1,2,4186,10,0
강원도,춘천시,강남동,강남동제1투,1934,1209,405,347,273,85,89,3,0,0,0,0,0,2,2,1206,3,725
강원도,춘천시,강남동,강남동제2투,2870,2039,746,531,475,159,115,3,0,1,0,0,1,0,0,2031,8,831
강원도,춘천시,강남동,강남동제3투,2512,1813,594,564,403,117,116,2,0,1,2,0,0,2,6,1807,6,699
강원도,춘천시,강남동,강남동제4투,3417,2486,955,601,530,182,200,6,0,1,0,5,1,1,0,2482,4,931
강원도,춘천시,신사우동,관내사전투표,3424,3424,1493,666,696,260,277,6,1,4,3,1,1,1,2,3411,13,0
강원도,춘천시,신사우동,합계,14774,11306,4166,2927,2578,798,749,16,3,7,5,3,2,7,8,11269,37,3468
강원도,춘천시,신사우동,신사우동제1투,2704,1756,670,420,422,130,105,2,0,0,1,1,0,2,0,1753,3,948
강원도,춘천시,신사우동,신사우동제2투,2438,1823,603,573,449,89,99,2,0,1,0,0,0,1,2,1819,4,615
강원도,춘천시,신사우동,신사우동제3투,2456,1724,539,563,375,125,106,2,1,1,0,1,0,1,3,1717,7,732
강원도,춘천시,신사우동,신사우동제4투,1262,819,202,301,192,54,58,2,1,1,1,0,1,0,1,814,5,443
강원도,춘천시,신사우동,신사우동제5투,2490,1760,659,404,444,140,104,2,0,0,0,0,0,2,0,1755,5,730
강원도,춘천시,잘못 투입·구분된 투표지,,0,0,0,0,0,0,0,0,0,0,0,0,0,0,0,0,0,0
강원도,원주시,합계,,273858,204233,77495,50750,45776,13797,14406,319,47,157,44,198,82,109,215,203395,838,69625
강원도,원주시,거소·선상투표,,658,623,229,111,184,46,22,3,3,3,0,1,1,2,2,607,16,35
강원도,원주시,관외사전투표,,19465,19465,8897,2712,3991,1811,1801,27,6,10,6,18,9,4,39,19331,134,0
강원도,원주시,재외투표,,1234,974,626,48,134,42,120,0,0,0,0,1,0,0,0,971,3,260
강원도,원주시,문막읍,관내사전투표,2451,2451,1089,538,486,133,181,4,1,1,1,6,1,1,2,2444,7,0
강원도,원주시,문막읍,합계,14218,9575,3405,2569,2253,554,703,11,2,7,2,14,4,7,11,9542,33,4643
강원도,원주시,문막읍,문막읍제1투,3362,2040,690,550,484,131,166,4,0,0,1,3,0,2,3,2034,6,1322
강원도,원주시,문막읍,문막읍제2투,1992,1189,278,469,316,55,55,0,1,1,0,2,1,3,2,1183,6,803
강원도,원주시,문막읍,문막읍제3투,1045,668,154,278,179,22,29,1,0,0,0,1,0,0,0,664,4,377
강원도,원주시,문막읍,문막읍제4투,2103,1215,392,355,291,76,85,1,0,4,0,0,0,1,2,1207,8,888
강원도,원주시,문막읍,문막읍제5투,3265,2012,802,379,497,137,187,1,0,1,0,2,2,0,2,2010,2,1253
강원도,원주시,소초면,합계,7258,4883,1401,1659,1229,282,261,18,1,6,3,4,0,1,2,4867,16,2375
강원도,원주시,소초면,관내사전투표,965,965,354,241,235,60,65,4,1,2,0,0,0,0,0,962,3,0
강원도,원주시,소초면,소초면제1투,1826,1074,277,452,238,46,50,3,0,3,1,2,0,0,1,1073,1,752
강원도,원주시,소초면,소초면제2투,1315,892,253,326,228,43,33,4,0,1,0,0,0,0,0,888,4,423
강원도,원주시,소초면,소초면제3투,2291,1377,360,473,372,78,77,5,0,0,1,2,0,0,1,1369,8,914
강원도,원주시,소초면,소초면제4투,861,575,157,167,156,55,36,2,0,0,1,0,0,1,0,575,0,286
강원도,원주시,호저면,관내사전투표,485,485,186,132,97,20,34,1,0,0,0,1,0,4,3,478,7,0
강원도,원주시,호저면,합계,3422,2427,674,973,508,111,112,5,0,6,2,5,3,7,6,2412,15,995
강원도,원주시,호저면,호저면제1투,1951,1269,321,561,258,63,43,3,0,4,1,3,0,3,3,1263,6,682
강원도,원주시,호저면,호저면제2투,986,673,167,280,153,28,35,1,0,2,1,1,3,0,0,671,2,313
강원도,원주시,지정면,합계,2527,1824,498,699,419,73,97,3,1,4,3,0,3,0,4,1804,20,703
강원도,원주시,지정면,관내사전투표,402,402,146,115,79,17,34,0,0,0,1,0,1,0,1,394,8,0
강원도,원주시,지정면,지정면제1투,1233,816,192,328,207,31,37,3,1,2,2,0,0,0,2,805,11,417
강원도,원주시,지정면,지정면제2투,892,606,160,256,133,25,26,0,0,2,0,0,2,0,1,605,1,286
강원도,원주시,부론면,관내사전투표,408,408,121,163,93,11,15,0,1,2,0,0,0,0,0,406,2,0
강원도,원주시,부론면,합계,2091,1504,344,646,400,55,45,0,2,2,1,1,1,1,0,1498,6,587
강원도,원주시,부론면,부론면투표소,1683,1096,223,483,307,44,30,0,1,0,1,1,1,1,0,1092,4,587
강원도,원주시,귀래면,합계,1872,1352,319,553,376,39,46,3,1,1,0,2,2,5,2,1349,3,520
강원도,원주시,귀래면,관내사전투표,461,461,147,167,107,14,20,0,1,1,0,2,1,0,1,461,0,0
강원도,원주시,귀래면,귀래면투표소,1411,891,172,386,269,25,26,3,0,0,0,0,1,5,1,888,3,520
강원도,원주시,흥업면,합계,7712,5640,2005,1512,1270,384,394,11,0,7,3,6,5,4,2,5603,37,2072
강원도,원주시,흥업면,관내사전투표,2316,2316,963,502,498,149,167,6,0,1,1,2,2,1,2,2294,22,0
강원도,원주시,흥업면,흥업면제1투,3142,1899,636,537,436,139,127,5,0,6,1,1,1,1,0,1890,9,1243
강원도,원주시,흥업면,흥업면제2투,963,602,153,233,132,36,38,0,0,0,1,3,1,2,0,599,3,361
강원도,원주시,흥업면,흥업면제3투,1291,823,253,240,204,60,62,0,0,0,0,0,1,0,0,820,3,468
강원도,원주시,판부면,관내사전투표,401,401,181,91,70,23,30,3,0,0,1,0,0,1,0,400,1,0
강원도,원주시,판부면,합계,4700,3086,1065,868,729,196,189,6,1,2,1,3,0,4,8,3072,14,1614
강원도,원주시,판부면,판부면제1투,859,576,166,189,137,37,38,1,1,1,0,0,0,1,3,574,2,283
강원도,원주시,판부면,판부면제2투,695,458,112,160,133,26,21,0,0,0,0,0,0,0,1,453,5,237
강원도,원주시,판부면,판부면제3투,2745,1651,606,428,389,110,100,2,0,1,0,3,0,2,4,1645,6,1094
강원도,원주시,신림면,관내사전투표,667,667,241,215,143,27,32,1,0,0,0,0,0,5,1,665,2,0
강원도,원주시,신림면,합계,3341,2396,671,939,531,127,99,4,0,0,1,2,1,7,3,2385,11,945
강원도,원주시,신림면,신림면제1투,1933,1228,303,524,273,70,44,2,0,0,1,1,1,0,2,1221,7,705
강원도,원주시,신림면,신림면제2투,741,501,127,200,115,30,23,1,0,0,0,1,0,2,0,499,2,240
강원도,원주시,중앙동,합계,4051,2963,953,1033,599,145,204,9,0,4,1,1,0,1,2,2952,11,1088
강원도,원주시,중앙동,관내사전투표,1771,1771,679,522,317,89,147,5,0,0,0,1,0,0,1,1761,10,0
강원도,원주시,중앙동,중앙동투표소,2280,1192,274,511,282,56,57,4,0,4,1,0,0,1,1,1191,1,1088
강원도,원주시,원인동,합계,4651,3111,994,949,734,179,215,11,0,1,1,6,0,2,4,3096,15,1540
강원도,원주시,원인동,관내사전투표,748,748,291,196,155,44,52,2,0,0,1,0,0,1,1,743,5,0
강원도,원주시,원인동,원인동제1투,2712,1600,484,481,389,97,126,6,0,1,0,6,0,0,1,1591,9,1112
강원도,원주시,원인동,원인동제2투,1191,763,219,272,190,38,37,3,0,0,0,0,0,1,2,762,1,428
강원도,원주시,개운동,합계,10789,7942,2606,2381,1833,539,518,7,3,8,2,6,1,2,9,7915,27,2847
강원도,원주시,개운동,관내사전투표,2307,2307,897,585,475,156,172,3,1,3,0,1,1,1,3,2298,9,0
강원도,원주시,개운동,개운동제1투,2960,1821,483,652,457,107,105,1,1,3,0,3,0,0,3,1815,6,1139
강원도,원주시,개운동,개운동제2투,3142,2107,610,686,522,153,123,0,1,0,2,2,0,0,1,2100,7,1035
강원도,원주시,개운동,개운동제3투,2380,1707,616,458,379,123,118,3,0,2,0,0,0,1,2,1702,5,673
강원도,원주시,명륜1동,합계,9594,7616,2962,1941,1590,489,549,15,0,9,0,9,2,8,11,7585,31,1978
강원도,원주시,명륜1동,관내사전투표,3370,3370,1633,588,556,230,330,5,0,2,0,5,1,4,6,3360,10,0
강원도,원주시,명륜1동,명륜1동제1투,2173,1411,401,485,370,75,62,3,0,1,0,1,0,3,1,1402,9,762
강원도,원주시,명륜1동,명륜1동제2투,1750,1161,359,406,272,45,62,5,0,2,0,1,1,1,2,1156,5,589
강원도,원주시,명륜1동,명륜1동제3투,2301,1674,569,462,392,139,95,2,0,4,0,2,0,0,2,1667,7,627
강원도,원주시,명륜2동,합계,13203,9721,3668,2490,2217,595,641,23,3,9,2,8,10,4,10,9680,41,3482
강원도,원주시,명륜2동,관내사전투표,2729,2729,1223,558,553,165,206,4,0,0,1,1,2,0,4,2717,12,0
강원도,원주시,명륜2동,명륜2동제1투,2436,1355,420,429,340,64,71,8,2,2,0,2,4,2,1,1345,10,1081
강원도,원주시,명륜2동,명륜2동제2투,3333,2581,1023,603,607,174,159,5,0,1,0,3,0,0,1,2576,5,752
강원도,원주시,명륜2동,명륜2동제3투,2372,1620,571,443,383,103,105,2,0,3,1,0,0,1,1,1613,7,752
강원도,원주시,명륜2동,명륜2동제4투,2333,1436,431,457,334,89,100,4,1,3,0,2,4,1,3,1429,7,897
강원도,원주시,단구동,합계,31810,23016,9082,5215,5168,1642,1704,25,5,20,5,25,3,6,24,22924,92,8794
강원도,원주시,단구동,관내사전투표,5409,5409,2489,1039,1003,379,442,5,0,4,2,4,1,2,6,5376,33,0
강원도,원주시,단구동,단구동제1투,2868,1781,606,511,404,131,115,2,0,2,2,0,0,0,2,1775,6,1087
강원도,원주시,단구동,단구동제2투,2608,1751,527,535,419,128,124,5,0,4,0,2,0,1,1,1746,5,857
강원도,원주시,단구동,단구동제3투,2941,1945,775,393,492,128,148,0,0,1,0,3,0,0,1,1941,4,996
강원도,원주시,단구동,단구동제4투,2116,1394,419,408,366,112,79,3,1,2,0,0,0,0,0,1390,4,722
강원도,원주시,단구동,단구동제5투,2510,1647,566,480,378,83,126,1,1,0,0,3,0,0,1,1639,8,863
강원도,원주시,단구동,단구동제6투,2977,2131,842,446,521,146,148,5,2,6,0,6,0,1,3,2126,5,846
강원도,원주시,단구동,단구동제7투,3134,1912,663,463,477,144,149,1,0,0,1,1,1,0,2,1902,10,1222
강원도,원주시,단구동,단구동제8투,2692,1776,751,354,380,135,134,2,1,0,0,3,0,1,5,1766,10,916
강원도,원주시,단구동,단구동제9투,1677,1251,558,227,272,95,95,0,0,0,0,0,0,0,2,1249,2,426
강원도,원주시,단구동,단구동제10투,2878,2019,886,359,456,161,144,1,0,1,0,3,1,1,1,2014,5,859
강원도,원주시,일산동,합계,7038,4968,1685,1501,1125,285,326,4,2,5,0,8,0,3,2,4946,22,2070
강원도,원주시,일산동,관내사전투표,1557,1557,687,345,283,103,126,0,1,2,0,0,0,1,1,1549,8,0
강원도,원주시,일산동,일산동제1투,2838,1734,524,593,413,87,102,2,1,0,0,5,0,1,0,1728,6,1104
강원도,원주시,일산동,일산동제2투,2643,1677,474,563,429,95,98,2,0,3,0,3,0,1,1,1669,8,966
강원도,원주시,학성동,관내사전투표,1537,1537,617,395,293,98,121,4,0,3,0,1,1,1,1,1535,2,0
강원도,원주시,학성동,합계,5363,3954,1331,1245,866,237,245,6,1,3,0,1,3,3,4,3945,9,1409
강원도,원주시,학성동,학성동제1투,2532,1656,512,562,386,95,91,1,1,0,0,0,2,1,1,1652,4,876
강원도,원주시,학성동,학성동제2투,1294,761,202,288,187,44,33,1,0,0,0,0,0,1,2,758,3,533
강원도,원주시,단계동,합계,18597,13530,4923,3459,3069,1003,967,17,3,10,0,9,4,4,17,13485,45,5067
강원도,원주시,단계동,관내사전투표,3879,3879,1709,750,737,302,354,3,0,4,0,2,1,0,5,3867,12,0
강원도,원주시,단계동,단계동제1투,2681,1628,528,459,411,114,104,1,0,1,0,0,1,1,4,1624,4,1053
강원도,원주시,단계동,단계동제2투,3564,2437,814,693,579,170,157,3,1,4,0,2,1,0,2,2426,11,1127
강원도,원주시,단계동,단계동제3투,2875,1824,541,533,473,130,128,4,0,1,0,1,0,0,3,1814,10,1051
강원도,원주시,단계동,단계동제4투,1796,1128,342,356,267,75,76,2,1,0,0,4,0,1,0,1124,4,668
강원도,원주시,단계동,단계동제5투,3802,2634,989,668,602,212,148,4,1,0,0,0,1,2,3,2630,4,1168
강원도,원주시,우산동,관내사전투표,2124,2124,878,497,414,136,178,3,0,2,0,3,0,1,4,2116,8,0
강원도,원주시,우산동,합계,11349,8195,2863,2268,1894,534,567,7,1,8,1,8,3,4,7,8165,30,3154
강원도,원주시,우산동,우산동제1투,2725,1715,465,653,407,95,78,1,0,2,0,2,0,2,0,1705,10,1010
강원도,원주시,우산동,우산동제2투,3415,2423,891,590,582,171,171,2,1,1,1,2,2,1,3,2418,5,992
강원도,원주시,우산동,우산동제3투,3085,1933,629,528,491,132,140,1,0,3,0,1,1,0,0,1926,7,1152
강원도,원주시,태장1동,관내사전투표,2039,2039,846,447,423,165,129,3,3,2,0,5,1,1,5,2030,9,0
강원도,원주시,태장1동,합계,7731,5590,1980,1461,1356,367,363,11,4,5,0,5,3,6,7,5568,22,2141
강원도,원주시,태장1동,태장1동제1투,2405,1557,459,479,417,96,92,5,0,1,0,0,1,2,2,1554,3,848
강원도,원주시,태장1동,태장1동제2투,3287,1994,675,535,516,106,142,3,1,2,0,0,1,3,0,1984,10,1293
강원도,원주시,태장2동,합계,18243,12605,4174,3380,3162,850,921,18,1,7,6,11,10,5,11,12556,49,5638
강원도,원주시,태장2동,관내사전투표,2744,2744,1098,597,597,205,228,3,1,1,0,1,2,2,0,2735,9,0
강원도,원주시,태장2동,태장2동제1투,2609,1520,435,443,429,106,90,5,0,0,1,2,1,0,2,1514,6,1089
강원도,원주시,태장2동,태장2동제2투,3153,2152,741,515,542,178,163,1,0,2,1,0,3,0,5,2151,1,1001
강원도,원주시,태장2동,태장2동제3투,2772,1850,613,490,463,111,154,3,0,0,2,2,1,0,0,1839,11,922
강원도,원주시,태장2동,태장2동제4투,1786,1065,264,399,274,51,59,2,0,1,0,2,1,2,2,1057,8,721
강원도,원주시,태장2동,태장2동제5투,2042,1232,337,420,319,70,70,3,0,1,2,1,2,0,1,1226,6,810
강원도,원주시,태장2동,태장2동제6투,3137,2042,686,516,538,129,157,1,0,2,0,3,0,1,1,2034,8,1095
강원도,원주시,봉산동,합계,7530,5384,1770,1737,1199,294,319,12,3,3,3,13,2,4,6,5365,19,2146
강원도,원주시,봉산동,관내사전투표,1307,1307,500,343,284,68,93,2,2,1,1,7,2,0,0,1303,4,0
강원도,원주시,봉산동,봉산동제1투,1930,1195,334,442,296,60,50,1,0,1,1,2,0,1,1,1189,6,735
강원도,원주시,봉산동,봉산동제2투,1766,1091,303,441,234,48,48,7,0,0,0,0,0,2,3,1086,5,675
강원도,원주시,봉산동,봉산동제3투,2527,1791,633,511,385,118,128,2,1,1,1,4,0,1,2,1787,4,736
강원도,원주시,행구동,합계,6103,4624,1753,1283,994,281,269,8,0,1,1,7,1,2,4,4604,20,1479
강원도,원주시,행구동,관내사전투표,1534,1534,659,372,294,94,95,3,0,1,1,2,0,1,1,1523,11,0
강원도,원주시,행구동,행구동제1투,1994,1207,380,448,251,68,49,3,0,0,0,1,1,1,1,1203,4,787
강원도,원주시,행구동,행구동제2투,2575,1883,714,463,449,119,125,2,0,0,0,4,0,0,2,1878,5,692
강원도,원주시,무실동,합계,24772,18698,8004,3874,4027,1300,1355,34,3,9,0,16,7,4,10,18643,55,6074
강원도,원주시,무실동,관내사전투표,5578,5578,2729,952,975,400,475,12,0,2,0,9,2,1,4,5561,17,0
강원도,원주시,무실동,무실동제1투,3181,2033,773,535,439,144,128,3,0,2,0,1,0,0,0,2025,8,1148
강원도,원주시,무실동,무실동제2투,3300,2180,808,584,511,120,139,8,1,1,0,1,1,1,2,2177,3,1120
강원도,원주시,무실동,무실동제3투,2493,1994,803,441,450,143,150,2,0,0,0,1,0,0,0,1990,4,499
강원도,원주시,무실동,무실동제4투,2537,1357,445,379,321,100,96,5,1,0,0,0,2,1,2,1352,5,1180
강원도,원주시,무실동,무실동제5투,3422,2415,996,481,591,177,152,4,1,1,0,1,2,0,0,2406,9,1007
강원도,원주시,무실동,무실동제6투,4261,3141,1450,502,740,216,215,0,0,3,0,3,0,1,2,3132,9,1120
강원도,원주시,반곡관설동,합계,24536,18567,8613,3244,3919,1337,1354,21,1,7,0,8,4,9,8,18525,42,5969
강원도,원주시,반곡관설동,관내사전투표,4780,4780,2610,621,785,367,377,5,0,3,0,2,0,4,1,4775,5,0
강원도,원주시,반곡관설동,반곡관설동제1투,926,644,154,252,169,29,34,0,0,1,0,1,0,1,0,641,3,282
강원도,원주시,반곡관설동,반곡관설동제2투,3190,2362,1110,365,540,172,161,4,1,0,0,0,0,0,1,2354,8,828
강원도,원주시,반곡관설동,반곡관설동제3투,2273,1299,455,327,307,97,101,2,0,1,0,2,1,0,0,1293,6,974
강원도,원주시,반곡관설동,반곡관설동제4투,2257,1594,715,320,321,106,127,1,0,0,0,0,3,0,1,1594,0,663
강원도,원주시,반곡관설동,반곡관설동제5투,3097,2297,1008,461,503,170,143,4,0,0,0,2,0,2,1,2294,3,800
강원도,원주시,반곡관설동,반곡관설동제6투,1681,1139,506,191,264,82,86,3,0,1,0,0,0,0,1,1134,5,542
강원도,원주시,반곡관설동,반곡관설동제7투,2897,2012,973,303,465,127,140,0,0,0,0,0,0,0,1,2009,3,885
강원도,원주시,반곡관설동,반곡관설동제8투,3435,2440,1082,404,565,187,185,2,0,1,0,1,0,2,2,2431,9,995
강원도,원주시,잘못 투입·구분된 투표지,,0,0,0,0,0,0,0,0,0,0,0,0,0,0,0,0,0,0
강원도,강릉시,합계,,178461,132395,41565,44421,26895,9690,8368,195,19,91,43,99,63,113,150,131712,683,46066
강원도,강릉시,거소·선상투표,,376,348,124,81,98,22,10,2,0,0,2,0,0,1,0,340,8,28
강원도,강릉시,관외사전투표,,11415,11415,4857,1866,2204,1185,1143,19,1,8,6,8,5,2,13,11317,98,0
강원도,강릉시,재외투표,,776,609,363,37,85,31,86,1,0,0,0,0,0,0,1,604,5,167
강원도,강릉시,주문진읍,합계,14671,9319,2243,4203,1860,510,382,15,2,15,2,13,3,14,12,9274,45,5352
강원도,강릉시,주문진읍,관내사전투표,1660,1660,556,609,309,85,79,0,0,5,1,4,0,3,2,1653,7,0
강원도,강릉시,주문진읍,주문진읍제1투,2744,1512,294,784,299,67,41,2,0,5,0,3,1,1,2,1499,13,1232
강원도,강릉시,주문진읍,주문진읍제2투,2754,1472,308,727,283,86,50,1,1,1,0,0,1,4,2,1464,8,1282
강원도,강릉시,주문진읍,주문진읍제3투,2577,1629,315,816,338,89,58,6,0,1,0,0,0,1,1,1625,4,948
강원도,강릉시,주문진읍,주문진읍제4투,876,585,116,308,110,24,18,2,0,2,0,1,0,2,0,583,2,291
강원도,강릉시,주문진읍,주문진읍제5투,2004,1195,271,500,273,77,60,1,1,0,0,1,0,3,3,1190,5,809
강원도,강릉시,주문진읍,주문진읍제6투,2056,1266,383,459,248,82,76,3,0,1,1,4,1,0,2,1260,6,790
강원도,강릉시,성산면,합계,2972,2196,561,917,445,141,102,3,0,3,3,1,2,4,4,2186,10,776
강원도,강릉시,성산면,관내사전투표,643,643,215,198,119,61,42,1,0,0,0,0,1,1,1,639,4,0
강원도,강릉시,성산면,성산면제1투,1796,1169,239,566,235,65,47,2,0,3,3,1,0,3,1,1165,4,627
강원도,강릉시,성산면,성산면제2투,533,384,107,153,91,15,13,0,0,0,0,0,1,0,2,382,2,149
강원도,강릉시,왕산면,합계,1397,1040,207,479,243,53,38,3,0,1,0,0,1,3,3,1031,9,357
강원도,강릉시,왕산면,관내사전투표,197,197,48,73,49,9,16,0,0,0,0,0,0,0,0,195,2,0
강원도,강릉시,왕산면,왕산면제1투,587,395,53,205,95,20,11,3,0,0,0,0,1,2,1,391,4,192
강원도,강릉시,왕산면,왕산면제2투,315,233,51,104,57,11,5,0,0,0,0,0,0,1,2,231,2,82
강원도,강릉시,왕산면,왕산면제3투,298,215,55,97,42,13,6,0,0,1,0,0,0,0,0,214,1,83
강원도,강릉시,구정면,합계,3410,2473,615,1031,508,141,144,5,0,1,2,2,2,3,4,2458,15,937
강원도,강릉시,구정면,관내사전투표,574,574,183,174,114,48,47,1,0,0,0,1,0,1,0,569,5,0
강원도,강릉시,구정면,구정면제1투,1887,1300,304,565,281,62,71,3,0,1,1,1,2,1,2,1294,6,587
강원도,강릉시,구정면,구정면제2투,949,599,128,292,113,31,26,1,0,0,1,0,0,1,2,595,4,350
강원도,강릉시,강동면,합계,4166,2848,585,1381,515,186,131,6,0,2,4,0,5,2,4,2821,27,1318
강원도,강릉시,강동면,관내사전투표,813,813,212,339,134,57,51,6,0,1,1,0,2,1,1,805,8,0
강원도,강릉시,강동면,강동면제1투,2258,1372,257,715,239,95,52,0,0,0,1,0,1,0,1,1361,11,886
강원도,강릉시,강동면,강동면제2투,1095,663,116,327,142,34,28,0,0,1,2,0,2,1,2,655,8,432
강원도,강릉시,옥계면,합계,3397,2393,514,1107,484,130,121,3,2,2,1,3,4,6,1,2378,15,1004
강원도,강릉시,옥계면,관내사전투표,685,685,175,279,145,35,39,0,0,1,0,3,1,3,0,681,4,0
강원도,강릉시,옥계면,옥계면제1투,1623,998,211,489,181,57,47,3,1,1,1,0,1,2,0,994,4,625
강원도,강릉시,옥계면,옥계면제2투,1089,710,128,339,158,38,35,0,1,0,0,0,2,1,1,703,7,379
강원도,강릉시,사천면,합계,3972,2893,788,1095,619,183,143,5,1,4,2,5,3,10,4,2862,31,1079
강원도,강릉시,사천면,관내사전투표,811,811,326,229,126,57,53,1,1,2,2,0,2,3,1,803,8,0
강원도,강릉시,사천면,사천면제1투,2029,1299,281,545,316,73,64,0,0,1,0,3,1,2,0,1286,13,730
강원도,강릉시,사천면,사천면제2투,1132,783,181,321,177,53,26,4,0,1,0,2,0,5,3,773,10,349
강원도,강릉시,연곡면,합계,5662,4092,1229,1555,801,262,216,2,2,2,0,1,0,5,8,4083,9,1570
강원도,강릉시,연곡면,관내사전투표,1096,1096,418,339,193,82,57,0,0,1,0,0,0,1,2,1093,3,0
강원도,강릉시,연곡면,연곡면제1투,3139,2049,622,693,453,138,129,1,1,1,0,1,0,2,5,2046,3,1090
강원도,강릉시,연곡면,연곡면제2투,1427,947,189,523,155,42,30,1,1,0,0,0,0,2,1,944,3,480
강원도,강릉시,홍제동,합계,7854,5867,1889,1945,1188,440,354,7,2,3,0,7,2,4,6,5847,20,1987
강원도,강릉시,홍제동,관내사전투표,1649,1649,644,436,304,144,102,4,1,0,0,4,0,0,3,1642,7,0
강원도,강릉시,홍제동,홍제동제1투,3037,2037,591,751,414,152,116,1,0,2,0,0,1,2,0,2030,7,1000
강원도,강릉시,홍제동,홍제동제2투,3168,2181,654,758,470,144,136,2,1,1,0,3,1,2,3,2175,6,987
강원도,강릉시,중앙동,합계,5854,4360,1216,1763,796,277,274,4,0,1,1,3,2,3,4,4344,16,1494
강원도,강릉시,중앙동,관내사전투표,1905,1905,689,590,305,142,159,2,0,1,0,1,1,2,3,1895,10,0
강원도,강릉시,중앙동,중앙동제1투,1546,1019,223,444,231,61,55,1,0,0,1,2,0,1,0,1019,0,527
강원도,강릉시,중앙동,중앙동제2투,2403,1436,304,729,260,74,60,1,0,0,0,0,1,0,1,1430,6,967
강원도,강릉시,옥천동,관내사전투표,1039,1039,328,370,187,72,73,0,0,0,0,2,0,0,1,1033,6,0
강원도,강릉시,옥천동,합계,3776,2732,683,1211,554,140,118,2,0,2,0,3,1,3,2,2719,13,1044
강원도,강릉시,옥천동,옥천동투표소,2737,1693,355,841,367,68,45,2,0,2,0,1,1,3,1,1686,7,1044
강원도,강릉시,교1동,합계,20462,15731,5582,4437,3246,1259,1086,15,2,8,5,10,8,6,9,15673,58,4731
강원도,강릉시,교1동,관내사전투표,4581,4581,2062,896,818,398,375,2,0,0,2,6,1,1,4,4565,16,0
강원도,강릉시,교1동,교1동제1투,2554,1767,445,641,422,159,88,3,1,0,0,0,3,0,0,1762,5,787
강원도,강릉시,교1동,교1동제2투,2716,1845,440,802,387,103,93,2,0,3,2,0,1,1,2,1836,9,871
강원도,강릉시,교1동,교1동제3투,2272,1781,651,505,359,145,111,1,0,1,0,0,0,2,1,1776,5,491
강원도,강릉시,교1동,교1동제4투,3178,2144,728,569,459,191,173,4,0,2,0,3,0,1,1,2131,13,1034
강원도,강릉시,교1동,교1동제5투,2638,1810,621,501,411,128,137,1,0,1,1,0,1,0,1,1803,7,828
강원도,강릉시,교1동,교1동제6투,2523,1803,635,523,390,135,109,2,1,1,0,1,2,1,0,1800,3,720
강원도,강릉시,교2동,관내사전투표,1596,1596,619,433,284,129,117,2,2,1,0,1,0,1,2,1591,5,0
강원도,강릉시,교2동,합계,7255,5213,1577,1901,1003,376,304,8,2,4,0,1,0,7,6,5189,24,2042
강원도,강릉시,교2동,교2동제1투,1940,1057,242,490,203,64,42,4,0,0,0,0,0,2,0,1047,10,883
강원도,강릉시,교2동,교2동제2투,1646,1048,252,440,219,67,57,0,0,2,0,0,0,1,2,1040,8,598
강원도,강릉시,교2동,교2동제3투,2073,1512,464,538,297,116,88,2,0,1,0,0,0,3,2,1511,1,561
강원도,강릉시,포남1동,관내사전투표,1371,1371,469,436,264,100,88,0,0,0,0,2,1,0,0,1360,11,0
강원도,강릉시,포남1동,합계,9245,6568,1739,2624,1376,428,335,11,0,3,1,4,5,3,5,6534,34,2677
강원도,강릉시,포남1동,포남1동제1투,2750,1838,451,761,390,118,99,2,0,0,0,0,1,3,3,1828,10,912
강원도,강릉시,포남1동,포남1동제2투,2508,1612,392,737,336,87,50,2,0,1,1,0,0,0,1,1607,5,896
강원도,강릉시,포남1동,포남1동제3투,2616,1747,427,690,386,123,98,7,0,2,0,2,3,0,1,1739,8,869
강원도,강릉시,포남2동,합계,11654,8399,2548,2819,1756,621,568,18,0,2,6,6,4,5,9,8362,37,3255
강원도,강릉시,포남2동,관내사전투표,2286,2286,883,594,399,177,200,5,0,0,3,2,0,4,2,2269,17,0
강원도,강릉시,포남2동,포남2동제1투,2647,1569,411,630,319,103,87,4,0,0,1,2,1,0,3,1561,8,1078
강원도,강릉시,포남2동,포남2동제2투,2453,1648,452,561,402,123,98,4,0,0,1,0,1,0,1,1643,5,805
강원도,강릉시,포남2동,포남2동제3투,2164,1410,403,487,315,102,91,2,0,0,1,1,0,0,2,1404,6,754
강원도,강릉시,포남2동,포남2동제4투,2104,1486,399,547,321,116,92,3,0,2,0,1,2,1,1,1485,1,618
강원도,강릉시,초당동,합계,4138,3149,1116,918,643,242,202,4,0,1,0,4,0,3,4,3137,12,989
강원도,강릉시,초당동,관내사전투표,1025,1025,434,231,181,92,78,2,0,0,0,1,0,1,1,1021,4,0
강원도,강릉시,초당동,초당동제1투,1297,857,242,334,160,68,41,2,0,1,0,0,0,1,0,849,8,440
강원도,강릉시,초당동,초당동제2투,1816,1267,440,353,302,82,83,0,0,0,0,3,0,1,3,1267,0,549
강원도,강릉시,송정동,관내사전투표,1352,1352,577,347,231,89,100,2,0,1,0,0,0,0,1,1348,4,0
강원도,강릉시,송정동,합계,5455,4148,1390,1325,858,296,242,9,1,3,0,1,0,2,3,4130,18,1307
강원도,강릉시,송정동,송정동제1투,1833,1224,288,508,266,92,57,1,0,0,0,1,0,1,1,1215,9,609
강원도,강릉시,송정동,송정동제2투,2270,1572,525,470,361,115,85,6,1,2,0,0,0,1,1,1567,5,698
강원도,강릉시,내곡동,합계,10561,7790,2612,2297,1584,644,581,9,0,6,0,5,2,7,9,7756,34,2771
강원도,강릉시,내곡동,관내사전투표,2078,2078,859,456,374,184,182,2,0,2,0,3,0,1,4,2067,11,0
강원도,강릉시,내곡동,내곡동제1투,4005,2815,857,926,610,223,182,3,0,3,0,0,1,2,4,2811,4,1190
강원도,강릉시,내곡동,내곡동제2투,4478,2897,896,915,600,237,217,4,0,1,0,2,1,4,1,2878,19,1581
강원도,강릉시,강남동,관내사전투표,2669,2669,991,768,480,215,181,6,0,1,2,5,1,1,5,2656,13,0
강원도,강릉시,강남동,합계,15443,11023,3117,4107,2317,745,610,20,2,8,4,11,3,12,20,10976,47,4420
강원도,강릉시,강남동,강남동제1투,2810,1836,481,749,401,102,88,1,1,2,0,2,0,1,3,1831,5,974
강원도,강릉시,강남동,강남동제2투,2565,1687,400,678,384,102,95,3,0,2,0,2,2,2,0,1670,17,878
강원도,강릉시,강남동,강남동제3투,2939,1863,462,762,418,120,90,4,0,0,1,2,0,0,2,1861,2,1076
강원도,강릉시,강남동,강남동제4투,2656,1795,552,600,390,129,109,2,0,3,0,0,0,1,5,1791,4,861
강원도,강릉시,강남동,강남동제5투,1048,690,143,318,144,48,24,3,1,0,0,0,0,3,2,686,4,358
강원도,강릉시,강남동,강남동제6투,756,483,88,232,100,29,23,1,0,0,1,0,0,4,3,481,2,273
강원도,강릉시,성덕동,합계,20615,15025,5246,4254,3152,1182,1039,20,1,8,4,10,10,7,14,14947,78,5590
강원도,강릉시,성덕동,관내사전투표,3189,3189,1395,702,534,284,247,4,0,2,0,5,0,0,7,3180,9,0
강원도,강릉시,성덕동,성덕동제1투,2964,1928,600,600,463,131,119,3,0,0,0,1,2,1,1,1921,7,1036
강원도,강릉시,성덕동,성덕동제2투,3372,2291,707,711,531,164,161,1,0,2,1,0,0,2,0,2280,11,1081
강원도,강릉시,성덕동,성덕동제3투,3786,2405,664,866,507,176,146,6,1,3,2,3,6,0,2,2382,23,1381
강원도,강릉시,성덕동,성덕동제4투,3016,2103,710,621,436,175,148,2,0,0,0,0,1,0,1,2094,9,913
강원도,강릉시,성덕동,성덕동제5투,3017,2233,944,450,483,177,160,3,0,0,0,1,1,3,1,2223,10,784
강원도,강릉시,성덕동,성덕동제6투,1271,876,226,304,198,75,58,1,0,1,1,0,0,1,2,867,9,395
강원도,강릉시,경포동,합계,3935,2764,764,1068,560,196,139,4,1,4,0,1,1,1,5,2744,20,1171
강원도,강릉시,경포동,관내사전투표,408,408,147,112,76,43,28,0,0,0,0,0,0,0,0,406,2,0
강원도,강릉시,경포동,경포동제1투,2111,1372,378,533,287,95,61,2,0,3,0,1,0,0,1,1361,11,739
강원도,강릉시,경포동,경포동제2투,1416,984,239,423,197,58,50,2,1,1,0,0,1,1,4,977,7,432
강원도,강릉시,잘못 투입·구분된 투표지,,0,0,0,0,0,0,0,0,0,0,0,0,0,0,0,0,0,0
강원도,동해시,합계,,76059,55542,17184,19009,11345,3917,3406,95,9,47,24,69,38,38,88,55269,273,20517
강원도,동해시,거소·선상투표,,874,854,241,129,274,103,38,6,0,2,0,1,0,0,16,810,44,20
강원도,동해시,관외사전투표,,5311,5310,2161,939,1097,535,503,7,1,2,3,8,3,3,6,5268,42,1
강원도,동해시,재외투표,,228,168,90,20,26,9,22,0,0,0,0,0,0,0,0,167,1,60
강원도,동해시,천곡동,합계,22159,16049,5193,5147,3352,1222,978,35,5,13,10,18,5,3,21,16002,47,6110
강원도,동해시,천곡동,관내사전투표,4618,4618,1856,1200,828,358,336,7,2,2,1,5,2,0,10,4607,11,0
강원도,동해시,천곡동,천곡동제1투,1964,1267,319,490,283,83,78,4,0,2,0,0,2,1,0,1262,5,697
강원도,동해시,천곡동,천곡동제2투,1691,1025,247,392,221,85,61,2,0,2,3,3,0,0,1,1017,8,666
강원도,동해시,천곡동,천곡동제3투,2063,1214,346,430,273,103,56,3,0,0,0,1,0,0,0,1212,2,849
강원도,동해시,천곡동,천곡동제4투,1859,1172,290,476,243,86,60,5,1,1,2,4,0,1,1,1170,2,687
강원도,동해시,천곡동,천곡동제5투,1678,1094,257,467,224,87,49,1,1,1,0,0,0,0,3,1090,4,584
강원도,동해시,천곡동,천곡동제6투,1514,1105,306,408,231,82,66,2,0,1,1,2,0,0,3,1102,3,409
강원도,동해시,천곡동,천곡동제7투,1895,1110,313,434,208,74,63,4,1,2,2,0,1,0,3,1105,5,785
강원도,동해시,천곡동,천곡동제8투,2768,1988,763,456,479,161,120,2,0,2,0,3,0,0,0,1986,2,780
강원도,동해시,천곡동,천곡동제9투,2109,1456,496,394,362,103,89,5,0,0,1,0,0,1,0,1451,5,653
강원도,동해시,송정동,관내사전투표,807,807,278,230,141,82,60,2,0,1,0,1,2,1,4,802,5,0
강원도,동해시,송정동,합계,3880,2712,700,1122,518,178,147,3,0,4,1,5,5,5,8,2696,16,1168
강원도,동해시,송정동,송정동제1투,2089,1238,256,598,245,61,52,0,0,3,1,4,3,4,2,1229,9,851
강원도,동해시,송정동,송정동제2투,984,667,166,294,132,35,35,1,0,0,0,0,0,0,2,665,2,317
강원도,동해시,북삼동,합계,14546,10737,3887,2979,2241,777,749,14,0,7,3,21,4,6,14,10702,35,3809
강원도,동해시,북삼동,관내사전투표,3146,3146,1432,629,538,265,253,2,0,0,1,10,1,1,3,3135,11,0
강원도,동해시,북삼동,북삼동제1투,1178,723,132,348,165,32,40,1,0,0,0,1,0,0,2,721,2,455
강원도,동해시,북삼동,북삼동제2투,1060,685,160,287,159,29,37,2,0,0,0,3,0,1,2,680,5,375
강원도,동해시,북삼동,북삼동제3투,1861,1222,372,440,267,68,65,2,0,0,0,1,1,2,3,1221,1,639
강원도,동해시,북삼동,북삼동제4투,2300,1517,537,367,353,118,131,2,0,2,0,2,0,1,2,1515,2,783
강원도,동해시,북삼동,북삼동제5투,2283,1553,528,472,320,124,93,2,0,3,1,1,0,0,1,1545,8,730
강원도,동해시,북삼동,북삼동제6투,2718,1891,726,436,439,141,130,3,0,2,1,3,2,1,1,1885,6,827
강원도,동해시,부곡동,합계,4987,3379,821,1406,710,209,195,5,0,2,1,4,4,4,3,3364,15,1608
강원도,동해시,부곡동,관내사전투표,877,877,274,297,155,71,66,0,0,1,1,1,1,1,2,870,7,0
강원도,동해시,부곡동,부곡동제1투,1742,1090,242,490,236,48,65,0,0,0,0,2,1,1,0,1085,5,652
강원도,동해시,부곡동,부곡동제2투,1232,746,178,312,171,43,32,3,0,0,0,0,2,1,1,743,3,486
강원도,동해시,부곡동,부곡동제3투,1136,666,127,307,148,47,32,2,0,1,0,1,0,1,0,666,0,470
강원도,동해시,동호동,합계,3588,2307,545,1082,427,119,98,4,1,4,2,3,3,3,4,2295,12,1281
강원도,동해시,동호동,관내사전투표,489,489,182,172,78,29,21,0,0,1,0,1,0,0,3,487,2,0
강원도,동해시,동호동,동호동제1투,1332,765,148,393,145,36,31,1,0,1,1,1,1,0,0,758,7,567
강원도,동해시,동호동,동호동제2투,1767,1053,215,517,204,54,46,3,1,2,1,1,2,3,1,1050,3,714
강원도,동해시,발한동,합계,3777,2506,593,1191,478,108,104,3,1,4,1,1,3,3,4,2494,12,1271
강원도,동해시,발한동,관내사전투표,691,691,234,266,107,37,41,1,0,2,0,1,0,0,1,690,1,0
강원도,동해시,발한동,발한동제1투,1399,793,162,415,148,36,21,1,0,1,1,0,3,1,0,789,4,606
강원도,동해시,발한동,발한동제2투,1687,1022,197,510,223,35,42,1,1,1,0,0,0,2,3,1015,7,665
강원도,동해시,묵호동,합계,3153,2020,461,1016,356,90,77,3,0,0,1,2,1,1,3,2011,9,1133
강원도,동해시,묵호동,관내사전투표,379,379,127,162,52,20,13,0,0,0,0,0,0,0,2,376,3,0
강원도,동해시,묵호동,묵호동제1투,2038,1183,249,610,213,50,48,3,0,0,0,2,1,1,1,1178,5,855
강원도,동해시,묵호동,묵호동제2투,736,458,85,244,91,20,16,0,0,0,1,0,0,0,0,457,1,278
강원도,동해시,북평동,합계,7385,5339,1518,2110,1054,324,277,8,0,4,1,5,8,4,3,5316,23,2046
강원도,동해시,북평동,관내사전투표,1481,1481,506,516,253,96,88,3,0,1,0,1,1,2,2,1469,12,0
강원도,동해시,북평동,북평동제1투,1842,1147,297,491,230,61,56,3,0,1,1,0,3,2,0,1145,2,695
강원도,동해시,북평동,북평동제2투,1715,1097,244,515,224,56,47,1,0,0,0,2,3,0,0,1092,5,618
강원도,동해시,북평동,북평동제3투,2347,1614,471,588,347,111,86,1,0,2,0,2,1,0,1,1610,4,733
강원도,동해시,망상동,합계,3390,2228,543,1000,441,123,98,6,0,4,0,0,1,3,5,2224,4,1162
강원도,동해시,망상동,관내사전투표,486,486,152,160,102,34,36,0,0,0,0,0,0,1,0,485,1,0
강원도,동해시,망상동,망상동제1투,1083,694,140,362,129,34,23,2,0,1,0,0,1,1,1,694,0,389
강원도,동해시,망상동,망상동제2투,1821,1048,251,478,210,55,39,4,0,3,0,0,0,1,4,1045,3,773
강원도,동해시,삼화동,합계,2781,1933,431,868,371,120,120,1,1,1,1,1,1,3,1,1920,13,848
강원도,동해시,삼화동,관내사전투표,511,511,142,221,68,40,35,0,0,0,1,0,1,1,0,509,2,0
강원도,동해시,삼화동,삼화동제1투,1350,838,166,370,186,50,56,0,1,0,0,1,0,1,0,831,7,512
강원도,동해시,삼화동,삼화동제2투,920,584,123,277,117,30,29,1,0,1,0,0,0,1,1,580,4,336
강원도,동해시,잘못 투입·구분된 투표지,,0,0,0,0,0,0,0,0,0,0,0,0,0,0,0,0,0,0
강원도,삼척시,합계,,59080,44097,13496,15971,8185,2878,2898,52,13,38,21,41,42,77,86,43798,299,14983
강원도,삼척시,거소·선상투표,,203,182,51,50,47,12,6,1,0,1,2,1,1,2,1,175,7,21
강원도,삼척시,관외사전투표,,5482,5482,2283,909,975,590,634,7,1,3,5,5,0,2,12,5426,56,0
강원도,삼척시,재외투표,,189,140,91,10,14,4,15,2,0,0,0,0,0,0,0,136,4,49
강원도,삼척시,도계읍,합계,9031,6168,1482,2547,1190,411,446,7,1,2,2,4,6,14,11,6123,45,2863
강원도,삼척시,도계읍,관내사전투표,1377,1377,402,523,252,82,96,3,1,1,0,1,0,1,0,1362,15,0
강원도,삼척시,도계읍,도계읍제1투,341,227,35,104,66,7,8,0,0,0,1,0,1,1,2,225,2,114
강원도,삼척시,도계읍,도계읍제2투,873,384,66,214,65,25,8,1,0,0,0,0,0,0,2,381,3,489
강원도,삼척시,도계읍,도계읍제3투,1068,732,137,374,114,39,52,0,0,0,0,2,3,5,1,727,5,336
강원도,삼척시,도계읍,도계읍제4투,1584,1028,215,472,199,65,66,1,0,1,0,0,2,0,1,1022,6,556
강원도,삼척시,도계읍,도계읍제5투,528,298,68,133,56,17,19,2,0,0,0,0,0,1,1,297,1,230
강원도,삼척시,도계읍,도계읍제6투,1609,1033,242,371,219,99,91,0,0,0,0,0,0,2,3,1027,6,576
강원도,삼척시,도계읍,도계읍제7투,129,106,16,57,22,2,5,0,0,0,1,0,0,2,0,105,1,23
강원도,삼척시,도계읍,도계읍제8투,1522,983,301,299,197,75,101,0,0,0,0,1,0,2,1,977,6,539
강원도,삼척시,원덕읍,관내사전투표,891,891,290,348,132,55,53,1,0,1,1,4,0,0,2,887,4,0
강원도,삼척시,원덕읍,합계,4672,3288,785,1575,557,155,146,4,1,5,1,7,7,14,7,3264,24,1384
강원도,삼척시,원덕읍,원덕읍제1투,1434,926,204,472,154,44,34,0,1,0,0,2,2,6,2,921,5,508
강원도,삼척시,원덕읍,원덕읍제2투,568,358,78,159,73,23,18,0,0,1,0,0,1,1,1,355,3,210
강원도,삼척시,원덕읍,원덕읍제3투,1168,708,113,380,133,28,30,3,0,3,0,1,0,5,1,697,11,460
강원도,삼척시,원덕읍,원덕읍제4투,414,279,79,136,49,1,8,0,0,0,0,0,4,1,1,279,0,135
강원도,삼척시,원덕읍,원덕읍제5투,197,126,21,80,16,4,3,0,0,0,0,0,0,1,0,125,1,71
강원도,삼척시,근덕면,관내사전투표,680,680,197,260,126,39,48,0,2,0,2,0,2,0,2,678,2,0
강원도,삼척시,근덕면,합계,4741,3352,746,1625,630,167,116,2,4,1,3,3,8,10,9,3324,28,1389
강원도,삼척시,근덕면,근덕면제1투,520,358,102,161,63,14,8,0,0,0,0,1,2,2,1,354,4,162
강원도,삼척시,근덕면,근덕면제2투,1512,902,172,472,174,44,21,0,0,0,1,0,2,2,2,890,12,610
강원도,삼척시,근덕면,근덕면제3투,771,518,99,268,103,18,16,1,1,0,0,1,2,2,2,513,5,253
강원도,삼척시,근덕면,근덕면제4투,684,454,80,247,73,26,15,1,1,1,0,1,0,3,2,450,4,230
강원도,삼척시,근덕면,근덕면제5투,574,440,96,217,91,26,8,0,0,0,0,0,0,1,0,439,1,134
강원도,삼척시,하장면,합계,1179,847,258,299,198,31,41,2,1,2,0,1,3,1,4,841,6,332
강원도,삼척시,하장면,관내사전투표,148,148,46,48,30,7,13,0,1,0,0,0,1,1,1,148,0,0
강원도,삼척시,하장면,하장면제1투,440,287,89,107,72,7,9,0,0,0,0,0,1,0,1,286,1,153
강원도,삼척시,하장면,하장면제2투,240,169,33,58,54,6,11,2,0,2,0,1,0,0,1,168,1,71
강원도,삼척시,하장면,하장면제3투,351,243,90,86,42,11,8,0,0,0,0,0,1,0,1,239,4,108
강원도,삼척시,노곡면,합계,665,502,134,229,103,14,12,0,0,0,0,1,1,4,2,500,2,163
강원도,삼척시,노곡면,관내사전투표,103,103,45,35,14,1,6,0,0,0,0,0,0,1,1,103,0,0
강원도,삼척시,노곡면,노곡면제1투,335,240,47,107,64,13,4,0,0,0,0,0,1,1,1,238,2,95
강원도,삼척시,노곡면,노곡면제2투,227,159,42,87,25,0,2,0,0,0,0,1,0,2,0,159,0,68
강원도,삼척시,미로면,합계,1688,1236,281,549,269,48,65,2,0,2,0,1,1,6,6,1230,6,452
강원도,삼척시,미로면,관내사전투표,291,291,86,106,57,17,21,0,0,0,0,1,1,2,0,291,0,0
강원도,삼척시,미로면,미로면제1투,763,518,100,241,113,21,32,2,0,2,0,0,0,3,2,516,2,245
강원도,삼척시,미로면,미로면제2투,382,259,55,111,72,8,7,0,0,0,0,0,0,0,3,256,3,123
강원도,삼척시,미로면,미로면제3투,252,168,40,91,27,2,5,0,0,0,0,0,0,1,1,167,1,84
강원도,삼척시,가곡면,합계,645,477,125,215,90,15,21,1,0,0,1,0,1,4,0,473,4,168
강원도,삼척시,가곡면,관내사전투표,142,142,48,51,30,4,8,0,0,0,0,0,1,0,0,142,0,0
강원도,삼척시,가곡면,가곡면제1투,248,140,31,67,21,5,10,0,0,0,0,0,0,2,0,136,4,108
강원도,삼척시,가곡면,가곡면제2투,255,195,46,97,39,6,3,1,0,0,1,0,0,2,0,195,0,60
강원도,삼척시,신기면,합계,622,447,111,219,63,18,23,1,0,0,1,1,1,3,2,443,4,175
강원도,삼척시,신기면,관내사전투표,145,145,54,55,20,5,7,1,0,0,1,0,1,1,0,145,0,0
강원도,삼척시,신기면,신기면투표소,477,302,57,164,43,13,16,0,0,0,0,1,0,2,2,298,4,175
강원도,삼척시,남양동,합계,7223,5293,1437,2244,978,294,282,6,0,4,0,5,5,4,8,5267,26,1930
강원도,삼척시,남양동,관내사전투표,1289,1289,499,394,202,96,83,0,0,1,0,1,2,0,0,1278,11,0
강원도,삼척시,남양동,남양동제1투,968,613,124,308,118,36,25,0,0,0,0,0,0,0,0,611,2,355
강원도,삼척시,남양동,남양동제2투,1108,744,172,377,122,39,30,1,0,1,0,1,0,0,0,743,1,364
강원도,삼척시,남양동,남양동제3투,1576,1114,289,489,207,60,58,4,0,0,0,1,0,0,3,1111,3,462
강원도,삼척시,남양동,남양동제4투,1592,1082,266,442,241,49,68,0,0,1,0,1,3,0,4,1075,7,510
강원도,삼척시,남양동,남양동제5투,690,451,87,234,88,14,18,1,0,1,0,1,0,4,1,449,2,239
강원도,삼척시,성내동,합계,7472,5572,1852,1999,957,345,341,11,2,9,2,6,2,6,10,5542,30,1900
강원도,삼척시,성내동,관내사전투표,1961,1961,865,460,321,145,148,3,0,4,0,2,1,3,4,1956,5,0
강원도,삼척시,성내동,성내동제1투,1545,1031,264,452,201,48,53,1,1,2,0,1,0,1,2,1026,5,514
강원도,삼척시,성내동,성내동제2투,1075,726,199,281,140,50,48,1,0,0,0,1,0,0,0,720,6,349
강원도,삼척시,성내동,성내동제3투,1779,1175,313,517,198,68,55,5,1,3,2,2,0,0,3,1167,8,604
강원도,삼척시,성내동,성내동제4투,1112,679,211,289,97,34,37,1,0,0,0,0,1,2,1,673,6,433
강원도,삼척시,교동,합계,8435,6581,2499,1813,1221,506,480,2,0,5,2,4,2,6,8,6548,33,1854
강원도,삼척시,교동,관내사전투표,2546,2546,1165,541,408,218,198,1,0,1,0,1,0,1,1,2535,11,0
강원도,삼척시,교동,교동제1투,2227,1572,528,473,323,133,100,0,0,1,1,1,1,3,2,1566,6,655
강원도,삼척시,교동,교동제2투,958,596,168,213,132,31,38,1,0,0,0,1,1,1,2,588,8,362
강원도,삼척시,교동,교동제3투,2704,1867,638,586,358,124,144,0,0,3,1,1,0,1,3,1859,8,837
강원도,삼척시,정라동,관내사전투표,405,405,117,166,69,28,22,0,0,1,0,0,0,0,0,403,2,0
강원도,삼척시,정라동,합계,6833,4530,1361,1688,893,268,270,4,3,4,2,2,4,1,6,4506,24,2303
강원도,삼척시,정라동,정라동제1투,1402,831,142,464,168,27,24,0,0,0,0,0,0,1,1,827,4,571
강원도,삼척시,정라동,정라동제2투,2238,1377,397,534,252,87,90,0,3,0,0,0,1,0,4,1368,9,861
강원도,삼척시,정라동,정라동제3투,1847,1242,488,308,253,88,93,3,0,1,1,1,0,0,1,1237,5,605
강원도,삼척시,정라동,정라동제4투,941,675,217,216,151,38,41,1,0,2,1,1,3,0,0,671,4,266
강원도,삼척시,잘못 투입·구분된 투표지,,0,0,0,0,0,0,0,0,0,0,0,0,0,0,0,0,0,0
강원도,태백시,합계,,39001,28101,9557,10046,4971,1468,1736,30,8,24,10,28,12,35,27,27952,149,10900
강원도,태백시,거소·선상투표,,87,81,33,23,18,3,1,0,1,0,0,0,0,0,0,79,2,6
강원도,태백시,관외사전투표,,3044,3044,1352,546,539,244,321,4,2,0,0,3,4,1,2,3018,26,0
강원도,태백시,재외투표,,113,89,59,7,12,0,10,0,0,0,0,0,0,1,0,89,0,24
강원도,태백시,황지동,합계,6010,4436,1600,1471,795,235,297,3,0,2,2,5,3,1,3,4417,19,1574
강원도,태백시,황지동,관내사전투표,1765,1765,819,377,268,116,167,0,0,1,1,2,1,0,3,1755,10,0
강원도,태백시,황지동,황지동제1투,1890,1125,280,529,230,33,46,1,0,0,0,0,1,1,0,1121,4,765
강원도,태백시,황지동,황지동제2투,1627,1048,356,354,214,58,58,1,0,0,1,1,1,0,0,1044,4,579
강원도,태백시,황지동,황지동제3투,728,498,145,211,83,28,26,1,0,1,0,2,0,0,0,497,1,230
강원도,태백시,황연동,합계,4357,2976,812,1266,602,122,122,2,2,4,1,8,3,7,3,2954,22,1381
강원도,태백시,황연동,관내사전투표,895,895,321,313,160,40,45,2,0,0,1,6,0,2,1,891,4,0
강원도,태백시,황연동,황연동제1투,1379,819,226,324,186,39,29,0,1,2,0,2,0,2,2,813,6,560
강원도,태백시,황연동,황연동제2투,819,505,110,243,106,19,17,0,1,0,0,0,1,1,0,498,7,314
강원도,태백시,황연동,황연동제3투,1264,757,155,386,150,24,31,0,0,2,0,0,2,2,0,752,5,507
강원도,태백시,삼수동,합계,4881,3071,948,1201,552,145,192,3,0,3,2,3,0,3,3,3055,16,1810
강원도,태백시,삼수동,관내사전투표,602,602,236,202,82,34,45,0,0,0,0,0,0,0,0,599,3,0
강원도,태백시,삼수동,삼수동제1투,2271,1217,374,469,229,54,76,2,0,0,1,2,0,0,2,1209,8,1054
강원도,태백시,삼수동,삼수동제2투,1573,985,263,414,197,48,51,1,0,3,1,1,0,2,0,981,4,588
강원도,태백시,삼수동,삼수동제3투,435,267,75,116,44,9,20,0,0,0,0,0,0,1,1,266,1,168
강원도,태백시,상장동,관내사전투표,1412,1412,652,360,201,81,111,1,0,2,0,0,0,0,1,1409,3,0
강원도,태백시,상장동,합계,9507,6612,2596,2027,1120,376,442,7,0,7,1,2,0,8,8,6594,18,2895
강원도,태백시,상장동,상장동제1투,1327,766,179,334,162,48,31,3,0,1,0,0,0,2,0,760,6,561
강원도,태백시,상장동,상장동제2투,2572,1780,757,469,308,104,132,2,0,1,1,1,0,0,0,1775,5,792
강원도,태백시,상장동,상장동제3투,1143,764,318,232,121,32,53,1,0,0,0,0,0,1,3,761,3,379
강원도,태백시,상장동,상장동제4투,998,606,178,258,106,34,25,0,0,2,0,0,0,3,0,606,0,392
강원도,태백시,상장동,상장동제5투,2055,1284,512,374,222,77,90,0,0,1,0,1,0,2,4,1283,1,771
강원도,태백시,문곡소도동,합계,3139,2168,649,903,382,103,107,4,2,1,3,3,1,1,1,2160,8,971
강원도,태백시,문곡소도동,관내사전투표,353,353,147,105,51,26,24,0,0,0,0,0,0,0,0,353,0,0
강원도,태백시,문곡소도동,문곡소도동제1투,729,402,92,194,78,14,14,1,0,0,0,1,1,1,1,397,5,327
강원도,태백시,문곡소도동,문곡소도동제2투,967,668,186,297,114,27,35,1,2,1,1,2,0,0,0,666,2,299
강원도,태백시,문곡소도동,문곡소도동제3투,1090,745,224,307,139,36,34,2,0,0,2,0,0,0,0,744,1,345
강원도,태백시,장성동,관내사전투표,1006,1006,306,422,183,37,43,0,0,2,1,0,0,2,1,997,9,0
강원도,태백시,장성동,합계,3282,2402,697,1039,431,96,108,3,0,2,1,2,0,6,3,2388,14,880
강원도,태백시,장성동,장성동제1투,604,311,68,163,59,8,8,0,0,0,0,0,0,1,0,307,4,293
강원도,태백시,장성동,장성동제2투,916,585,175,234,109,30,33,1,0,0,0,1,0,1,1,585,0,331
강원도,태백시,장성동,장성동제3투,756,500,148,220,80,21,24,2,0,0,0,1,0,2,1,499,1,256
강원도,태백시,구문소동,합계,2422,1720,451,824,262,80,81,2,0,2,0,1,1,3,2,1709,11,702
강원도,태백시,구문소동,관내사전투표,523,523,185,203,70,30,32,0,0,0,0,0,0,2,1,523,0,0
강원도,태백시,구문소동,구문소동제1투,1219,751,184,358,116,42,40,2,0,1,0,1,0,0,1,745,6,468
강원도,태백시,구문소동,구문소동제2투,680,446,82,263,76,8,9,0,0,1,0,0,1,1,0,441,5,234
강원도,태백시,철암동,합계,2159,1502,360,739,258,64,55,2,1,3,0,1,0,4,2,1489,13,657
강원도,태백시,철암동,관내사전투표,411,411,139,169,56,24,16,1,1,0,0,1,0,2,0,409,2,0
강원도,태백시,철암동,철암동제1투,958,604,135,317,102,18,23,0,0,1,0,0,0,0,1,597,7,354
강원도,태백시,철암동,철암동제2투,790,487,86,253,100,22,16,1,0,2,0,0,0,2,1,483,4,303
강원도,태백시,잘못 투입·구분된 투표지,,0,0,0,0,0,0,0,0,0,0,0,0,0,0,0,0,0,0
강원도,정선군,합계,,33408,23859,8270,8323,4489,1170,1215,32,15,22,7,35,19,46,64,23707,152,9549
강원도,정선군,거소·선상투표,,89,79,26,29,18,1,4,0,0,0,0,0,0,0,0,78,1,10
강원도,정선군,관외사전투표,,2684,2684,1190,523,499,203,235,2,1,1,1,2,1,2,7,2667,17,0
강원도,정선군,재외투표,,82,60,32,6,9,5,7,0,0,0,0,0,0,0,0,59,1,22
강원도,정선군,정선읍,관내사전투표,1766,1766,820,401,267,122,131,1,1,2,1,1,0,2,6,1755,11,0
강원도,정선군,정선읍,합계,8521,6105,2282,1985,1130,334,279,5,7,4,1,13,1,9,14,6064,41,2416
강원도,정선군,정선읍,정선읍제1투,1611,955,313,362,194,44,27,2,0,1,0,3,0,0,1,947,8,656
강원도,정선군,정선읍,정선읍제2투,1517,1011,332,408,190,37,32,1,0,0,0,3,0,1,2,1006,5,506
강원도,정선군,정선읍,정선읍제3투,1491,1000,403,267,206,61,50,1,4,0,0,2,0,1,1,996,4,491
강원도,정선군,정선읍,정선읍제4투,965,564,187,204,100,42,20,0,1,1,0,0,1,2,3,561,3,401
강원도,정선군,정선읍,정선읍제5투,617,429,106,204,87,13,11,0,1,0,0,1,0,2,0,425,4,188
강원도,정선군,정선읍,정선읍제6투,268,180,52,69,47,6,3,0,0,0,0,0,0,0,1,178,2,88
강원도,정선군,정선읍,정선읍제7투,286,200,69,70,39,9,5,0,0,0,0,3,0,1,0,196,4,86
강원도,정선군,고한읍,합계,3855,2419,928,778,422,124,143,1,0,1,0,3,1,1,2,2404,15,1436
강원도,정선군,고한읍,관내사전투표,798,798,383,189,131,43,48,0,0,0,0,0,0,1,1,796,2,0
강원도,정선군,고한읍,고한읍제1투,1101,450,158,148,94,19,27,0,0,0,0,0,0,0,0,446,4,651
강원도,정선군,고한읍,고한읍제2투,1303,781,263,287,126,47,50,0,0,0,0,2,1,0,0,776,5,522
강원도,정선군,고한읍,고한읍제3투,653,390,124,154,71,15,18,1,0,1,0,1,0,0,1,386,4,263
강원도,정선군,사북읍,관내사전투표,727,727,344,177,104,37,58,1,1,0,0,2,1,1,0,726,1,0
강원도,정선군,사북읍,합계,4082,2694,895,985,480,135,168,1,1,1,1,4,2,2,4,2679,15,1388
강원도,정선군,사북읍,사북읍제1투,2234,1312,403,480,265,68,80,0,0,1,1,1,1,0,1,1301,11,922
강원도,정선군,사북읍,사북읍제2투,1121,655,148,328,111,30,30,0,0,0,0,1,0,1,3,652,3,466
강원도,정선군,신동읍,합계,3066,2112,653,783,449,88,85,7,3,6,2,5,3,4,4,2092,20,954
강원도,정선군,신동읍,관내사전투표,359,359,162,85,75,18,14,0,1,0,0,0,0,0,0,355,4,0
강원도,정선군,신동읍,신동읍제1투,1044,695,208,270,141,23,33,4,0,0,1,1,1,3,3,688,7,349
강원도,정선군,신동읍,신동읍제2투,931,566,147,216,130,31,26,3,1,4,1,2,0,1,0,562,4,365
강원도,정선군,신동읍,신동읍제3투,368,243,54,117,49,12,4,0,1,1,0,0,2,0,1,241,2,125
강원도,정선군,신동읍,신동읍제4투,364,249,82,95,54,4,8,0,0,1,0,2,0,0,0,246,3,115
강원도,정선군,화암면,합계,1365,925,287,402,145,34,42,0,0,0,0,0,2,8,1,921,4,440
강원도,정선군,화암면,관내사전투표,175,175,62,71,22,10,8,0,0,0,0,0,0,1,1,175,0,0
강원도,정선군,화암면,화암면제1투,967,613,185,270,103,19,27,0,0,0,0,0,1,4,0,609,4,354
강원도,정선군,화암면,화암면제2투,223,137,40,61,20,5,7,0,0,0,0,0,1,3,0,137,0,86
강원도,정선군,남면,합계,2764,1869,607,728,355,61,81,2,0,1,0,4,4,8,6,1857,12,895
강원도,정선군,남면,관내사전투표,363,363,158,112,57,12,21,0,0,0,0,0,1,0,1,362,1,0
강원도,정선군,남면,남면제1투,657,382,123,149,68,7,21,1,0,0,0,3,0,4,3,379,3,275
강원도,정선군,남면,남면제2투,1381,883,241,387,179,30,31,1,0,1,0,0,2,3,1,876,7,498
강원도,정선군,남면,남면제3투,363,241,85,80,51,12,8,0,0,0,0,1,1,1,1,240,1,122
강원도,정선군,여량면,합계,1734,1254,320,612,218,44,30,2,0,4,0,4,1,3,9,1247,7,480
강원도,정선군,여량면,관내사전투표,287,287,118,97,40,12,12,1,0,1,0,3,0,2,1,287,0,0
강원도,정선군,여량면,여량면제1투,1229,823,170,431,156,28,18,1,0,3,0,1,1,1,7,817,6,406
강원도,정선군,여량면,여량면제2투,218,144,32,84,22,4,0,0,0,0,0,0,0,0,1,143,1,74
강원도,정선군,북평면,관내사전투표,363,363,142,107,81,15,16,0,0,0,0,0,0,0,1,362,1,0
강원도,정선군,북평면,합계,2094,1465,446,567,318,58,53,4,3,1,1,0,2,2,4,1459,6,629
강원도,정선군,북평면,북평면제1투,1213,781,215,329,170,36,23,1,3,0,0,0,2,0,0,779,2,432
강원도,정선군,북평면,북평면제2투,518,321,89,131,67,7,14,3,0,1,1,0,0,2,3,318,3,197
강원도,정선군,임계면,합계,3072,2193,604,925,446,83,88,8,0,3,1,0,2,7,13,2180,13,879
강원도,정선군,임계면,관내사전투표,481,481,165,167,87,25,29,1,0,0,0,0,0,1,3,478,3,0
강원도,정선군,임계면,임계면제1투,953,641,185,276,112,28,23,5,0,1,0,0,0,4,5,639,2,312
강원도,정선군,임계면,임계면제2투,310,207,55,79,56,6,8,1,0,0,0,0,1,0,1,207,0,103
강원도,정선군,임계면,임계면제3투,658,428,116,191,85,12,11,0,0,1,1,0,1,1,3,422,6,230
강원도,정선군,임계면,임계면제4투,341,229,38,123,51,8,7,1,0,1,0,0,0,0,0,229,0,112
강원도,정선군,임계면,임계면제5투,329,207,45,89,55,4,10,0,0,0,0,0,0,1,1,205,2,122
강원도,정선군,잘못 투입·구분된 투표지,,0,0,0,0,0,0,0,0,0,0,0,0,0,0,0,0,0,0
강원도,속초시,합계,,67471,46985,15045,13883,11031,3422,3143,73,9,28,14,23,20,33,52,46776,209,20486
강원도,속초시,거소·선상투표,,269,254,91,41,75,16,19,2,1,0,2,0,0,1,0,248,6,15
강원도,속초시,관외사전투표,,5138,5138,2081,851,1091,494,535,7,5,1,1,9,2,4,16,5097,41,0
강원도,속초시,재외투표,,261,200,109,21,22,15,31,0,0,0,0,0,0,0,1,199,1,61
강원도,속초시,영랑동,합계,4622,3195,955,1188,666,191,164,6,0,2,3,1,1,4,3,3184,11,1427
강원도,속초시,영랑동,관내사전투표,938,938,368,278,157,65,63,1,0,0,0,0,1,0,2,935,3,0
강원도,속초시,영랑동,영랑동제1투,1376,857,216,355,195,46,40,1,0,0,0,0,0,2,0,855,2,519
강원도,속초시,영랑동,영랑동제2투,2308,1400,371,555,314,80,61,4,0,2,3,1,0,2,1,1394,6,908
강원도,속초시,동명동,관내사전투표,393,393,146,127,61,30,22,0,0,0,0,0,1,1,0,388,5,0
강원도,속초시,동명동,합계,2835,1832,503,706,396,121,84,4,0,1,0,3,1,3,3,1825,7,1003
강원도,속초시,동명동,동명동제1투,1424,818,206,292,212,59,38,4,0,0,0,2,0,2,2,817,1,606
강원도,속초시,동명동,동명동제2투,1018,621,151,287,123,32,24,0,0,1,0,1,0,0,1,620,1,397
강원도,속초시,금호동,합계,5677,3795,1023,1448,858,242,192,8,0,4,1,1,1,3,3,3784,11,1882
강원도,속초시,금호동,관내사전투표,914,914,271,319,201,56,62,1,0,0,0,0,1,0,1,912,2,0
강원도,속초시,금호동,금호동제1투,1282,691,147,297,170,42,29,1,0,1,0,0,0,0,1,688,3,591
강원도,속초시,금호동,금호동제2투,942,535,126,240,108,38,17,1,0,0,0,0,0,0,1,531,4,407
강원도,속초시,금호동,금호동제3투,1165,711,180,290,167,32,36,0,0,1,0,1,0,3,0,710,1,454
강원도,속초시,금호동,금호동제4투,1374,944,299,302,212,74,48,5,0,2,1,0,0,0,0,943,1,430
강원도,속초시,교동,관내사전투표,1757,1757,675,399,361,134,173,3,0,0,0,0,0,0,4,1749,8,0
강원도,속초시,교동,합계,8556,5787,1786,1759,1371,424,402,7,0,2,0,1,2,1,9,5764,23,2769
강원도,속초시,교동,교동제1투,1277,648,153,274,140,49,23,1,0,0,0,1,2,1,1,645,3,629
강원도,속초시,교동,교동제2투,2332,1483,480,408,377,110,100,2,0,0,0,0,0,0,2,1479,4,849
강원도,속초시,교동,교동제3투,1701,1019,287,314,269,70,71,1,0,0,0,0,0,0,2,1014,5,682
강원도,속초시,교동,교동제4투,1489,880,191,364,224,61,35,0,0,2,0,0,0,0,0,877,3,609
강원도,속초시,노학동,합계,16514,11130,3558,3340,2637,845,657,18,0,7,3,4,2,4,11,11086,44,5384
강원도,속초시,노학동,관내사전투표,2751,2751,1065,690,576,216,177,4,0,2,1,1,0,1,4,2737,14,0
강원도,속초시,노학동,노학동제1투,2865,1723,537,508,429,146,91,1,0,0,0,0,0,1,1,1714,9,1142
강원도,속초시,노학동,노학동제2투,2286,1430,403,532,305,97,81,4,0,0,0,0,1,1,1,1425,5,856
강원도,속초시,노학동,노학동제3투,2635,1482,444,443,374,117,89,4,0,3,0,2,1,0,2,1479,3,1153
강원도,속초시,노학동,노학동제4투,1545,921,273,312,213,59,57,2,0,0,1,1,0,0,0,918,3,624
강원도,속초시,노학동,노학동제5투,1853,1060,256,443,259,54,41,0,0,1,0,0,0,1,1,1056,4,793
강원도,속초시,노학동,노학동제6투,2579,1763,580,412,481,156,121,3,0,1,1,0,0,0,2,1757,6,816
강원도,속초시,조양동,관내사전투표,2576,2576,1177,445,485,196,249,3,2,1,0,1,1,3,2,2565,11,0
강원도,속초시,조양동,합계,17645,11856,4057,2984,2987,853,891,13,2,8,3,4,6,7,4,11819,37,5789
강원도,속초시,조양동,조양동제1투,1127,664,163,253,174,35,28,3,0,1,0,1,1,1,0,660,4,463
강원도,속초시,조양동,조양동제2투,2278,1429,486,328,394,105,110,1,0,2,0,0,0,0,0,1426,3,849
강원도,속초시,조양동,조양동제3투,2092,1163,338,319,316,86,89,0,0,2,2,0,1,1,1,1155,8,929
강원도,속초시,조양동,조양동제4투,3062,1866,572,479,519,133,147,4,0,2,1,2,0,1,1,1861,5,1196
강원도,속초시,조양동,조양동제5투,2496,1624,525,457,436,116,86,1,0,0,0,0,1,0,0,1622,2,872
강원도,속초시,조양동,조양동제6투,2481,1596,496,491,405,101,100,1,0,0,0,0,0,0,0,1594,2,885
강원도,속초시,조양동,조양동제7투,1533,938,300,212,258,81,82,0,0,0,0,0,2,1,0,936,2,595
강원도,속초시,청호동,합계,3185,1961,461,761,481,131,91,6,0,3,1,0,5,2,1,1943,18,1224
강원도,속초시,청호동,관내사전투표,484,484,137,157,112,46,29,1,0,0,0,0,0,0,0,482,2,0
강원도,속초시,청호동,청호동제1투,1807,957,185,419,236,48,45,3,0,2,0,0,4,0,1,943,14,850
강원도,속초시,청호동,청호동제2투,894,520,139,185,133,37,17,2,0,1,1,0,1,2,0,518,2,374
강원도,속초시,대포동,관내사전투표,300,300,107,87,62,19,24,0,0,0,0,0,0,0,0,299,1,0
강원도,속초시,대포동,합계,2769,1837,421,784,447,90,77,2,1,0,0,0,0,4,1,1827,10,932
강원도,속초시,대포동,대포동제1투,987,632,136,287,152,34,19,1,0,0,0,0,0,2,0,631,1,355
강원도,속초시,대포동,대포동제2투,1482,905,178,410,233,37,34,1,1,0,0,0,0,2,1,897,8,577
강원도,속초시,잘못 투입·구분된 투표지,,0,0,0,0,0,0,0,0,0,0,0,0,0,0,0,0,0,0
강원도,고성군,합계,,25637,18692,5664,6511,3964,1239,979,23,8,27,5,16,12,26,47,18521,171,6945
강원도,고성군,거소·선상투표,,289,283,93,48,58,48,13,0,0,0,0,0,0,0,2,262,21,6
강원도,고성군,관외사전투표,,2312,2311,996,367,456,211,243,2,1,3,0,4,0,1,5,2289,22,1
강원도,고성군,재외투표,,59,44,27,5,8,2,2,0,0,0,0,0,0,0,0,44,0,15
강원도,고성군,간성읍,합계,5604,4050,1331,1335,780,294,236,9,1,6,1,5,3,4,16,4021,29,1554
강원도,고성군,간성읍,관내사전투표,1357,1357,527,299,254,140,115,3,0,0,0,2,1,0,7,1348,9,0
강원도,고성군,간성읍,간성읍제1투,1134,698,211,256,145,39,32,1,0,2,0,0,1,0,3,690,8,436
강원도,고성군,간성읍,간성읍제2투,1815,1114,337,411,209,82,55,5,0,2,1,1,0,1,5,1109,5,701
강원도,고성군,간성읍,간성읍제3투,873,576,178,232,108,23,27,0,0,0,0,1,1,2,1,573,3,297
강원도,고성군,간성읍,간성읍제4투,238,169,44,76,39,2,2,0,0,1,0,1,0,0,0,165,4,69
강원도,고성군,간성읍,간성읍제5투,187,136,34,61,25,8,5,0,1,1,0,0,0,1,0,136,0,51
강원도,고성군,거진읍,관내사전투표,654,654,231,183,131,59,37,1,0,1,0,0,0,1,2,646,8,0
강원도,고성군,거진읍,합계,5669,3857,1057,1549,838,220,127,2,0,5,0,5,5,7,10,3825,32,1812
강원도,고성군,거진읍,거진읍제1투,1245,819,197,369,175,35,29,0,0,1,0,0,2,2,3,813,6,426
강원도,고성군,거진읍,거진읍제2투,1060,678,146,313,164,32,10,0,0,1,0,1,0,1,3,671,7,382
강원도,고성군,거진읍,거진읍제3투,701,395,120,148,85,25,11,0,0,2,0,1,0,0,1,393,2,306
강원도,고성군,거진읍,거진읍제4투,324,228,69,108,30,9,9,0,0,0,0,0,1,0,0,226,2,96
강원도,고성군,거진읍,거진읍제5투,541,340,104,122,75,22,11,0,0,0,0,0,1,0,1,336,4,201
강원도,고성군,거진읍,거진읍제6투,1144,743,190,306,178,38,20,1,0,0,0,3,1,3,0,740,3,401
강원도,고성군,현내면,합계,2210,1596,473,647,330,69,47,5,1,3,1,1,0,3,4,1584,12,614
강원도,고성군,현내면,관내사전투표,234,234,124,36,42,18,10,0,0,0,0,0,0,0,0,230,4,0
강원도,고성군,현내면,현내면제1투,656,434,126,167,103,17,11,3,0,1,0,0,0,0,3,431,3,222
강원도,고성군,현내면,현내면제2투,707,472,98,245,95,12,14,2,0,2,0,0,0,0,1,469,3,235
강원도,고성군,현내면,현내면제3투,347,258,70,99,63,16,7,0,0,0,0,0,0,2,0,257,1,89
강원도,고성군,현내면,현내면제4투,266,198,55,100,27,6,5,0,1,0,1,1,0,1,0,197,1,68
강원도,고성군,죽왕면,관내사전투표,475,475,174,126,102,34,30,1,0,0,1,0,0,1,1,470,5,0
강원도,고성군,죽왕면,합계,3259,2288,610,939,467,131,104,2,2,7,1,1,1,5,3,2273,15,971
강원도,고성군,죽왕면,죽왕면제1투,810,498,117,223,110,29,13,1,0,1,0,0,0,0,0,494,4,312
강원도,고성군,죽왕면,죽왕면제2투,540,331,80,132,79,22,11,0,1,1,0,1,0,0,1,328,3,209
강원도,고성군,죽왕면,죽왕면제3투,987,697,169,313,123,37,43,0,1,5,0,0,0,2,1,694,3,290
강원도,고성군,죽왕면,죽왕면제4투,447,287,70,145,53,9,7,0,0,0,0,0,1,2,0,287,0,160
강원도,고성군,토성면,합계,6235,4263,1077,1621,1027,264,207,3,3,3,2,0,3,6,7,4223,40,1972
강원도,고성군,토성면,관내사전투표,1091,1091,329,325,263,91,55,1,1,1,1,0,1,2,4,1074,17,0
강원도,고성군,토성면,토성면제1투,2028,1206,274,461,319,63,73,2,0,2,1,0,1,0,1,1197,9,822
강원도,고성군,토성면,토성면제2투,1023,680,126,321,162,41,21,0,0,0,0,0,1,1,0,673,7,343
강원도,고성군,토성면,토성면제3투,928,608,155,248,144,35,18,0,0,0,0,0,0,2,1,603,5,320
강원도,고성군,토성면,토성면제4투,1165,678,193,266,139,34,40,0,2,0,0,0,0,1,1,676,2,487
강원도,고성군,잘못 투입·구분된 투표지,,0,0,0,0,0,0,0,0,0,0,0,0,0,0,0,0,0,0
강원도,양양군,합계,,23853,17853,5017,6687,3868,1044,954,37,12,22,14,14,18,22,24,17733,120,6000
강원도,양양군,거소·선상투표,,56,54,24,11,13,0,3,0,1,0,0,0,0,0,1,53,1,2
강원도,양양군,관외사전투표,,1909,1908,798,384,402,145,159,2,0,2,1,1,0,0,2,1896,12,1
강원도,양양군,재외투표,,73,55,33,4,10,1,6,0,0,0,0,0,0,0,0,54,1,18
강원도,양양군,양양읍,합계,9046,6602,1901,2461,1383,404,372,9,6,4,2,6,6,6,7,6567,35,2444
강원도,양양군,양양읍,관내사전투표,1909,1909,709,568,359,118,133,1,0,2,0,2,3,3,3,1901,8,0
강원도,양양군,양양읍,양양읍제1투,2652,1708,463,632,364,116,107,2,5,2,1,1,1,1,2,1697,11,944
강원도,양양군,양양읍,양양읍제2투,1959,1254,338,496,275,71,63,2,0,0,0,1,1,1,2,1250,4,705
강원도,양양군,양양읍,양양읍제3투,1157,772,158,386,152,42,30,0,0,0,0,0,0,1,0,769,3,385
강원도,양양군,양양읍,양양읍제4투,719,484,131,190,102,32,22,1,0,0,0,2,0,0,0,480,4,235
강원도,양양군,양양읍,양양읍제5투,650,475,102,189,131,25,17,3,1,0,1,0,1,0,0,470,5,175
강원도,양양군,서면,관내사전투표,378,378,113,129,77,24,27,1,0,0,0,1,1,0,3,376,2,0
강원도,양양군,서면,합계,2548,1849,405,800,399,108,77,4,2,3,4,2,4,4,6,1818,31,699
강원도,양양군,서면,서면제1투,962,643,129,284,139,35,20,3,2,2,3,1,1,2,2,623,20,319
강원도,양양군,서면,서면제2투,527,362,73,162,76,27,18,0,0,1,0,0,0,1,0,358,4,165
강원도,양양군,서면,서면제3투,355,244,47,100,69,10,10,0,0,0,1,0,2,0,1,240,4,111
강원도,양양군,서면,서면제4투,326,222,43,125,38,12,2,0,0,0,0,0,0,1,0,221,1,104
강원도,양양군,손양면,관내사전투표,229,229,88,59,51,13,16,0,0,0,0,0,0,0,0,227,2,0
강원도,양양군,손양면,합계,1968,1444,389,569,312,80,73,3,1,1,4,2,0,2,1,1437,7,524
강원도,양양군,손양면,손양면제1투,991,702,173,273,165,43,34,2,1,1,4,2,0,1,1,700,2,289
강원도,양양군,손양면,손양면제2투,748,513,128,237,96,24,23,1,0,0,0,0,0,1,0,510,3,235
강원도,양양군,현북면,관내사전투표,284,284,105,71,61,22,20,0,0,0,0,2,1,0,0,282,2,0
강원도,양양군,현북면,합계,2240,1661,417,635,423,82,77,2,0,2,0,2,5,2,4,1651,10,579
강원도,양양군,현북면,현북면제1투,906,612,126,266,156,32,26,0,0,2,0,0,0,1,1,610,2,294
강원도,양양군,현북면,현북면제2투,377,287,86,99,74,11,11,1,0,0,0,0,0,0,2,284,3,90
강원도,양양군,현북면,현북면제3투,383,270,61,110,76,10,9,1,0,0,0,0,0,1,0,268,2,113
강원도,양양군,현북면,현북면제4투,290,208,39,89,56,7,11,0,0,0,0,0,4,0,1,207,1,82
강원도,양양군,현남면,관내사전투표,431,431,109,193,71,18,34,2,1,1,0,0,2,0,0,431,0,0
강원도,양양군,현남면,합계,2618,1872,435,887,380,66,68,12,2,2,3,1,2,6,2,1866,6,746
강원도,양양군,현남면,현남면제1투,801,501,116,244,105,16,9,5,0,0,0,0,0,3,0,498,3,300
강원도,양양군,현남면,현남면제2투,857,588,132,269,138,25,14,3,0,1,2,1,0,1,1,587,1,269
강원도,양양군,현남면,현남면제3투,529,352,78,181,66,7,11,2,1,0,1,0,0,2,1,350,2,177
강원도,양양군,강현면,합계,3395,2408,615,936,546,158,119,5,0,8,0,0,1,2,1,2391,17,987
강원도,양양군,강현면,관내사전투표,437,437,142,133,96,28,32,0,0,0,0,0,0,0,1,432,5,0
강원도,양양군,강현면,강현면제1투,1150,720,162,293,168,51,37,3,0,1,0,0,0,0,0,715,5,430
강원도,양양군,강현면,강현면제2투,669,469,133,168,94,39,28,0,0,4,0,0,0,0,0,466,3,200
강원도,양양군,강현면,강현면제3투,327,200,57,84,39,10,6,0,0,0,0,0,1,0,0,197,3,127
강원도,양양군,강현면,강현면제4투,812,582,121,258,149,30,16,2,0,3,0,0,0,2,0,581,1,230
강원도,양양군,잘못 투입·구분된 투표지,,0,0,0,0,0,0,0,0,0,0,0,0,0,0,0,0,0,0
강원도,인제군,합계,,27251,20751,6574,6009,4759,1665,1311,32,13,23,13,21,28,24,69,20541,210,6500
강원도,인제군,거소·선상투표,,251,242,75,26,63,32,14,0,0,2,1,0,2,1,6,222,20,9
강원도,인제군,관외사전투표,,2601,2600,1035,496,498,264,261,5,0,3,2,4,3,1,4,2576,24,1
강원도,인제군,재외투표,,73,62,37,2,16,0,7,0,0,0,0,0,0,0,0,62,0,11
강원도,인제군,인제읍,관내사전투표,1648,1648,663,378,297,153,124,2,0,1,1,1,1,2,4,1627,21,0
강원도,인제군,인제읍,합계,7167,5303,1711,1600,1151,423,335,7,2,5,1,6,2,4,11,5258,45,1864
강원도,인제군,인제읍,인제읍제1투,968,609,177,216,120,55,35,0,0,0,0,0,1,0,1,605,4,359
강원도,인제군,인제읍,인제읍제2투,1698,1154,368,346,281,82,60,5,0,1,0,2,0,1,1,1147,7,544
강원도,인제군,인제읍,인제읍제3투,1882,1200,348,372,285,104,76,0,1,2,0,2,0,1,3,1194,6,682
강원도,인제군,인제읍,인제읍제4투,548,382,77,174,95,13,15,0,1,1,0,0,0,0,1,377,5,166
강원도,인제군,인제읍,인제읍제5투,423,310,78,114,73,16,25,0,0,0,0,1,0,0,1,308,2,113
강원도,인제군,남면,관내사전투표,687,687,254,163,151,69,35,2,0,0,0,0,2,1,3,680,7,0
강원도,인제군,남면,합계,3086,2179,677,656,506,188,108,4,0,2,0,1,5,5,5,2157,22,907
강원도,인제군,남면,남면제1투,1623,999,282,379,227,55,38,2,0,0,0,0,2,2,2,989,10,624
강원도,인제군,남면,남면제2투,776,493,141,114,128,64,35,0,0,2,0,1,1,2,0,488,5,283
강원도,인제군,북면,합계,6545,4680,1463,1361,1198,307,277,4,4,4,2,3,8,4,14,4649,31,1865
강원도,인제군,북면,관내사전투표,1336,1336,486,297,330,98,98,3,1,1,1,0,2,2,7,1326,10,0
강원도,인제군,북면,북면제1투,1349,812,264,239,189,54,52,0,0,1,0,1,2,0,3,805,7,537
강원도,인제군,북면,북면제2투,1912,1232,363,361,337,87,71,0,0,0,1,0,2,0,4,1226,6,680
강원도,인제군,북면,북면제3투,578,377,117,121,102,13,20,1,0,0,0,0,1,1,0,376,1,201
강원도,인제군,북면,북면제4투,483,318,59,143,85,15,12,0,3,0,0,0,0,0,0,317,1,165
강원도,인제군,북면,북면제5투,887,605,174,200,155,40,24,0,0,2,0,2,1,1,0,599,6,282
강원도,인제군,기린면,관내사전투표,674,674,218,155,168,72,48,1,1,1,1,0,0,2,2,669,5,0
강원도,인제군,기린면,합계,3895,2921,756,986,705,236,154,7,6,3,6,3,5,4,16,2887,34,974
강원도,인제군,기린면,기린면제1투,911,607,163,241,137,38,21,1,0,0,0,0,1,0,3,605,2,304
강원도,인제군,기린면,기린면제2투,346,239,39,109,60,15,13,0,0,0,0,0,0,0,1,237,2,107
강원도,인제군,기린면,기린면제3투,310,227,45,120,38,12,10,0,0,1,0,0,0,0,0,226,1,83
강원도,인제군,기린면,기린면제4투,263,177,42,67,50,8,6,0,0,1,0,0,1,1,1,177,0,86
강원도,인제군,기린면,기린면제5투,429,322,79,104,71,9,17,5,4,0,5,2,1,1,5,303,19,107
강원도,인제군,기린면,기린면제6투,962,675,170,190,181,82,39,0,1,0,0,1,2,0,4,670,5,287
강원도,인제군,서화면,관내사전투표,637,637,218,147,123,79,44,2,0,0,0,1,0,2,8,624,13,0
강원도,인제군,서화면,합계,2323,1788,531,526,406,161,108,5,1,3,1,3,3,3,10,1761,27,535
강원도,인제군,서화면,서화면제1투,1039,702,188,217,174,62,47,2,0,0,0,0,2,1,0,693,9,337
강원도,인제군,서화면,서화면제2투,394,277,81,87,74,10,13,1,1,3,1,0,1,0,1,273,4,117
강원도,인제군,서화면,서화면제3투,253,172,44,75,35,10,4,0,0,0,0,2,0,0,1,171,1,81
강원도,인제군,상남면,합계,1310,976,289,356,216,54,47,0,0,1,0,1,0,2,3,969,7,334
강원도,인제군,상남면,관내사전투표,272,272,86,79,59,25,17,0,0,0,0,0,0,1,3,270,2,0
강원도,인제군,상남면,상남면제1투,615,403,114,162,85,20,18,0,0,0,0,0,0,1,0,400,3,212
강원도,인제군,상남면,상남면제2투,423,301,89,115,72,9,12,0,0,1,0,1,0,0,0,299,2,122
강원도,인제군,잘못 투입·구분된 투표지,,0,0,0,0,0,0,0,0,0,0,0,0,0,0,0,0,0,0
강원도,홍천군,합계,,59882,43648,13851,13549,10023,2879,2687,60,20,49,17,81,36,47,63,43362,286,16234
강원도,홍천군,거소·선상투표,,180,170,52,48,33,9,9,2,1,1,2,0,2,1,2,162,8,10
강원도,홍천군,관외사전투표,,4812,4811,1914,1025,916,440,450,12,0,1,0,9,4,1,9,4781,30,1
강원도,홍천군,재외투표,,233,185,110,20,23,11,18,2,0,0,0,0,0,0,1,185,0,48
강원도,홍천군,홍천읍,합계,26295,18534,6301,5169,4179,1383,1289,23,8,12,7,12,5,12,21,18421,113,7761
강원도,홍천군,홍천읍,관내사전투표,5276,5276,2015,1251,1042,459,448,9,4,2,1,5,0,1,9,5246,30,0
강원도,홍천군,홍천읍,홍천읍제1투,1051,667,224,193,148,55,42,0,0,0,0,0,2,1,0,665,2,384
강원도,홍천군,홍천읍,홍천읍제2투,1005,637,151,243,162,36,32,0,0,1,0,0,0,5,1,631,6,368
강원도,홍천군,홍천읍,홍천읍제3투,1631,900,272,330,177,63,46,2,1,0,1,0,0,0,0,892,8,731
강원도,홍천군,홍천읍,홍천읍제4투,1791,1101,347,369,247,67,57,0,0,0,3,2,1,1,2,1096,5,690
강원도,홍천군,홍천읍,홍천읍제5투,1517,901,250,334,211,47,47,2,0,1,0,0,0,1,0,893,8,616
강원도,홍천군,홍천읍,홍천읍제6투,609,395,91,166,93,20,14,1,1,0,0,1,1,1,2,391,4,214
강원도,홍천군,홍천읍,홍천읍제7투,2367,1607,581,389,374,116,132,1,2,1,0,0,0,0,0,1596,11,760
강원도,홍천군,홍천읍,홍천읍제8투,1653,1142,401,249,310,77,93,2,0,0,1,0,0,1,2,1136,6,511
강원도,홍천군,홍천읍,홍천읍제9투,2155,1276,375,427,300,91,64,1,0,2,0,2,1,0,2,1265,11,879
강원도,홍천군,홍천읍,홍천읍제10투,3022,1921,689,478,470,126,138,4,0,1,1,0,0,0,1,1908,13,1101
강원도,홍천군,홍천읍,홍천읍제11투,1463,898,285,286,208,55,58,0,0,1,0,1,0,0,1,895,3,565
강원도,홍천군,홍천읍,홍천읍제12투,2755,1813,620,454,437,171,118,1,0,3,0,1,0,1,1,1807,6,942
강원도,홍천군,화촌면,합계,3866,2668,752,929,669,134,127,0,1,5,2,6,5,8,5,2643,25,1198
강원도,홍천군,화촌면,관내사전투표,691,691,216,208,156,46,48,0,0,1,1,2,1,1,2,682,9,0
강원도,홍천군,화촌면,화촌면제1투,1508,948,277,345,231,48,32,0,0,2,0,0,2,3,2,942,6,560
강원도,홍천군,화촌면,화촌면제2투,576,359,86,130,103,13,20,0,0,1,0,1,1,0,1,356,3,217
강원도,홍천군,화촌면,화촌면제3투,474,299,71,116,88,8,9,0,1,1,1,0,0,1,0,296,3,175
강원도,홍천군,화촌면,화촌면제4투,617,371,102,130,91,19,18,0,0,0,0,3,1,3,0,367,4,246
강원도,홍천군,두촌면,합계,2057,1468,388,595,338,77,44,4,1,0,1,1,2,2,3,1456,12,589
강원도,홍천군,두촌면,관내사전투표,340,340,94,129,72,24,13,1,0,0,0,0,1,1,2,337,3,0
강원도,홍천군,두촌면,두촌면제1투,1188,781,196,329,187,33,25,2,1,0,1,1,0,1,1,777,4,407
강원도,홍천군,두촌면,두촌면제2투,529,347,98,137,79,20,6,1,0,0,0,0,1,0,0,342,5,182
강원도,홍천군,내촌면,합계,1986,1401,343,563,345,50,70,2,1,1,0,2,0,4,2,1383,18,585
강원도,홍천군,내촌면,관내사전투표,337,337,99,118,81,9,27,0,0,0,0,1,0,0,0,335,2,0
강원도,홍천군,내촌면,내촌면제1투,719,443,98,193,106,16,23,1,0,1,0,0,0,0,2,440,3,276
강원도,홍천군,내촌면,내촌면제2투,512,343,76,157,87,10,11,0,0,0,0,0,0,0,0,341,2,169
강원도,홍천군,내촌면,내촌면제3투,418,278,70,95,71,15,9,1,1,0,0,1,0,4,0,267,11,140
강원도,홍천군,서석면,합계,3268,2320,662,910,509,96,103,1,0,6,0,9,5,7,2,2310,10,948
강원도,홍천군,서석면,관내사전투표,568,568,191,197,116,24,33,0,0,1,0,2,2,1,0,567,1,0
강원도,홍천군,서석면,서석면제1투,1124,736,189,320,160,28,27,1,0,2,0,0,3,3,0,733,3,388
강원도,홍천군,서석면,서석면제2투,776,496,128,187,125,19,26,0,0,3,0,3,0,1,1,493,3,280
강원도,홍천군,서석면,서석면제3투,422,269,80,101,62,17,6,0,0,0,0,2,0,0,1,269,0,153
강원도,홍천군,서석면,서석면제4투,378,251,74,105,46,8,11,0,0,0,0,2,0,2,0,248,3,127
강원도,홍천군,동면,합계,3213,2312,672,825,542,100,120,3,2,5,1,20,2,4,2,2298,14,901
강원도,홍천군,동면,관내사전투표,535,535,181,169,114,25,36,0,0,2,0,4,0,1,1,533,2,0
강원도,홍천군,동면,동면제1투,1820,1173,314,436,283,48,57,3,2,1,1,11,2,3,1,1162,11,647
강원도,홍천군,동면,동면제2투,525,362,103,125,98,15,16,0,0,2,0,3,0,0,0,362,0,163
강원도,홍천군,동면,동면제3투,333,242,74,95,47,12,11,0,0,0,0,2,0,0,0,241,1,91
강원도,홍천군,남면,합계,5004,3516,1028,1129,889,226,181,0,1,6,0,13,5,1,9,3488,28,1488
강원도,홍천군,남면,관내사전투표,1108,1108,379,285,251,104,62,0,0,4,0,4,2,0,5,1096,12,0
강원도,홍천군,남면,남면제1투,1453,876,219,295,251,46,52,0,0,1,0,2,1,1,2,870,6,577
강원도,홍천군,남면,남면제2투,882,509,152,176,125,28,20,0,0,1,0,0,1,0,2,505,4,373
강원도,홍천군,남면,남면제3투,1561,1023,278,373,262,48,47,0,1,0,0,7,1,0,0,1017,6,538
강원도,홍천군,서면,관내사전투표,327,327,88,108,85,23,19,2,1,0,0,0,0,0,0,326,1,0
강원도,홍천군,서면,합계,2993,2026,391,860,549,107,90,5,1,2,0,7,2,5,0,2019,7,967
강원도,홍천군,서면,서면제1투,981,625,102,288,163,34,31,1,0,1,0,2,0,2,0,624,1,356
강원도,홍천군,서면,서면제2투,466,305,67,130,71,17,16,0,0,0,0,1,1,1,0,304,1,161
강원도,홍천군,서면,서면제3투,1219,769,134,334,230,33,24,2,0,1,0,4,1,2,0,765,4,450
강원도,홍천군,북방면,관내사전투표,603,603,214,158,137,48,36,1,0,1,3,1,0,0,2,601,2,0
강원도,홍천군,북방면,합계,3313,2393,665,880,563,142,111,2,0,3,4,1,3,2,6,2382,11,920
강원도,홍천군,북방면,북방면제1투,1549,1009,250,412,227,57,50,0,0,2,1,0,2,2,2,1005,4,540
강원도,홍천군,북방면,북방면제2투,693,464,115,203,103,24,13,1,0,0,0,0,1,0,2,462,2,229
강원도,홍천군,북방면,북방면제3투,468,317,86,107,96,13,12,0,0,0,0,0,0,0,0,314,3,151
강원도,홍천군,내면,합계,2662,1844,573,596,468,104,75,4,4,7,0,1,1,0,1,1834,10,818
강원도,홍천군,내면,관내사전투표,363,363,137,90,78,25,24,1,1,6,0,0,0,0,0,362,1,0
강원도,홍천군,내면,내면제1투,1213,774,252,231,201,45,29,1,2,1,0,1,1,0,1,765,9,439
강원도,홍천군,내면,내면제2투,601,377,98,149,103,12,13,1,1,0,0,0,0,0,0,377,0,224
강원도,홍천군,내면,내면제3투,485,330,86,126,86,22,9,1,0,0,0,0,0,0,0,330,0,155
강원도,홍천군,잘못 투입·구분된 투표지,,0,0,0,0,0,0,0,0,0,0,0,0,0,0,0,0,0,0
강원도,횡성군,합계,,39885,29447,8833,10423,6479,1675,1612,64,8,31,7,37,27,41,44,29281,166,10438
강원도,횡성군,거소·선상투표,,89,82,34,16,24,4,1,1,0,0,0,0,0,0,1,81,1,7
강원도,횡성군,관외사전투표,,3742,3741,1532,739,765,324,329,11,1,3,1,3,2,0,6,3716,25,1
강원도,횡성군,재외투표,,190,147,88,11,19,5,22,1,0,0,0,0,0,0,0,146,1,43
강원도,횡성군,횡성읍,합계,15312,10811,3378,3732,2209,685,669,27,4,10,2,11,7,8,17,10759,52,4501
강원도,횡성군,횡성읍,관내사전투표,3163,3163,1214,912,542,208,242,7,2,4,2,5,0,2,5,3145,18,0
강원도,횡성군,횡성읍,횡성읍제1투,3322,2035,603,715,471,116,99,4,1,1,0,4,3,2,7,2026,9,1287
강원도,횡성군,횡성읍,횡성읍제2투,565,364,98,142,84,19,14,1,0,1,0,0,2,1,2,364,0,201
강원도,횡성군,횡성읍,횡성읍제3투,550,332,81,131,86,14,13,3,1,1,0,0,0,0,1,331,1,218
강원도,횡성군,횡성읍,횡성읍제4투,960,626,125,299,121,38,32,5,0,0,0,0,1,0,1,622,4,334
강원도,횡성군,횡성읍,횡성읍제5투,2934,1769,486,670,393,99,107,5,0,1,0,0,0,0,1,1762,7,1165
강원도,횡성군,횡성읍,횡성읍제6투,1871,1265,406,429,246,88,82,1,0,2,0,1,0,2,0,1257,8,606
강원도,횡성군,횡성읍,횡성읍제7투,1947,1257,365,434,266,103,80,1,0,0,0,1,1,1,0,1252,5,690
강원도,횡성군,우천면,관내사전투표,530,530,170,161,130,32,29,3,0,0,0,2,0,1,0,528,2,0
강원도,횡성군,우천면,합계,3722,2583,688,1008,607,119,109,7,1,2,1,7,3,6,3,2561,22,1139
강원도,횡성군,우천면,우천면제1투,1166,733,192,291,161,35,30,1,0,2,1,4,0,4,1,722,11,433
강원도,횡성군,우천면,우천면제2투,1069,689,134,309,177,26,33,0,1,0,0,1,2,1,1,685,4,380
강원도,횡성군,우천면,우천면제3투,957,631,192,247,139,26,17,3,0,0,0,0,1,0,1,626,5,326
강원도,횡성군,안흥면,합계,2241,1616,412,696,340,84,69,0,1,0,0,0,1,4,2,1609,7,625
강원도,횡성군,안흥면,관내사전투표,384,384,120,147,74,19,20,0,0,0,0,0,0,0,1,381,3,0
강원도,횡성군,안흥면,안흥면제1투,1507,998,242,436,217,56,39,0,0,0,0,0,1,3,0,994,4,509
강원도,횡성군,안흥면,안흥면제2투,350,234,50,113,49,9,10,0,1,0,0,0,0,1,1,234,0,116
강원도,횡성군,둔내면,관내사전투표,794,794,275,256,188,41,26,0,0,0,0,0,1,0,0,787,7,0
강원도,횡성군,둔내면,합계,4576,3197,850,1175,866,140,123,4,1,1,1,1,4,2,4,3172,25,1379
강원도,횡성군,둔내면,둔내면제1투,1401,873,219,314,260,35,34,3,0,0,0,0,1,1,3,870,3,528
강원도,횡성군,둔내면,둔내면제2투,412,286,56,113,94,11,5,1,0,0,0,1,1,0,0,282,4,126
강원도,횡성군,둔내면,둔내면제3투,1531,928,227,355,246,43,46,0,0,1,1,0,0,1,1,921,7,603
강원도,횡성군,둔내면,둔내면제4투,438,316,73,137,78,10,12,0,1,0,0,0,1,0,0,312,4,122
강원도,횡성군,갑천면,합계,1863,1370,306,625,309,56,51,2,0,2,1,4,1,4,0,1361,9,493
강원도,횡성군,갑천면,관내사전투표,297,297,91,103,68,16,18,0,0,1,0,0,0,0,0,297,0,0
강원도,횡성군,갑천면,갑천면제1투,1017,673,123,338,152,29,17,1,0,1,0,3,1,2,0,667,6,344
강원도,횡성군,갑천면,갑천면제2투,549,400,92,184,89,11,16,1,0,0,1,1,0,2,0,397,3,149
강원도,횡성군,청일면,관내사전투표,330,330,108,130,56,17,12,0,0,2,0,1,1,1,2,330,0,0
강원도,횡성군,청일면,합계,1983,1394,329,662,280,51,50,0,0,3,0,3,2,5,6,1391,3,589
강원도,횡성군,청일면,청일면제1투,472,300,61,156,64,9,8,0,0,0,0,0,1,1,0,300,0,172
강원도,횡성군,청일면,청일면제2투,493,303,57,137,80,13,9,0,0,1,0,2,0,1,2,302,1,190
강원도,횡성군,청일면,청일면제3투,688,461,103,239,80,12,21,0,0,0,0,0,0,2,2,459,2,227
강원도,횡성군,공근면,합계,2996,2146,580,793,528,113,96,1,0,8,1,7,2,8,2,2139,7,850
강원도,횡성군,공근면,관내사전투표,559,559,178,171,135,36,31,0,0,3,0,2,0,2,1,559,0,0
강원도,횡성군,공근면,공근면제1투,1592,1009,257,382,261,46,43,1,0,3,1,3,1,4,1,1003,6,583
강원도,횡성군,공근면,공근면제2투,845,578,145,240,132,31,22,0,0,2,0,2,1,2,0,577,1,267
강원도,횡성군,서원면,관내사전투표,282,282,85,111,56,11,14,2,0,1,0,0,0,0,0,280,2,0
강원도,횡성군,서원면,합계,1803,1325,375,525,295,49,58,5,0,2,0,1,4,0,2,1316,9,478
강원도,횡성군,서원면,서원면제1투,864,584,149,251,121,22,33,2,0,0,0,1,0,0,2,581,3,280
강원도,횡성군,서원면,서원면제2투,657,459,141,163,118,16,11,1,0,1,0,0,4,0,0,455,4,198
강원도,횡성군,강림면,합계,1368,1035,261,441,237,45,35,5,0,0,0,0,1,4,1,1030,5,333
강원도,횡성군,강림면,관내사전투표,285,285,91,97,61,16,16,1,0,0,0,0,1,1,1,285,0,0
강원도,횡성군,강림면,강림면투표소,1083,750,170,344,176,29,19,4,0,0,0,0,0,3,0,745,5,333
강원도,횡성군,잘못 투입·구분된 투표지,,0,0,0,0,0,0,0,0,0,0,0,0,0,0,0,0,0,0
강원도,영월군,합계,,34905,25925,8067,8779,5753,1532,1424,40,8,24,12,34,25,47,39,25784,141,8980
강원도,영월군,거소·선상투표,,173,147,41,32,45,5,1,3,0,3,1,3,0,1,2,137,10,26
강원도,영월군,관외사전투표,,3376,3376,1413,652,665,308,298,2,2,2,2,4,2,0,5,3355,21,0
강원도,영월군,재외투표,,118,82,40,5,18,4,15,0,0,0,0,0,0,0,0,82,0,36
강원도,영월군,영월읍,합계,16142,11564,3949,3669,2435,716,667,19,1,10,3,16,6,15,5,11511,53,4578
강원도,영월군,영월읍,관내사전투표,3387,3387,1415,815,620,229,278,6,0,1,1,7,1,0,1,3374,13,0
강원도,영월군,영월읍,영월읍제1투,1616,916,253,368,189,63,37,2,0,1,0,0,0,0,0,913,3,700
강원도,영월군,영월읍,영월읍제2투,1839,1194,374,418,249,78,63,3,0,1,0,0,2,2,1,1191,3,645
강원도,영월군,영월읍,영월읍제3투,2682,1725,641,454,382,112,112,0,0,0,1,2,2,3,1,1710,15,957
강원도,영월군,영월읍,영월읍제4투,1648,1096,335,381,252,80,36,2,1,1,0,3,0,3,1,1095,1,552
강원도,영월군,영월읍,영월읍제5투,1199,826,248,323,170,41,40,0,0,0,0,1,0,1,0,824,2,373
강원도,영월군,영월읍,영월읍제6투,550,368,98,138,90,15,16,3,0,0,0,1,1,0,1,363,5,182
강원도,영월군,영월읍,영월읍제7투,315,196,44,89,47,6,6,0,0,0,0,0,0,3,0,195,1,119
강원도,영월군,영월읍,영월읍제8투,1322,849,255,299,192,55,37,2,0,3,0,0,0,3,0,846,3,473
강원도,영월군,영월읍,영월읍제9투,1584,1007,286,384,244,37,42,1,0,3,1,2,0,0,0,1000,7,577
강원도,영월군,상동읍,합계,1014,722,189,308,139,28,37,1,0,2,0,0,3,1,7,715,7,292
강원도,영월군,상동읍,관내사전투표,186,186,58,63,40,4,13,0,0,1,0,0,0,0,2,181,5,0
강원도,영월군,상동읍,상동읍제1투,235,133,44,52,21,7,8,0,0,0,0,0,0,0,1,133,0,102
강원도,영월군,상동읍,상동읍제2투,284,188,38,94,35,13,6,0,0,0,0,0,1,0,1,188,0,96
강원도,영월군,상동읍,상동읍제3투,309,215,49,99,43,4,10,1,0,1,0,0,2,1,3,213,2,94
강원도,영월군,중동면,관내사전투표,198,198,59,72,39,15,8,0,0,1,0,0,1,0,0,195,3,0
강원도,영월군,중동면,합계,1341,932,222,413,193,49,39,0,0,1,1,1,2,2,1,924,8,409
강원도,영월군,중동면,중동면제1투,645,400,92,178,90,15,21,0,0,0,1,0,0,1,0,398,2,245
강원도,영월군,중동면,중동면제2투,498,334,71,163,64,19,10,0,0,0,0,1,1,1,1,331,3,164
강원도,영월군,김삿갓면,합계,1453,1040,286,383,274,39,36,1,1,1,1,0,3,4,3,1032,8,413
강원도,영월군,김삿갓면,관내사전투표,243,243,86,65,62,12,13,0,0,0,1,0,1,0,0,240,3,0
강원도,영월군,김삿갓면,김삿갓면제1투,686,444,120,151,130,19,14,0,1,1,0,0,1,3,3,443,1,242
강원도,영월군,김삿갓면,김삿갓면제2투,524,353,80,167,82,8,9,1,0,0,0,0,1,1,0,349,4,171
강원도,영월군,북면,관내사전투표,266,266,79,86,65,12,19,1,0,0,0,2,0,1,0,265,1,0
강원도,영월군,북면,합계,1922,1297,327,529,316,51,62,2,0,1,0,3,0,1,1,1293,4,625
강원도,영월군,북면,북면제1투,635,381,95,166,85,19,13,1,0,1,0,0,0,0,0,380,1,254
강원도,영월군,북면,북면제2투,580,374,85,177,78,14,18,0,0,0,0,0,0,0,0,372,2,206
강원도,영월군,북면,북면제3투,441,276,68,100,88,6,12,0,0,0,0,1,0,0,1,276,0,165
강원도,영월군,남면,합계,1993,1476,400,554,376,66,54,5,0,2,1,3,2,5,3,1471,5,517
강원도,영월군,남면,관내사전투표,376,376,132,101,91,18,24,3,0,1,0,0,1,0,1,372,4,0
강원도,영월군,남면,남면제1투,964,634,129,268,183,28,17,1,0,1,0,2,0,4,1,634,0,330
강원도,영월군,남면,남면제2투,439,301,84,134,63,8,8,0,0,0,1,1,1,0,1,301,0,138
강원도,영월군,남면,남면제3투,214,165,55,51,39,12,5,1,0,0,0,0,0,1,0,164,1,49
강원도,영월군,한반도면,합계,2533,1832,420,781,437,87,82,2,1,1,1,2,1,5,2,1822,10,701
강원도,영월군,한반도면,관내사전투표,252,252,82,80,43,20,25,1,0,0,1,0,0,0,0,252,0,0
강원도,영월군,한반도면,한반도면제1투,796,529,130,214,130,25,26,0,0,0,0,0,1,1,0,527,2,267
강원도,영월군,한반도면,한반도면제2투,1485,1051,208,487,264,42,31,1,1,1,0,2,0,4,2,1043,8,434
강원도,영월군,주천면,합계,3297,2346,554,979,555,120,98,3,3,1,2,0,1,8,9,2333,13,951
강원도,영월군,주천면,관내사전투표,574,574,173,219,124,23,30,2,1,0,0,0,0,1,0,573,1,0
강원도,영월군,주천면,주천면제1투,1654,1034,209,464,243,61,39,0,1,0,2,0,0,4,4,1027,7,620
강원도,영월군,주천면,주천면제2투,323,218,42,102,50,9,13,1,0,0,0,0,0,0,0,217,1,105
강원도,영월군,주천면,주천면제3투,746,520,130,194,138,27,16,0,1,1,0,0,1,3,5,516,4,226
강원도,영월군,무릉도원면,관내사전투표,192,192,41,70,52,12,15,1,0,0,0,0,1,0,0,192,0,0
강원도,영월군,무릉도원면,합계,1543,1111,226,474,300,59,35,2,0,0,0,2,5,5,1,1109,2,432
강원도,영월군,무릉도원면,무릉도원면제1투,772,491,110,200,139,21,16,0,0,0,0,1,2,1,0,490,1,281
강원도,영월군,무릉도원면,무릉도원면제2투,579,428,75,204,109,26,4,1,0,0,0,1,2,4,1,427,1,151
강원도,영월군,잘못 투입·구분된 투표지,,0,0,0,0,0,0,0,0,0,0,0,0,0,0,0,0,0,0
강원도,평창군,합계,,37478,27444,8591,9348,5998,1547,1588,33,9,26,8,22,34,38,42,27284,160,10034
강원도,평창군,거소·선상투표,,92,87,36,14,28,5,0,0,1,0,0,1,1,0,0,86,1,5
강원도,평창군,관외사전투표,,3534,3534,1384,822,682,300,310,5,2,0,1,0,1,4,3,3514,20,0
강원도,평창군,재외투표,,166,125,71,8,20,8,17,1,0,0,0,0,0,0,0,125,0,41
강원도,평창군,평창읍,관내사전투표,1476,1476,602,396,236,105,122,2,0,0,0,3,1,1,2,1470,6,0
강원도,평창군,평창읍,합계,6825,4972,1545,1746,1049,282,283,3,2,1,1,7,6,9,9,4943,29,1853
강원도,평창군,평창읍,평창읍제1투,1418,872,252,333,171,51,57,1,1,0,1,0,1,0,0,868,4,546
강원도,평창군,평창읍,평창읍제2투,1879,1203,387,417,251,72,59,0,0,0,0,0,3,3,3,1195,8,676
강원도,평창군,평창읍,평창읍제3투,255,171,24,94,36,9,7,0,0,0,0,0,0,0,1,171,0,84
강원도,평창군,평창읍,평창읍제4투,477,343,79,126,111,8,14,0,1,0,0,0,0,0,2,341,2,134
강원도,평창군,평창읍,평창읍제5투,454,319,65,147,75,14,8,0,0,1,0,3,1,1,0,315,4,135
강원도,평창군,평창읍,평창읍제6투,480,328,69,126,108,9,11,0,0,0,0,0,0,3,0,326,2,152
강원도,평창군,평창읍,평창읍제7투,386,260,67,107,61,14,5,0,0,0,0,1,0,1,1,257,3,126
강원도,평창군,미탄면,합계,1413,1055,322,429,195,38,53,2,1,2,0,1,1,1,4,1049,6,358
강원도,평창군,미탄면,관내사전투표,277,277,104,86,52,8,23,0,1,0,0,1,0,0,0,275,2,0
강원도,평창군,미탄면,미탄면제1투,989,677,194,297,118,26,29,2,0,2,0,0,1,0,4,673,4,312
강원도,평창군,미탄면,미탄면제2투,147,101,24,46,25,4,1,0,0,0,0,0,0,1,0,101,0,46
강원도,평창군,방림면,관내사전투표,255,255,96,73,47,15,15,0,0,1,1,1,0,1,1,251,4,0
강원도,평창군,방림면,합계,2076,1506,428,573,356,65,56,3,0,5,1,2,1,4,4,1498,8,570
강원도,평창군,방림면,방림면제1투,627,421,114,179,93,19,13,0,0,2,0,0,0,0,0,420,1,206
강원도,평창군,방림면,방림면제2투,372,275,67,115,70,10,10,1,0,0,0,0,0,1,1,275,0,97
강원도,평창군,방림면,방림면제3투,822,555,151,206,146,21,18,2,0,2,0,1,1,2,2,552,3,267
강원도,평창군,대화면,관내사전투표,836,836,295,244,187,42,56,1,0,4,0,0,0,1,1,831,5,0
강원도,평창군,대화면,합계,4472,3169,1020,1101,698,146,146,4,0,9,1,0,8,8,3,3144,25,1303
강원도,평창군,대화면,대화면제1투,1661,1053,328,396,226,46,35,0,0,3,1,0,5,5,0,1045,8,608
강원도,평창군,대화면,대화면제2투,708,446,136,154,114,17,17,1,0,2,0,0,2,1,1,445,1,262
강원도,평창군,대화면,대화면제3투,1003,654,217,219,134,36,34,2,0,0,0,0,0,1,1,644,10,349
강원도,평창군,대화면,대화면제4투,264,180,44,88,37,5,4,0,0,0,0,0,1,0,0,179,1,84
강원도,평창군,봉평면,합계,4459,3140,936,1084,733,172,181,3,0,2,0,1,5,2,6,3125,15,1319
강원도,평창군,봉평면,관내사전투표,766,766,304,204,156,34,60,0,0,0,0,0,2,1,1,762,4,0
강원도,평창군,봉평면,봉평면제1투,1761,1166,285,448,290,69,58,1,0,1,0,0,2,0,4,1158,8,595
강원도,평창군,봉평면,봉평면제2투,807,513,141,202,105,31,28,2,0,1,0,0,0,0,1,511,2,294
강원도,평창군,봉평면,봉평면제3투,1125,695,206,230,182,38,35,0,0,0,0,1,1,1,0,694,1,430
강원도,평창군,용평면,합계,2468,1760,475,668,422,81,92,1,2,1,0,4,3,4,1,1754,6,708
강원도,평창군,용평면,관내사전투표,312,312,114,83,70,19,24,0,0,0,0,1,1,0,0,312,0,0
강원도,평창군,용평면,용평면제1투,490,331,101,121,82,7,14,1,0,1,0,3,1,0,0,331,0,159
강원도,평창군,용평면,용평면제2투,557,388,94,161,95,16,17,0,1,0,0,0,1,2,0,387,1,169
강원도,평창군,용평면,용평면제3투,1109,729,166,303,175,39,37,0,1,0,0,0,0,2,1,724,5,380
강원도,평창군,진부면,관내사전투표,1260,1260,494,334,247,82,84,3,0,2,1,1,2,1,2,1253,7,0
강원도,평창군,진부면,합계,7357,5052,1457,1790,1176,287,273,10,1,3,3,3,8,2,9,5022,30,2305
강원도,평창군,진부면,진부면제1투,1220,734,172,280,189,38,47,0,1,0,1,0,1,1,1,731,3,486
강원도,평창군,진부면,진부면제2투,1636,1021,299,341,237,73,56,3,0,1,1,1,2,0,1,1015,6,615
강원도,평창군,진부면,진부면제3투,1704,1016,275,400,231,54,48,0,0,0,0,0,0,0,1,1009,7,688
강원도,평창군,진부면,진부면제4투,419,270,46,123,74,9,11,1,0,0,0,0,2,0,1,267,3,149
강원도,평창군,진부면,진부면제5투,451,275,57,140,57,7,10,2,0,0,0,0,0,0,1,274,1,176
강원도,평창군,진부면,진부면제6투,383,285,75,105,78,14,9,1,0,0,0,0,1,0,1,284,1,98
강원도,평창군,진부면,진부면제7투,284,191,39,67,63,10,8,0,0,0,0,1,0,0,1,189,2,93
강원도,평창군,대관령면,관내사전투표,755,755,282,240,121,46,59,0,0,1,0,1,0,1,1,752,3,0
강원도,평창군,대관령면,합계,4616,3044,917,1113,639,163,177,1,0,3,1,3,0,4,3,3024,20,1572
강원도,평창군,대관령면,대관령면제1투,1709,974,246,401,228,53,40,1,0,1,0,0,0,0,0,970,4,735
강원도,평창군,대관령면,대관령면제2투,1787,1073,325,383,228,57,64,0,0,0,0,2,0,3,1,1063,10,714
강원도,평창군,대관령면,대관령면제3투,365,242,64,89,62,7,14,0,0,1,1,0,0,0,1,239,3,123
강원도,평창군,잘못 투입·구분된 투표지,,0,0,0,0,0,0,0,0,0,0,0,0,0,0,0,0,0,0
강원도,화천군,합계,,22164,17083,5161,5019,4000,1441,1113,32,8,21,2,14,18,21,41,16891,192,5081
강원도,화천군,거소·선상투표,,370,331,112,43,86,43,16,0,0,2,0,0,0,0,4,306,25,39
강원도,화천군,관외사전투표,,2389,2389,920,447,522,238,216,3,1,0,0,2,3,1,6,2359,30,0
강원도,화천군,재외투표,,84,60,34,3,14,1,7,1,0,0,0,0,0,0,0,60,0,24
강원도,화천군,화천읍,합계,6310,4560,1326,1440,1062,400,269,6,2,3,1,2,5,7,7,4530,30,1750
강원도,화천군,화천읍,관내사전투표,1420,1420,511,373,272,129,111,0,1,0,0,1,1,3,3,1405,15,0
강원도,화천군,화천읍,화천읍제1투,1568,952,245,349,240,71,40,0,0,1,0,0,0,2,1,949,3,616
강원도,화천군,화천읍,화천읍제2투,1989,1323,368,387,338,136,73,5,0,0,1,0,1,1,3,1313,10,666
강원도,화천군,화천읍,화천읍제3투,639,418,86,171,102,32,19,0,1,2,0,0,3,1,0,417,1,221
강원도,화천군,화천읍,화천읍제4투,694,447,116,160,110,32,26,1,0,0,0,1,0,0,0,446,1,247
강원도,화천군,간동면,관내사전투표,383,383,132,93,92,23,34,3,0,0,0,0,0,0,0,377,6,0
강원도,화천군,간동면,합계,2225,1661,414,625,403,74,105,7,1,5,0,1,2,5,1,1643,18,564
강원도,화천군,간동면,간동면제1투,638,430,81,172,116,20,30,2,1,1,0,0,0,2,0,425,5,208
강원도,화천군,간동면,간동면제2투,579,394,80,172,101,17,17,0,0,1,0,1,1,1,0,391,3,185
강원도,화천군,간동면,간동면제3투,470,344,101,131,73,12,18,0,0,2,0,0,1,2,1,341,3,126
강원도,화천군,간동면,간동면제4투,155,110,20,57,21,2,6,2,0,1,0,0,0,0,0,109,1,45
강원도,화천군,하남면,합계,2417,1881,557,593,398,147,150,0,2,3,0,0,1,3,6,1860,21,536
강원도,화천군,하남면,관내사전투표,699,699,250,150,140,72,75,0,1,0,0,0,0,0,4,692,7,0
강원도,화천군,하남면,하남면제1투,804,533,125,213,110,48,32,0,0,0,0,0,0,2,1,531,2,271
강원도,화천군,하남면,하남면제2투,618,430,142,137,99,15,24,0,1,1,0,0,1,1,1,422,8,188
강원도,화천군,하남면,하남면제3투,296,219,40,93,49,12,19,0,0,2,0,0,0,0,0,215,4,77
강원도,화천군,상서면,합계,3492,2571,703,768,635,252,154,4,1,3,0,4,4,1,9,2538,33,921
강원도,화천군,상서면,관내사전투표,884,884,282,185,210,116,69,0,0,0,0,1,3,0,2,868,16,0
강원도,화천군,상서면,상서면제1투,519,369,93,126,105,20,13,0,0,1,0,3,0,1,2,364,5,150
강원도,화천군,상서면,상서면제2투,364,243,44,120,55,11,8,0,0,0,0,0,0,0,0,238,5,121
강원도,화천군,상서면,상서면제3투,368,272,59,99,84,12,11,1,0,0,0,0,0,0,2,268,4,96
강원도,화천군,상서면,상서면제4투,657,368,97,99,85,52,28,1,0,2,0,0,0,0,1,365,3,289
강원도,화천군,상서면,상서면제5투,338,223,67,57,51,27,18,0,0,0,0,0,1,0,2,223,0,115
강원도,화천군,상서면,상서면제6투,362,212,61,82,45,14,7,2,1,0,0,0,0,0,0,212,0,150
강원도,화천군,사내면,관내사전투표,1163,1163,373,289,251,120,91,5,0,2,1,3,2,0,4,1141,22,0
강원도,화천군,사내면,합계,4877,3630,1095,1100,880,286,196,11,1,5,1,5,3,4,8,3595,35,1247
강원도,화천군,사내면,사내면제1투,2130,1378,432,398,354,114,60,5,0,1,0,1,1,1,3,1370,8,752
강원도,화천군,사내면,사내면제2투,574,415,124,148,101,14,21,1,0,2,0,0,0,2,0,413,2,159
강원도,화천군,사내면,사내면제3투,436,286,74,117,68,14,10,0,1,0,0,1,0,0,0,285,1,150
강원도,화천군,사내면,사내면제4투,574,388,92,148,106,24,14,0,0,0,0,0,0,1,1,386,2,186
강원도,화천군,잘못 투입·구분된 투표지,,0,0,0,0,0,0,0,0,0,0,0,0,0,0,0,0,0,0
강원도,양구군,합계,,19610,14848,4526,4250,3519,1287,944,16,7,19,8,19,24,27,40,14686,162,4762
강원도,양구군,거소·선상투표,,289,276,101,32,70,36,12,0,1,0,1,0,2,0,3,258,18,13
강원도,양구군,관외사전투표,,1740,1740,717,320,331,159,182,2,0,0,1,1,1,1,3,1718,22,0
강원도,양구군,재외투표,,62,44,21,6,5,2,10,0,0,0,0,0,0,0,0,44,0,18
강원도,양구군,양구읍,합계,10413,7590,2269,2171,1843,712,461,8,6,12,4,8,12,12,18,7536,54,2823
강원도,양구군,양구읍,관내사전투표,2124,2124,773,426,487,238,153,6,1,1,3,2,2,1,7,2100,24,0
강원도,양구군,양구읍,양구읍제1투,503,351,72,157,87,14,14,0,1,0,0,2,0,0,1,348,3,152
강원도,양구군,양구읍,양구읍제2투,634,430,123,123,124,36,13,0,0,1,0,1,0,3,1,425,5,204
강원도,양구군,양구읍,양구읍제3투,1263,861,269,240,189,87,66,0,2,1,0,0,2,1,1,858,3,402
강원도,양구군,양구읍,양구읍제4투,857,556,127,215,142,46,20,0,1,0,1,0,0,1,2,555,1,301
강원도,양구군,양구읍,양구읍제5투,2644,1757,492,482,448,184,122,0,1,5,0,1,5,1,2,1743,14,887
강원도,양구군,양구읍,양구읍제6투,2047,1264,358,419,308,99,63,2,0,1,0,2,2,2,4,1260,4,783
강원도,양구군,양구읍,양구읍제7투,128,88,18,34,26,4,3,0,0,1,0,0,0,2,0,88,0,40
강원도,양구군,양구읍,양구읍제8투,213,159,37,75,32,4,7,0,0,2,0,0,1,1,0,159,0,54
강원도,양구군,남면,합계,2926,2035,520,737,484,138,98,3,0,4,1,8,2,7,8,2010,25,891
강원도,양구군,남면,관내사전투표,430,430,147,109,99,41,18,0,0,0,0,0,0,2,5,421,9,0
강원도,양구군,남면,남면제1투,370,246,70,88,58,17,7,0,0,2,0,1,0,0,0,243,3,124
강원도,양구군,남면,남면제2투,1082,697,161,281,172,37,27,0,0,2,0,6,0,2,1,689,8,385
강원도,양구군,남면,남면제3투,685,410,85,171,90,22,28,2,0,0,1,1,1,3,2,406,4,275
강원도,양구군,남면,남면제4투,359,252,57,88,65,21,18,1,0,0,0,0,1,0,0,251,1,107
강원도,양구군,동면,합계,1831,1396,368,469,325,128,70,2,0,1,1,0,3,3,2,1372,24,435
강원도,양구군,동면,관내사전투표,438,438,148,86,101,69,20,2,0,0,0,0,1,0,0,427,11,0
강원도,양구군,동면,동면제1투,470,322,73,138,74,19,12,0,0,0,1,0,0,0,1,318,4,148
강원도,양구군,동면,동면제2투,598,417,103,145,103,31,22,0,0,1,0,0,2,2,1,410,7,181
강원도,양구군,동면,동면제3투,325,219,44,100,47,9,16,0,0,0,0,0,0,1,0,217,2,106
강원도,양구군,방산면,합계,1224,951,247,286,272,58,60,1,0,1,0,1,3,2,5,936,15,273
강원도,양구군,방산면,관내사전투표,274,274,86,54,73,27,25,0,0,0,0,0,1,0,3,269,5,0
강원도,양구군,방산면,방산면제1투,318,223,55,82,69,5,9,1,0,0,0,1,0,0,0,222,1,95
강원도,양구군,방산면,방산면제2투,337,267,51,92,94,8,14,0,0,1,0,0,1,1,2,264,3,70
강원도,양구군,방산면,방산면제3투,295,187,55,58,36,18,12,0,0,0,0,0,1,1,0,181,6,108
강원도,양구군,해안면,합계,1125,816,283,229,189,54,51,0,0,1,0,1,1,2,1,812,4,309
강원도,양구군,해안면,관내사전투표,238,238,87,53,57,17,21,0,0,0,0,0,0,0,1,236,2,0
강원도,양구군,해안면,해안면투표소,887,578,196,176,132,37,30,0,0,1,0,1,1,2,0,576,2,309
강원도,양구군,잘못 투입·구분된 투표지,,0,0,0,0,0,0,0,0,0,0,0,0,0,0,0,0,0,0
강원도,철원군,합계,,39884,29103,8998,8437,7101,2225,1847,42,12,34,10,22,12,16,72,28828,275,10781
강원도,철원군,거소·선상투표,,563,535,181,77,157,62,19,2,2,2,1,0,0,0,8,511,24,28
강원도,철원군,관외사전투표,,3266,3265,1257,589,707,346,308,4,1,5,0,3,0,0,13,3233,32,1
강원도,철원군,재외투표,,138,105,61,5,20,2,13,0,0,0,0,0,0,0,1,102,3,33
강원도,철원군,철원읍,합계,4272,3001,902,894,732,208,214,4,1,1,3,9,3,2,6,2979,22,1271
강원도,철원군,철원읍,관내사전투표,897,897,313,196,215,84,78,2,0,0,0,1,0,0,4,893,4,0
강원도,철원군,철원읍,철원읍제1투,834,483,129,182,111,21,31,0,0,0,1,0,0,1,0,476,7,351
강원도,철원군,철원읍,철원읍제2투,982,684,195,200,170,65,46,2,0,0,0,0,1,0,1,680,4,298
강원도,철원군,철원읍,철원읍제3투,224,156,46,56,36,3,9,0,0,0,0,3,0,1,1,155,1,68
강원도,철원군,철원읍,철원읍제4투,441,268,74,74,69,14,25,0,0,1,1,5,1,0,0,264,4,173
강원도,철원군,철원읍,철원읍제5투,894,513,145,186,131,21,25,0,1,0,1,0,1,0,0,511,2,381
강원도,철원군,김화읍,합계,2803,2096,631,634,486,178,130,2,1,3,2,0,0,3,4,2074,22,707
강원도,철원군,김화읍,관내사전투표,579,579,195,121,129,70,51,0,1,0,1,0,0,0,2,570,9,0
강원도,철원군,김화읍,김화읍제1투,606,378,107,136,83,22,22,0,0,1,1,0,0,0,0,372,6,228
강원도,철원군,김화읍,김화읍제2투,198,146,46,50,41,4,3,0,0,0,0,0,0,0,1,145,1,52
강원도,철원군,김화읍,김화읍제3투,1122,782,225,261,171,72,44,0,0,1,0,0,0,3,1,778,4,340
강원도,철원군,김화읍,김화읍제4투,298,211,58,66,62,10,10,2,0,1,0,0,0,0,0,209,2,87
강원도,철원군,갈말읍,관내사전투표,1880,1880,708,420,366,198,153,0,1,0,0,0,0,1,6,1853,27,0
강원도,철원군,갈말읍,합계,9869,6923,2010,2371,1516,515,394,9,4,6,0,4,5,3,16,6853,70,2946
강원도,철원군,갈말읍,갈말읍제1투,1014,588,146,247,120,35,33,1,0,1,0,0,0,0,1,584,4,426
강원도,철원군,갈말읍,갈말읍제2투,930,623,189,221,146,39,21,0,2,0,0,0,1,1,2,622,1,307
강원도,철원군,갈말읍,갈말읍제3투,1009,484,98,217,105,36,14,3,0,0,0,0,1,0,2,476,8,525
강원도,철원군,갈말읍,갈말읍제4투,744,475,131,161,107,34,35,0,0,1,0,0,0,0,0,469,6,269
강원도,철원군,갈말읍,갈말읍제5투,732,493,111,205,124,26,17,0,1,0,0,2,0,0,2,488,5,239
강원도,철원군,갈말읍,갈말읍제6투,601,382,55,203,82,21,14,0,0,0,0,1,1,0,0,377,5,219
강원도,철원군,갈말읍,갈말읍제7투,1591,1104,325,362,281,59,58,1,0,3,0,1,2,1,1,1094,10,487
강원도,철원군,갈말읍,갈말읍제8투,1199,763,231,269,150,61,43,4,0,1,0,0,0,0,2,761,2,436
강원도,철원군,갈말읍,갈말읍제9투,169,131,16,66,35,6,6,0,0,0,0,0,0,0,0,129,2,38
강원도,철원군,동송읍,관내사전투표,1550,1550,625,308,341,114,139,1,0,1,0,0,1,0,7,1537,13,0
강원도,철원군,동송읍,합계,12118,8223,2504,2383,2200,516,514,12,2,9,2,3,2,5,14,8166,57,3895
강원도,철원군,동송읍,동송읍제1투,2599,1616,492,374,502,141,90,4,0,2,0,1,0,2,2,1610,6,983
강원도,철원군,동송읍,동송읍제2투,1094,707,177,252,190,35,45,1,1,0,1,0,0,0,0,702,5,387
강원도,철원군,동송읍,동송읍제3투,1613,1036,330,289,265,67,73,3,0,2,0,0,0,0,3,1032,4,577
강원도,철원군,동송읍,동송읍제4투,1199,730,182,210,251,45,36,0,0,0,1,0,0,0,0,725,5,469
강원도,철원군,동송읍,동송읍제5투,440,291,85,92,88,6,12,0,0,2,0,0,0,1,2,288,3,149
강원도,철원군,동송읍,동송읍제6투,864,584,161,216,145,33,19,1,1,0,0,0,0,1,0,577,7,280
강원도,철원군,동송읍,동송읍제7투,519,339,76,137,92,18,12,0,0,0,0,0,1,0,0,336,3,180
강원도,철원군,동송읍,동송읍제8투,1330,771,222,263,184,37,55,1,0,1,0,1,0,0,0,764,7,559
강원도,철원군,동송읍,동송읍제9투,588,380,96,160,90,14,16,1,0,1,0,0,0,1,0,379,1,208
강원도,철원군,동송읍,동송읍제10투,322,219,58,82,52,6,17,0,0,0,0,1,0,0,0,216,3,103
강원도,철원군,서면,합계,4942,3521,1014,1009,963,299,180,7,1,6,0,1,1,2,5,3488,33,1421
강원도,철원군,서면,관내사전투표,1138,1138,380,215,312,147,59,1,0,2,0,0,1,2,2,1121,17,0
강원도,철원군,서면,서면제1투,1200,764,185,253,216,57,38,3,1,1,0,0,0,0,1,755,9,436
강원도,철원군,서면,서면제2투,1270,766,225,221,214,52,47,1,0,2,0,0,0,0,1,763,3,504
강원도,철원군,서면,서면제3투,1334,853,224,320,221,43,36,2,0,1,0,1,0,0,1,849,4,481
강원도,철원군,근남면,합계,1691,1233,360,429,284,70,64,2,0,2,2,2,1,1,5,1222,11,458
강원도,철원군,근남면,관내사전투표,276,276,99,58,76,18,17,1,0,1,0,0,0,1,2,273,3,0
강원도,철원군,근남면,근남면제1투,281,183,36,81,42,8,12,0,0,1,0,2,0,0,0,182,1,98
강원도,철원군,근남면,근남면제2투,708,456,140,154,106,28,18,1,0,0,0,0,1,0,1,449,7,252
강원도,철원군,근남면,근남면제3투,426,318,85,136,60,16,17,0,0,0,2,0,0,0,2,318,0,108
강원도,철원군,근북면,합계,222,201,78,46,36,29,11,0,0,0,0,0,0,0,0,200,1,21
강원도,철원군,근북면,관내사전투표,145,145,58,21,28,28,9,0,0,0,0,0,0,0,0,144,1,0
강원도,철원군,근북면,근북면투표소,77,56,20,25,8,1,2,0,0,0,0,0,0,0,0,56,0,21
강원도,철원군,잘못 투입·구분된 투표지,,0,0,0,0,0,0,0,0,0,0,0,0,0,0,0,0,0,0
충청북도,합계,,,1303688,975441,374806,255502,211454,57282,65095,1153,308,722,421,840,686,943,1347,970559,4882,328247
충청북도,청주시상당구,합계,,140080,106316,42308,27108,21983,6509,7306,132,27,60,44,95,63,87,127,105849,467,33764
충청북도,청주시상당구,거소·선상투표,,373,353,126,67,96,15,13,4,3,2,2,1,1,2,4,336,17,20
충청북도,청주시상당구,관외사전투표,,11477,11476,5328,1832,2261,931,979,12,2,1,6,9,8,2,20,11391,85,1
충청북도,청주시상당구,재외투표,,577,444,267,36,73,18,48,0,0,0,0,0,1,0,0,443,1,133
충청북도,청주시상당구,중앙동,합계,5187,3687,1240,1262,756,199,203,7,0,2,0,0,1,2,3,3675,12,1500
충청북도,청주시상당구,중앙동,관내사전투표,992,992,445,271,158,51,59,4,0,0,0,0,0,1,1,990,2,0
충청북도,청주시상당구,중앙동,중앙동제1투,2030,1274,398,433,279,78,75,2,0,2,0,0,0,1,0,1268,6,756
충청북도,청주시상당구,중앙동,중앙동제2투,2165,1421,397,558,319,70,69,1,0,0,0,0,1,0,2,1417,4,744
충청북도,청주시상당구,성안동,합계,5992,4161,1296,1566,834,190,234,10,2,4,1,4,1,3,4,4149,12,1831
충청북도,청주시상당구,성안동,관내사전투표,1449,1449,572,446,242,75,103,1,0,0,0,3,1,0,1,1444,5,0
충청북도,청주시상당구,성안동,성안동제1투,2231,1274,346,523,287,51,52,3,1,2,1,1,0,2,2,1271,3,957
충청북도,청주시상당구,성안동,성안동제2투,2312,1438,378,597,305,64,79,6,1,2,0,0,0,1,1,1434,4,874
충청북도,청주시상당구,탑·대성동,합계,7862,5361,1761,1791,1132,311,313,6,1,3,4,7,3,5,4,5341,20,2501
충청북도,청주시상당구,탑·대성동,관내사전투표,1108,1108,450,344,201,51,54,1,0,1,0,2,0,2,0,1106,2,0
충청북도,청주시상당구,탑·대성동,탑·대성동제1투,2303,1440,413,529,317,81,88,0,0,1,3,1,1,0,1,1435,5,863
충청북도,청주시상당구,탑·대성동,탑·대성동제2투,2182,1460,443,505,327,87,89,1,0,1,0,1,1,1,0,1456,4,722
충청북도,청주시상당구,탑·대성동,탑·대성동제3투,2269,1353,455,413,287,92,82,4,1,0,1,3,1,2,3,1344,9,916
충청북도,청주시상당구,용담·명암·산성동,합계,8069,6278,2690,1408,1277,410,448,7,2,0,2,0,4,4,4,6256,22,1791
충청북도,청주시상당구,용담·명암·산성동,관내사전투표,1904,1904,893,371,374,115,140,2,0,0,1,0,2,2,1,1901,3,0
충청북도,청주시상당구,용담·명암·산성동,용담·명암·산성동제1투,2260,1400,474,438,294,89,96,0,0,0,1,0,0,1,0,1393,7,860
충청북도,청주시상당구,용담·명암·산성동,용담·명암·산성동제2투,3905,2974,1323,599,609,206,212,5,2,0,0,0,2,1,3,2962,12,931
충청북도,청주시상당구,금천동,합계,24037,18379,7604,4414,3793,1149,1290,8,2,7,10,12,6,9,13,18317,62,5658
충청북도,청주시상당구,금천동,관내사전투표,4163,4163,1877,917,727,293,321,1,0,0,1,5,1,1,1,4145,18,0
충청북도,청주시상당구,금천동,금천동제1투,1991,1262,361,506,271,43,64,3,0,1,2,2,1,1,2,1257,5,729
충청북도,청주시상당구,금천동,금천동제2투,2079,1360,476,415,310,72,71,1,0,2,0,3,0,0,2,1352,8,719
충청북도,청주시상당구,금천동,금천동제3투,3325,2504,983,642,550,153,163,0,0,0,2,0,0,2,2,2497,7,821
충청북도,청주시상당구,금천동,금천동제4투,2296,1515,536,427,343,94,100,0,1,2,0,0,1,0,1,1505,10,781
충청북도,청주시상당구,금천동,금천동제5투,2320,1673,663,392,369,107,127,0,0,2,1,0,3,1,1,1666,7,647
충청북도,청주시상당구,금천동,금천동제6투,3225,2315,1018,451,481,156,196,2,1,0,2,0,0,2,2,2311,4,910
충청북도,청주시상당구,금천동,금천동제7투,2305,1729,798,304,377,114,131,1,0,0,1,1,0,1,0,1728,1,576
충청북도,청주시상당구,금천동,금천동제8투,2333,1858,892,360,365,117,117,0,0,0,1,1,0,1,2,1856,2,475
충청북도,청주시상당구,영운동,합계,9379,6699,2486,1870,1463,354,460,9,2,5,3,6,2,5,5,6670,29,2680
충청북도,청주시상당구,영운동,관내사전투표,1645,1644,717,388,311,90,120,4,0,1,0,1,1,3,1,1637,7,1
충청북도,청주시상당구,영운동,영운동제1투,2673,1737,564,535,422,90,110,3,1,1,1,3,1,0,1,1732,5,936
충청북도,청주시상당구,영운동,영운동제2투,2622,1677,606,476,365,87,127,0,0,1,1,0,0,2,1,1666,11,945
충청북도,청주시상당구,영운동,영운동제3투,2439,1641,599,471,365,87,103,2,1,2,1,2,0,0,2,1635,6,798
충청북도,청주시상당구,용암제1동,합계,30306,22357,9374,5023,4717,1455,1627,28,4,14,6,8,5,10,16,22287,70,7949
충청북도,청주시상당구,용암제1동,관내사전투표,4524,4524,2189,870,797,305,339,5,1,4,2,1,1,1,2,4517,7,0
충청북도,청주시상당구,용암제1동,용암제1동제1투,2896,1881,658,493,473,110,131,1,0,1,1,0,1,0,3,1872,9,1015
충청북도,청주시상당구,용암제1동,용암제1동제2투,3810,2682,1064,668,569,171,192,6,1,2,0,0,0,1,3,2677,5,1128
충청북도,청주시상당구,용암제1동,용암제1동제3투,2916,1945,728,484,417,152,144,1,0,2,1,2,0,3,3,1937,8,971
충청북도,청주시상당구,용암제1동,용암제1동제4투,2392,1608,483,549,386,72,82,5,1,1,2,0,1,4,2,1588,20,784
충청북도,청주시상당구,용암제1동,용암제1동제5투,3391,2456,1165,451,511,156,160,1,0,1,0,2,2,0,1,2450,6,935
충청북도,청주시상당구,용암제1동,용암제1동제6투,3054,1862,773,400,421,116,145,3,0,1,0,1,0,1,0,1861,1,1192
충청북도,청주시상당구,용암제1동,용암제1동제7투,3165,2458,1037,510,531,167,199,1,0,1,0,1,0,0,1,2448,10,707
충청북도,청주시상당구,용암제1동,용암제1동제8투,4158,2941,1277,598,612,206,235,5,1,1,0,1,0,0,1,2937,4,1217
충청북도,청주시상당구,용암제2동,합계,17129,13054,5736,2639,2707,844,993,15,4,6,4,10,8,13,16,12995,59,4075
충청북도,청주시상당구,용암제2동,관내사전투표,3025,3025,1525,503,525,191,261,1,0,2,2,3,0,0,1,3014,11,0
충청북도,청주시상당구,용암제2동,용암제2동제1투,2609,1656,693,330,374,113,129,6,0,1,0,0,0,1,4,1651,5,953
충청북도,청주시상당구,용암제2동,용암제2동제2투,3220,2401,1033,463,549,164,173,0,1,2,0,3,2,0,3,2393,8,819
충청북도,청주시상당구,용암제2동,용암제2동제3투,3264,2532,1059,559,533,158,200,2,1,1,1,2,2,2,2,2522,10,732
충청북도,청주시상당구,용암제2동,용암제2동제4투,1700,1101,359,346,252,52,51,2,2,0,1,1,2,7,5,1080,21,599
충청북도,청주시상당구,용암제2동,용암제2동제5투,3311,2339,1067,438,474,166,179,4,0,0,0,1,2,3,1,2335,4,972
충청북도,청주시상당구,낭성면,합계,1960,1388,368,633,255,53,62,2,1,0,0,3,1,2,3,1383,5,572
충청북도,청주시상당구,낭성면,관내사전투표,390,390,130,144,73,13,26,1,0,0,0,0,0,1,1,389,1,0
충청북도,청주시상당구,낭성면,낭성면투표소,1570,998,238,489,182,40,36,1,1,0,0,3,1,1,2,994,4,572
충청북도,청주시상당구,미원면,합계,4546,3183,934,1267,649,123,122,7,2,5,3,27,3,5,16,3163,20,1363
충청북도,청주시상당구,미원면,관내사전투표,1014,1014,316,388,197,35,40,5,1,1,1,7,2,3,8,1004,10,0
충청북도,청주시상당구,미원면,미원면제1투,1332,725,218,276,158,30,29,1,0,0,2,1,0,2,2,719,6,607
충청북도,청주시상당구,미원면,미원면제2투,1583,1002,289,402,202,40,38,0,1,2,0,19,1,0,4,998,4,581
충청북도,청주시상당구,미원면,미원면제3투,617,442,111,201,92,18,15,1,0,2,0,0,0,0,2,442,0,175
충청북도,청주시상당구,가덕면,합계,3647,2579,817,955,517,112,125,5,0,4,1,3,3,10,5,2557,22,1068
충청북도,청주시상당구,가덕면,관내사전투표,477,477,183,153,81,29,25,0,0,0,0,0,1,1,1,474,3,0
충청북도,청주시상당구,가덕면,가덕면제1투,1341,887,247,347,186,43,47,2,0,1,0,2,0,4,3,882,5,454
충청북도,청주시상당구,가덕면,가덕면제2투,751,493,158,188,96,19,27,0,0,1,0,0,0,4,0,493,0,258
충청북도,청주시상당구,가덕면,가덕면제3투,1078,722,229,267,154,21,26,3,0,2,1,1,2,1,1,708,14,356
충청북도,청주시상당구,남일면,합계,5920,4349,1493,1356,930,247,271,7,1,4,1,1,9,5,4,4329,20,1571
충청북도,청주시상당구,남일면,관내사전투표,1090,1090,462,271,193,69,85,2,0,1,0,0,0,2,0,1085,5,0
충청북도,청주시상당구,남일면,남일면제1투,2288,1532,509,492,324,106,84,1,0,1,0,1,4,2,1,1525,7,756
충청북도,청주시상당구,남일면,남일면제2투,790,533,157,193,118,22,34,4,0,2,1,0,1,0,0,532,1,257
충청북도,청주시상당구,남일면,남일면제3투,1752,1194,365,400,295,50,68,0,1,0,0,0,4,1,3,1187,7,558
충청북도,청주시상당구,문의면,합계,3619,2568,788,989,523,98,118,5,1,3,1,4,7,10,10,2557,11,1051
충청북도,청주시상당구,문의면,관내사전투표,741,741,261,250,147,29,38,0,0,3,0,1,0,4,5,738,3,0
충청북도,청주시상당구,문의면,문의면제1투,2136,1341,366,536,293,49,69,4,1,0,0,2,5,4,5,1334,7,795
충청북도,청주시상당구,문의면,문의면제2투,742,486,161,203,83,20,11,1,0,0,1,1,2,2,0,485,1,256
충청북도,청주시상당구,잘못 투입·구분된 투표지,,0,0,0,0,0,0,0,0,0,0,0,0,0,0,0,0,0,0
충청북도,청주시서원구,합계,,174200,134980,56521,30471,28912,8459,9454,157,30,73,48,103,56,50,114,134448,532,39220
충청북도,청주시서원구,거소·선상투표,,461,428,158,70,131,27,11,4,3,1,3,0,4,3,1,416,12,33
충청북도,청주시서원구,관외사전투표,,16458,16455,7745,2494,3326,1275,1406,10,2,7,6,18,6,4,30,16329,126,3
충청북도,청주시서원구,재외투표,,739,585,401,26,77,22,56,1,0,0,0,1,0,1,0,585,0,154
충청북도,청주시서원구,남이면,합계,7022,4925,1708,1537,1093,259,278,13,2,2,1,0,3,4,7,4907,18,2097
충청북도,청주시서원구,남이면,관내사전투표,936,936,392,261,186,31,54,7,0,0,0,0,0,1,1,933,3,0
충청북도,청주시서원구,남이면,남이면제1투,2325,1442,465,510,336,62,52,3,0,1,0,0,2,3,2,1436,6,883
충청북도,청주시서원구,남이면,남이면제2투,984,639,188,247,136,26,36,1,1,0,0,0,1,0,0,636,3,345
충청북도,청주시서원구,남이면,남이면제3투,2777,1908,663,519,435,140,136,2,1,1,1,0,0,0,4,1902,6,869
충청북도,청주시서원구,현도면,합계,3034,2077,584,725,592,61,85,0,2,1,1,0,1,5,7,2064,13,957
충청북도,청주시서원구,현도면,관내사전투표,512,512,170,132,159,24,22,0,1,0,1,0,0,0,1,510,2,0
충청북도,청주시서원구,현도면,현도면제1투,1584,1020,249,405,289,23,35,0,1,1,0,0,1,4,3,1011,9,564
충청북도,청주시서원구,현도면,현도면제2투,938,545,165,188,144,14,28,0,0,0,0,0,0,1,3,543,2,393
충청북도,청주시서원구,사직1동,합계,7559,5437,1843,1740,1247,274,284,7,2,3,4,8,3,1,1,5417,20,2122
충청북도,청주시서원구,사직1동,관내사전투표,1188,1188,488,310,237,64,77,2,0,1,1,2,1,0,0,1183,5,0
충청북도,청주시서원구,사직1동,사직1동제1투,1882,1124,324,424,258,50,57,2,0,1,0,1,1,1,1,1120,4,758
충청북도,청주시서원구,사직1동,사직1동제2투,1989,1302,424,430,306,57,74,2,0,1,1,1,1,0,0,1297,5,687
충청북도,청주시서원구,사직1동,사직1동제3투,2500,1823,607,576,446,103,76,1,2,0,2,4,0,0,0,1817,6,677
충청북도,청주시서원구,사직2동,합계,10781,8463,3223,2268,1901,485,518,16,1,2,2,8,2,2,6,8434,29,2318
충청북도,청주시서원구,사직2동,관내사전투표,1394,1394,618,329,268,65,99,1,0,0,1,2,0,0,3,1386,8,0
충청북도,청주시서원구,사직2동,사직2동제1투,1497,976,287,362,219,41,56,2,1,1,1,1,0,1,0,972,4,521
충청북도,청주시서원구,사직2동,사직2동제2투,1889,1198,374,393,276,51,88,4,0,0,0,3,0,1,3,1193,5,691
충청북도,청주시서원구,사직2동,사직2동제3투,3087,2504,954,659,588,153,137,2,0,1,0,1,1,0,0,2496,8,583
충청북도,청주시서원구,사직2동,사직2동제4투,2914,2391,990,525,550,175,138,7,0,0,0,1,1,0,0,2387,4,523
충청북도,청주시서원구,사창동,합계,14470,10551,4258,2606,2172,688,742,9,1,3,3,13,5,3,11,10514,37,3919
충청북도,청주시서원구,사창동,관내사전투표,3825,3825,1815,696,698,290,294,2,0,2,0,5,1,0,4,3807,18,0
충청북도,청주시서원구,사창동,사창동제1투,2813,1557,575,402,358,113,96,3,1,1,0,1,1,1,1,1553,4,1256
충청북도,청주시서원구,사창동,사창동제2투,3039,2142,854,556,431,127,154,2,0,0,1,4,2,1,5,2137,5,897
충청북도,청주시서원구,사창동,사창동제3투,3054,1973,649,628,457,107,115,2,0,0,2,3,1,1,1,1966,7,1081
충청북도,청주시서원구,사창동,사창동제4투,1739,1054,365,324,228,51,83,0,0,0,0,0,0,0,0,1051,3,685
충청북도,청주시서원구,모충동,합계,12909,8740,3142,2603,1867,516,539,16,5,6,3,7,2,5,2,8713,27,4169
충청북도,청주시서원구,모충동,관내사전투표,1547,1547,645,374,280,104,125,4,1,2,1,1,0,1,0,1538,9,0
충청북도,청주시서원구,모충동,모충동제1투,3429,2074,715,627,480,128,106,5,0,1,1,0,0,3,1,2067,7,1355
충청북도,청주시서원구,모충동,모충동제2투,1841,1081,367,336,232,70,70,0,1,2,0,1,0,0,0,1079,2,760
충청북도,청주시서원구,모충동,모충동제3투,3458,2359,919,631,514,127,151,3,3,1,0,3,1,0,1,2354,5,1099
충청북도,청주시서원구,모충동,모충동제4투,2634,1679,496,635,361,87,87,4,0,0,1,2,1,1,0,1675,4,955
충청북도,청주시서원구,산남동,합계,18923,14824,6863,2796,3067,963,1062,6,1,4,2,6,2,3,9,14784,40,4099
충청북도,청주시서원구,산남동,관내사전투표,3421,3421,1841,472,575,236,285,1,0,1,0,1,0,0,3,3415,6,0
충청북도,청주시서원구,산남동,산남동제1투,2813,1827,697,437,448,112,123,3,0,1,1,0,0,0,2,1824,3,986
충청북도,청주시서원구,산남동,산남동제2투,2813,2064,694,649,442,138,125,0,0,0,0,2,1,2,1,2054,10,749
충청북도,청주시서원구,산남동,산남동제3투,3530,2693,1340,410,563,154,211,1,0,1,1,1,0,1,1,2684,9,837
충청북도,청주시서원구,산남동,산남동제4투,3315,2407,1110,490,497,157,144,0,0,1,0,2,0,0,0,2401,6,908
충청북도,청주시서원구,산남동,산남동제5투,3031,2412,1181,338,542,166,174,1,1,0,0,0,1,0,2,2406,6,619
충청북도,청주시서원구,분평동,합계,23999,19324,8587,3658,4142,1329,1474,20,4,7,2,22,7,7,11,19270,54,4675
충청북도,청주시서원구,분평동,관내사전투표,5983,5983,2884,984,1152,435,484,9,1,2,1,10,1,2,2,5967,16,0
충청북도,청주시서원구,분평동,분평동제1투,877,592,181,236,119,32,19,0,0,2,0,0,0,1,0,590,2,285
충청북도,청주시서원구,분평동,분평동제2투,3189,2322,1009,426,531,146,196,3,0,1,1,2,0,1,2,2318,4,867
충청북도,청주시서원구,분평동,분평동제3투,2908,2083,904,384,484,141,149,2,2,1,0,1,2,0,2,2072,11,825
충청북도,청주시서원구,분평동,분평동제4투,2759,2065,928,370,428,144,176,2,0,1,0,5,1,1,2,2058,7,694
충청북도,청주시서원구,분평동,분평동제5투,2620,1935,749,445,453,141,131,4,1,0,0,2,3,1,3,1933,2,685
충청북도,청주시서원구,분평동,분평동제6투,2633,1991,900,369,440,148,128,0,0,0,0,0,0,0,0,1985,6,642
충청북도,청주시서원구,분평동,분평동제7투,3030,2353,1032,444,535,142,191,0,0,0,0,2,0,1,0,2347,6,677
충청북도,청주시서원구,수곡1동,합계,12133,8563,3211,2457,1843,425,526,20,5,10,12,3,9,3,7,8531,32,3570
충청북도,청주시서원구,수곡1동,관내사전투표,1809,1808,821,379,340,123,122,8,1,4,3,1,1,1,3,1807,1,1
충청북도,청주시서원구,수곡1동,수곡1동제1투,2601,1717,619,479,381,98,114,3,1,0,5,0,2,1,1,1704,13,884
충청북도,청주시서원구,수곡1동,수곡1동제2투,2669,1737,652,490,398,79,98,4,1,1,2,1,3,1,2,1732,5,932
충청북도,청주시서원구,수곡1동,수곡1동제3투,2613,1673,535,568,398,59,96,4,2,1,1,1,2,0,1,1668,5,940
충청북도,청주시서원구,수곡1동,수곡1동제4투,2441,1628,584,541,326,66,96,1,0,4,1,0,1,0,0,1620,8,813
충청북도,청주시서원구,수곡2동,합계,12476,9284,3430,2490,2109,544,610,12,1,11,7,5,4,3,6,9232,52,3192
충청북도,청주시서원구,수곡2동,관내사전투표,2740,2740,1111,645,579,168,205,4,0,2,2,2,1,1,0,2720,20,0
충청북도,청주시서원구,수곡2동,수곡2동제1투,2578,1627,635,401,348,112,110,1,0,7,1,0,0,0,1,1616,11,951
충청북도,청주시서원구,수곡2동,수곡2동제2투,2555,1757,624,481,408,109,125,1,0,0,2,2,2,0,0,1754,3,798
충청북도,청주시서원구,수곡2동,수곡2동제3투,2443,1704,570,499,427,86,101,3,1,2,1,1,1,2,3,1697,7,739
충청북도,청주시서원구,수곡2동,수곡2동제4투,2160,1456,490,464,347,69,69,3,0,0,1,0,0,0,2,1445,11,704
충청북도,청주시서원구,성화·개신·죽림동,합계,33236,25324,11368,5001,5345,1591,1863,23,1,16,2,12,8,6,16,25252,72,7912
충청북도,청주시서원구,성화·개신·죽림동,관내사전투표,5284,5284,2715,822,943,363,401,4,1,2,0,6,1,1,5,5264,20,0
충청북도,청주시서원구,성화·개신·죽림동,성화·개신·죽림동제1투,3802,2553,1111,511,577,143,193,2,0,2,0,1,0,2,0,2542,11,1249
충청북도,청주시서원구,성화·개신·죽림동,성화·개신·죽림동제2투,2876,2145,822,579,439,153,141,2,0,0,0,0,1,1,0,2138,7,731
충청북도,청주시서원구,성화·개신·죽림동,성화·개신·죽림동제3투,2766,2046,743,610,429,109,142,3,0,2,0,0,3,0,0,2041,5,720
충청북도,청주시서원구,성화·개신·죽림동,성화·개신·죽림동제4투,3450,2743,1265,509,574,166,217,0,0,3,0,2,1,0,2,2739,4,707
충청북도,청주시서원구,성화·개신·죽림동,성화·개신·죽림동제5투,3083,2300,1071,416,481,145,170,2,0,4,0,0,0,1,3,2293,7,783
충청북도,청주시서원구,성화·개신·죽림동,성화·개신·죽림동제6투,1794,1338,543,295,304,85,100,2,0,2,2,0,0,1,1,1335,3,456
충청북도,청주시서원구,성화·개신·죽림동,성화·개신·죽림동제7투,2682,1673,691,374,397,87,115,0,0,0,0,1,1,0,2,1668,5,1009
충청북도,청주시서원구,성화·개신·죽림동,성화·개신·죽림동제8투,2229,1595,678,278,400,117,115,2,0,0,0,0,0,0,1,1591,4,634
충청북도,청주시서원구,성화·개신·죽림동,성화·개신·죽림동제9투,2659,1616,727,314,352,82,130,0,0,1,0,1,1,0,2,1610,6,1043
충청북도,청주시서원구,성화·개신·죽림동,성화·개신·죽림동제10투,2611,2031,1002,293,449,141,139,6,0,0,0,1,0,0,0,2031,0,580
충청북도,청주시서원구,잘못 투입·구분된 투표지,,0,0,0,0,0,0,0,0,0,0,0,0,0,0,0,0,0,0
충청북도,청주시흥덕구,합계,,202801,153064,66281,31023,32756,9951,11601,144,40,74,73,123,60,71,188,152385,679,49737
충청북도,청주시흥덕구,거소·선상투표,,427,406,130,68,118,24,17,3,1,1,3,3,6,1,3,378,28,21
충청북도,청주시흥덕구,관외사전투표,,17703,17695,8301,2429,3609,1465,1617,17,5,5,7,16,9,11,48,17539,156,8
충청북도,청주시흥덕구,재외투표,,900,728,443,39,128,30,82,2,0,0,0,0,1,1,0,726,2,172
충청북도,청주시흥덕구,오송읍,관내사전투표,2322,2322,1291,304,414,132,165,3,0,0,0,5,0,3,1,2318,4,0
충청북도,청주시흥덕구,오송읍,합계,14734,11181,5244,2099,2382,635,707,11,5,4,3,20,8,9,15,11142,39,3553
충청북도,청주시흥덕구,오송읍,오송읍제1투,1456,917,310,243,222,60,66,3,0,0,0,3,0,2,2,911,6,539
충청북도,청주시흥덕구,오송읍,오송읍제2투,1486,946,317,305,218,42,51,0,0,0,0,3,2,1,2,941,5,540
충청북도,청주시흥덕구,오송읍,오송읍제3투,2059,1337,526,334,307,73,78,3,2,1,2,0,3,1,2,1332,5,722
충청북도,청주시흥덕구,오송읍,오송읍제4투,2294,1697,870,277,341,83,116,1,1,0,0,2,2,0,1,1694,3,597
충청북도,청주시흥덕구,오송읍,오송읍제5투,2025,1637,847,233,372,89,89,1,0,2,0,1,0,0,1,1635,2,388
충청북도,청주시흥덕구,오송읍,오송읍제6투,2038,1626,867,180,340,120,106,0,0,1,0,4,0,1,2,1621,5,412
충청북도,청주시흥덕구,오송읍,오송읍제7투,1054,699,216,223,168,36,36,0,2,0,1,2,1,1,4,690,9,355
충청북도,청주시흥덕구,강내면,관내사전투표,1826,1826,906,322,354,107,121,2,0,0,0,5,0,1,3,1821,5,0
충청북도,청주시흥덕구,강내면,합계,8140,6107,2518,1424,1351,343,406,6,1,2,2,14,3,5,6,6081,26,2033
충청북도,청주시흥덕구,강내면,강내면제1투,2447,1675,701,356,381,95,123,1,0,0,2,3,0,2,1,1665,10,772
충청북도,청주시흥덕구,강내면,강내면제2투,1542,991,313,330,224,57,51,2,0,2,0,2,3,0,1,985,6,551
충청북도,청주시흥덕구,강내면,강내면제3투,2325,1615,598,416,392,84,111,1,1,0,0,4,0,2,1,1610,5,710
충청북도,청주시흥덕구,옥산면,합계,9040,6451,2628,1613,1369,328,454,9,2,3,5,2,3,4,5,6425,26,2589
충청북도,청주시흥덕구,옥산면,관내사전투표,1517,1517,707,324,272,70,132,2,1,0,2,0,1,0,1,1512,5,0
충청북도,청주시흥덕구,옥산면,옥산면제1투,2203,1390,441,469,331,56,81,1,0,0,0,0,1,1,3,1384,6,813
충청북도,청주시흥덕구,옥산면,옥산면제2투,1546,971,334,330,219,32,44,2,0,0,1,1,0,3,0,966,5,575
충청북도,청주시흥덕구,옥산면,옥산면제3투,2254,1389,552,324,310,80,108,2,0,2,2,1,1,0,1,1383,6,865
충청북도,청주시흥덕구,옥산면,옥산면제4투,1520,1184,594,166,237,90,89,2,1,1,0,0,0,0,0,1180,4,336
충청북도,청주시흥덕구,운천·신봉동,합계,15069,10766,4214,2738,2305,639,744,9,3,12,8,14,4,5,11,10706,60,4303
충청북도,청주시흥덕구,운천·신봉동,관내사전투표,2028,2028,939,382,383,131,164,1,0,1,2,3,1,2,4,2013,15,0
충청북도,청주시흥덕구,운천·신봉동,운천·신봉동제1투,2248,1424,492,494,268,75,85,2,0,1,0,0,0,2,2,1421,3,824
충청북도,청주시흥덕구,운천·신봉동,운천·신봉동제2투,2953,1927,771,432,433,123,151,0,2,4,0,2,1,1,0,1920,7,1026
충청북도,청주시흥덕구,운천·신봉동,운천·신봉동제3투,3200,2212,851,552,533,112,138,4,0,2,3,4,1,0,3,2203,9,988
충청북도,청주시흥덕구,운천·신봉동,운천·신봉동제4투,1699,1050,334,339,252,53,60,1,0,4,1,3,0,0,1,1048,2,649
충청북도,청주시흥덕구,운천·신봉동,운천·신봉동제5투,2941,2125,827,539,436,145,146,1,1,0,2,2,1,0,1,2101,24,816
충청북도,청주시흥덕구,복대제1동,합계,35920,27236,12727,4570,5861,1878,2044,14,4,12,5,9,4,7,28,27163,73,8684
충청북도,청주시흥덕구,복대제1동,관내사전투표,6046,6046,3126,811,1132,426,504,3,0,6,2,3,1,0,8,6022,24,0
충청북도,청주시흥덕구,복대제1동,복대제1동제1투,2617,1703,841,223,384,116,130,0,0,1,0,0,0,2,3,1700,3,914
충청북도,청주시흥덕구,복대제1동,복대제1동제2투,2456,1930,860,370,432,110,152,0,0,0,0,2,0,0,0,1926,4,526
충청북도,청주시흥덕구,복대제1동,복대제1동제3투,3144,2134,920,408,441,148,198,3,0,0,0,1,1,2,3,2125,9,1010
충청북도,청주시흥덕구,복대제1동,복대제1동제4투,1587,987,366,278,197,73,70,0,0,1,1,0,0,0,0,986,1,600
충청북도,청주시흥덕구,복대제1동,복대제1동제5투,2143,1174,403,341,277,65,82,1,1,0,0,0,0,0,1,1171,3,969
충청북도,청주시흥덕구,복대제1동,복대제1동제6투,3088,1754,725,328,435,99,155,0,2,1,1,0,0,2,2,1750,4,1334
충청북도,청주시흥덕구,복대제1동,복대제1동제7투,2670,1986,982,242,437,151,161,3,1,0,0,0,0,0,1,1978,8,684
충청북도,청주시흥덕구,복대제1동,복대제1동제8투,2661,2081,939,397,453,155,127,1,0,1,1,1,0,0,1,2076,5,580
충청북도,청주시흥덕구,복대제1동,복대제1동제9투,2385,1763,934,202,356,123,139,0,0,1,0,0,0,0,5,1760,3,622
충청북도,청주시흥덕구,복대제1동,복대제1동제10투,3824,3017,1325,599,732,212,138,2,0,1,0,1,2,0,2,3014,3,807
충청북도,청주시흥덕구,복대제1동,복대제1동제11투,3299,2661,1306,371,585,200,188,1,0,0,0,1,0,1,2,2655,6,638
충청북도,청주시흥덕구,복대제2동,합계,14265,9831,3547,2623,2230,651,689,12,3,5,3,12,6,1,12,9794,37,4434
충청북도,청주시흥덕구,복대제2동,관내사전투표,1955,1955,841,414,366,141,177,3,0,0,0,1,0,0,5,1948,7,0
충청북도,청주시흥덕구,복대제2동,복대제2동제1투,2769,1782,623,468,433,117,134,2,1,0,0,0,0,0,0,1778,4,987
충청북도,청주시흥덕구,복대제2동,복대제2동제2투,2104,1324,413,430,309,90,71,0,0,1,0,2,2,0,1,1319,5,780
충청북도,청주시흥덕구,복대제2동,복대제2동제3투,2635,1609,528,454,408,91,107,4,1,0,1,3,2,0,4,1603,6,1026
충청북도,청주시흥덕구,복대제2동,복대제2동제4투,2415,1626,586,436,357,112,111,1,0,4,0,6,2,1,1,1617,9,789
충청북도,청주시흥덕구,복대제2동,복대제2동제5투,2387,1535,556,421,357,100,89,2,1,0,2,0,0,0,1,1529,6,852
충청북도,청주시흥덕구,가경동,관내사전투표,5945,5945,2885,1052,1064,379,509,9,4,0,4,6,3,2,6,5923,22,0
충청북도,청주시흥덕구,가경동,합계,35767,26986,11624,5503,5881,1681,2088,26,4,10,10,17,5,11,27,26887,99,8781
충청북도,청주시흥덕구,가경동,가경동제1투,1751,1059,354,331,240,51,68,1,0,2,0,1,0,0,0,1048,11,692
충청북도,청주시흥덕구,가경동,가경동제2투,2501,1794,635,536,392,105,115,1,0,1,0,1,0,1,2,1789,5,707
충청북도,청주시흥덕구,가경동,가경동제3투,2876,1998,778,444,460,133,164,3,0,2,0,2,0,1,3,1990,8,878
충청북도,청주시흥덕구,가경동,가경동제4투,3072,2268,956,418,539,153,182,0,0,2,0,1,1,4,3,2259,9,804
충청북도,청주시흥덕구,가경동,가경동제5투,3230,2144,860,485,508,115,159,2,0,0,2,1,0,0,0,2132,12,1086
충청북도,청주시흥덕구,가경동,가경동제6투,3350,2441,1021,432,612,153,206,2,0,2,2,3,0,2,2,2437,4,909
충청북도,청주시흥덕구,가경동,가경동제7투,2935,1966,820,448,418,120,142,3,0,1,0,1,0,1,1,1955,11,969
충청북도,청주시흥덕구,가경동,가경동제8투,3664,2716,1288,466,590,162,197,2,0,0,0,1,0,0,4,2710,6,948
충청북도,청주시흥덕구,가경동,가경동제9투,3116,2252,998,455,482,122,182,3,0,0,1,0,1,0,2,2246,6,864
충청북도,청주시흥덕구,가경동,가경동제10투,3327,2403,1029,436,576,188,164,0,0,0,1,0,0,0,4,2398,5,924
충청북도,청주시흥덕구,봉명제1동,합계,9740,6489,2533,1529,1470,389,515,6,2,2,6,0,1,3,10,6466,23,3251
충청북도,청주시흥덕구,봉명제1동,관내사전투표,1802,1802,830,313,369,119,157,3,1,0,2,0,0,0,4,1798,4,0
충청북도,청주시흥덕구,봉명제1동,봉명제1동제1투,2454,1337,507,328,320,68,110,0,0,1,0,0,0,0,0,1334,3,1117
충청북도,청주시흥덕구,봉명제1동,봉명제1동제2투,2885,1786,635,478,424,110,122,2,0,1,1,0,0,1,4,1778,8,1099
충청북도,청주시흥덕구,봉명제1동,봉명제1동제3투,2599,1564,561,410,357,92,126,1,1,0,3,0,1,2,2,1556,8,1035
충청북도,청주시흥덕구,봉명제2·송정동,합계,19820,13737,5831,2902,2857,887,1145,14,4,7,12,12,3,2,10,13686,51,6083
충청북도,청주시흥덕구,봉명제2·송정동,관내사전투표,2980,2980,1436,500,558,197,261,4,1,2,2,3,0,2,2,2968,12,0
충청북도,청주시흥덕구,봉명제2·송정동,봉명제2·송정동제1투,2794,1754,565,547,390,114,122,3,0,0,5,0,0,0,2,1748,6,1040
충청북도,청주시흥덕구,봉명제2·송정동,봉명제2·송정동제2투,2550,1609,551,458,352,89,144,3,2,0,0,3,0,0,1,1603,6,941
충청북도,청주시흥덕구,봉명제2·송정동,봉명제2·송정동제3투,3368,1918,767,412,458,100,159,2,1,1,2,4,2,0,3,1911,7,1450
충청북도,청주시흥덕구,봉명제2·송정동,봉명제2·송정동제4투,2181,1467,698,230,276,113,142,0,0,1,0,2,1,0,1,1464,3,714
충청북도,청주시흥덕구,봉명제2·송정동,봉명제2·송정동제5투,2748,2236,1027,440,453,140,161,2,0,3,0,0,0,0,1,2227,9,512
충청북도,청주시흥덕구,봉명제2·송정동,봉명제2·송정동제6투,3199,1773,787,315,370,134,156,0,0,0,3,0,0,0,0,1765,8,1426
충청북도,청주시흥덕구,강서제1동,관내사전투표,3347,3347,1638,599,636,203,248,4,0,1,0,1,1,0,2,3333,14,0
충청북도,청주시흥덕구,강서제1동,합계,17630,12724,5389,2890,2694,782,864,13,5,11,4,4,7,5,11,12679,45,4906
충청북도,청주시흥덕구,강서제1동,강서제1동제1투,3854,2304,923,574,487,147,154,3,1,1,1,3,2,1,1,2298,6,1550
충청북도,청주시흥덕구,강서제1동,강서제1동제2투,818,530,136,229,116,21,19,0,1,1,0,0,1,1,2,527,3,288
충청북도,청주시흥덕구,강서제1동,강서제1동제3투,1156,716,227,261,161,29,28,0,0,3,0,0,1,1,0,711,5,440
충청북도,청주시흥덕구,강서제1동,강서제1동제4투,3114,2247,1035,369,490,145,195,3,0,2,1,0,0,1,1,2242,5,867
충청북도,청주시흥덕구,강서제1동,강서제1동제5투,1777,1113,410,280,257,69,81,0,2,2,1,0,2,1,2,1107,6,664
충청북도,청주시흥덕구,강서제1동,강서제1동제6투,3564,2467,1020,578,547,168,139,3,1,1,1,0,0,0,3,2461,6,1097
충청북도,청주시흥덕구,강서제2동,합계,3646,2727,1152,596,501,219,229,2,1,0,5,0,0,6,2,2713,14,919
충청북도,청주시흥덕구,강서제2동,관내사전투표,1136,1136,632,84,138,131,139,1,0,0,3,0,0,0,1,1129,7,0
충청북도,청주시흥덕구,강서제2동,강서제2동제1투,1576,961,355,248,221,64,67,1,1,0,0,0,0,1,0,958,3,615
충청북도,청주시흥덕구,강서제2동,강서제2동제2투,934,630,165,264,142,24,23,0,0,0,2,0,0,5,1,626,4,304
충청북도,청주시흥덕구,잘못 투입·구분된 투표지,,0,0,0,0,0,0,0,0,0,0,0,0,0,0,0,0,0,0
충청북도,청주시청원구,합계,,150781,115327,50487,24026,24203,7285,8249,114,29,73,34,95,63,67,151,114876,451,35454
충청북도,청주시청원구,거소·선상투표,,358,334,119,72,98,19,6,0,0,3,1,3,1,0,2,324,10,24
충청북도,청주시청원구,관외사전투표,,13452,13450,6607,1866,2653,1051,1118,14,2,2,2,8,10,3,33,13369,81,2
충청북도,청주시청원구,재외투표,,614,488,326,25,63,20,46,3,1,1,0,0,1,0,0,486,2,126
충청북도,청주시청원구,내수읍,관내사전투표,2459,2459,1111,549,473,127,156,3,4,3,2,4,1,2,5,2440,19,0
충청북도,청주시청원구,내수읍,합계,15611,10763,4108,2780,2423,586,729,12,5,7,6,12,4,13,18,10703,60,4848
충청북도,청주시청원구,내수읍,내수읍제1투,2212,1350,520,338,297,71,100,2,1,3,0,3,0,1,3,1339,11,862
충청북도,청주시청원구,내수읍,내수읍제2투,1315,823,211,308,226,37,29,0,0,0,2,1,0,3,1,818,5,492
충청북도,청주시청원구,내수읍,내수읍제3투,840,556,170,196,134,21,33,0,0,0,0,0,0,1,0,555,1,284
충청북도,청주시청원구,내수읍,내수읍제4투,2817,1925,799,336,485,137,152,2,0,0,0,0,0,4,3,1918,7,892
충청북도,청주시청원구,내수읍,내수읍제5투,1860,1220,416,352,287,60,98,0,0,1,0,0,1,0,1,1216,4,640
충청북도,청주시청원구,내수읍,내수읍제6투,2852,1709,654,442,382,96,117,2,0,0,1,3,1,1,3,1702,7,1143
충청북도,청주시청원구,내수읍,내수읍제7투,1256,721,227,259,139,37,44,3,0,0,1,1,1,1,2,715,6,535
충청북도,청주시청원구,오창읍,합계,40105,30505,15267,4513,6141,2123,2288,20,3,18,7,12,7,13,25,30437,68,9600
충청북도,청주시청원구,오창읍,관내사전투표,5399,5399,3063,608,952,357,390,1,0,5,2,0,0,1,6,5385,14,0
충청북도,청주시청원구,오창읍,오창읍제1투,2226,1337,385,467,323,64,84,2,0,0,0,0,3,1,2,1331,6,889
충청북도,청주시청원구,오창읍,오창읍제2투,2024,1262,422,382,292,75,80,1,0,1,0,0,0,2,1,1256,6,762
충청북도,청주시청원구,오창읍,오창읍제3투,875,557,172,195,138,25,22,0,1,0,0,0,0,1,1,555,2,318
충청북도,청주시청원구,오창읍,오창읍제4투,2778,2108,978,369,453,133,165,0,1,2,1,0,0,1,1,2104,4,670
충청북도,청주시청원구,오창읍,오창읍제5투,2153,1815,865,294,389,130,131,0,0,2,0,0,1,0,1,1813,2,338
충청북도,청주시청원구,오창읍,오창읍제6투,2335,1933,1034,243,374,142,134,1,1,0,0,1,0,0,0,1930,3,402
충청북도,청주시청원구,오창읍,오창읍제7투,2649,2172,1189,237,454,156,126,1,0,0,1,2,1,2,1,2170,2,477
충청북도,청주시청원구,오창읍,오창읍제8투,2395,1960,1064,236,381,133,136,1,0,2,0,1,0,1,1,1956,4,435
충청북도,청주시청원구,오창읍,오창읍제9투,2519,2088,1131,233,417,121,176,3,0,1,0,1,0,1,0,2084,4,431
충청북도,청주시청원구,오창읍,오창읍제10투,2576,1627,787,243,328,133,128,1,0,1,1,1,0,1,1,1625,2,949
충청북도,청주시청원구,오창읍,오창읍제11투,2313,1344,626,222,249,100,134,2,0,1,0,1,1,1,3,1340,4,969
충청북도,청주시청원구,오창읍,오창읍제12투,2808,1566,735,202,325,155,138,2,0,0,0,1,0,0,2,1560,6,1242
충청북도,청주시청원구,오창읍,오창읍제13투,2734,1983,1016,257,397,151,153,2,0,1,2,1,0,0,1,1981,2,751
충청북도,청주시청원구,오창읍,오창읍제14투,1923,1474,804,154,277,108,123,0,0,1,0,2,0,0,2,1471,3,449
충청북도,청주시청원구,오창읍,오창읍제15투,2398,1880,996,171,392,140,168,3,0,1,0,1,1,1,2,1876,4,518
충청북도,청주시청원구,북이면,합계,4208,2894,915,1009,609,117,142,8,4,7,7,18,5,9,13,2863,31,1314
충청북도,청주시청원구,북이면,관내사전투표,521,521,210,142,99,24,27,2,1,2,3,4,0,1,4,519,2,0
충청북도,청주시청원구,북이면,북이면제1투,938,566,172,200,123,24,29,3,1,0,1,2,1,4,2,562,4,372
충청북도,청주시청원구,북이면,북이면제2투,781,504,130,194,128,16,23,0,0,2,1,2,0,0,2,498,6,277
충청북도,청주시청원구,북이면,북이면제3투,959,654,209,236,133,22,29,3,0,2,0,1,3,2,3,643,11,305
충청북도,청주시청원구,북이면,북이면제4투,1009,649,194,237,126,31,34,0,2,1,2,9,1,2,2,641,8,360
충청북도,청주시청원구,우암동,합계,10539,7388,2456,2388,1612,399,458,5,5,9,1,1,2,7,11,7354,34,3151
충청북도,청주시청원구,우암동,관내사전투표,1924,1924,794,498,391,93,128,1,2,1,0,0,0,1,2,1911,13,0
충청북도,청주시청원구,우암동,우암동제1투,1996,1174,356,415,260,61,75,0,0,0,0,1,0,1,1,1170,4,822
충청북도,청주시청원구,우암동,우암동제2투,1921,1281,411,411,303,67,79,0,0,4,0,0,0,0,1,1276,5,640
충청북도,청주시청원구,우암동,우암동제3투,1972,1266,346,480,272,81,72,3,2,1,0,0,0,1,1,1259,7,706
충청북도,청주시청원구,우암동,우암동제4투,2726,1743,549,584,386,97,104,1,1,3,1,0,2,4,6,1738,5,983
충청북도,청주시청원구,내덕제1동,합계,8647,6265,2098,2058,1326,351,361,13,0,4,1,5,4,5,7,6233,32,2382
충청북도,청주시청원구,내덕제1동,관내사전투표,1914,1914,775,559,338,101,118,8,0,0,0,2,0,2,3,1906,8,0
충청북도,청주시청원구,내덕제1동,내덕제1동제1투,2142,1252,383,444,291,57,62,2,0,4,0,0,0,1,0,1244,8,890
충청북도,청주시청원구,내덕제1동,내덕제1동제2투,2230,1472,457,506,337,92,67,1,0,0,0,0,3,2,2,1467,5,758
충청북도,청주시청원구,내덕제1동,내덕제1동제3투,2361,1627,483,549,360,101,114,2,0,0,1,3,1,0,2,1616,11,734
충청북도,청주시청원구,내덕제2동,합계,9802,7079,2697,1985,1483,368,478,4,1,0,0,4,5,5,17,7047,32,2723
충청북도,청주시청원구,내덕제2동,관내사전투표,1895,1895,820,445,366,105,141,0,0,0,0,2,2,1,2,1884,11,0
충청북도,청주시청원구,내덕제2동,내덕제2동제1투,2339,1430,452,492,296,79,99,0,0,0,0,0,2,1,2,1423,7,909
충청북도,청주시청원구,내덕제2동,내덕제2동제2투,2336,1508,542,451,323,82,86,2,0,0,0,1,0,2,10,1499,9,828
충청북도,청주시청원구,내덕제2동,내덕제2동제3투,3232,2246,883,597,498,102,152,2,1,0,0,1,1,1,3,2241,5,986
충청북도,청주시청원구,율량·사천동,합계,35818,27435,11880,5627,5892,1778,2050,31,4,20,7,25,13,11,22,27360,75,8383
충청북도,청주시청원구,율량·사천동,관내사전투표,6460,6460,3286,1034,1174,446,479,10,2,3,0,5,3,0,5,6447,13,0
충청북도,청주시청원구,율량·사천동,율량·사천동제1투,2285,1625,644,398,350,104,113,2,0,2,2,1,0,1,2,1619,6,660
충청북도,청주시청원구,율량·사천동,율량·사천동제2투,2716,1710,655,402,377,114,146,5,0,0,0,4,1,1,1,1706,4,1006
충청북도,청주시청원구,율량·사천동,율량·사천동제3투,3038,2092,764,511,503,146,149,8,0,2,0,0,1,3,1,2088,4,946
충청북도,청주시청원구,율량·사천동,율량·사천동제4투,1799,1390,505,378,324,79,93,2,0,1,0,0,1,0,2,1385,5,409
충청북도,청주시청원구,율량·사천동,율량·사천동제5투,3073,2056,819,482,471,119,138,3,1,4,0,0,2,2,5,2046,10,1017
충청북도,청주시청원구,율량·사천동,율량·사천동제6투,2332,1680,766,312,354,108,130,0,0,0,0,1,1,0,2,1674,6,652
충청북도,청주시청원구,율량·사천동,율량·사천동제7투,2728,2024,802,458,451,121,175,0,0,2,3,2,0,1,1,2016,8,704
충청북도,청주시청원구,율량·사천동,율량·사천동제8투,2357,1680,615,473,383,92,98,0,0,3,0,3,2,2,1,1672,8,677
충청북도,청주시청원구,율량·사천동,율량·사천동제9투,1366,1108,501,215,224,84,79,0,0,0,0,1,1,0,0,1105,3,258
충청북도,청주시청원구,율량·사천동,율량·사천동제10투,1629,1140,586,134,252,72,94,0,0,0,0,0,0,0,0,1138,2,489
충청북도,청주시청원구,율량·사천동,율량·사천동제11투,2127,1602,654,323,383,98,138,0,0,0,1,2,0,0,1,1600,2,525
충청북도,청주시청원구,율량·사천동,율량·사천동제12투,1907,1440,639,228,339,104,120,1,0,2,0,3,0,1,0,1437,3,467
충청북도,청주시청원구,율량·사천동,율량·사천동제13투,2001,1428,644,279,307,91,98,0,1,1,1,3,1,0,1,1427,1,573
충청북도,청주시청원구,오근장동,합계,11627,8726,4014,1703,1903,473,573,4,4,2,2,7,11,1,3,8700,26,2901
충청북도,청주시청원구,오근장동,관내사전투표,810,810,368,177,169,33,55,0,1,0,0,0,2,0,0,805,5,0
충청북도,청주시청원구,오근장동,오근장동제1투,2076,1265,412,439,292,45,60,1,1,0,0,4,4,1,0,1259,6,811
충청북도,청주시청원구,오근장동,오근장동제2투,3057,2452,1234,357,517,149,183,3,2,1,1,2,1,0,0,2450,2,605
충청북도,청주시청원구,오근장동,오근장동제3투,3295,2241,976,461,514,120,150,0,0,0,1,1,4,0,2,2229,12,1054
충청북도,청주시청원구,오근장동,오근장동제4투,2389,1958,1024,269,411,126,125,0,0,1,0,0,0,0,1,1957,1,431
충청북도,청주시청원구,잘못 투입·구분된 투표지,,0,0,0,0,0,0,0,0,0,0,0,0,0,0,0,0,0,0
충청북도,충주시,합계,,172800,127426,43551,38532,28588,7233,8115,151,33,85,44,89,88,129,147,126785,641,45374
충청북도,충주시,거소·선상투표,,323,303,93,63,91,20,10,0,0,1,0,0,2,2,3,285,18,20
충청북도,충주시,관외사전투표,,11511,11511,4951,1848,2443,983,1105,17,3,8,2,8,4,7,27,11406,105,0
충청북도,충주시,재외투표,,669,551,335,36,74,23,81,2,0,0,0,0,0,0,0,551,0,118
충청북도,충주시,주덕읍,관내사전투표,862,862,287,269,202,42,50,0,0,1,1,2,0,0,2,856,6,0
충청북도,충주시,주덕읍,합계,4721,3222,911,1175,804,135,145,2,0,3,3,4,4,4,4,3194,28,1499
충청북도,충주시,주덕읍,주덕읍제1투,1243,760,204,301,189,31,28,0,0,0,0,0,0,0,0,753,7,483
충청북도,충주시,주덕읍,주덕읍제2투,1447,844,213,321,223,36,41,1,0,1,0,0,3,1,0,840,4,603
충청북도,충주시,주덕읍,주덕읍제3투,1169,756,207,284,190,26,26,1,0,1,2,2,1,3,2,745,11,413
충청북도,충주시,살미면,합계,1922,1411,387,561,318,69,65,1,0,0,1,1,0,2,2,1407,4,511
충청북도,충주시,살미면,관내사전투표,422,422,151,129,95,23,22,0,0,0,0,0,0,0,0,420,2,0
충청북도,충주시,살미면,살미면투표소,1500,989,236,432,223,46,43,1,0,0,1,1,0,2,2,987,2,511
충청북도,충주시,수안보면,관내사전투표,541,541,162,223,97,28,21,3,1,0,0,0,1,2,1,539,2,0
충청북도,충주시,수안보면,합계,2847,2008,526,874,416,80,75,4,2,0,0,0,5,6,5,1993,15,839
충청북도,충주시,수안보면,수안보면제1투,1741,1086,263,504,226,38,37,1,1,0,0,0,3,2,3,1078,8,655
충청북도,충주시,수안보면,수안보면제2투,565,381,101,147,93,14,17,0,0,0,0,0,1,2,1,376,5,184
충청북도,충주시,대소원면,합계,5814,3915,1266,1237,904,207,242,6,3,1,3,8,9,8,1,3895,20,1899
충청북도,충주시,대소원면,관내사전투표,1179,1179,480,296,227,71,86,3,0,1,0,1,3,2,1,1171,8,0
충청북도,충주시,대소원면,대소원면제1투,2564,1503,492,445,368,84,94,2,1,0,2,3,1,3,0,1495,8,1061
충청북도,충주시,대소원면,대소원면제2투,1611,917,232,344,245,40,44,0,0,0,0,4,3,2,0,914,3,694
충청북도,충주시,대소원면,대소원면제3투,460,316,62,152,64,12,18,1,2,0,1,0,2,1,0,315,1,144
충청북도,충주시,신니면,합계,2956,2120,579,854,476,94,90,3,1,0,2,2,3,3,3,2110,10,836
충청북도,충주시,신니면,관내사전투표,628,628,210,222,116,36,36,1,1,0,1,1,0,1,0,625,3,0
충청북도,충주시,신니면,신니면제1투,1326,823,182,364,201,30,32,2,0,0,1,0,2,2,3,819,4,503
충청북도,충주시,신니면,신니면제2투,1002,669,187,268,159,28,22,0,0,0,0,1,1,0,0,666,3,333
충청북도,충주시,노은면,합계,2155,1517,371,625,365,73,52,4,2,3,0,2,4,3,1,1505,12,638
충청북도,충주시,노은면,관내사전투표,519,519,158,186,119,25,26,1,1,0,0,1,1,1,0,519,0,0
충청북도,충주시,노은면,노은면투표소,1636,998,213,439,246,48,26,3,1,3,0,1,3,2,1,986,12,638
충청북도,충주시,앙성면,관내사전투표,701,701,223,260,145,25,38,1,0,1,0,1,0,0,1,695,6,0
충청북도,충주시,앙성면,합계,3655,2589,630,1143,579,87,114,4,1,4,1,2,0,9,1,2575,14,1066
충청북도,충주시,앙성면,앙성면제1투,643,433,77,222,105,9,11,3,0,0,1,0,0,3,0,431,2,210
충청북도,충주시,앙성면,앙성면제2투,1767,1088,262,479,241,41,53,0,0,3,0,1,0,3,0,1083,5,679
충청북도,충주시,앙성면,앙성면제3투,544,367,68,182,88,12,12,0,1,0,0,0,0,3,0,366,1,177
충청북도,충주시,중앙탑면,합계,2475,1754,452,674,474,60,75,1,1,0,0,0,2,3,2,1744,10,721
충청북도,충주시,중앙탑면,관내사전투표,520,520,183,165,112,27,30,0,0,0,0,0,0,0,0,517,3,0
충청북도,충주시,중앙탑면,중앙탑면제1투,688,450,92,191,130,12,19,0,1,0,0,0,0,2,1,448,2,238
충청북도,충주시,중앙탑면,중앙탑면제2투,1267,784,177,318,232,21,26,1,0,0,0,0,2,1,1,779,5,483
충청북도,충주시,금가면,관내사전투표,693,693,260,152,165,57,54,0,0,1,0,0,1,1,1,692,1,0
충청북도,충주시,금가면,합계,3102,2304,687,709,601,156,128,0,0,1,1,1,1,5,3,2293,11,798
충청북도,충주시,금가면,금가면제1투,1321,913,247,313,257,37,45,0,0,0,0,1,0,2,1,903,10,408
충청북도,충주시,금가면,금가면제2투,1088,698,180,244,179,62,29,0,0,0,1,0,0,2,1,698,0,390
충청북도,충주시,동량면,합계,3306,2363,582,972,568,93,112,1,1,5,1,2,5,2,4,2348,15,943
충청북도,충주시,동량면,관내사전투표,514,514,146,198,110,22,31,0,0,1,0,0,2,0,0,510,4,0
충청북도,충주시,동량면,동량면제1투,1307,859,185,374,220,30,36,1,0,2,1,2,2,0,3,856,3,448
충청북도,충주시,동량면,동량면제2투,1485,990,251,400,238,41,45,0,1,2,0,0,1,2,1,982,8,495
충청북도,충주시,산척면,합계,2278,1683,410,794,327,66,67,0,0,1,1,1,2,4,4,1677,6,595
충청북도,충주시,산척면,관내사전투표,587,587,167,248,111,21,34,0,0,0,0,1,0,4,0,586,1,0
충청북도,충주시,산척면,산척면투표소,1691,1096,243,546,216,45,33,0,0,1,1,0,2,0,4,1091,5,595
충청북도,충주시,엄정면,관내사전투표,758,758,229,336,126,22,30,3,1,0,1,1,0,2,1,752,6,0
충청북도,충주시,엄정면,합계,3025,2220,557,1015,456,77,80,5,1,1,2,1,2,7,3,2207,13,805
충청북도,충주시,엄정면,엄정면투표소,2267,1462,328,679,330,55,50,2,0,1,1,0,2,5,2,1455,7,805
충청북도,충주시,소태면,합계,1619,1217,281,511,300,45,59,1,1,4,2,1,2,3,1,1211,6,402
충청북도,충주시,소태면,관내사전투표,262,262,75,89,67,16,11,0,0,0,1,0,0,0,0,259,3,0
충청북도,충주시,소태면,소태면제1투,770,536,137,216,137,9,25,1,1,1,1,1,1,2,1,533,3,234
충청북도,충주시,소태면,소태면제2투,587,419,69,206,96,20,23,0,0,3,0,0,1,1,0,419,0,168
충청북도,충주시,성내·충인동,합계,3259,2329,637,971,501,104,97,4,0,0,0,0,0,3,1,2318,11,930
충청북도,충주시,성내·충인동,관내사전투표,925,925,292,336,186,49,56,2,0,0,0,0,0,2,0,923,2,0
충청북도,충주시,성내·충인동,성내·충인동제1투,652,444,91,218,101,17,11,0,0,0,0,0,0,1,0,439,5,208
충청북도,충주시,성내·충인동,성내·충인동제2투,1682,960,254,417,214,38,30,2,0,0,0,0,0,0,1,956,4,722
충청북도,충주시,교현·안림동,합계,18908,13481,4689,3943,3072,794,856,20,3,6,3,7,5,8,13,13419,62,5427
충청북도,충주시,교현·안림동,관내사전투표,3445,3445,1486,750,709,231,242,5,1,0,1,3,2,3,1,3434,11,0
충청북도,충주시,교현·안림동,교현·안림동제1투,1653,1040,299,365,239,53,73,1,0,0,0,1,0,1,0,1032,8,613
충청북도,충주시,교현·안림동,교현·안림동제2투,2075,1256,330,449,312,70,78,1,1,3,0,0,1,2,2,1249,7,819
충청북도,충주시,교현·안림동,교현·안림동제3투,2455,1687,534,561,396,93,85,3,0,1,1,1,0,1,2,1678,9,768
충청북도,충주시,교현·안림동,교현·안림동제4투,1982,1200,336,453,298,48,56,3,1,0,0,0,0,0,1,1196,4,782
충청북도,충주시,교현·안림동,교현·안림동제5투,3032,2018,677,592,480,110,133,3,0,1,0,2,1,1,4,2004,14,1014
충청북도,충주시,교현·안림동,교현·안림동제6투,4266,2835,1027,773,638,189,189,4,0,1,1,0,1,0,3,2826,9,1431
충청북도,충주시,교현2동,합계,6736,4667,1471,1657,991,241,255,7,0,2,2,5,2,6,5,4644,23,2069
충청북도,충주시,교현2동,관내사전투표,1231,1231,486,347,232,73,86,1,0,1,0,0,0,1,1,1228,3,0
충청북도,충주시,교현2동,교현2동제1투,1274,792,237,334,159,33,20,1,0,0,0,1,1,0,1,787,5,482
충청북도,충주시,교현2동,교현2동제2투,1968,1173,318,429,282,55,73,2,0,0,1,1,1,5,1,1168,5,795
충청북도,충주시,교현2동,교현2동제3투,2263,1471,430,547,318,80,76,3,0,1,1,3,0,0,2,1461,10,792
충청북도,충주시,용산동,합계,11577,8415,3128,2201,1962,475,576,10,0,8,5,6,3,7,13,8394,21,3162
충청북도,충주시,용산동,관내사전투표,2318,2318,945,576,465,124,180,8,0,3,3,2,2,1,2,2311,7,0
충청북도,충주시,용산동,용산동제1투,2108,1336,416,402,342,70,95,0,0,0,1,1,0,2,2,1331,5,772
충청북도,충주시,용산동,용산동제2투,1744,1074,354,342,258,47,66,1,0,0,0,1,0,0,3,1072,2,670
충청북도,충주시,용산동,용산동제3투,2000,1328,441,400,328,78,70,1,0,3,0,0,0,2,2,1325,3,672
충청북도,충주시,용산동,용산동제4투,3407,2359,972,481,569,156,165,0,0,2,1,2,1,2,4,2355,4,1048
충청북도,충주시,지현동,합계,4693,3360,1033,1202,753,162,179,1,0,1,0,2,4,3,2,3342,18,1333
충청북도,충주시,지현동,관내사전투표,758,758,295,231,139,41,45,0,0,0,0,0,1,2,0,754,4,0
충청북도,충주시,지현동,지현동제1투,2006,1341,403,481,319,55,68,0,0,1,0,0,2,1,2,1332,9,665
충청북도,충주시,지현동,지현동제2투,1929,1261,335,490,295,66,66,1,0,0,0,2,1,0,0,1256,5,668
충청북도,충주시,문화동,합계,8877,6372,1895,2338,1433,307,333,10,1,7,3,2,2,8,6,6345,27,2505
충청북도,충주시,문화동,관내사전투표,1549,1549,572,462,347,71,85,2,1,0,3,0,0,0,2,1545,4,0
충청북도,충주시,문화동,문화동제1투,1859,1106,303,460,234,51,44,2,0,0,0,0,2,3,1,1100,6,753
충청북도,충주시,문화동,문화동제2투,1906,1485,387,585,341,75,83,4,0,0,0,1,0,1,1,1478,7,421
충청북도,충주시,문화동,문화동제3투,1639,1047,276,420,241,51,47,1,0,2,0,1,0,2,1,1042,5,592
충청북도,충주시,문화동,문화동제4투,1924,1185,357,411,270,59,74,1,0,5,0,0,0,2,1,1180,5,739
충청북도,충주시,호암·직동,합계,7520,5459,2100,1351,1242,338,374,3,3,4,1,6,3,1,2,5428,31,2061
충청북도,충주시,호암·직동,관내사전투표,1589,1589,729,323,296,94,131,1,2,0,1,3,1,0,1,1582,7,0
충청북도,충주시,호암·직동,호암·직동제1투,3271,2161,760,552,541,143,139,1,1,3,0,2,2,0,1,2145,16,1110
충청북도,충주시,호암·직동,호암·직동제2투,1086,719,231,241,163,34,46,0,0,0,0,0,0,1,0,716,3,367
충청북도,충주시,호암·직동,호암·직동제3투,1574,990,380,235,242,67,58,1,0,1,0,1,0,0,0,985,5,584
충청북도,충주시,달천동,합계,3577,2408,682,821,576,157,146,2,1,3,1,0,3,2,1,2395,13,1169
충청북도,충주시,달천동,관내사전투표,710,710,247,204,139,61,52,1,0,1,1,0,0,1,0,707,3,0
충청북도,충주시,달천동,달천동제1투,2106,1241,333,459,302,70,64,1,1,1,0,0,3,1,0,1235,6,865
충청북도,충주시,달천동,달천동제2투,761,457,102,158,135,26,30,0,0,1,0,0,0,0,1,453,4,304
충청북도,충주시,봉방동,합계,8507,6082,1980,2031,1363,301,333,9,5,5,1,8,2,5,7,6050,32,2425
충청북도,충주시,봉방동,관내사전투표,2010,2010,741,606,401,106,129,5,2,0,0,3,0,1,1,1995,15,0
충청북도,충주시,봉방동,봉방동제1투,1484,911,230,372,199,48,50,0,1,1,0,0,0,1,1,903,8,573
충청북도,충주시,봉방동,봉방동제2투,2456,1622,553,493,394,83,85,4,0,1,0,3,1,0,2,1619,3,834
충청북도,충주시,봉방동,봉방동제3투,2557,1539,456,560,369,64,69,0,2,3,1,2,1,3,3,1533,6,1018
충청북도,충주시,칠금·금릉동,합계,12567,9433,3607,2400,2063,582,706,10,1,5,2,4,5,7,8,9400,33,3134
충청북도,충주시,칠금·금릉동,관내사전투표,2738,2738,1275,499,490,205,243,2,0,1,1,2,0,1,3,2722,16,0
충청북도,충주시,칠금·금릉동,칠금·금릉동제1투,913,569,151,231,136,23,22,0,0,1,0,0,2,1,0,567,2,344
충청북도,충주시,칠금·금릉동,칠금·금릉동제2투,1519,1025,327,356,219,47,68,1,0,1,0,0,0,2,1,1022,3,494
충청북도,충주시,칠금·금릉동,칠금·금릉동제3투,2266,1462,539,375,343,87,110,1,1,1,0,0,0,0,1,1458,4,804
충청북도,충주시,칠금·금릉동,칠금·금릉동제4투,2428,1588,559,450,363,88,117,4,0,0,0,0,2,1,1,1585,3,840
충청북도,충주시,칠금·금릉동,칠금·금릉동제5투,2703,2051,756,489,512,132,146,2,0,1,1,2,1,2,2,2046,5,652
충청북도,충주시,연수동,합계,29251,21087,7896,5630,4603,1300,1494,22,3,7,6,14,10,9,23,21017,70,8164
충청북도,충주시,연수동,관내사전투표,5321,5321,2290,1195,997,337,459,3,2,3,3,2,2,4,6,5303,18,0
충청북도,충주시,연수동,연수동제1투,2220,1331,383,509,295,69,64,1,0,0,1,2,2,0,0,1326,5,889
충청북도,충주시,연수동,연수동제2투,2125,1314,492,327,322,70,91,2,0,1,0,0,0,1,0,1306,8,811
충청북도,충주시,연수동,연수동제3투,2529,1893,737,418,483,138,111,1,0,0,0,0,0,0,2,1890,3,636
충청북도,충주시,연수동,연수동제4투,1972,1359,499,389,276,95,87,2,1,0,0,1,0,1,3,1354,5,613
충청북도,충주시,연수동,연수동제5투,1458,891,260,315,210,47,52,1,0,1,0,1,0,1,1,889,2,567
충청북도,충주시,연수동,연수동제6투,2155,1218,320,512,267,39,50,5,0,2,1,3,3,1,4,1207,11,937
충청북도,충주시,연수동,연수동제7투,2065,1442,582,307,338,98,112,0,0,0,0,1,1,0,1,1440,2,623
충청북도,충주시,연수동,연수동제8투,2072,1404,535,340,316,91,115,3,0,0,1,0,0,0,0,1401,3,668
충청북도,충주시,연수동,연수동제9투,3384,2108,816,539,439,131,169,0,0,0,0,2,1,0,4,2101,7,1276
충청북도,충주시,연수동,연수동제10투,1876,1382,484,348,338,105,98,1,0,0,0,0,0,1,2,1377,5,494
충청북도,충주시,연수동,연수동제11투,2074,1424,498,431,322,80,86,3,0,0,0,2,1,0,0,1423,1,650
충청북도,충주시,목행·용탄동,합계,4950,3645,1415,896,833,204,266,2,0,5,1,2,4,2,2,3632,13,1305
충청북도,충주시,목행·용탄동,관내사전투표,1202,1202,534,229,235,83,112,1,0,1,0,2,2,0,2,1201,1,0
충청북도,충주시,목행·용탄동,목행·용탄동제1투,2204,1505,615,328,352,90,109,0,0,2,0,0,2,0,0,1498,7,699
충청북도,충주시,목행·용탄동,목행·용탄동제2투,1544,938,266,339,246,31,45,1,0,2,1,0,0,2,0,933,5,606
충청북도,충주시,잘못 투입·구분된 투표지,,0,0,0,0,0,0,0,0,0,0,0,0,0,0,0,0,0,0
충청북도,제천시,합계,,113835,84700,28517,26977,17768,5085,5249,99,19,76,40,64,74,106,135,84209,491,29135
충청북도,제천시,거소·선상투표,,333,314,95,64,80,17,16,2,3,3,1,2,2,0,2,287,27,19
충청북도,제천시,관외사전투표,,8217,8211,3623,1258,1652,752,786,8,1,6,3,7,5,8,25,8134,77,6
충청북도,제천시,재외투표,,395,299,191,16,42,8,40,1,0,0,0,0,0,0,1,299,0,96
충청북도,제천시,봉양읍,합계,5882,4139,1177,1579,888,193,226,11,4,5,2,2,2,8,10,4107,32,1743
충청북도,제천시,봉양읍,관내사전투표,1088,1088,381,378,211,48,55,4,2,0,1,0,1,2,1,1084,4,0
충청북도,제천시,봉양읍,봉양읍제1투,2811,1705,436,698,380,67,83,6,1,3,0,0,0,3,8,1685,20,1106
충청북도,제천시,봉양읍,봉양읍제2투,1260,858,249,302,177,54,66,1,1,1,0,0,0,3,0,854,4,402
충청북도,제천시,봉양읍,봉양읍제3투,723,488,111,201,120,24,22,0,0,1,1,2,1,0,1,484,4,235
충청북도,제천시,금성면,합계,1831,1323,385,556,249,57,56,1,0,1,1,1,1,2,2,1312,11,508
충청북도,제천시,금성면,관내사전투표,313,313,100,129,57,13,12,0,0,1,0,0,0,0,0,312,1,0
충청북도,제천시,금성면,금성면제1투,721,466,127,201,79,29,24,1,0,0,1,0,0,0,2,464,2,255
충청북도,제천시,금성면,금성면제2투,797,544,158,226,113,15,20,0,0,0,0,1,1,2,0,536,8,253
충청북도,제천시,청풍면,관내사전투표,229,229,64,95,41,12,12,0,0,0,0,0,0,0,0,224,5,0
충청북도,제천시,청풍면,합계,1152,878,177,410,201,42,31,2,1,0,0,2,2,2,0,870,8,274
충청북도,제천시,청풍면,청풍면제1투,762,524,96,246,137,26,15,0,0,0,0,1,1,1,0,523,1,238
충청북도,제천시,청풍면,청풍면제2투,161,125,17,69,23,4,4,2,1,0,0,1,1,1,0,123,2,36
충청북도,제천시,수산면,합계,1830,1325,281,606,312,49,51,9,1,2,1,0,3,1,1,1317,8,505
충청북도,제천시,수산면,관내사전투표,279,279,73,110,67,13,13,2,0,0,0,0,0,0,0,278,1,0
충청북도,제천시,수산면,수산면제1투,1251,838,159,409,194,30,32,6,1,1,1,0,0,1,1,835,3,413
충청북도,제천시,수산면,수산면제2투,300,208,49,87,51,6,6,1,0,1,0,0,3,0,0,204,4,92
충청북도,제천시,덕산면,관내사전투표,368,368,118,129,80,18,15,0,0,1,0,1,1,0,1,364,4,0
충청북도,제천시,덕산면,합계,1922,1428,371,588,328,44,59,2,0,2,4,3,5,3,8,1417,11,494
충청북도,제천시,덕산면,덕산면제1투,1182,798,204,334,189,22,26,2,0,0,3,0,4,3,4,791,7,384
충청북도,제천시,덕산면,덕산면제2투,372,262,49,125,59,4,18,0,0,1,1,2,0,0,3,262,0,110
충청북도,제천시,한수면,관내사전투표,106,106,49,32,13,4,7,0,1,0,0,0,0,0,0,106,0,0
충청북도,제천시,한수면,합계,615,446,111,216,82,10,20,0,1,0,0,0,1,1,0,442,4,169
충청북도,제천시,한수면,한수면투표소,509,340,62,184,69,6,13,0,0,0,0,0,1,1,0,336,4,169
충청북도,제천시,백운면,합계,2823,2066,532,815,488,98,102,4,0,0,2,2,2,9,5,2059,7,757
충청북도,제천시,백운면,관내사전투표,566,566,187,202,116,29,29,0,0,0,0,0,0,2,0,565,1,0
충청북도,제천시,백운면,백운면제1투,1490,980,229,393,237,46,52,4,0,0,1,1,2,5,5,975,5,510
충청북도,제천시,백운면,백운면제2투,767,520,116,220,135,23,21,0,0,0,1,1,0,2,0,519,1,247
충청북도,제천시,송학면,합계,4240,3038,770,1251,690,120,152,6,0,6,2,2,6,8,6,3019,19,1202
충청북도,제천시,송학면,관내사전투표,658,658,233,207,149,24,37,1,0,0,1,0,0,2,2,656,2,0
충청북도,제천시,송학면,송학면제1투,2021,1303,306,567,288,57,58,1,0,6,1,1,3,3,3,1294,9,718
충청북도,제천시,송학면,송학면제2투,1144,781,165,357,169,27,49,3,0,0,0,1,3,1,0,775,6,363
충청북도,제천시,송학면,송학면제3투,417,296,66,120,84,12,8,1,0,0,0,0,0,2,1,294,2,121
충청북도,제천시,교동,관내사전투표,2274,2274,1011,523,422,144,154,3,0,3,1,4,0,0,1,2266,8,0
충청북도,제천시,교동,합계,12324,8951,3243,2534,1952,546,588,11,1,9,5,7,2,5,7,8910,41,3373
충청북도,제천시,교동,교동제1투,1831,1234,307,488,294,77,56,2,0,0,3,0,0,2,1,1230,4,597
충청북도,제천시,교동,교동제2투,3511,2259,864,520,528,151,170,3,0,1,0,2,0,0,4,2243,16,1252
충청북도,제천시,교동,교동제3투,2283,1566,558,448,343,96,105,1,1,4,0,1,2,1,0,1560,6,717
충청북도,제천시,교동,교동제4투,2425,1618,503,555,365,78,103,2,0,1,1,0,0,2,1,1611,7,807
충청북도,제천시,남현동,관내사전투표,929,929,358,270,163,68,58,3,0,1,0,0,0,2,3,926,3,0
충청북도,제천시,남현동,합계,4720,3366,984,1324,649,207,166,6,0,1,2,1,3,6,6,3355,11,1354
충청북도,제천시,남현동,남현동제1투,1395,927,219,445,175,50,26,0,0,0,1,0,1,2,1,920,7,468
충청북도,제천시,남현동,남현동제2투,2396,1510,407,609,311,89,82,3,0,0,1,1,2,2,2,1509,1,886
충청북도,제천시,영서동,관내사전투표,1634,1634,610,512,320,87,92,2,0,2,0,1,1,2,4,1633,1,0
충청북도,제천시,영서동,합계,7244,5091,1519,1956,1027,277,259,2,0,2,1,1,6,8,11,5069,22,2153
충청북도,제천시,영서동,영서동제1투,1556,945,232,431,197,43,32,0,0,0,1,0,0,1,2,939,6,611
충청북도,제천시,영서동,영서동제2투,2467,1482,399,648,292,80,52,0,0,0,0,0,1,4,0,1476,6,985
충청북도,제천시,영서동,영서동제3투,1587,1030,278,365,218,67,83,0,0,0,0,0,4,1,5,1021,9,557
충청북도,제천시,용두동,관내사전투표,2973,2973,1245,747,554,183,205,1,0,3,3,3,2,7,7,2960,13,0
충청북도,제천시,용두동,합계,13083,9579,3678,2577,1962,639,616,3,4,5,6,10,6,15,15,9536,43,3504
충청북도,제천시,용두동,용두동제1투,2168,1412,490,431,297,91,97,0,2,1,0,1,0,1,0,1411,1,756
충청북도,제천시,용두동,용두동제2투,2638,1745,667,405,377,144,132,2,1,0,1,3,1,3,3,1739,6,893
충청북도,제천시,용두동,용두동제3투,2751,1572,460,536,381,80,85,0,1,1,2,1,3,2,4,1556,16,1179
충청북도,제천시,용두동,용두동제4투,2553,1877,816,458,353,141,97,0,0,0,0,2,0,2,1,1870,7,676
충청북도,제천시,신백동,합계,9196,6462,2306,1818,1395,376,473,5,1,11,0,6,12,8,8,6419,43,2734
충청북도,제천시,신백동,관내사전투표,1376,1376,602,292,256,83,123,0,0,1,0,2,0,2,1,1362,14,0
충청북도,제천시,신백동,신백동제1투,1949,1331,525,316,305,80,93,0,0,3,0,2,0,0,4,1328,3,618
충청북도,제천시,신백동,신백동제2투,1855,1072,309,343,250,71,88,2,0,1,0,0,1,1,1,1067,5,783
충청북도,제천시,신백동,신백동제3투,2171,1485,558,369,329,95,120,1,1,3,0,0,0,0,1,1477,8,686
충청북도,제천시,신백동,신백동제4투,1122,746,204,291,169,32,27,2,0,1,0,1,9,2,1,739,7,376
충청북도,제천시,신백동,신백동제5투,723,452,108,207,86,15,22,0,0,2,0,1,2,3,0,446,6,271
충청북도,제천시,청전동,합계,14604,10788,3363,3825,2234,643,614,7,1,10,6,8,8,10,3,10732,56,3816
충청북도,제천시,청전동,관내사전투표,3393,3393,1288,1010,640,211,219,0,0,5,1,1,1,3,0,3379,14,0
충청북도,제천시,청전동,청전동제1투,2012,1324,383,500,286,69,70,2,0,0,1,3,1,4,0,1319,5,688
충청북도,제천시,청전동,청전동제2투,1831,1284,413,467,235,83,73,0,0,0,0,0,3,1,0,1275,9,547
충청북도,제천시,청전동,청전동제3투,1389,935,242,362,210,53,51,2,1,1,2,2,1,0,0,927,8,454
충청북도,제천시,청전동,청전동제4투,2209,1209,309,494,260,58,71,1,0,0,1,2,2,1,1,1200,9,1000
충청북도,제천시,청전동,청전동제5투,2142,1561,450,575,338,111,77,1,0,1,1,0,0,0,2,1556,5,581
충청북도,제천시,청전동,청전동제6투,1628,1082,278,417,265,58,53,1,0,3,0,0,0,1,0,1076,6,546
충청북도,제천시,화산동,합계,10278,7073,2420,2338,1477,384,396,6,1,3,2,3,4,7,10,7051,22,3205
충청북도,제천시,화산동,관내사전투표,1733,1733,723,501,291,95,104,2,0,0,1,2,0,2,4,1725,8,0
충청북도,제천시,화산동,화산동제1투,2664,1686,516,581,382,92,104,2,0,1,1,1,2,3,0,1685,1,978
충청북도,제천시,화산동,화산동제2투,4086,2589,922,750,602,148,146,2,0,2,0,0,2,2,3,2579,10,1497
충청북도,제천시,화산동,화산동제3투,1795,1065,259,506,202,49,42,0,1,0,0,0,0,0,3,1062,3,730
충청북도,제천시,의림지동,합계,6969,5339,1960,1443,1167,369,340,4,0,5,0,6,4,5,12,5315,24,1630
충청북도,제천시,의림지동,관내사전투표,1569,1569,698,337,308,95,117,0,0,2,0,1,1,0,2,1561,8,0
충청북도,제천시,의림지동,의림지동제1투,2820,2030,768,503,444,150,142,0,0,3,0,4,1,1,4,2020,10,790
충청북도,제천시,의림지동,의림지동제2투,1116,743,239,233,172,47,42,1,0,0,0,1,2,2,2,741,2,373
충청북도,제천시,의림지동,의림지동제3투,1464,997,255,370,243,77,39,3,0,0,0,0,0,2,4,993,4,467
충청북도,제천시,중앙동,합계,6177,4584,1331,1803,893,254,258,9,0,5,2,1,0,0,3,4559,25,1593
충청북도,제천시,중앙동,관내사전투표,1925,1925,661,667,329,109,143,1,0,2,1,1,0,0,0,1914,11,0
충청북도,제천시,중앙동,중앙동제1투,2734,1750,455,740,371,88,75,6,0,2,1,0,0,0,3,1741,9,984
충청북도,제천시,중앙동,중앙동제2투,1518,909,215,396,193,57,40,2,0,1,0,0,0,0,0,904,5,609
충청북도,제천시,잘못 투입·구분된 투표지,,0,0,0,0,0,0,0,0,0,0,0,0,0,0,0,0,0,0
충청북도,단양군,합계,,26699,19905,5708,7901,4026,978,964,44,10,18,9,11,49,43,19,19780,125,6794
충청북도,단양군,거소·선상투표,,103,102,30,23,22,4,3,1,4,0,0,1,0,0,0,88,14,1
충청북도,단양군,관외사전투표,,2144,2143,892,450,435,168,174,2,1,0,1,1,1,2,1,2128,15,1
충청북도,단양군,재외투표,,100,75,56,4,8,1,5,0,0,0,0,0,0,1,0,75,0,25
충청북도,단양군,단양읍,합계,8274,6039,1920,2313,1118,319,307,10,1,7,2,2,8,3,5,6015,24,2235
충청북도,단양군,단양읍,관내사전투표,1815,1815,744,530,294,121,114,2,0,2,0,0,1,0,1,1809,6,0
충청북도,단양군,단양읍,단양읍제1투,2040,1310,375,536,260,65,62,1,1,3,0,1,3,0,2,1309,1,730
충청북도,단양군,단양읍,단양읍제2투,1592,1102,266,513,221,50,40,4,0,1,0,0,0,1,0,1096,6,490
충청북도,단양군,단양읍,단양읍제3투,2827,1812,535,734,343,83,91,3,0,1,2,1,4,2,2,1801,11,1015
충청북도,단양군,매포읍,관내사전투표,913,913,308,358,140,41,59,2,0,0,0,0,1,2,0,911,2,0
충청북도,단양군,매포읍,합계,4909,3578,959,1484,729,164,198,13,1,1,0,0,5,6,2,3562,16,1331
충청북도,단양군,매포읍,매포읍제1투,2204,1477,347,616,328,75,87,7,1,0,0,0,4,2,2,1469,8,727
충청북도,단양군,매포읍,매포읍제2투,1013,642,177,241,158,24,34,4,0,1,0,0,0,0,0,639,3,371
충청북도,단양군,매포읍,매포읍제3투,779,546,127,269,103,24,18,0,0,0,0,0,0,2,0,543,3,233
충청북도,단양군,단성면,합계,1517,1079,253,486,229,39,54,0,0,0,2,1,3,4,2,1073,6,438
충청북도,단양군,단성면,관내사전투표,260,260,81,81,73,12,12,0,0,0,0,1,0,0,0,260,0,0
충청북도,단양군,단성면,단성면제1투,913,568,129,271,113,18,32,0,0,0,0,0,1,1,0,565,3,345
충청북도,단양군,단성면,단성면제2투,344,251,43,134,43,9,10,0,0,0,2,0,2,3,2,248,3,93
충청북도,단양군,대강면,합계,2184,1567,328,777,307,68,55,3,1,0,2,3,1,4,2,1551,16,617
충청북도,단양군,대강면,관내사전투표,503,503,131,233,84,31,13,1,1,0,0,0,1,1,0,496,7,0
충청북도,단양군,대강면,대강면제1투,1219,735,145,372,147,27,27,2,0,0,1,2,0,3,2,728,7,484
충청북도,단양군,대강면,대강면제2투,462,329,52,172,76,10,15,0,0,0,1,1,0,0,0,327,2,133
충청북도,단양군,가곡면,합계,1743,1257,329,522,277,52,55,3,0,4,0,1,3,4,2,1252,5,486
충청북도,단양군,가곡면,관내사전투표,386,386,125,146,72,20,18,0,0,0,0,0,3,1,0,385,1,0
충청북도,단양군,가곡면,가곡면투표소,1357,871,204,376,205,32,37,3,0,4,0,1,0,3,2,867,4,486
충청북도,단양군,영춘면,합계,2840,2090,457,1045,378,86,60,3,1,2,2,0,24,12,3,2073,17,750
충청북도,단양군,영춘면,관내사전투표,585,585,120,327,76,24,20,0,0,1,0,0,7,5,1,581,4,0
충청북도,단양군,영춘면,영춘면제1투,1261,801,149,445,128,26,22,3,0,1,0,0,13,5,0,792,9,460
충청북도,단양군,영춘면,영춘면제2투,150,126,26,42,42,8,2,0,0,0,1,0,1,1,2,125,1,24
충청북도,단양군,영춘면,영춘면제3투,844,578,162,231,132,28,16,0,1,0,1,0,3,1,0,575,3,266
충청북도,단양군,어상천면,관내사전투표,252,252,86,70,63,18,10,2,0,2,0,0,0,1,0,252,0,0
충청북도,단양군,어상천면,합계,1612,1073,284,373,320,47,27,5,0,3,0,0,3,3,2,1067,6,539
충청북도,단양군,어상천면,어상천면투표소,1360,821,198,303,257,29,17,3,0,1,0,0,3,2,2,815,6,539
충청북도,단양군,적성면,합계,1273,902,200,424,203,30,26,4,1,1,0,2,1,4,0,896,6,371
충청북도,단양군,적성면,관내사전투표,151,151,42,69,26,7,4,0,1,0,0,0,0,0,0,149,2,0
충청북도,단양군,적성면,적성면제1투,483,323,59,181,64,5,5,1,0,1,0,2,0,2,0,320,3,160
충청북도,단양군,적성면,적성면제2투,639,428,99,174,113,18,17,3,0,0,0,0,1,2,0,427,1,211
충청북도,단양군,잘못 투입·구분된 투표지,,0,0,0,0,0,0,0,0,0,0,0,0,0,0,0,0,0,0
충청북도,영동군,합계,,43884,32554,10432,10958,7017,1726,1873,42,18,35,17,50,29,70,77,32344,210,11330
충청북도,영동군,거소·선상투표,,169,156,45,45,33,4,5,1,0,0,1,2,1,4,3,144,12,13
충청북도,영동군,관외사전투표,,4275,4274,1851,724,840,377,430,6,0,1,4,2,3,3,12,4253,21,1
충청북도,영동군,재외투표,,227,123,67,10,34,2,7,0,0,0,1,1,0,1,0,123,0,104
충청북도,영동군,영동읍,합계,16309,11742,4088,3635,2428,652,774,11,4,16,3,19,10,9,21,11670,72,4567
충청북도,영동군,영동읍,관내사전투표,4137,4137,1702,1089,718,252,317,1,2,7,0,7,3,2,7,4107,30,0
충청북도,영동군,영동읍,영동읍제1투,2090,1255,394,444,266,64,71,1,1,1,1,5,0,4,2,1254,1,835
충청북도,영동군,영동읍,영동읍제2투,1991,1265,359,479,276,65,73,1,0,1,1,1,1,0,1,1258,7,726
충청북도,영동군,영동읍,영동읍제3투,1095,702,207,263,164,30,31,1,0,0,0,2,1,0,1,700,2,393
충청북도,영동군,영동읍,영동읍제4투,2506,1579,502,538,362,94,68,1,0,2,0,1,1,1,1,1571,8,927
충청북도,영동군,영동읍,영동읍제5투,2200,1290,442,319,317,61,124,0,1,5,1,2,2,1,5,1280,10,910
충청북도,영동군,영동읍,영동읍제6투,2290,1514,482,503,325,86,90,6,0,0,0,1,2,1,4,1500,14,776
충청북도,영동군,용산면,관내사전투표,856,856,260,294,199,41,45,0,0,2,1,2,1,3,1,849,7,0
충청북도,영동군,용산면,합계,2929,1978,534,774,448,82,104,0,1,2,2,4,2,5,4,1962,16,951
충청북도,영동군,용산면,용산면투표소,2073,1122,274,480,249,41,59,0,1,0,1,2,1,2,3,1113,9,951
충청북도,영동군,황간면,합계,3702,2638,740,985,607,129,113,2,3,6,1,2,2,13,9,2612,26,1064
충청북도,영동군,황간면,관내사전투표,654,654,244,172,142,41,38,0,0,0,0,1,1,6,2,647,7,0
충청북도,영동군,황간면,황간면제1투,1777,1131,295,450,267,47,45,1,1,4,1,0,1,3,4,1119,12,646
충청북도,영동군,황간면,황간면제2투,1271,853,201,363,198,41,30,1,2,2,0,1,0,4,3,846,7,418
충청북도,영동군,추풍령면,합계,2047,1480,358,688,269,77,67,5,0,0,1,1,2,6,1,1475,5,567
충청북도,영동군,추풍령면,관내사전투표,373,373,135,144,51,17,21,2,0,0,1,0,1,0,0,372,1,0
충청북도,영동군,추풍령면,추풍령면투표소,1674,1107,223,544,218,60,46,3,0,0,0,1,1,6,1,1103,4,567
충청북도,영동군,매곡면,합계,1733,1294,280,553,340,47,50,1,2,2,0,5,1,0,2,1283,11,439
충청북도,영동군,매곡면,관내사전투표,404,404,103,151,109,17,16,1,1,0,0,1,0,0,0,399,5,0
충청북도,영동군,매곡면,매곡면투표소,1329,890,177,402,231,30,34,0,1,2,0,4,1,0,2,884,6,439
충청북도,영동군,상촌면,합계,2052,1520,401,658,318,57,59,3,1,1,1,4,0,4,5,1512,8,532
충청북도,영동군,상촌면,관내사전투표,455,455,119,194,82,29,20,0,1,1,1,3,0,4,0,454,1,0
충청북도,영동군,상촌면,상촌면투표소,1597,1065,282,464,236,28,39,3,0,0,0,1,0,0,5,1058,7,532
충청북도,영동군,양강면,합계,2619,1817,451,719,457,75,79,1,3,2,1,7,2,7,6,1810,7,802
충청북도,영동군,양강면,관내사전투표,538,538,156,180,132,24,34,1,1,2,0,2,1,2,1,536,2,0
충청북도,영동군,양강면,양강면투표소,2081,1279,295,539,325,51,45,0,2,0,1,5,1,5,5,1274,5,802
충청북도,영동군,용화면,합계,867,648,225,228,121,32,28,1,2,1,0,1,3,2,1,645,3,219
충청북도,영동군,용화면,관내사전투표,242,242,87,76,43,18,12,0,1,1,0,1,2,1,0,242,0,0
충청북도,영동군,용화면,용화면투표소,625,406,138,152,78,14,16,1,1,0,0,0,1,1,1,403,3,219
충청북도,영동군,학산면,합계,2547,1770,502,699,411,68,62,6,1,0,1,0,1,4,3,1758,12,777
충청북도,영동군,학산면,관내사전투표,534,534,201,183,97,16,32,2,0,0,0,0,0,1,0,532,2,0
충청북도,영동군,학산면,학산면제1투,1593,960,237,400,245,38,20,4,1,0,1,0,1,2,3,952,8,633
충청북도,영동군,학산면,학산면제2투,420,276,64,116,69,14,10,0,0,0,0,0,0,1,0,274,2,144
충청북도,영동군,양산면,합계,1625,1181,333,465,289,42,31,2,1,3,0,1,0,6,4,1177,4,444
충청북도,영동군,양산면,관내사전투표,359,359,147,112,74,8,9,2,0,2,0,0,0,3,2,359,0,0
충청북도,영동군,양산면,양산면투표소,1266,822,186,353,215,34,22,0,1,1,0,1,0,3,2,818,4,444
충청북도,영동군,심천면,합계,2783,1933,557,775,422,82,64,3,0,1,1,1,2,6,6,1920,13,850
충청북도,영동군,심천면,관내사전투표,634,634,201,242,130,31,18,0,0,0,0,0,0,2,0,624,10,0
충청북도,영동군,심천면,심천면제1투,1720,1008,285,407,214,45,41,3,0,1,1,1,2,1,4,1005,3,712
충청북도,영동군,심천면,심천면제2투,429,291,71,126,78,6,5,0,0,0,0,0,0,3,2,291,0,138
충청북도,영동군,잘못 투입·구분된 투표지,,0,0,0,0,0,0,0,0,0,0,0,0,0,0,0,0,0,0
충청북도,보은군,합계,,30016,22341,7268,7587,4910,1015,1135,38,14,32,14,22,35,65,47,22182,159,7675
충청북도,보은군,거소·선상투표,,157,143,41,40,31,6,11,3,1,1,0,0,0,0,3,137,6,14
충청북도,보은군,관외사전투표,,2500,2500,1045,504,492,187,241,2,0,1,1,1,1,0,4,2479,21,0
충청북도,보은군,재외투표,,121,77,49,8,9,4,6,0,0,1,0,0,0,0,0,77,0,44
충청북도,보은군,보은읍,관내사전투표,3136,3136,1264,875,572,149,230,5,2,2,1,3,1,3,5,3112,24,0
충청북도,보은군,보은읍,합계,11713,8416,2965,2787,1709,370,450,13,4,8,3,8,9,9,15,8350,66,3297
충청북도,보은군,보은읍,보은읍제1투,1677,989,284,394,212,43,39,1,0,3,0,0,1,0,2,979,10,688
충청북도,보은군,보은읍,보은읍제2투,1051,627,164,251,160,25,19,1,0,1,0,2,1,0,0,624,3,424
충청북도,보은군,보은읍,보은읍제3투,1931,1184,387,437,241,53,47,0,1,0,0,1,2,3,2,1174,10,747
충청북도,보은군,보은읍,보은읍제4투,2621,1645,577,527,374,73,72,4,1,1,1,2,1,1,3,1637,8,976
충청북도,보은군,보은읍,보은읍제5투,1297,835,289,303,150,27,43,2,0,1,1,0,3,2,3,824,11,462
충청북도,보은군,속리산면,합계,1803,1312,417,487,279,57,46,5,0,0,1,1,2,6,3,1304,8,491
충청북도,보은군,속리산면,관내사전투표,375,375,139,103,95,19,16,1,0,0,0,0,0,0,1,374,1,0
충청북도,보은군,속리산면,속리산면제1투,1222,802,241,327,161,30,28,3,0,0,1,0,1,4,1,797,5,420
충청북도,보은군,속리산면,속리산면제2투,206,135,37,57,23,8,2,1,0,0,0,1,1,2,1,133,2,71
충청북도,보은군,장안면,관내사전투표,326,326,133,67,73,18,29,1,0,1,1,0,0,2,0,325,1,0
충청북도,보은군,장안면,합계,1347,970,324,274,253,48,53,1,2,2,2,1,1,4,1,966,4,377
충청북도,보은군,장안면,장안면투표소,1021,644,191,207,180,30,24,0,2,1,1,1,1,2,1,641,3,377
충청북도,보은군,마로면,합계,2088,1552,412,592,394,70,47,2,2,3,0,4,2,6,9,1543,9,536
충청북도,보은군,마로면,관내사전투표,352,352,116,112,86,18,12,0,1,2,0,0,1,1,3,352,0,0
충청북도,보은군,마로면,마로면제1투,1198,825,209,323,208,43,23,1,1,0,0,4,0,4,3,819,6,373
충청북도,보은군,마로면,마로면제2투,538,375,87,157,100,9,12,1,0,1,0,0,1,1,3,372,3,163
충청북도,보은군,탄부면,관내사전투표,248,248,78,85,60,11,11,0,0,2,0,0,0,0,0,247,1,0
충청북도,보은군,탄부면,합계,1514,1087,299,435,252,31,44,3,1,2,0,1,4,5,2,1079,8,427
충청북도,보은군,탄부면,탄부면투표소,1266,839,221,350,192,20,33,3,1,0,0,1,4,5,2,832,7,427
충청북도,보은군,삼승면,합계,1948,1308,411,419,342,70,46,1,0,2,2,0,2,5,1,1301,7,640
충청북도,보은군,삼승면,관내사전투표,407,407,137,131,98,23,13,1,0,1,1,0,0,1,0,406,1,0
충청북도,보은군,삼승면,삼승면투표소,1541,901,274,288,244,47,33,0,0,1,1,0,2,4,1,895,6,640
충청북도,보은군,수한면,합계,1580,1131,293,493,239,49,45,1,1,0,0,1,1,4,0,1127,4,449
충청북도,보은군,수한면,관내사전투표,287,287,92,99,67,12,15,0,0,0,0,0,1,1,0,287,0,0
충청북도,보은군,수한면,수한면투표소,1293,844,201,394,172,37,30,1,1,0,0,1,0,3,0,840,4,449
충청북도,보은군,회남면,관내사전투표,147,147,45,49,34,7,8,1,0,0,0,1,1,0,1,147,0,0
충청북도,보은군,회남면,합계,623,479,118,199,119,14,17,1,1,3,0,2,2,1,1,478,1,144
충청북도,보은군,회남면,회남면투표소,476,332,73,150,85,7,9,0,1,3,0,1,1,1,0,331,1,144
충청북도,보은군,회인면,합계,1584,1158,287,541,227,29,30,4,2,7,1,0,5,14,2,1149,9,426
충청북도,보은군,회인면,관내사전투표,409,409,116,180,72,14,9,1,1,3,0,0,2,7,1,406,3,0
충청북도,보은군,회인면,회인면투표소,1175,749,171,361,155,15,21,3,1,4,1,0,3,7,1,743,6,426
충청북도,보은군,내북면,합계,1522,1087,318,375,293,38,35,2,0,2,2,1,4,8,4,1082,5,435
충청북도,보은군,내북면,관내사전투표,273,273,80,92,76,13,5,0,0,1,2,1,0,2,0,272,1,0
충청북도,보은군,내북면,내북면제1투,734,469,149,159,121,14,18,1,0,0,0,0,1,3,2,468,1,265
충청북도,보은군,내북면,내북면제2투,515,345,89,124,96,11,12,1,0,1,0,0,3,3,2,342,3,170
충청북도,보은군,산외면,합계,1516,1121,289,433,271,42,64,0,0,0,2,2,2,3,2,1110,11,395
충청북도,보은군,산외면,관내사전투표,231,231,75,80,44,15,15,0,0,0,1,0,0,0,0,230,1,0
충청북도,보은군,산외면,산외면제1투,783,513,115,202,146,16,26,0,0,0,0,0,1,2,0,508,5,270
충청북도,보은군,산외면,산외면제2투,502,377,99,151,81,11,23,0,0,0,1,2,1,1,2,372,5,125
충청북도,보은군,잘못 투입·구분된 투표지,,0,0,0,0,0,0,0,0,0,0,0,0,0,0,0,0,0,0
충청북도,옥천군,합계,,44730,33175,11181,10431,7465,1552,1905,57,23,53,20,51,52,79,67,32936,239,11555
충청북도,옥천군,거소·선상투표,,309,297,100,65,78,7,8,8,2,2,2,3,2,4,0,281,16,12
충청북도,옥천군,관외사전투표,,3543,3542,1513,696,664,294,314,5,1,6,3,2,2,2,9,3511,31,1
충청북도,옥천군,재외투표,,185,142,77,12,21,6,22,2,0,1,0,0,0,0,0,141,1,43
충청북도,옥천군,옥천읍,합계,21805,15786,5821,4439,3528,764,1021,16,10,22,9,16,12,16,20,15694,92,6019
충청북도,옥천군,옥천읍,관내사전투표,4243,4243,1912,913,837,230,308,2,1,7,2,3,1,2,9,4227,16,0
충청북도,옥천군,옥천읍,옥천읍제1투,3142,1988,766,533,446,83,142,2,0,2,0,0,1,3,1,1979,9,1154
충청북도,옥천군,옥천읍,옥천읍제2투,1964,1330,438,450,301,67,56,2,2,1,0,0,1,2,1,1321,9,634
충청북도,옥천군,옥천읍,옥천읍제3투,2889,1923,696,491,473,89,150,2,1,5,1,1,0,1,2,1912,11,966
충청북도,옥천군,옥천읍,옥천읍제4투,2102,1435,422,517,337,67,77,0,0,1,1,0,0,2,0,1424,11,667
충청북도,옥천군,옥천읍,옥천읍제5투,1503,923,279,329,227,29,30,2,3,1,2,1,4,3,1,911,12,580
충청북도,옥천군,옥천읍,옥천읍제6투,2872,1868,620,582,436,84,114,1,2,5,1,5,3,2,2,1857,11,1004
충청북도,옥천군,옥천읍,옥천읍제7투,3090,2076,688,624,471,115,144,5,1,0,2,6,2,1,4,2063,13,1014
충청북도,옥천군,동이면,합계,2818,2057,570,778,486,70,101,5,4,4,2,8,5,9,5,2047,10,761
충청북도,옥천군,동이면,관내사전투표,566,566,187,207,113,19,31,0,1,0,1,3,1,1,2,566,0,0
충청북도,옥천군,동이면,동이면제1투,1392,904,245,318,241,33,42,3,2,4,0,0,3,4,2,897,7,488
충청북도,옥천군,동이면,동이면제2투,316,218,45,113,40,8,6,1,0,0,0,1,0,3,0,217,1,98
충청북도,옥천군,동이면,동이면제3투,544,369,93,140,92,10,22,1,1,0,1,4,1,1,1,367,2,175
충청북도,옥천군,안남면,합계,1246,923,294,324,216,28,36,1,1,3,0,4,0,3,3,913,10,323
충청북도,옥천군,안남면,관내사전투표,227,227,92,63,43,10,15,0,0,1,0,1,0,0,0,225,2,0
충청북도,옥천군,안남면,안남면투표소,1019,696,202,261,173,18,21,1,1,2,0,3,0,3,3,688,8,323
충청북도,옥천군,안내면,합계,1747,1275,296,536,294,58,52,3,0,2,0,9,6,3,5,1264,11,472
충청북도,옥천군,안내면,관내사전투표,344,344,87,141,73,16,19,0,0,0,0,4,1,0,2,343,1,0
충청북도,옥천군,안내면,안내면투표소,1403,931,209,395,221,42,33,3,0,2,0,5,5,3,3,921,10,472
충청북도,옥천군,청성면,관내사전투표,312,312,86,139,60,12,8,0,1,2,0,0,0,3,1,312,0,0
충청북도,옥천군,청성면,합계,1941,1297,323,524,341,47,25,2,1,4,2,1,1,9,6,1286,11,644
충청북도,옥천군,청성면,청성면투표소,1629,985,237,385,281,35,17,2,0,2,2,1,1,6,5,974,11,644
충청북도,옥천군,청산면,합계,2820,2010,536,788,485,69,78,3,0,2,0,2,11,8,8,1990,20,810
충청북도,옥천군,청산면,관내사전투표,557,557,186,174,142,22,22,0,0,0,0,0,2,1,3,552,5,0
충청북도,옥천군,청산면,청산면제1투,986,609,169,242,139,23,27,0,0,1,0,2,2,2,0,607,2,377
충청북도,옥천군,청산면,청산면제2투,508,320,85,138,71,8,8,1,0,1,0,0,2,1,1,316,4,188
충청북도,옥천군,청산면,청산면제3투,769,524,96,234,133,16,21,2,0,0,0,0,5,4,4,515,9,245
충청북도,옥천군,이원면,합계,3731,2608,717,1001,649,93,98,6,0,3,0,2,6,11,5,2591,17,1123
충청북도,옥천군,이원면,관내사전투표,901,901,302,306,207,32,40,2,0,1,0,0,2,3,2,897,4,0
충청북도,옥천군,이원면,이원면제1투,1886,1089,272,441,286,35,37,3,0,2,0,1,1,3,1,1082,7,797
충청북도,옥천군,이원면,이원면제2투,944,618,143,254,156,26,21,1,0,0,0,1,3,5,2,612,6,326
충청북도,옥천군,군서면,합계,2000,1459,429,597,312,41,52,1,3,0,2,3,2,9,0,1451,8,541
충청북도,옥천군,군서면,관내사전투표,328,328,117,99,68,13,25,1,1,0,0,1,0,0,0,325,3,0
충청북도,옥천군,군서면,군서면투표소,1672,1131,312,498,244,28,27,0,2,0,2,2,2,9,0,1126,5,541
충청북도,옥천군,군북면,합계,2585,1779,505,671,391,75,98,5,1,4,0,1,5,5,6,1767,12,806
충청북도,옥천군,군북면,관내사전투표,523,523,163,193,106,20,31,0,1,2,0,1,1,2,1,521,2,0
충청북도,옥천군,군북면,군북면제1투,1334,755,220,270,182,32,30,5,0,1,0,0,3,2,2,747,8,579
충청북도,옥천군,군북면,군북면제2투,287,206,58,88,36,12,11,0,0,0,0,0,0,1,0,206,0,81
충청북도,옥천군,군북면,군북면제3투,441,295,64,120,67,11,26,0,0,1,0,0,1,0,3,293,2,146
충청북도,옥천군,잘못 투입·구분된 투표지,,0,0,0,0,0,0,0,0,0,0,0,0,0,0,0,0,0,0
충청북도,음성군,합계,,81508,56788,20723,15180,13381,2988,3671,76,31,57,27,59,44,72,104,56413,375,24720
충청북도,음성군,거소·선상투표,,393,358,119,57,86,15,14,4,4,5,6,4,3,3,6,326,32,35
충청북도,음성군,관외사전투표,,7282,7281,3318,1238,1444,555,646,8,0,5,2,4,4,4,12,7240,41,1
충청북도,음성군,재외투표,,283,211,130,19,25,12,25,0,0,0,0,0,0,0,0,211,0,72
충청북도,음성군,음성읍,합계,14034,9762,3269,3089,2229,462,580,14,11,5,2,9,6,11,20,9707,55,4272
충청북도,음성군,음성읍,관내사전투표,2978,2978,1280,748,586,126,209,2,1,2,0,1,0,2,3,2960,18,0
충청북도,음성군,음성읍,음성읍제1투,2427,1506,465,491,346,103,85,2,1,1,0,0,0,0,4,1498,8,921
충청북도,음성군,음성읍,음성읍제2투,2348,1557,408,575,410,74,64,3,2,0,0,1,2,3,3,1545,12,791
충청북도,음성군,음성읍,음성읍제3투,3258,1933,620,593,467,88,136,5,2,0,1,7,2,1,5,1927,6,1325
충청북도,음성군,음성읍,음성읍제4투,782,432,106,181,108,11,16,0,1,0,1,0,1,3,0,428,4,350
충청북도,음성군,음성읍,음성읍제5투,2241,1356,390,501,312,60,70,2,4,2,0,0,1,2,5,1349,7,885
충청북도,음성군,금왕읍,합계,16001,10550,4008,2657,2498,575,684,15,3,6,6,6,9,9,13,10489,61,5451
충청북도,음성군,금왕읍,관내사전투표,2914,2914,1319,552,606,162,236,6,1,3,0,2,0,3,2,2892,22,0
충청북도,음성군,금왕읍,금왕읍제1투,4446,2491,918,667,620,130,131,3,1,1,3,0,2,0,4,2480,11,1955
충청북도,음성군,금왕읍,금왕읍제2투,3296,1918,726,450,463,109,146,2,0,1,2,2,4,1,3,1909,9,1378
충청북도,음성군,금왕읍,금왕읍제3투,2607,1625,628,381,387,104,106,2,1,0,1,1,0,3,3,1617,8,982
충청북도,음성군,금왕읍,금왕읍제4투,1157,681,180,247,193,22,30,1,0,0,0,0,2,2,0,677,4,476
충청북도,음성군,금왕읍,금왕읍제5투,1581,921,237,360,229,48,35,1,0,1,0,1,1,0,1,914,7,660
충청북도,음성군,소이면,합계,2596,1799,510,623,516,52,68,2,0,3,0,2,2,1,5,1784,15,797
충청북도,음성군,소이면,관내사전투표,584,584,190,184,152,16,35,0,0,1,0,1,0,1,1,581,3,0
충청북도,음성군,소이면,소이면투표소,2012,1215,320,439,364,36,33,2,0,2,0,1,2,0,4,1203,12,797
충청북도,음성군,원남면,관내사전투표,408,408,134,133,98,14,20,1,0,1,0,0,1,2,1,405,3,0
충청북도,음성군,원남면,합계,2610,1765,495,649,465,58,61,4,2,3,0,0,1,8,5,1751,14,845
충청북도,음성군,원남면,원남면제1투,1324,811,207,300,239,26,23,1,0,2,0,0,0,4,3,805,6,513
충청북도,음성군,원남면,원남면제2투,878,546,154,216,128,18,18,2,2,0,0,0,0,2,1,541,5,332
충청북도,음성군,맹동면,관내사전투표,1575,1575,730,267,283,87,131,8,2,7,2,4,5,4,9,1539,36,0
충청북도,음성군,맹동면,합계,8244,5313,2401,927,1171,314,392,10,2,8,4,6,6,10,12,5263,50,2931
충청북도,음성군,맹동면,맹동면제1투,3041,1239,422,336,337,48,72,2,0,1,2,1,1,2,3,1227,12,1802
충청북도,음성군,맹동면,맹동면제2투,3628,2499,1249,324,551,179,189,0,0,0,0,1,0,4,0,2497,2,1129
충청북도,음성군,대소면,합계,11504,7418,2819,1721,1892,402,491,3,4,11,4,10,2,8,15,7382,36,4086
충청북도,음성군,대소면,관내사전투표,1958,1958,933,345,405,124,122,1,0,4,2,3,0,4,3,1946,12,0
충청북도,음성군,대소면,대소면제1투,2210,1330,432,373,369,58,77,0,2,1,2,2,1,2,2,1321,9,880
충청북도,음성군,대소면,대소면제2투,1262,714,216,231,196,32,32,1,0,0,0,1,0,0,1,710,4,548
충청북도,음성군,대소면,대소면제3투,3205,1916,683,428,528,107,148,1,0,3,0,4,1,0,5,1908,8,1289
충청북도,음성군,대소면,대소면제4투,2869,1500,555,344,394,81,112,0,2,3,0,0,0,2,4,1497,3,1369
충청북도,음성군,삼성면,합계,6147,4023,1272,1310,994,174,223,5,1,2,0,7,2,1,6,3997,26,2124
충청북도,음성군,삼성면,관내사전투표,1156,1156,395,334,289,53,75,1,1,0,0,1,1,0,2,1152,4,0
충청북도,음성군,삼성면,삼성면제1투,2813,1593,521,526,363,69,96,3,0,1,0,3,0,0,2,1584,9,1220
충청북도,음성군,삼성면,삼성면제2투,2178,1274,356,450,342,52,52,1,0,1,0,3,1,1,2,1261,13,904
충청북도,음성군,생극면,관내사전투표,679,679,218,219,144,35,43,1,1,2,1,2,0,4,2,672,7,0
충청북도,음성군,생극면,합계,3957,2681,707,1007,669,100,146,3,1,5,1,4,6,7,4,2660,21,1276
충청북도,음성군,생극면,생극면제1투,2210,1291,322,499,348,36,65,2,0,2,0,2,2,2,1,1281,10,919
충청북도,음성군,생극면,생극면제2투,1068,711,167,289,177,29,38,0,0,1,0,0,4,1,1,707,4,357
충청북도,음성군,감곡면,관내사전투표,1535,1535,534,431,341,78,133,2,0,1,0,4,1,4,2,1531,4,0
충청북도,음성군,감곡면,합계,8457,5627,1675,1883,1392,269,341,8,3,4,2,7,3,10,6,5603,24,2830
충청북도,음성군,감곡면,감곡면제1투,3205,1816,547,523,499,99,127,2,1,3,1,0,1,1,0,1804,12,1389
충청북도,음성군,감곡면,감곡면제2투,2472,1489,388,595,373,57,54,3,2,0,1,3,0,4,4,1484,5,983
충청북도,음성군,감곡면,감곡면제3투,1245,787,206,334,179,35,27,1,0,0,0,0,1,1,0,784,3,458
충청북도,음성군,잘못 투입·구분된 투표지,,0,0,0,0,0,0,0,0,0,0,0,0,0,0,0,0,0,0
충청북도,진천군,합계,,57571,41255,15844,10265,9489,2239,2925,53,12,36,15,31,21,30,71,41031,224,16316
충청북도,진천군,거소·선상투표,,145,131,45,21,47,9,4,0,0,0,0,0,0,0,2,128,3,14
충청북도,진천군,관외사전투표,,4748,4748,2167,778,968,367,412,6,0,5,0,3,1,1,8,4716,32,0
충청북도,진천군,재외투표,,197,148,90,13,22,8,12,2,0,0,0,0,0,0,0,147,1,49
충청북도,진천군,진천읍,합계,23244,16298,6291,3921,3722,887,1282,16,5,12,7,11,7,12,31,16204,94,6946
충청북도,진천군,진천읍,관내사전투표,5103,5103,2301,1053,967,289,437,6,1,3,3,6,1,3,8,5078,25,0
충청북도,진천군,진천읍,진천읍제1투,2362,1311,416,434,308,53,84,1,1,1,1,0,0,1,7,1307,4,1051
충청북도,진천군,진천읍,진천읍제2투,1061,710,195,255,186,27,31,2,1,0,0,2,1,4,0,704,6,351
충청북도,진천군,진천읍,진천읍제3투,1586,996,338,232,262,58,93,0,0,1,1,0,1,0,2,988,8,590
충청북도,진천군,진천읍,진천읍제4투,1988,1183,379,362,288,60,80,0,0,1,0,0,0,0,5,1175,8,805
충청북도,진천군,진천읍,진천읍제5투,2380,1407,529,312,349,90,114,2,0,2,0,1,1,0,1,1401,6,973
충청북도,진천군,진천읍,진천읍제6투,2804,1721,680,386,415,90,131,3,1,2,0,1,2,0,1,1712,9,1083
충청북도,진천군,진천읍,진천읍제7투,1520,971,332,261,227,56,84,0,0,0,1,0,1,0,2,964,7,549
충청북도,진천군,진천읍,진천읍제8투,1858,1169,352,328,323,60,83,2,1,2,0,0,0,3,1,1155,14,689
충청북도,진천군,진천읍,진천읍제9투,2582,1727,769,298,397,104,145,0,0,0,1,1,0,1,4,1720,7,855
충청북도,진천군,덕산면,합계,7752,5388,2289,1179,1239,282,353,6,0,4,1,3,2,2,8,5368,20,2364
충청북도,진천군,덕산면,관내사전투표,1447,1447,698,296,297,62,84,2,0,0,0,0,1,1,2,1443,4,0
충청북도,진천군,덕산면,덕산면제1투,3201,1807,601,562,437,97,93,2,0,2,0,1,1,1,3,1800,7,1394
충청북도,진천군,덕산면,덕산면제2투,3104,2134,990,321,505,123,176,2,0,2,1,2,0,0,3,2125,9,970
충청북도,진천군,초평면,합계,2755,1916,585,708,429,86,88,0,1,2,2,1,0,2,0,1904,12,839
충청북도,진천군,초평면,관내사전투표,454,454,160,149,92,29,19,0,0,0,0,1,0,1,0,451,3,0
충청북도,진천군,초평면,초평면제1투,1464,919,280,343,206,30,46,0,1,1,2,0,0,1,0,910,9,545
충청북도,진천군,초평면,초평면제2투,837,543,145,216,131,27,23,0,0,1,0,0,0,0,0,543,0,294
충청북도,진천군,문백면,합계,3021,2113,685,711,513,66,99,7,1,2,1,1,3,4,7,2100,13,908
충청북도,진천군,문백면,관내사전투표,421,421,158,125,99,13,21,0,0,0,0,0,1,1,0,418,3,0
충청북도,진천군,문백면,문백면제1투,1631,1016,292,372,242,35,54,4,1,1,1,1,1,3,2,1009,7,615
충청북도,진천군,문백면,문백면제2투,969,676,235,214,172,18,24,3,0,1,0,0,1,0,5,673,3,293
충청북도,진천군,백곡면,관내사전투표,412,412,112,152,83,24,34,0,1,1,0,0,1,1,1,410,2,0
충청북도,진천군,백곡면,합계,1853,1363,353,568,292,66,65,1,1,2,0,2,2,3,1,1356,7,490
충청북도,진천군,백곡면,백곡면투표소,1441,951,241,416,209,42,31,1,0,1,0,2,1,2,0,946,5,490
충청북도,진천군,이월면,합계,5631,3705,1291,1071,941,145,208,10,0,2,1,5,4,4,6,3688,17,1926
충청북도,진천군,이월면,관내사전투표,949,949,362,267,230,34,47,5,0,0,0,1,2,0,0,948,1,0
충청북도,진천군,이월면,이월면제1투,2536,1491,517,449,360,54,88,4,0,1,1,3,1,3,1,1482,9,1045
충청북도,진천군,이월면,이월면제2투,2146,1265,412,355,351,57,73,1,0,1,0,1,1,1,5,1258,7,881
충청북도,진천군,광혜원면,합계,8225,5445,2048,1295,1316,323,402,5,4,7,3,5,2,2,8,5420,25,2780
충청북도,진천군,광혜원면,관내사전투표,1731,1731,745,337,393,101,141,1,1,2,0,0,1,0,2,1724,7,0
충청북도,진천군,광혜원면,광혜원면제1투,2532,1380,431,436,355,66,73,1,1,0,3,1,0,1,2,1370,10,1152
충청북도,진천군,광혜원면,광혜원면제2투,1900,1049,397,255,245,62,73,1,2,3,0,2,1,1,3,1045,4,851
충청북도,진천군,광혜원면,광혜원면제3투,2062,1285,475,267,323,94,115,2,0,2,0,2,0,0,1,1281,4,777
충청북도,진천군,잘못 투입·구분된 투표지,,0,0,0,0,0,0,0,0,0,0,0,0,0,0,0,0,0,0
충청북도,괴산군,합계,,34611,25824,7876,9435,5830,1063,1198,29,14,31,19,30,39,55,54,25673,151,8787
충청북도,괴산군,거소·선상투표,,84,69,22,15,28,1,1,0,0,0,0,1,0,0,0,68,1,15
충청북도,괴산군,관외사전투표,,3496,3496,1524,791,626,240,263,4,2,3,0,4,2,2,7,3468,28,0
충청북도,괴산군,재외투표,,136,100,64,4,19,3,7,1,0,0,0,0,0,0,0,98,2,36
충청북도,괴산군,괴산읍,합계,7658,5516,1888,1895,1139,243,270,6,2,1,9,15,5,7,12,5492,24,2142
충청북도,괴산군,괴산읍,관내사전투표,1994,1994,808,615,342,85,118,1,0,1,2,6,1,2,4,1985,9,0
충청북도,괴산군,괴산읍,괴산읍제1투,2601,1674,526,622,358,66,78,4,1,0,4,2,2,1,4,1668,6,927
충청북도,괴산군,괴산읍,괴산읍제2투,1767,1058,321,352,259,65,43,0,0,0,1,6,1,3,1,1052,6,709
충청북도,괴산군,괴산읍,괴산읍제3투,1296,790,233,306,180,27,31,1,1,0,2,1,1,1,3,787,3,506
충청북도,괴산군,감물면,관내사전투표,381,381,114,145,86,10,19,3,0,0,0,0,1,0,0,378,3,0
충청북도,괴산군,감물면,합계,1652,1217,325,461,303,46,57,3,0,2,1,0,5,2,3,1208,9,435
충청북도,괴산군,감물면,감물면투표소,1271,836,211,316,217,36,38,0,0,2,1,0,4,2,3,830,6,435
충청북도,괴산군,장연면,합계,1590,1113,252,468,290,39,42,1,1,3,0,2,4,5,1,1108,5,477
충청북도,괴산군,장연면,관내사전투표,364,364,79,174,84,14,10,0,0,0,0,1,0,2,0,364,0,0
충청북도,괴산군,장연면,장연면투표소,1226,749,173,294,206,25,32,1,1,3,0,1,4,3,1,744,5,477
충청북도,괴산군,연풍면,합계,2065,1486,323,729,301,66,45,1,1,6,0,0,2,5,4,1483,3,579
충청북도,괴산군,연풍면,관내사전투표,571,571,155,264,113,22,10,0,0,3,0,0,2,1,1,571,0,0
충청북도,괴산군,연풍면,연풍면투표소,1494,915,168,465,188,44,35,1,1,3,0,0,0,4,3,912,3,579
충청북도,괴산군,칠성면,관내사전투표,854,854,267,329,194,19,32,2,0,0,0,2,1,3,3,852,2,0
충청북도,괴산군,칠성면,합계,2589,1927,548,735,473,64,78,3,0,0,0,4,2,5,5,1917,10,662
충청북도,괴산군,칠성면,칠성면투표소,1735,1073,281,406,279,45,46,1,0,0,0,2,1,2,2,1065,8,662
충청북도,괴산군,문광면,합계,1857,1354,391,496,335,43,61,3,1,2,1,0,1,5,3,1342,12,503
충청북도,괴산군,문광면,관내사전투표,448,448,128,163,115,14,24,0,0,1,0,0,0,0,0,445,3,0
충청북도,괴산군,문광면,문광면투표소,1409,906,263,333,220,29,37,3,1,1,1,0,1,5,3,897,9,503
충청북도,괴산군,청천면,합계,4176,3008,744,1337,676,96,91,4,3,5,3,0,6,12,4,2981,27,1168
충청북도,괴산군,청천면,관내사전투표,636,636,167,287,136,18,19,3,0,2,0,0,1,1,0,634,2,0
충청북도,괴산군,청천면,청천면제1투,1503,949,232,434,208,35,24,1,0,2,1,0,3,2,1,943,6,554
충청북도,괴산군,청천면,청천면제2투,555,400,89,168,109,15,10,0,0,0,0,0,1,2,2,396,4,155
충청북도,괴산군,청천면,청천면제3투,802,606,172,249,128,19,27,0,1,1,1,0,1,4,0,603,3,196
충청북도,괴산군,청천면,청천면제4투,680,417,84,199,95,9,11,0,2,0,1,0,0,3,1,405,12,263
충청북도,괴산군,청안면,합계,2846,1939,517,712,535,73,75,0,2,3,1,0,5,2,3,1928,11,907
충청북도,괴산군,청안면,관내사전투표,464,464,143,149,135,14,17,0,0,2,0,0,1,0,1,462,2,0
충청북도,괴산군,청안면,청안면제1투,1307,755,204,273,209,20,34,0,1,1,1,0,2,2,2,749,6,552
충청북도,괴산군,청안면,청안면제2투,1075,720,170,290,191,39,24,0,1,0,0,0,2,0,0,717,3,355
충청북도,괴산군,사리면,합계,2337,1679,424,702,382,63,77,1,1,2,1,2,2,8,5,1670,9,658
충청북도,괴산군,사리면,관내사전투표,417,417,124,167,80,20,19,0,1,0,1,1,0,3,1,417,0,0
충청북도,괴산군,사리면,사리면제1투,1224,779,181,331,184,29,37,0,0,2,0,0,1,3,3,771,8,445
충청북도,괴산군,사리면,사리면제2투,696,483,119,204,118,14,21,1,0,0,0,1,1,2,1,482,1,213
충청북도,괴산군,소수면,합계,1666,1166,392,379,286,40,56,2,0,1,2,1,3,0,1,1163,3,500
충청북도,괴산군,소수면,관내사전투표,378,378,135,108,83,16,27,0,0,1,2,1,2,0,1,376,2,0
충청북도,괴산군,소수면,소수면투표소,1288,788,257,271,203,24,29,2,0,0,0,0,1,0,0,787,1,500
충청북도,괴산군,불정면,관내사전투표,659,659,202,241,159,21,25,0,0,3,0,0,1,0,5,657,2,0
충청북도,괴산군,불정면,합계,2459,1754,462,711,437,46,75,0,1,3,1,1,2,2,6,1747,7,705
충청북도,괴산군,불정면,불정면투표소,1800,1095,260,470,278,25,50,0,1,0,1,1,1,2,1,1090,5,705
충청북도,괴산군,잘못 투입·구분된 투표지,,0,0,0,0,0,0,0,0,0,0,0,0,0,0,0,0,0,0
충청북도,증평군,합계,,30172,21786,8109,5608,5126,1199,1450,17,8,19,17,17,13,19,46,21648,138,8386
충청북도,증평군,거소·선상투표,,56,55,16,7,21,4,2,0,0,1,1,0,0,0,2,54,1,1
충청북도,증평군,관외사전투표,,2649,2646,1219,422,530,202,222,1,1,6,2,2,2,2,7,2618,28,3
충청북도,증평군,재외투표,,92,67,45,2,10,1,9,0,0,0,0,0,0,0,0,67,0,25
충청북도,증평군,증평읍,관내사전투표,5417,5417,2326,1109,1189,316,400,2,4,4,6,2,3,7,13,5381,36,0
충청북도,증평군,증평읍,합계,25575,17758,6453,4700,4284,951,1153,14,7,11,13,11,9,16,36,17658,100,7817
충청북도,증평군,증평읍,증평읍제1투,2119,1250,416,396,288,53,88,0,0,0,1,0,0,0,0,1242,8,869
충청북도,증평군,증평읍,증평읍제2투,1974,1212,328,448,325,49,53,1,0,0,0,1,2,0,2,1209,3,762
충청북도,증평군,증평읍,증평읍제3투,2069,1307,364,479,332,63,50,2,0,1,1,1,1,2,0,1296,11,762
충청북도,증평군,증평읍,증평읍제4투,2609,1461,569,317,376,82,104,2,0,1,2,0,1,0,3,1457,4,1148
충청북도,증평군,증평읍,증평읍제5투,2553,1699,669,415,388,80,132,0,1,1,0,0,1,2,4,1693,6,854
충청북도,증평군,증평읍,증평읍제6투,2175,1443,600,294,340,81,118,0,0,0,1,4,0,1,1,1440,3,732
충청북도,증평군,증평읍,증평읍제7투,2073,1292,413,369,355,78,59,3,1,2,0,2,1,1,1,1285,7,781
충청북도,증평군,증평읍,증평읍제8투,1202,801,190,333,201,31,30,1,1,1,0,0,0,2,2,792,9,401
충청북도,증평군,증평읍,증평읍제9투,3384,1876,578,540,490,118,119,3,0,1,2,1,0,1,10,1863,13,1508
충청북도,증평군,도안면,합계,1800,1260,376,477,281,41,64,2,0,1,1,4,2,1,1,1251,9,540
충청북도,증평군,도안면,관내사전투표,302,302,109,110,53,7,18,1,0,1,0,1,0,0,0,300,2,0
충청북도,증평군,도안면,도안면투표소,1498,958,267,367,228,34,46,1,0,0,1,3,2,1,1,951,7,540
충청북도,증평군,잘못 투입·구분된 투표지,,0,0,0,0,0,0,0,0,0,0,0,0,0,0,0,0,0,0
충청남도,합계,,,1711912,1240204,476661,306614,290216,68521,83868,1415,324,1148,429,1260,803,1025,1662,1233946,6258,471708
충청남도,천안시서북구,합계,,285471,212329,94202,37293,47891,14613,16591,234,40,125,60,119,89,73,209,211539,790,73142
충청남도,천안시서북구,거소·선상투표,,458,425,140,59,146,37,15,3,1,1,2,0,2,0,5,411,14,33
충청남도,천안시서북구,관외사전투표,,25354,25342,12186,3252,5080,2174,2343,22,11,14,10,18,16,12,42,25180,162,12
충청남도,천안시서북구,재외투표,,1227,948,543,62,164,46,124,2,0,1,1,0,2,0,0,945,3,279
충청남도,천안시서북구,성환읍,관내사전투표,3589,3589,1452,941,683,214,263,8,2,2,1,0,3,4,4,3577,12,0
충청남도,천안시서북구,성환읍,합계,21315,14639,4938,4281,3576,769,930,24,3,15,3,10,9,12,11,14581,58,6676
충청남도,천안시서북구,성환읍,성환읍제1투,1871,1124,331,399,284,53,45,2,0,1,0,0,0,1,0,1116,8,747
충청남도,천안시서북구,성환읍,성환읍제2투,2767,1491,439,486,384,85,86,1,0,1,0,1,0,0,3,1486,5,1276
충청남도,천안시서북구,성환읍,성환읍제3투,1544,1080,381,226,329,59,73,2,0,1,1,0,1,1,1,1075,5,464
충청남도,천안시서북구,성환읍,성환읍제4투,796,520,120,193,157,20,25,0,0,1,0,1,1,0,1,519,1,276
충청남도,천안시서북구,성환읍,성환읍제5투,1095,719,161,294,185,31,38,2,0,0,0,0,0,1,0,712,7,376
충청남도,천안시서북구,성환읍,성환읍제6투,1774,1106,260,407,322,47,54,3,1,0,0,1,0,2,1,1098,8,668
충청남도,천안시서북구,성환읍,성환읍제7투,2294,1320,405,430,316,62,89,2,0,5,1,3,0,1,1,1315,5,974
충청남도,천안시서북구,성환읍,성환읍제8투,736,484,136,180,112,20,31,1,0,0,0,0,1,1,0,482,2,252
충청남도,천안시서북구,성환읍,성환읍제9투,2712,1683,560,471,436,102,102,1,0,2,0,3,1,1,0,1679,4,1029
충청남도,천안시서북구,성환읍,성환읍제10투,2137,1523,693,254,368,76,124,2,0,2,0,1,2,0,0,1522,1,614
충청남도,천안시서북구,성거읍,합계,15942,10925,4452,2216,2670,663,830,11,5,16,4,8,4,4,7,10890,35,5017
충청남도,천안시서북구,성거읍,관내사전투표,2857,2857,1281,578,563,163,241,5,1,6,2,2,2,2,3,2849,8,0
충청남도,천안시서북구,성거읍,성거읍제1투,2692,1439,551,303,349,99,126,2,1,2,0,1,1,1,0,1436,3,1253
충청남도,천안시서북구,성거읍,성거읍제2투,1746,1065,330,249,342,59,69,1,1,2,1,1,0,1,1,1057,8,681
충청남도,천안시서북구,성거읍,성거읍제3투,2796,2037,960,263,509,148,147,0,1,1,0,1,0,0,3,2033,4,759
충청남도,천안시서북구,성거읍,성거읍제4투,2439,1376,491,352,362,69,91,1,1,2,1,0,0,0,0,1370,6,1063
충청남도,천안시서북구,성거읍,성거읍제5투,1661,895,268,290,231,43,56,0,0,3,0,0,1,0,0,892,3,766
충청남도,천안시서북구,성거읍,성거읍제6투,1751,1256,571,181,314,82,100,2,0,0,0,3,0,0,0,1253,3,495
충청남도,천안시서북구,직산읍,관내사전투표,3366,3366,1573,639,697,191,239,5,0,4,0,4,3,0,3,3358,8,0
충청남도,천안시서북구,직산읍,합계,16108,10858,4218,2445,2714,600,752,13,1,19,5,11,7,6,25,10816,42,5250
충청남도,천안시서북구,직산읍,직산읍제1투,1557,995,303,370,212,43,51,0,0,2,1,0,1,1,4,988,7,562
충청남도,천안시서북구,직산읍,직산읍제2투,2564,1465,555,279,398,94,122,1,1,3,2,2,1,2,1,1461,4,1099
충청남도,천안시서북구,직산읍,직산읍제3투,2346,1320,376,416,392,54,61,5,0,2,0,2,1,0,4,1313,7,1026
충청남도,천안시서북구,직산읍,직산읍제4투,1899,1015,398,206,273,55,69,2,0,2,1,0,1,1,2,1010,5,884
충청남도,천안시서북구,직산읍,직산읍제5투,2241,1272,485,238,343,76,110,0,0,3,1,1,0,2,8,1267,5,969
충청남도,천안시서북구,직산읍,직산읍제6투,2135,1425,528,297,399,87,100,0,0,3,0,2,0,0,3,1419,6,710
충청남도,천안시서북구,입장면,합계,7923,5329,1742,1604,1309,288,325,8,0,7,0,2,6,3,11,5305,24,2594
충청남도,천안시서북구,입장면,관내사전투표,1426,1426,579,339,312,80,109,1,0,0,0,0,1,0,3,1424,2,0
충청남도,천안시서북구,입장면,입장면제1투,2270,1316,413,383,338,84,82,0,0,4,0,0,2,1,1,1308,8,954
충청남도,천안시서북구,입장면,입장면제2투,968,595,179,177,165,32,32,2,0,1,0,0,0,0,3,591,4,373
충청남도,천안시서북구,입장면,입장면제3투,2467,1450,423,492,379,70,74,1,0,1,0,1,1,2,2,1446,4,1017
충청남도,천안시서북구,입장면,입장면제4투,792,542,148,213,115,22,28,4,0,1,0,1,2,0,2,536,6,250
충청남도,천안시서북구,성정1동,합계,13896,8508,3025,2262,2027,473,631,5,2,5,6,4,10,2,11,8463,45,5388
충청남도,천안시서북구,성정1동,관내사전투표,1712,1712,728,352,362,105,150,0,0,0,1,2,3,0,0,1703,9,0
충청남도,천안시서북구,성정1동,성정1동제1투,1815,1124,300,397,301,45,68,1,0,1,0,0,3,0,1,1117,7,691
충청남도,천안시서북구,성정1동,성정1동제2투,4006,2067,785,472,464,134,190,2,1,2,0,1,1,1,4,2057,10,1939
충청남도,천안시서북구,성정1동,성정1동제3투,2568,1305,468,310,347,75,89,0,0,1,3,0,3,0,4,1300,5,1263
충청남도,천안시서북구,성정1동,성정1동제4투,1981,1033,283,375,260,51,50,2,0,0,1,0,0,0,1,1023,10,948
충청남도,천안시서북구,성정1동,성정1동제5투,1814,1267,461,356,293,63,84,0,1,1,1,1,0,1,1,1263,4,547
충청남도,천안시서북구,성정2동,합계,21496,12326,5202,2411,2810,792,1015,13,3,8,2,10,5,5,8,12284,42,9170
충청남도,천안시서북구,성정2동,관내사전투표,2645,2645,1308,414,492,168,242,6,0,3,1,2,1,0,0,2637,8,0
충청남도,천안시서북구,성정2동,성정2동제1투,4403,2017,955,272,428,160,189,0,0,2,0,0,0,1,2,2009,8,2386
충청남도,천안시서북구,성정2동,성정2동제2투,4001,2347,861,561,579,135,187,0,2,0,1,3,3,2,2,2336,11,1654
충청남도,천안시서북구,성정2동,성정2동제3투,3645,2073,776,502,507,133,144,0,0,2,0,2,1,0,0,2067,6,1572
충청남도,천안시서북구,성정2동,성정2동제4투,3228,1583,597,386,401,81,105,3,0,1,0,1,0,1,2,1578,5,1645
충청남도,천안시서북구,성정2동,성정2동제5투,3574,1661,705,276,403,115,148,4,1,0,0,2,0,1,2,1657,4,1913
충청남도,천안시서북구,쌍용1동,합계,11724,8546,3381,1926,1951,554,660,12,1,2,5,4,0,6,6,8508,38,3178
충청남도,천안시서북구,쌍용1동,관내사전투표,1933,1933,934,338,335,131,179,3,1,0,1,1,0,2,1,1926,7,0
충청남도,천안시서북구,쌍용1동,쌍용1동제1투,2353,1552,586,391,353,99,111,2,0,0,1,0,0,2,1,1546,6,801
충청남도,천안시서북구,쌍용1동,쌍용1동제2투,2333,1427,542,329,347,94,108,1,0,1,1,1,0,0,0,1424,3,906
충청남도,천안시서북구,쌍용1동,쌍용1동제3투,2525,1803,680,421,444,116,124,1,0,1,2,1,0,0,2,1792,11,722
충청남도,천안시서북구,쌍용1동,쌍용1동제4투,2580,1831,639,447,472,114,138,5,0,0,0,1,0,2,2,1820,11,749
충청남도,천안시서북구,쌍용2동,합계,26765,20504,9053,3487,4651,1432,1732,30,2,7,2,8,7,9,21,20441,63,6261
충청남도,천안시서북구,쌍용2동,관내사전투표,3886,3884,2065,444,711,255,387,5,0,1,1,1,3,1,4,3878,6,2
충청남도,천안시서북구,쌍용2동,쌍용2동제1투,3460,2346,882,556,539,158,189,5,0,0,0,1,0,0,5,2335,11,1114
충청남도,천안시서북구,쌍용2동,쌍용2동제2투,2677,1862,754,384,431,132,144,1,1,0,0,4,2,0,1,1854,8,815
충청남도,천안시서북구,쌍용2동,쌍용2동제3투,2097,1329,611,183,316,110,100,2,0,0,0,0,0,1,3,1326,3,768
충청남도,천안시서북구,쌍용2동,쌍용2동제4투,3527,2755,1213,409,677,216,223,4,0,2,0,0,1,2,1,2748,7,772
충청남도,천안시서북구,쌍용2동,쌍용2동제5투,1658,1129,535,151,231,85,114,3,0,0,0,0,0,1,3,1123,6,529
충청남도,천안시서북구,쌍용2동,쌍용2동제6투,2858,2109,867,418,503,127,178,2,1,3,0,0,0,2,1,2102,7,749
충청남도,천안시서북구,쌍용2동,쌍용2동제7투,2905,2402,1059,392,602,140,196,4,0,0,1,0,1,0,1,2396,6,503
충청남도,천안시서북구,쌍용2동,쌍용2동제8투,3697,2688,1067,550,641,209,201,4,0,1,0,2,0,2,2,2679,9,1009
충청남도,천안시서북구,쌍용3동,합계,15003,11461,4936,2042,2742,828,814,22,1,5,2,2,1,2,13,11410,51,3542
충청남도,천안시서북구,쌍용3동,관내사전투표,3096,3096,1497,439,653,222,264,7,0,2,1,0,1,0,2,3088,8,0
충청남도,천안시서북구,쌍용3동,쌍용3동제1투,2340,1654,649,357,417,121,97,6,0,1,1,0,0,0,0,1649,5,686
충청남도,천안시서북구,쌍용3동,쌍용3동제2투,2129,1348,476,361,354,66,71,2,0,2,0,1,0,2,1,1336,12,781
충청남도,천안시서북구,쌍용3동,쌍용3동제3투,1603,1103,399,231,281,93,84,1,1,0,0,0,0,0,4,1094,9,500
충청남도,천안시서북구,쌍용3동,쌍용3동제4투,1979,1383,655,164,316,109,129,3,0,0,0,0,0,0,2,1378,5,596
충청남도,천안시서북구,쌍용3동,쌍용3동제5투,2079,1459,705,193,336,94,118,1,0,0,0,0,0,0,3,1450,9,620
충청남도,천안시서북구,쌍용3동,쌍용3동제6투,1777,1418,555,297,385,123,51,2,0,0,0,1,0,0,1,1415,3,359
충청남도,천안시서북구,백석동,합계,25186,20021,9605,3020,4432,1419,1443,16,4,1,3,12,5,6,8,19974,47,5165
충청남도,천안시서북구,백석동,관내사전투표,4417,4417,2423,482,841,281,364,3,1,0,1,3,2,1,3,4405,12,0
충청남도,천안시서북구,백석동,백석동제1투,3810,2638,1165,466,622,178,194,1,1,1,0,4,0,1,0,2633,5,1172
충청남도,천안시서북구,백석동,백석동제2투,1882,1401,546,332,303,107,105,3,0,0,0,2,0,1,0,1399,2,481
충청남도,천안시서북구,백석동,백석동제3투,2899,2050,850,414,480,133,161,3,1,0,1,1,1,0,1,2046,4,849
충청남도,천안시서북구,백석동,백석동제4투,3359,2399,1110,373,533,172,198,1,1,0,0,1,1,3,0,2393,6,960
충청남도,천안시서북구,백석동,백석동제5투,2868,2214,1043,320,526,189,127,2,0,0,1,1,0,0,0,2209,5,654
충청남도,천안시서북구,백석동,백석동제6투,2318,1887,899,299,427,140,112,1,0,0,0,0,0,0,1,1879,8,431
충청남도,천안시서북구,백석동,백석동제7투,2696,2257,1154,277,529,160,130,2,0,0,0,0,0,0,3,2255,2,439
충청남도,천안시서북구,백석동,백석동제8투,937,758,415,57,171,59,52,0,0,0,0,0,1,0,0,755,3,179
충청남도,천안시서북구,불당동,관내사전투표,5708,5708,3184,544,1072,445,438,7,0,2,0,2,0,1,2,5697,11,0
충청남도,천안시서북구,불당동,합계,26625,21707,10974,2628,4894,1616,1503,28,0,5,4,6,2,3,5,21668,39,4918
충청남도,천안시서북구,불당동,불당동제1투,3149,2396,1071,386,594,166,172,2,0,1,0,0,0,2,1,2395,1,753
충청남도,천안시서북구,불당동,불당동제2투,2950,2378,1180,294,587,169,144,1,0,0,0,0,0,0,0,2375,3,572
충청남도,천안시서북구,불당동,불당동제3투,3247,2347,1048,375,605,165,143,2,0,1,1,1,0,0,0,2341,6,900
충청남도,천안시서북구,불당동,불당동제4투,3152,2591,1440,228,553,198,165,1,0,0,2,1,0,0,0,2588,3,561
충청남도,천안시서북구,불당동,불당동제5투,4387,3381,1714,365,798,249,238,5,0,0,1,2,1,0,1,3374,7,1006
충청남도,천안시서북구,불당동,불당동제6투,1439,993,492,127,202,90,75,5,0,0,0,0,1,0,1,993,0,446
충청남도,천안시서북구,불당동,불당동제7투,2593,1913,845,309,483,134,128,5,0,1,0,0,0,0,0,1905,8,680
충청남도,천안시서북구,부성1동,합계,26034,18496,8604,2878,4068,1306,1519,16,2,9,6,11,5,1,11,18436,60,7538
충청남도,천안시서북구,부성1동,관내사전투표,3944,3944,2088,440,759,269,356,2,0,1,4,3,1,0,4,3927,17,0
충청남도,천안시서북구,부성1동,부성1동제1투,1905,1411,652,244,290,115,105,0,0,0,0,0,1,0,0,1407,4,494
충청남도,천안시서북구,부성1동,부성1동제2투,2034,1224,423,394,278,56,60,3,0,1,0,0,1,1,2,1219,5,810
충청남도,천안시서북구,부성1동,부성1동제3투,921,601,186,181,164,32,33,0,0,0,0,1,0,0,1,598,3,320
충청남도,천안시서북구,부성1동,부성1동제4투,2292,1702,734,287,401,136,130,2,0,1,1,2,0,0,1,1695,7,590
충청남도,천안시서북구,부성1동,부성1동제5투,2785,1786,886,212,407,119,156,1,0,1,0,0,1,0,0,1783,3,999
충청남도,천안시서북구,부성1동,부성1동제6투,1448,1058,465,157,254,65,107,2,2,2,0,0,0,0,0,1054,4,390
충청남도,천안시서북구,부성1동,부성1동제7투,2292,1510,744,224,302,99,140,0,0,0,0,0,0,0,0,1509,1,782
충청남도,천안시서북구,부성1동,부성1동제8투,2901,2057,907,350,500,139,149,5,0,0,0,1,1,0,0,2052,5,844
충청남도,천안시서북구,부성1동,부성1동제9투,3041,1329,700,100,247,116,156,0,0,0,0,2,0,0,2,1323,6,1712
충청남도,천안시서북구,부성1동,부성1동제10투,2471,1874,819,289,466,160,127,1,0,3,1,2,0,0,1,1869,5,597
충청남도,천안시서북구,부성2동,합계,30415,22292,11203,2720,4656,1615,1955,9,4,10,5,13,8,2,25,22225,67,8123
충청남도,천안시서북구,부성2동,관내사전투표,4776,4776,2693,435,806,353,456,1,1,3,1,3,1,0,5,4758,18,0
충청남도,천안시서북구,부성2동,부성2동제1투,3141,2447,1305,197,531,200,202,2,0,0,0,1,2,1,2,2443,4,694
충청남도,천안시서북구,부성2동,부성2동제2투,3380,2566,1090,449,627,171,216,1,1,1,0,2,0,0,4,2562,4,814
충청남도,천안시서북구,부성2동,부성2동제3투,3558,2635,1182,398,653,177,210,3,0,1,0,1,0,1,2,2628,7,923
충청남도,천안시서북구,부성2동,부성2동제4투,2747,1295,603,173,262,99,143,0,1,0,1,4,1,0,2,1289,6,1452
충청남도,천안시서북구,부성2동,부성2동제5투,3134,1895,843,282,449,126,181,1,0,1,0,1,2,0,3,1889,6,1239
충청남도,천안시서북구,부성2동,부성2동제6투,2321,1312,690,135,284,84,106,0,0,0,1,1,1,0,1,1303,9,1009
충청남도,천안시서북구,부성2동,부성2동제7투,2759,2007,1000,274,435,145,140,0,1,1,0,0,1,0,1,1998,9,752
충청남도,천안시서북구,부성2동,부성2동제8투,2899,2022,1067,272,333,157,184,1,0,3,1,0,0,0,3,2021,1,877
충청남도,천안시서북구,부성2동,부성2동제9투,1700,1337,730,105,276,103,117,0,0,0,1,0,0,0,2,1334,3,363
충청남도,천안시서북구,잘못 투입·구분된 투표지,,0,2,0,0,1,1,0,0,0,0,0,0,0,0,0,2,0,-2
충청남도,천안시동남구,합계,,207268,151132,59695,34869,34933,9089,11067,189,35,130,57,84,66,82,148,150444,688,56136
충청남도,천안시동남구,거소·선상투표,,365,339,115,56,100,26,17,1,1,1,1,0,1,2,2,323,16,26
충청남도,천안시동남구,관외사전투표,,17123,17121,7889,2510,3620,1339,1536,17,7,10,5,9,15,2,34,16993,128,2
충청남도,천안시동남구,재외투표,,941,735,465,34,105,35,87,3,0,0,0,0,0,1,0,730,5,206
충청남도,천안시동남구,목천읍,합계,18405,12473,4922,2790,3016,714,922,23,0,7,1,10,11,10,10,12436,37,5932
충청남도,천안시동남구,목천읍,관내사전투표,2119,2119,962,425,441,113,160,4,0,0,0,2,3,3,0,2113,6,0
충청남도,천안시동남구,목천읍,목천읍제1투,2845,1675,511,556,410,79,100,3,0,3,0,1,1,5,2,1671,4,1170
충청남도,천안시동남구,목천읍,목천읍제2투,1438,928,278,281,247,49,67,1,0,1,0,1,2,0,0,927,1,510
충청남도,천안시동남구,목천읍,목천읍제3투,850,571,143,207,150,23,39,4,0,0,0,1,0,0,0,567,4,279
충청남도,천안시동남구,목천읍,목천읍제4투,2520,1550,576,383,360,106,112,2,0,1,0,0,1,0,2,1543,7,970
충청남도,천안시동남구,목천읍,목천읍제5투,2989,2102,909,354,524,122,173,4,0,0,0,2,2,1,1,2092,10,887
충청남도,천안시동남구,목천읍,목천읍제6투,1386,892,380,137,239,45,77,4,0,0,1,2,1,1,3,890,2,494
충청남도,천안시동남구,목천읍,목천읍제7투,4258,2636,1163,447,645,177,194,1,0,2,0,1,1,0,2,2633,3,1622
충청남도,천안시동남구,풍세면,합계,3657,2514,734,877,629,106,140,4,1,4,1,2,0,6,1,2505,9,1143
충청남도,천안시동남구,풍세면,관내사전투표,610,610,222,157,173,19,34,0,0,0,1,0,0,2,0,608,2,0
충청남도,천안시동남구,풍세면,풍세면제1투,1068,655,203,192,180,31,42,3,0,0,0,0,0,1,1,653,2,413
충청남도,천안시동남구,풍세면,풍세면제2투,665,433,106,172,101,15,31,1,0,2,0,0,0,3,0,431,2,232
충청남도,천안시동남구,풍세면,풍세면제3투,1314,816,203,356,175,41,33,0,1,2,0,2,0,0,0,813,3,498
충청남도,천안시동남구,광덕면,관내사전투표,517,517,198,147,109,23,38,1,0,0,0,1,0,0,0,517,0,0
충청남도,천안시동남구,광덕면,합계,3845,2753,711,1177,583,122,135,2,2,6,0,1,2,4,1,2746,7,1092
충청남도,천안시동남구,광덕면,광덕면제1투,1367,908,174,508,154,38,22,0,2,4,0,0,1,2,0,905,3,459
충청남도,천안시동남구,광덕면,광덕면제2투,1134,779,214,292,190,24,49,1,0,2,0,0,1,2,1,776,3,355
충청남도,천안시동남구,광덕면,광덕면제3투,827,549,125,230,130,37,26,0,0,0,0,0,0,0,0,548,1,278
충청남도,천안시동남구,북면,합계,3620,2303,653,772,575,110,146,1,0,6,0,1,3,4,11,2282,21,1317
충청남도,천안시동남구,북면,관내사전투표,368,368,138,97,83,18,28,1,0,0,0,0,0,0,1,366,2,0
충청남도,천안시동남구,북면,북면제1투,2058,1179,353,376,274,74,85,0,0,5,0,1,1,2,1,1172,7,879
충청남도,천안시동남구,북면,북면제2투,576,359,72,144,107,9,19,0,0,1,0,0,0,0,3,355,4,217
충청남도,천안시동남구,북면,북면제3투,618,397,90,155,111,9,14,0,0,0,0,0,2,2,6,389,8,221
충청남도,천안시동남구,성남면,관내사전투표,602,602,228,150,145,27,34,0,5,4,1,0,3,1,1,599,3,0
충청남도,천안시동남구,성남면,합계,3058,2116,609,730,559,93,91,1,5,5,2,0,5,1,1,2102,14,942
충청남도,천안시동남구,성남면,성남면제1투,921,577,150,213,158,26,21,1,0,1,1,0,0,0,0,571,6,344
충청남도,천안시동남구,성남면,성남면제2투,1535,937,231,367,256,40,36,0,0,0,0,0,2,0,0,932,5,598
충청남도,천안시동남구,수신면,관내사전투표,351,351,122,104,81,16,28,0,0,0,0,0,0,0,0,351,0,0
충청남도,천안시동남구,수신면,합계,2148,1501,405,564,387,60,66,4,3,0,0,0,0,1,1,1491,10,647
충청남도,천안시동남구,수신면,수신면제1투,1206,759,194,295,204,30,26,2,2,0,0,0,0,0,1,754,5,447
충청남도,천안시동남구,수신면,수신면제2투,591,391,89,165,102,14,12,2,1,0,0,0,0,1,0,386,5,200
충청남도,천안시동남구,병천면,합계,5576,3786,1227,1175,933,196,206,6,1,2,3,2,3,6,6,3766,20,1790
충청남도,천안시동남구,병천면,관내사전투표,1283,1283,498,320,287,77,86,1,0,1,1,1,0,1,1,1274,9,0
충청남도,천안시동남구,병천면,병천면제1투,2410,1375,414,474,333,61,74,4,1,0,0,1,1,2,3,1368,7,1035
충청남도,천안시동남구,병천면,병천면제2투,1204,721,217,233,196,40,30,0,0,0,1,0,0,2,0,719,2,483
충청남도,천안시동남구,병천면,병천면제3투,679,407,98,148,117,18,16,1,0,1,1,0,2,1,2,405,2,272
충청남도,천안시동남구,동면,관내사전투표,454,454,121,157,110,18,23,1,3,2,2,0,1,2,2,442,12,0
충청남도,천안시동남구,동면,합계,1997,1337,298,549,337,52,60,3,3,4,2,1,2,4,3,1318,19,660
충청남도,천안시동남구,동면,동면투표소,1543,883,177,392,227,34,37,2,0,2,0,1,1,2,1,876,7,660
충청남도,천안시동남구,중앙동,관내사전투표,999,999,304,374,210,52,51,1,0,0,2,0,1,0,1,996,3,0
충청남도,천안시동남구,중앙동,합계,5049,3323,904,1339,772,134,141,5,0,2,2,0,1,0,2,3302,21,1726
충청남도,천안시동남구,중앙동,중앙동제1투,2479,1384,338,568,355,53,54,3,0,0,0,0,0,0,0,1371,13,1095
충청남도,천안시동남구,중앙동,중앙동제2투,1571,940,262,397,207,29,36,1,0,2,0,0,0,0,1,935,5,631
충청남도,천안시동남구,문성동,합계,3987,2486,792,830,590,102,140,3,1,3,3,4,1,2,3,2474,12,1501
충청남도,천안시동남구,문성동,관내사전투표,1009,1009,351,331,222,45,48,2,0,1,1,2,0,2,0,1005,4,0
충청남도,천안시동남구,문성동,문성동제1투,1213,481,132,170,119,23,32,1,0,0,0,1,0,0,1,479,2,732
충청남도,천안시동남구,문성동,문성동제2투,1765,996,309,329,249,34,60,0,1,2,2,1,1,0,2,990,6,769
충청남도,천안시동남구,원성1동,합계,7881,5387,1829,1657,1287,251,319,6,1,2,1,6,1,0,2,5362,25,2494
충청남도,천안시동남구,원성1동,관내사전투표,1479,1479,607,377,322,72,91,1,0,1,1,1,0,0,1,1474,5,0
충청남도,천안시동남구,원성1동,원성1동제1투,2039,1278,408,411,301,57,88,3,1,0,0,1,0,0,0,1270,8,761
충청남도,천안시동남구,원성1동,원성1동제2투,1373,793,234,283,197,36,38,1,0,1,0,1,0,0,0,791,2,580
충청남도,천안시동남구,원성1동,원성1동제3투,1623,977,300,314,246,55,55,0,0,0,0,1,0,0,1,972,5,646
충청남도,천안시동남구,원성1동,원성1동제4투,1367,860,280,272,221,31,47,1,0,0,0,2,1,0,0,855,5,507
충청남도,천안시동남구,원성2동,합계,9619,6425,2044,2054,1456,353,446,11,0,10,3,5,1,5,6,6394,31,3194
충청남도,천안시동남구,원성2동,관내사전투표,1766,1766,679,493,340,101,131,5,0,4,3,1,0,1,2,1760,6,0
충청남도,천안시동남구,원성2동,원성2동제1투,1117,712,191,256,185,38,31,1,0,0,0,2,0,3,0,707,5,405
충청남도,천안시동남구,원성2동,원성2동제2투,2802,1747,517,592,411,92,116,1,0,0,0,2,1,0,2,1734,13,1055
충청남도,천안시동남구,원성2동,원성2동제3투,1596,884,285,288,192,50,58,3,0,3,0,0,0,1,1,881,3,712
충청남도,천안시동남구,원성2동,원성2동제4투,2338,1316,372,425,328,72,110,1,0,3,0,0,0,0,1,1312,4,1022
충청남도,천안시동남구,봉명동,합계,14258,8927,3361,2193,2167,498,628,10,0,8,2,6,6,8,6,8893,34,5331
충청남도,천안시동남구,봉명동,관내사전투표,1748,1748,782,344,353,105,140,4,0,4,0,3,3,1,0,1739,9,0
충청남도,천안시동남구,봉명동,봉명동제1투,2412,1243,424,322,317,67,102,0,0,1,0,1,2,2,0,1238,5,1169
충청남도,천안시동남구,봉명동,봉명동제2투,2489,1359,472,359,357,81,83,2,0,0,0,0,0,1,1,1356,3,1130
충청남도,천안시동남구,봉명동,봉명동제3투,947,533,144,198,142,23,22,0,0,0,0,0,1,0,1,531,2,414
충청남도,천안시동남구,봉명동,봉명동제4투,1810,967,306,315,239,50,46,1,0,0,0,0,0,3,1,961,6,843
충청남도,천안시동남구,봉명동,봉명동제5투,2716,1745,639,444,406,112,128,3,0,3,1,2,0,1,1,1740,5,971
충청남도,천안시동남구,봉명동,봉명동제6투,2136,1332,594,211,353,60,107,0,0,0,1,0,0,0,2,1328,4,804
충청남도,천안시동남구,일봉동,합계,16647,11862,4666,2670,2884,693,855,20,1,9,5,8,3,4,9,11827,35,4785
충청남도,천안시동남구,일봉동,관내사전투표,1761,1761,729,399,378,97,144,4,0,2,1,1,1,0,1,1757,4,0
충청남도,천안시동남구,일봉동,일봉동제1투,3173,1783,556,528,471,94,110,6,0,4,1,2,0,1,3,1776,7,1390
충청남도,천안시동남구,일봉동,일봉동제2투,2202,1421,486,364,356,88,118,0,0,0,1,1,0,0,1,1415,6,781
충청남도,천안시동남구,일봉동,일봉동제3투,2583,1613,562,431,423,75,109,2,1,1,1,0,1,1,2,1609,4,970
충청남도,천안시동남구,일봉동,일봉동제4투,3230,2459,1032,515,572,153,177,1,0,1,1,1,0,1,0,2454,5,771
충청남도,천안시동남구,일봉동,일봉동제5투,3698,2825,1301,433,684,186,197,7,0,1,0,3,1,1,2,2816,9,873
충청남도,천안시동남구,신방동,합계,32273,23912,11074,3700,5505,1556,1921,15,1,17,9,6,5,9,20,23838,74,8361
충청남도,천안시동남구,신방동,관내사전투표,5230,5230,2798,627,1012,327,437,3,0,3,3,1,1,1,3,5216,14,0
충청남도,천안시동남구,신방동,신방동제1투,2267,1680,700,359,369,119,123,2,0,0,0,0,0,1,1,1674,6,587
충청남도,천안시동남구,신방동,신방동제2투,2696,2058,932,326,502,129,157,1,0,0,0,1,0,3,2,2053,5,638
충청남도,천안시동남구,신방동,신방동제3투,3124,2346,1036,374,592,150,177,1,0,2,1,1,1,1,1,2337,9,778
충청남도,천안시동남구,신방동,신방동제4투,2619,1953,880,286,471,132,168,1,0,3,2,2,0,0,3,1948,5,666
충청남도,천안시동남구,신방동,신방동제5투,2325,1251,510,221,324,85,99,0,0,2,0,0,2,1,2,1246,5,1074
충청남도,천안시동남구,신방동,신방동제6투,2367,1251,518,243,318,73,93,1,0,1,0,0,0,0,1,1248,3,1116
충청남도,천안시동남구,신방동,신방동제7투,1341,816,322,170,190,51,78,0,0,0,0,0,0,0,1,812,4,525
충청남도,천안시동남구,신방동,신방동제8투,2847,2238,937,417,546,144,175,4,0,2,0,1,0,1,2,2229,9,609
충청남도,천안시동남구,신방동,신방동제9투,3536,2440,1190,301,561,173,199,2,1,2,2,0,1,1,2,2435,5,1096
충청남도,천안시동남구,신방동,신방동제10투,3921,2649,1251,376,620,173,215,0,0,2,1,0,0,0,2,2640,9,1272
충청남도,천안시동남구,청룡동,합계,33028,24602,10257,5176,5651,1455,1841,33,4,21,12,15,4,6,18,24493,109,8426
충청남도,천안시동남구,청룡동,관내사전투표,5593,5593,2743,948,1085,310,442,7,1,7,1,0,0,2,3,5549,44,0
충청남도,천안시동남구,청룡동,청룡동제1투,2816,2021,696,540,496,109,157,7,0,3,1,2,0,0,1,2012,9,795
충청남도,천안시동남구,청룡동,청룡동제2투,2803,1777,613,471,415,120,142,5,1,2,1,0,0,1,1,1772,5,1026
충청남도,천안시동남구,청룡동,청룡동제3투,2068,1578,658,340,376,104,97,0,0,0,0,0,0,0,1,1576,2,490
충청남도,천안시동남구,청룡동,청룡동제4투,3671,2657,1067,574,624,171,198,5,0,2,1,3,0,0,2,2647,10,1014
충청남도,천안시동남구,청룡동,청룡동제5투,3627,2318,757,674,585,119,153,2,2,3,2,6,3,1,3,2310,8,1309
충청남도,천안시동남구,청룡동,청룡동제6투,1164,686,193,223,195,27,40,0,0,0,1,0,0,1,2,682,4,478
충청남도,천안시동남구,청룡동,청룡동제7투,3263,2468,1077,437,594,164,186,0,0,3,0,1,0,0,1,2463,5,795
충청남도,천안시동남구,청룡동,청룡동제8투,1688,1234,605,191,267,67,95,1,0,0,3,1,0,0,0,1230,4,454
충청남도,천안시동남구,청룡동,청룡동제9투,3815,2426,1055,450,558,145,203,1,0,1,1,2,1,0,2,2419,7,1389
충청남도,천안시동남구,청룡동,청룡동제10투,2520,1844,793,328,456,119,128,5,0,0,1,0,0,1,2,1833,11,676
충청남도,천안시동남구,신안동,합계,23791,17230,6740,4016,3777,1194,1370,21,4,13,5,8,2,7,12,17169,61,6561
충청남도,천안시동남구,신안동,관내사전투표,3817,3817,1763,610,699,280,429,4,0,5,2,2,1,1,3,3799,18,0
충청남도,천안시동남구,신안동,신안동제1투,2692,1541,572,403,347,105,101,2,1,2,0,2,0,0,1,1536,5,1151
충청남도,천안시동남구,신안동,신안동제2투,801,490,163,148,109,27,39,0,0,0,0,0,0,0,3,489,1,311
충청남도,천안시동남구,신안동,신안동제3투,1724,1000,321,291,244,62,76,1,1,0,0,0,0,0,0,996,4,724
충청남도,천안시동남구,신안동,신안동제4투,2599,1853,697,514,388,114,125,0,0,2,0,1,0,4,2,1847,6,746
충청남도,천안시동남구,신안동,신안동제5투,3159,2315,948,450,540,182,179,5,0,0,2,0,0,1,0,2307,8,844
충청남도,천안시동남구,신안동,신안동제6투,3284,2207,887,462,501,167,172,4,0,2,1,0,0,0,2,2198,9,1077
충청남도,천안시동남구,신안동,신안동제7투,1062,581,159,207,162,28,21,0,2,0,0,0,1,0,1,581,0,481
충청남도,천안시동남구,신안동,신안동제8투,2385,1682,613,430,398,106,123,1,0,2,0,2,0,1,0,1676,6,703
충청남도,천안시동남구,신안동,신안동제9투,2268,1744,617,501,389,123,105,4,0,0,0,1,0,0,0,1740,4,524
충청남도,천안시동남구,잘못 투입·구분된 투표지,,0,0,0,0,0,0,0,0,0,0,0,0,0,0,0,0,0,0
충청남도,공주시,합계,,93453,67018,25036,18449,15814,2948,3852,82,24,58,31,77,57,82,108,66618,400,26435
충청남도,공주시,거소·선상투표,,195,183,64,43,52,12,3,0,0,1,2,0,0,0,2,179,4,12
충청남도,공주시,관외사전투표,,7764,7764,3710,1212,1536,540,672,11,2,7,2,9,2,4,13,7720,44,0
충청남도,공주시,재외투표,,415,297,172,28,50,15,31,1,0,0,0,0,0,0,0,297,0,118
충청남도,공주시,유구읍,합계,6707,4453,1195,1703,1160,127,201,3,1,5,4,3,7,6,9,4424,29,2254
충청남도,공주시,유구읍,관내사전투표,993,993,328,309,245,36,60,1,0,0,2,1,1,1,2,986,7,0
충청남도,공주시,유구읍,유구읍제1투,2749,1647,436,662,419,40,74,0,1,1,0,1,1,1,0,1636,11,1102
충청남도,공주시,유구읍,유구읍제2투,1771,1102,256,456,286,34,47,1,0,1,2,0,4,2,5,1094,8,669
충청남도,공주시,유구읍,유구읍제3투,1194,711,175,276,210,17,20,1,0,3,0,1,1,2,2,708,3,483
충청남도,공주시,이인면,합계,3081,2018,626,685,522,77,73,1,3,0,1,6,1,3,4,2002,16,1063
충청남도,공주시,이인면,관내사전투표,381,381,145,89,94,30,13,0,0,0,1,2,1,1,0,376,5,0
충청남도,공주시,이인면,이인면제1투,1488,857,232,330,228,21,38,0,0,0,0,1,0,0,0,850,7,631
충청남도,공주시,이인면,이인면제2투,1212,780,249,266,200,26,22,1,3,0,0,3,0,2,4,776,4,432
충청남도,공주시,탄천면,합계,2753,1793,520,589,493,47,96,4,0,3,1,4,3,2,6,1768,25,960
충청남도,공주시,탄천면,관내사전투표,342,342,137,76,68,9,30,2,0,0,0,1,1,0,4,328,14,0
충청남도,공주시,탄천면,탄천면제1투,1544,894,226,337,246,25,42,1,0,2,0,3,1,1,1,885,9,650
충청남도,공주시,탄천면,탄천면제2투,867,557,157,176,179,13,24,1,0,1,1,0,1,1,1,555,2,310
충청남도,공주시,계룡면,합계,5012,3368,995,1175,895,136,117,6,1,2,0,4,3,5,6,3345,23,1644
충청남도,공주시,계룡면,관내사전투표,659,659,254,210,134,33,16,3,0,1,0,2,0,1,0,654,5,0
충청남도,공주시,계룡면,계룡면제1투,1551,942,279,316,256,33,47,1,1,0,0,2,1,0,2,938,4,609
충청남도,공주시,계룡면,계룡면제2투,486,314,77,124,82,24,4,1,0,0,0,0,0,0,0,312,2,172
충청남도,공주시,계룡면,계룡면제3투,830,554,120,230,168,14,11,0,0,1,0,0,1,3,1,549,5,276
충청남도,공주시,계룡면,계룡면제4투,1486,899,265,295,255,32,39,1,0,0,0,0,1,1,3,892,7,587
충청남도,공주시,반포면,합계,3749,2594,847,832,607,120,109,5,3,6,10,5,1,5,7,2557,37,1155
충청남도,공주시,반포면,관내사전투표,664,664,257,195,129,34,31,0,1,2,5,1,0,3,3,661,3,0
충청남도,공주시,반포면,반포면제1투,1742,1079,349,319,253,57,49,3,2,3,5,4,0,1,4,1049,30,663
충청남도,공주시,반포면,반포면제2투,1343,851,241,318,225,29,29,2,0,1,0,0,1,1,0,847,4,492
충청남도,공주시,의당면,합계,4378,2975,1060,795,813,109,162,0,1,2,2,3,2,6,6,2961,14,1403
충청남도,공주시,의당면,관내사전투표,925,925,375,217,229,29,66,0,0,0,1,1,0,1,1,920,5,0
충청남도,공주시,의당면,의당면제1투,1892,1057,367,258,311,48,65,0,0,1,1,2,0,1,1,1055,2,835
충청남도,공주시,의당면,의당면제2투,658,449,141,147,121,12,18,0,0,1,0,0,1,2,2,445,4,209
충청남도,공주시,의당면,의당면제3투,903,544,177,173,152,20,13,0,1,0,0,0,1,2,2,541,3,359
충청남도,공주시,정안면,합계,4231,2838,778,1068,746,83,113,6,0,6,1,3,3,8,2,2817,21,1393
충청남도,공주시,정안면,관내사전투표,637,637,209,216,147,24,36,0,0,0,0,1,1,1,0,635,2,0
충청남도,공주시,정안면,정안면제1투,1203,723,189,306,172,12,24,5,0,3,0,1,1,1,1,715,8,480
충청남도,공주시,정안면,정안면제2투,824,524,147,205,126,19,17,0,0,1,0,1,1,2,0,519,5,300
충청남도,공주시,정안면,정안면제3투,1567,954,233,341,301,28,36,1,0,2,1,0,0,4,1,948,6,613
충청남도,공주시,우성면,합계,4661,3151,1020,1064,781,90,151,3,2,1,0,2,6,10,4,3134,17,1510
충청남도,공주시,우성면,관내사전투표,490,490,214,110,116,17,27,1,0,0,0,0,1,1,0,487,3,0
충청남도,공주시,우성면,우성면제1투,889,551,162,207,118,18,37,1,0,1,0,0,1,2,1,548,3,338
충청남도,공주시,우성면,우성면제2투,1059,704,230,261,158,17,30,0,0,0,0,0,0,2,2,700,4,355
충청남도,공주시,우성면,우성면제3투,1350,890,283,260,272,29,34,1,2,0,0,0,2,2,0,885,5,460
충청남도,공주시,우성면,우성면제4투,873,516,131,226,117,9,23,0,0,0,0,2,2,3,1,514,2,357
충청남도,공주시,사곡면,관내사전투표,465,465,160,166,101,14,16,2,0,0,0,0,0,3,0,462,3,0
충청남도,공주시,사곡면,합계,2630,1786,552,630,447,47,79,4,1,0,0,2,2,6,4,1774,12,844
충청남도,공주시,사곡면,사곡면제1투,1244,720,186,276,194,15,39,2,0,0,0,0,1,1,1,715,5,524
충청남도,공주시,사곡면,사곡면제2투,921,601,206,188,152,18,24,0,1,0,0,2,1,2,3,597,4,320
충청남도,공주시,신풍면,합계,2685,1809,502,636,507,50,86,3,1,1,1,2,5,4,5,1803,6,876
충청남도,공주시,신풍면,관내사전투표,588,588,184,199,152,16,25,1,0,0,0,1,2,1,2,583,5,0
충청남도,공주시,신풍면,신풍면제1투,1364,777,197,295,217,24,36,1,0,1,0,0,2,3,1,777,0,587
충청남도,공주시,신풍면,신풍면제2투,733,444,121,142,138,10,25,1,1,0,1,1,1,0,2,443,1,289
충청남도,공주시,중학동,관내사전투표,847,847,361,214,181,44,37,1,0,0,0,1,0,0,1,840,7,0
충청남도,공주시,중학동,합계,4560,3066,1106,871,797,137,126,6,1,3,0,1,0,1,3,3052,14,1494
충청남도,공주시,중학동,중학동제1투,735,392,129,121,101,16,20,3,0,1,0,0,0,1,0,392,0,343
충청남도,공주시,중학동,중학동제2투,923,586,197,178,162,23,21,2,0,0,0,0,0,0,1,584,2,337
충청남도,공주시,중학동,중학동제3투,1101,672,213,209,188,31,25,0,1,2,0,0,0,0,0,669,3,429
충청남도,공주시,중학동,중학동제4투,954,569,206,149,165,23,23,0,0,0,0,0,0,0,1,567,2,385
충청남도,공주시,웅진동,합계,7104,4956,1727,1490,1235,198,252,3,2,6,0,3,4,6,7,4933,23,2148
충청남도,공주시,웅진동,관내사전투표,1560,1560,596,416,381,57,92,1,2,2,0,0,1,1,3,1552,8,0
충청남도,공주시,웅진동,웅진동제1투,1031,589,213,163,152,24,29,1,0,0,0,1,1,1,2,587,2,442
충청남도,공주시,웅진동,웅진동제2투,1208,730,208,288,168,29,33,0,0,1,0,0,0,2,0,729,1,478
충청남도,공주시,웅진동,웅진동제3투,1908,1210,400,370,321,50,56,0,0,3,0,0,2,2,1,1205,5,698
충청남도,공주시,웅진동,웅진동제4투,1397,867,310,253,213,38,42,1,0,0,0,2,0,0,1,860,7,530
충청남도,공주시,금학동,합계,4608,3291,1347,799,727,152,220,6,0,1,2,2,4,3,7,3270,21,1317
충청남도,공주시,금학동,관내사전투표,1075,1075,516,187,198,69,93,0,0,1,0,0,1,0,2,1067,8,0
충청남도,공주시,금학동,금학동제1투,2313,1508,629,372,341,64,96,1,0,0,0,1,1,0,2,1507,1,805
충청남도,공주시,금학동,금학동제2투,1220,708,202,240,188,19,31,5,0,0,2,1,2,3,3,696,12,512
충청남도,공주시,옥룡동,합계,7609,5088,1848,1473,1239,197,260,7,0,4,3,6,9,4,8,5058,30,2521
충청남도,공주시,옥룡동,관내사전투표,1303,1303,562,344,248,53,83,4,0,4,0,0,3,1,0,1302,1,0
충청남도,공주시,옥룡동,옥룡동제1투,1178,720,206,227,213,27,40,0,0,0,1,0,3,1,1,719,1,458
충청남도,공주시,옥룡동,옥룡동제2투,2551,1468,503,467,358,56,68,1,0,0,2,2,0,1,2,1460,8,1083
충청남도,공주시,옥룡동,옥룡동제3투,1615,1001,385,250,266,40,41,1,0,0,0,2,2,1,2,990,11,614
충청남도,공주시,옥룡동,옥룡동제4투,962,596,192,185,154,21,28,1,0,0,0,2,1,0,3,587,9,366
충청남도,공주시,신관동,합계,14342,10343,4570,2272,2098,568,738,9,4,4,0,18,1,5,11,10298,45,3999
충청남도,공주시,신관동,관내사전투표,3877,3877,1941,714,645,243,297,4,0,1,0,9,0,1,7,3862,15,0
충청남도,공주시,신관동,신관동제1투,1971,1196,455,293,297,71,72,1,0,0,0,1,0,0,1,1191,5,775
충청남도,공주시,신관동,신관동제2투,2149,1442,649,314,291,69,107,1,0,0,0,3,0,0,2,1436,6,707
충청남도,공주시,신관동,신관동제3투,1846,1144,476,245,282,48,80,2,2,2,0,0,0,1,1,1139,5,702
충청남도,공주시,신관동,신관동제4투,2301,1295,517,319,276,69,98,1,0,0,0,3,0,3,0,1286,9,1006
충청남도,공주시,신관동,신관동제5투,2198,1389,532,387,307,68,84,0,2,1,0,2,1,0,0,1384,5,809
충청남도,공주시,월송동,관내사전투표,1464,1464,755,242,281,66,105,1,0,3,1,2,1,1,1,1459,5,0
충청남도,공주시,월송동,합계,6969,5245,2397,1084,1109,243,363,4,2,6,2,4,4,4,4,5226,19,1724
충청남도,공주시,월송동,월송동제1투,2637,1860,857,356,399,88,144,1,0,0,1,1,1,1,2,1851,9,777
충청남도,공주시,월송동,월송동제2투,2226,1498,674,325,319,71,98,1,2,3,0,0,1,1,0,1495,3,728
충청남도,공주시,월송동,월송동제3투,642,423,111,161,110,18,16,1,0,0,0,1,1,1,1,421,2,219
충청남도,공주시,잘못 투입·구분된 투표지,,0,0,0,0,0,0,0,0,0,0,0,0,0,0,0,0,0,0
충청남도,보령시,합계,,87274,62825,20674,19453,15428,2819,3546,74,16,68,27,65,51,64,102,62387,438,24449
충청남도,보령시,거소·선상투표,,232,213,72,45,67,4,13,1,0,0,0,0,0,0,1,203,10,19
충청남도,보령시,관외사전투표,,6781,6781,3013,1048,1457,530,615,7,1,5,6,9,6,3,24,6724,57,0
충청남도,보령시,재외투표,,291,221,128,11,39,7,34,2,0,0,0,0,0,0,0,221,0,70
충청남도,보령시,웅천읍,합계,5737,3929,1042,1557,994,126,139,6,4,1,1,11,4,4,8,3897,32,1808
충청남도,보령시,웅천읍,관내사전투표,1132,1132,404,368,231,50,51,2,2,0,0,3,1,0,5,1117,15,0
충청남도,보령시,웅천읍,웅천읍제1투,1872,1147,250,506,310,27,35,3,1,0,0,5,0,2,0,1139,8,725
충청남도,보령시,웅천읍,웅천읍제2투,1441,849,192,384,204,28,30,0,0,1,1,3,2,1,1,847,2,592
충청남도,보령시,웅천읍,웅천읍제3투,1292,801,196,299,249,21,23,1,1,0,0,0,1,1,2,794,7,491
충청남도,보령시,주포면,합계,1506,1050,295,375,279,57,30,1,0,3,0,0,0,0,1,1041,9,456
충청남도,보령시,주포면,관내사전투표,339,339,113,100,93,19,10,0,0,2,0,0,0,0,0,337,2,0
충청남도,보령시,주포면,주포면투표소,1167,711,182,275,186,38,20,1,0,1,0,0,0,0,1,704,7,456
충청남도,보령시,주교면,합계,4526,3052,936,994,740,104,160,9,1,4,4,6,3,8,13,2982,70,1474
충청남도,보령시,주교면,관내사전투표,946,946,382,189,196,32,61,3,1,1,3,6,2,6,8,890,56,0
충청남도,보령시,주교면,주교면제1투,2119,1210,346,454,291,44,54,3,0,2,1,0,1,1,2,1199,11,909
충청남도,보령시,주교면,주교면제2투,1461,896,208,351,253,28,45,3,0,1,0,0,0,1,3,893,3,565
충청남도,보령시,오천면,합계,4058,2557,624,1035,665,78,104,1,1,2,1,1,6,8,5,2531,26,1501
충청남도,보령시,오천면,관내사전투표,401,401,151,111,104,11,21,0,0,0,0,0,0,1,1,400,1,0
충청남도,보령시,오천면,오천면제1투,1445,878,209,344,240,31,37,0,1,2,0,0,1,3,0,868,10,567
충청남도,보령시,오천면,오천면제2투,193,94,17,42,27,0,6,0,0,0,1,0,0,0,0,93,1,99
충청남도,보령시,오천면,오천면제3투,763,447,76,269,65,20,4,1,0,0,0,1,4,2,1,443,4,316
충청남도,보령시,오천면,오천면제4투,330,204,28,74,82,7,12,0,0,0,0,0,0,1,0,204,0,126
충청남도,보령시,오천면,오천면제5투,158,93,15,51,24,0,0,0,0,0,0,0,0,0,0,90,3,65
충청남도,보령시,오천면,오천면제6투,175,119,39,31,36,2,10,0,0,0,0,0,0,0,0,118,1,56
충청남도,보령시,오천면,오천면제7투,113,68,22,23,14,0,4,0,0,0,0,0,1,1,0,65,3,45
충청남도,보령시,오천면,오천면제8투,173,108,23,48,25,3,4,0,0,0,0,0,0,0,3,106,2,65
충청남도,보령시,오천면,오천면제9투,307,145,44,42,48,4,6,0,0,0,0,0,0,0,0,144,1,162
충청남도,보령시,천북면,합계,3116,2194,579,849,557,71,104,3,0,1,0,0,5,4,5,2178,16,922
충청남도,보령시,천북면,관내사전투표,321,321,106,99,77,13,22,1,0,0,0,0,0,1,0,319,2,0
충청남도,보령시,천북면,천북면제1투,1874,1245,292,522,317,36,58,2,0,0,0,0,5,2,2,1236,9,629
충청남도,보령시,천북면,천북면제2투,921,628,181,228,163,22,24,0,0,1,0,0,0,1,3,623,5,293
충청남도,보령시,청소면,합계,2515,1799,424,789,431,62,63,3,2,3,1,0,1,3,0,1782,17,716
충청남도,보령시,청소면,관내사전투표,574,574,162,225,135,18,23,1,2,2,0,0,0,0,0,568,6,0
충청남도,보령시,청소면,청소면투표소,1941,1225,262,564,296,44,40,2,0,1,1,0,1,3,0,1214,11,716
충청남도,보령시,청라면,관내사전투표,451,451,145,153,99,14,32,0,0,1,0,1,0,0,1,446,5,0
충청남도,보령시,청라면,합계,3483,2443,592,984,643,78,104,3,0,4,2,2,1,3,2,2418,25,1040
충청남도,보령시,청라면,청라면제1투,997,644,142,274,173,18,25,0,0,0,0,0,1,1,1,635,9,353
충청남도,보령시,청라면,청라면제2투,1076,746,168,310,209,27,22,1,0,0,0,1,0,1,0,739,7,330
충청남도,보령시,청라면,청라면제3투,959,602,137,247,162,19,25,2,0,3,2,0,0,1,0,598,4,357
충청남도,보령시,남포면,합계,4467,2922,754,1030,862,100,126,2,1,4,1,3,6,4,8,2901,21,1545
충청남도,보령시,남포면,관내사전투표,533,533,163,152,158,20,33,0,1,0,0,0,0,0,2,529,4,0
충청남도,보령시,남포면,남포면제1투,1517,921,255,328,261,33,31,0,0,1,0,0,2,2,2,915,6,596
충청남도,보령시,남포면,남포면제2투,1409,841,178,333,252,26,35,2,0,0,1,2,1,2,1,833,8,568
충청남도,보령시,남포면,남포면제3투,1008,627,158,217,191,21,27,0,0,3,0,1,3,0,3,624,3,381
충청남도,보령시,주산면,합계,2237,1602,410,596,458,40,67,0,0,2,2,1,0,5,5,1586,16,635
충청남도,보령시,주산면,관내사전투표,400,400,108,138,111,9,26,0,0,1,2,0,0,1,1,397,3,0
충청남도,보령시,주산면,주산면제1투,1352,889,216,363,242,26,28,0,0,0,0,1,0,4,2,882,7,463
충청남도,보령시,주산면,주산면제2투,485,313,86,95,105,5,13,0,0,1,0,0,0,0,2,307,6,172
충청남도,보령시,미산면,합계,1573,1117,241,479,298,38,33,4,0,4,1,0,1,6,3,1108,9,456
충청남도,보령시,미산면,관내사전투표,180,180,52,58,46,12,8,1,0,1,0,0,0,0,0,178,2,0
충청남도,보령시,미산면,미산면제1투,502,326,69,132,99,8,7,1,0,1,0,0,0,4,1,322,4,176
충청남도,보령시,미산면,미산면제2투,475,326,57,155,87,9,12,1,0,1,1,0,0,2,1,326,0,149
충청남도,보령시,미산면,미산면제3투,416,285,63,134,66,9,6,1,0,1,0,0,1,0,1,282,3,131
충청남도,보령시,성주면,합계,2247,1533,481,490,410,57,72,6,0,0,3,1,3,2,0,1525,8,714
충청남도,보령시,성주면,관내사전투표,505,505,206,131,118,19,27,2,0,0,0,0,0,0,0,503,2,0
충청남도,보령시,성주면,성주면제1투,1226,692,182,240,199,26,36,0,0,0,1,1,2,1,0,688,4,534
충청남도,보령시,성주면,성주면제2투,516,336,93,119,93,12,9,4,0,0,2,0,1,1,0,334,2,180
충청남도,보령시,대천1동,합계,11962,8402,2971,2534,1924,401,502,6,0,11,1,10,6,3,5,8374,28,3560
충청남도,보령시,대천1동,관내사전투표,2499,2499,1030,669,489,123,170,2,0,2,0,1,4,1,3,2494,5,0
충청남도,보령시,대천1동,대천1동제1투,1478,756,193,339,181,24,16,0,0,0,1,1,0,0,0,755,1,722
충청남도,보령시,대천1동,대천1동제2투,1216,747,204,312,175,31,18,0,0,0,0,0,0,0,0,740,7,469
충청남도,보령시,대천1동,대천1동제3투,1982,1211,295,485,314,52,49,0,0,2,0,3,0,0,1,1201,10,771
충청남도,보령시,대천1동,대천1동제4투,2066,1400,476,386,348,76,104,1,0,2,0,2,1,1,0,1397,3,666
충청남도,보령시,대천1동,대천1동제5투,2721,1789,773,343,417,95,145,3,0,5,0,3,1,1,1,1787,2,932
충청남도,보령시,대천2동,합계,6391,4743,1661,1424,1119,213,285,4,0,8,0,5,2,1,5,4727,16,1648
충청남도,보령시,대천2동,관내사전투표,2053,2053,788,576,438,98,136,1,0,3,0,3,1,0,1,2045,8,0
충청남도,보령시,대천2동,대천2동제1투,1277,734,220,240,197,34,39,0,0,1,0,1,0,0,1,733,1,543
충청남도,보령시,대천2동,대천2동제2투,848,526,126,220,141,20,14,0,0,2,0,1,0,0,0,524,2,322
충청남도,보령시,대천2동,대천2동제3투,2213,1430,527,388,343,61,96,3,0,2,0,0,1,1,3,1425,5,783
충청남도,보령시,대천3동,관내사전투표,2166,2166,984,412,476,102,178,2,0,1,1,1,0,1,0,2158,8,0
충청남도,보령시,대천3동,합계,10253,7116,2736,1832,1690,333,473,5,1,3,3,10,3,3,3,7095,21,3137
충청남도,보령시,대천3동,대천3동제1투,1723,1022,288,351,255,45,72,3,0,1,1,3,1,0,2,1022,0,701
충청남도,보령시,대천3동,대천3동제2투,2244,1519,656,358,348,58,92,0,0,0,0,1,0,0,0,1513,6,725
충청남도,보령시,대천3동,대천3동제3투,2308,1349,429,441,345,61,62,0,0,1,0,2,1,1,1,1344,5,959
충청남도,보령시,대천3동,대천3동제4투,1812,1060,379,270,266,67,69,0,1,0,1,3,1,1,0,1058,2,752
충청남도,보령시,대천4동,합계,10023,7295,2636,1926,1811,371,492,8,2,5,1,4,0,4,7,7267,28,2728
충청남도,보령시,대천4동,관내사전투표,2541,2540,1076,530,561,151,205,4,0,2,0,2,0,2,0,2533,7,1
충청남도,보령시,대천4동,대천4동제1투,938,540,148,190,143,24,29,0,0,2,0,0,0,0,0,536,4,398
충청남도,보령시,대천4동,대천4동제2투,1708,1121,330,381,295,53,54,0,0,1,1,0,0,2,2,1119,2,587
충청남도,보령시,대천4동,대천4동제3투,1524,910,282,272,278,30,31,2,2,0,0,2,0,0,3,902,8,614
충청남도,보령시,대천4동,대천4동제4투,3312,2184,800,553,534,113,173,2,0,0,0,0,0,0,2,2177,7,1128
충청남도,보령시,대천5동,합계,5876,3856,1079,1455,984,149,130,3,3,8,0,2,4,3,7,3827,29,2020
충청남도,보령시,대천5동,관내사전투표,928,928,312,310,214,36,38,0,3,3,0,0,0,0,1,917,11,0
충청남도,보령시,대천5동,대천5동제1투,1380,783,205,296,218,35,25,0,0,0,0,0,2,0,2,783,0,597
충청남도,보령시,대천5동,대천5동제2투,1774,1009,296,351,278,29,34,3,0,3,0,2,1,1,1,999,10,765
충청남도,보령시,대천5동,대천5동제3투,1794,1136,266,498,274,49,33,0,0,2,0,0,1,2,3,1128,8,658
충청남도,보령시,잘못 투입·구분된 투표지,,0,0,0,0,0,0,0,0,0,0,0,0,0,0,0,0,0,0
충청남도,아산시,합계,,236407,173795,73461,36741,38368,10252,13340,203,41,132,54,105,64,85,184,173030,765,62612
충청남도,아산시,거소·선상투표,,449,424,147,53,140,23,19,1,2,2,3,2,3,1,2,398,26,25
충청남도,아산시,관외사전투표,,18529,18529,8677,2655,3839,1460,1651,25,5,13,1,9,8,10,36,18389,140,0
충청남도,아산시,재외투표,,1017,770,494,39,107,32,88,4,0,0,1,0,1,0,0,766,4,247
충청남도,아산시,염치읍,관내사전투표,811,811,345,194,167,45,51,1,0,0,0,1,1,1,0,806,5,0
충청남도,아산시,염치읍,합계,5674,3637,1243,1098,849,180,225,4,1,3,0,4,3,3,6,3619,18,2037
충청남도,아산시,염치읍,염치읍제1투,1205,679,195,251,164,31,30,1,0,0,0,1,0,1,2,676,3,526
충청남도,아산시,염치읍,염치읍제2투,1491,846,292,245,209,29,60,1,1,0,0,0,1,1,0,839,7,645
충청남도,아산시,염치읍,염치읍제3투,2167,1301,411,408,309,75,84,1,0,3,0,2,1,0,4,1298,3,866
충청남도,아산시,배방읍,합계,43106,32604,15784,5218,7056,2026,2320,33,7,16,7,19,3,11,18,32518,86,10502
충청남도,아산시,배방읍,관내사전투표,6547,6547,3602,803,1177,370,553,7,3,3,3,3,1,1,6,6532,15,0
충청남도,아산시,배방읍,배방읍제1투,861,575,161,204,148,30,23,1,0,1,0,0,0,2,0,570,5,286
충청남도,아산시,배방읍,배방읍제2투,2984,1690,598,464,388,110,110,2,2,3,2,0,0,2,2,1683,7,1294
충청남도,아산시,배방읍,배방읍제3투,2309,1744,942,211,361,109,114,0,0,0,0,3,0,0,0,1740,4,565
충청남도,아산시,배방읍,배방읍제4투,2414,1945,937,314,418,142,127,1,0,2,0,2,0,0,0,1943,2,469
충청남도,아산시,배방읍,배방읍제5투,3329,2046,1020,279,456,117,159,4,0,0,0,2,0,0,1,2038,8,1283
충청남도,아산시,배방읍,배방읍제6투,1999,1548,788,225,313,95,117,4,0,0,1,0,1,1,1,1546,2,451
충청남도,아산시,배방읍,배방읍제7투,2744,1819,903,283,412,111,102,1,0,1,0,1,0,0,1,1815,4,925
충청남도,아산시,배방읍,배방읍제8투,1215,731,210,280,163,39,32,0,0,0,0,0,0,0,1,725,6,484
충청남도,아산시,배방읍,배방읍제9투,3124,2530,1273,354,553,137,202,1,0,0,0,3,0,2,1,2526,4,594
충청남도,아산시,배방읍,배방읍제10투,1015,664,181,276,148,32,23,0,0,1,0,0,0,0,0,661,3,351
충청남도,아산시,배방읍,배방읍제11투,1575,1037,439,180,261,57,93,3,0,0,0,1,1,1,0,1036,1,538
충청남도,아산시,배방읍,배방읍제12투,3577,2678,1309,371,605,191,189,4,0,0,1,0,0,1,1,2672,6,899
충청남도,아산시,배방읍,배방읍제13투,3297,2442,1183,368,563,145,162,3,2,2,0,4,0,0,1,2433,9,855
충청남도,아산시,배방읍,배방읍제14투,2310,1881,845,292,467,163,107,1,0,1,0,0,0,1,1,1878,3,429
충청남도,아산시,배방읍,배방읍제15투,1674,1331,655,183,325,85,82,0,0,0,0,0,0,0,0,1330,1,343
충청남도,아산시,배방읍,배방읍제16투,2132,1396,738,131,298,93,125,1,0,2,0,0,0,0,2,1390,6,736
충청남도,아산시,송악면,합계,3314,2320,747,827,504,79,132,2,1,2,2,3,3,3,4,2309,11,994
충청남도,아산시,송악면,관내사전투표,558,558,196,178,122,18,36,1,1,1,0,2,0,0,1,556,2,0
충청남도,아산시,송악면,송악면제1투,1374,865,253,334,179,34,52,1,0,0,1,0,2,0,3,859,6,509
충청남도,아산시,송악면,송악면제2투,831,516,170,184,110,20,24,0,0,1,1,1,1,3,0,515,1,315
충청남도,아산시,송악면,송악면제3투,551,381,128,131,93,7,20,0,0,0,0,0,0,0,0,379,2,170
충청남도,아산시,탕정면,합계,14264,10984,5803,1258,2184,803,862,6,1,2,7,7,3,5,6,10947,37,3280
충청남도,아산시,탕정면,관내사전투표,3333,3333,1884,328,567,233,293,3,0,1,2,2,0,1,5,3319,14,0
충청남도,아산시,탕정면,탕정면제1투,1867,1035,346,302,240,56,75,3,0,0,4,0,1,2,1,1030,5,832
충청남도,아산시,탕정면,탕정면제2투,2180,1223,463,238,275,72,164,0,1,0,0,2,2,0,0,1217,6,957
충청남도,아산시,탕정면,탕정면제3투,1116,562,271,68,73,74,69,0,0,1,0,1,0,1,0,558,4,554
충청남도,아산시,탕정면,탕정면제4투,3336,2770,1542,210,633,218,159,0,0,0,0,2,0,1,0,2765,5,566
충청남도,아산시,탕정면,탕정면제5투,2432,2061,1297,112,396,150,102,0,0,0,1,0,0,0,0,2058,3,371
충청남도,아산시,음봉면,합계,13907,9719,4181,1998,2266,558,648,11,1,7,1,4,4,4,9,9692,27,4188
충청남도,아산시,음봉면,관내사전투표,1503,1503,754,262,317,72,94,1,0,1,0,0,1,0,1,1503,0,0
충청남도,아산시,음봉면,음봉면제1투,1386,793,202,316,183,35,46,2,0,0,0,0,0,1,1,786,7,593
충청남도,아산시,음봉면,음봉면제2투,2685,1661,679,335,401,104,132,0,0,1,1,0,1,0,1,1655,6,1024
충청남도,아산시,음봉면,음봉면제3투,1180,794,218,301,191,35,44,0,0,1,0,2,0,1,0,793,1,386
충청남도,아산시,음봉면,음봉면제4투,2953,2008,799,459,471,124,138,4,0,0,0,1,1,2,2,2001,7,945
충청남도,아산시,음봉면,음봉면제5투,1230,624,261,111,175,32,35,4,0,1,0,0,1,0,2,622,2,606
충청남도,아산시,음봉면,음봉면제6투,2970,2336,1268,214,528,156,159,0,1,3,0,1,0,0,2,2332,4,634
충청남도,아산시,둔포면,합계,11811,7889,2940,2033,1950,413,487,7,0,11,1,1,4,1,12,7860,29,3922
충청남도,아산시,둔포면,관내사전투표,1800,1800,856,366,359,96,114,1,0,3,0,0,0,0,2,1797,3,0
충청남도,아산시,둔포면,둔포면제1투,1669,944,267,351,232,42,46,1,0,1,0,0,0,0,0,940,4,725
충청남도,아산시,둔포면,둔포면제2투,901,589,119,234,161,29,40,0,0,2,0,0,0,0,1,586,3,312
충청남도,아산시,둔포면,둔포면제3투,1287,807,228,298,220,26,28,1,0,0,0,0,0,1,1,803,4,480
충청남도,아산시,둔포면,둔포면제4투,3857,2440,1047,425,614,147,182,1,0,5,1,0,4,0,6,2432,8,1417
충청남도,아산시,둔포면,둔포면제5투,2297,1309,423,359,364,73,77,3,0,0,0,1,0,0,2,1302,7,988
충청남도,아산시,영인면,합계,5304,3793,1133,1256,939,152,224,6,3,6,5,6,1,4,5,3740,53,1511
충청남도,아산시,영인면,관내사전투표,1012,1012,390,263,214,41,80,3,1,3,3,3,0,1,0,1002,10,0
충청남도,아산시,영인면,영인면제1투,1355,784,223,253,204,43,53,0,0,0,0,1,0,2,1,780,4,571
충청남도,아산시,영인면,영인면제2투,985,670,159,231,218,23,28,2,0,0,0,1,1,1,2,666,4,315
충청남도,아산시,영인면,영인면제3투,1274,863,225,329,194,36,37,1,2,2,1,1,0,0,2,830,33,411
충청남도,아산시,영인면,영인면제4투,678,464,136,180,109,9,26,0,0,1,1,0,0,0,0,462,2,214
충청남도,아산시,인주면,관내사전투표,1332,1332,552,270,264,80,145,4,2,0,0,4,0,2,3,1326,6,0
충청남도,아산시,인주면,합계,5945,3948,1453,988,911,207,332,9,4,2,0,6,2,3,6,3923,25,1997
충청남도,아산시,인주면,인주면제1투,1456,872,303,231,241,40,44,2,0,0,0,0,1,1,2,865,7,584
충청남도,아산시,인주면,인주면제2투,1805,890,286,280,198,47,62,3,2,1,0,2,1,0,1,883,7,915
충청남도,아산시,인주면,인주면제3투,1352,854,312,207,208,40,81,0,0,1,0,0,0,0,0,849,5,498
충청남도,아산시,선장면,합계,3060,2054,514,838,522,76,79,2,0,3,0,3,2,2,1,2042,12,1006
충청남도,아산시,선장면,관내사전투표,486,486,158,171,98,23,29,1,0,0,0,1,0,1,0,482,4,0
충청남도,아산시,선장면,선장면제1투,949,541,120,232,142,21,18,0,0,3,0,0,1,1,1,539,2,408
충청남도,아산시,선장면,선장면제2투,832,500,110,219,134,13,18,0,0,0,0,2,1,0,0,497,3,332
충청남도,아산시,선장면,선장면제3투,793,527,126,216,148,19,14,1,0,0,0,0,0,0,0,524,3,266
충청남도,아산시,도고면,관내사전투표,717,717,247,236,163,31,33,2,0,2,0,0,0,0,0,714,3,0
충청남도,아산시,도고면,합계,4137,2832,735,1126,687,120,120,5,0,8,0,2,1,5,5,2814,18,1305
충청남도,아산시,도고면,도고면제1투,1538,915,238,358,228,28,48,2,0,4,0,0,1,0,1,908,7,623
충청남도,아산시,도고면,도고면제2투,927,560,126,236,146,27,20,1,0,0,0,1,0,0,2,559,1,367
충청남도,아산시,도고면,도고면제3투,955,640,124,296,150,34,19,0,0,2,0,1,0,5,2,633,7,315
충청남도,아산시,신창면,합계,15630,10173,3833,2481,2446,512,804,9,3,5,2,7,6,4,11,10123,50,5457
충청남도,아산시,신창면,관내사전투표,1737,1737,767,317,400,85,154,0,0,0,0,1,0,1,3,1728,9,0
충청남도,아산시,신창면,신창면제1투,1247,685,181,257,177,17,46,0,0,0,1,1,2,1,2,685,0,562
충청남도,아산시,신창면,신창면제2투,776,491,126,184,139,16,20,0,0,3,0,0,0,1,0,489,2,285
충청남도,아산시,신창면,신창면제3투,1638,974,235,392,242,44,54,0,0,0,0,1,0,0,1,969,5,664
충청남도,아산시,신창면,신창면제4투,2420,1480,567,318,382,88,102,1,1,1,0,2,2,0,3,1467,13,940
충청남도,아산시,신창면,신창면제5투,2958,1802,711,378,436,114,150,6,0,0,0,2,1,1,0,1799,3,1156
충청남도,아산시,신창면,신창면제6투,3012,1800,728,391,417,80,168,0,2,0,1,0,0,0,1,1788,12,1212
충청남도,아산시,신창면,신창면제7투,1842,1204,518,244,253,68,110,2,0,1,0,0,1,0,1,1198,6,638
충청남도,아산시,온양1동,관내사전투표,2050,2050,834,545,393,112,157,2,1,0,1,0,0,1,2,2048,2,0
충청남도,아산시,온양1동,합계,7565,5311,1936,1503,1147,301,391,4,1,3,1,2,1,1,5,5296,15,2254
충청남도,아산시,온양1동,온양1동제1투,1068,631,150,279,124,36,38,0,0,0,0,0,0,0,0,627,4,437
충청남도,아산시,온양1동,온양1동제2투,3452,2144,839,483,499,138,169,2,0,3,0,2,1,0,3,2139,5,1308
충청남도,아산시,온양1동,온양1동제3투,995,486,113,196,131,15,27,0,0,0,0,0,0,0,0,482,4,509
충청남도,아산시,온양2동,합계,7723,5583,1947,1642,1235,287,415,10,4,5,3,2,2,2,2,5556,27,2140
충청남도,아산시,온양2동,관내사전투표,2520,2520,991,653,500,134,212,4,1,3,2,2,0,0,1,2503,17,0
충청남도,아산시,온양2동,온양2동제1투,1902,1171,347,388,289,65,72,1,0,0,0,0,1,1,1,1165,6,731
충청남도,아산시,온양2동,온양2동제2투,1713,1053,335,336,248,52,76,1,0,2,0,0,1,0,0,1051,2,660
충청남도,아산시,온양2동,온양2동제3투,1588,839,274,265,198,36,55,4,3,0,1,0,0,1,0,837,2,749
충청남도,아산시,온양3동,합계,24417,18044,7443,4129,3774,994,1564,19,2,11,7,9,4,3,13,17972,72,6373
충청남도,아산시,온양3동,관내사전투표,4897,4897,2275,991,915,262,430,3,1,4,0,2,1,0,1,4885,12,0
충청남도,아산시,온양3동,온양3동제1투,3479,2413,931,540,549,161,211,3,0,0,2,1,2,0,3,2403,10,1066
충청남도,아산시,온양3동,온양3동제2투,3330,1963,621,689,410,77,144,3,0,1,3,3,0,0,1,1952,11,1367
충청남도,아산시,온양3동,온양3동제3투,2843,1944,816,398,407,126,181,4,1,1,0,0,0,0,1,1935,9,899
충청남도,아산시,온양3동,온양3동제4투,1629,1163,538,195,251,63,112,0,0,0,0,0,0,0,1,1160,3,466
충청남도,아산시,온양3동,온양3동제5투,3292,2142,742,611,470,112,182,3,0,4,1,3,1,0,4,2133,9,1150
충청남도,아산시,온양3동,온양3동제6투,3187,2127,785,559,472,116,173,3,0,1,1,0,0,1,1,2112,15,1060
충청남도,아산시,온양3동,온양3동제7투,1760,1395,735,146,300,77,131,0,0,0,0,0,0,2,1,1392,3,365
충청남도,아산시,온양4동,합계,13952,9545,3779,2201,2145,538,799,12,1,8,4,9,0,7,13,9516,29,4407
충청남도,아산시,온양4동,관내사전투표,1970,1970,898,364,388,125,175,4,1,3,0,1,0,0,2,1961,9,0
충청남도,아산시,온양4동,온양4동제1투,2705,1891,752,456,437,83,145,2,0,2,2,1,0,1,5,1886,5,814
충청남도,아산시,온양4동,온양4동제2투,3314,2263,914,493,507,135,207,2,0,0,0,1,0,0,1,2260,3,1051
충청남도,아산시,온양4동,온양4동제3투,1724,1057,262,422,250,59,51,0,0,2,0,1,0,3,3,1053,4,667
충청남도,아산시,온양4동,온양4동제4투,2342,1130,455,225,261,74,101,3,0,0,1,2,0,2,1,1125,5,1212
충청남도,아산시,온양4동,온양4동제5투,1897,1234,498,241,302,62,120,1,0,1,1,3,0,1,1,1231,3,663
충청남도,아산시,온양5동,합계,18487,12795,5276,2707,2797,738,1167,18,2,15,6,3,8,4,12,12753,42,5692
충청남도,아산시,온양5동,관내사전투표,2460,2460,1231,378,444,144,242,2,0,1,1,1,2,0,0,2446,14,0
충청남도,아산시,온양5동,온양5동제1투,2804,1840,675,465,428,91,157,2,0,8,1,0,1,4,1,1833,7,964
충청남도,아산시,온양5동,온양5동제2투,2901,1837,613,521,464,86,140,3,0,3,0,0,2,0,1,1833,4,1064
충청남도,아산시,온양5동,온양5동제3투,1626,1028,361,297,224,61,76,2,1,1,2,0,0,0,0,1025,3,598
충청남도,아산시,온양5동,온양5동제4투,3567,2350,846,574,557,135,222,2,0,2,1,0,1,0,3,2343,7,1217
충청남도,아산시,온양5동,온양5동제5투,2852,1495,670,207,341,111,149,4,1,0,0,0,0,0,6,1489,6,1357
충청남도,아산시,온양5동,온양5동제6투,2277,1785,880,265,339,110,181,3,0,0,1,2,2,0,1,1784,1,492
충청남도,아산시,온양6동,합계,18116,12841,5396,2691,2870,753,1013,16,3,10,3,7,5,12,18,12797,44,5275
충청남도,아산시,온양6동,관내사전투표,2190,2190,1110,342,403,123,195,5,0,2,1,1,2,0,2,2186,4,0
충청남도,아산시,온양6동,온양6동제1투,1964,1181,392,361,249,71,90,2,0,0,0,1,0,2,4,1172,9,783
충청남도,아산시,온양6동,온양6동제2투,2286,1548,638,294,356,97,154,0,0,0,0,1,0,1,2,1543,5,738
충청남도,아산시,온양6동,온양6동제3투,1503,926,220,368,250,36,28,1,1,1,1,3,1,4,1,915,11,577
충청남도,아산시,온양6동,온양6동제4투,2870,1824,682,424,470,82,151,3,0,3,0,0,1,1,3,1820,4,1046
충청남도,아산시,온양6동,온양6동제5투,2369,1447,596,322,341,81,99,3,1,0,0,0,1,0,2,1446,1,922
충청남도,아산시,온양6동,온양6동제6투,2359,1664,706,330,371,109,136,1,0,3,0,0,0,1,4,1661,3,695
충청남도,아산시,온양6동,온양6동제7투,2575,2061,1052,250,430,154,160,1,1,1,1,1,0,3,0,2054,7,514
충청남도,아산시,잘못 투입·구분된 투표지,,0,0,0,0,0,0,0,0,0,0,0,0,0,0,0,0,0,0
충청남도,서산시,합계,,137217,98859,37376,24572,23237,5520,7016,96,25,93,28,137,64,78,133,98375,484,38358
충청남도,서산시,거소·선상투표,,442,416,150,75,105,21,20,3,4,4,0,3,7,2,3,397,19,26
충청남도,서산시,관외사전투표,,10074,10072,4559,1477,2124,830,928,9,2,4,3,12,7,4,19,9978,94,2
충청남도,서산시,재외투표,,496,376,242,21,51,13,44,0,0,0,0,0,1,0,0,372,4,120
충청남도,서산시,대산읍,관내사전투표,2080,2080,959,331,425,137,208,2,0,1,1,7,0,0,4,2075,5,0
충청남도,서산시,대산읍,합계,11198,7724,2950,1685,1894,450,650,4,1,10,2,24,3,7,10,7690,34,3474
충청남도,서산시,대산읍,대산읍제1투,2351,1322,378,350,408,72,91,0,0,3,0,10,0,0,2,1314,8,1029
충청남도,서산시,대산읍,대산읍제2투,749,420,122,133,111,20,23,1,0,1,0,0,1,2,1,415,5,329
충청남도,서산시,대산읍,대산읍제3투,1048,681,286,128,162,40,60,0,0,0,0,0,0,0,3,679,2,367
충청남도,서산시,대산읍,대산읍제4투,1486,1083,478,148,256,69,122,1,0,1,0,1,0,1,0,1077,6,403
충청남도,서산시,대산읍,대산읍제5투,2320,1360,428,390,350,75,97,0,1,4,0,4,2,2,0,1353,7,960
충청남도,서산시,대산읍,대산읍제6투,1164,778,299,205,182,37,49,0,0,0,1,2,0,2,0,777,1,386
충청남도,서산시,인지면,관내사전투표,1183,1183,520,231,263,60,96,0,1,0,0,1,0,1,2,1175,8,0
충청남도,서산시,인지면,합계,6027,4222,1382,1219,1092,205,273,7,1,5,0,2,1,7,7,4201,21,1805
충청남도,서산시,인지면,인지면제1투,3113,1974,622,547,551,105,126,3,0,4,0,1,1,2,3,1965,9,1139
충청남도,서산시,인지면,인지면제2투,870,530,130,207,139,19,30,1,0,0,0,0,0,1,2,529,1,340
충청남도,서산시,인지면,인지면제3투,861,535,110,234,139,21,21,3,0,1,0,0,0,3,0,532,3,326
충청남도,서산시,부석면,관내사전투표,503,503,180,147,120,19,34,0,0,0,0,1,0,1,1,503,0,0
충청남도,서산시,부석면,합계,4872,3179,931,1135,810,107,139,7,1,1,2,7,3,7,12,3162,17,1693
충청남도,서산시,부석면,부석면제1투,1459,918,230,381,232,32,24,4,0,1,0,0,2,3,6,915,3,541
충청남도,서산시,부석면,부석면제2투,1255,756,234,250,195,27,36,3,0,0,0,3,0,2,0,750,6,499
충청남도,서산시,부석면,부석면제3투,738,463,127,166,128,12,20,0,1,0,1,1,0,1,3,460,3,275
충청남도,서산시,부석면,부석면제4투,917,539,160,191,135,17,25,0,0,0,1,2,1,0,2,534,5,378
충청남도,서산시,팔봉면,합계,2986,2048,519,745,595,78,80,3,2,2,0,1,7,4,0,2036,12,938
충청남도,서산시,팔봉면,관내사전투표,427,427,134,117,126,20,23,1,1,1,0,1,1,0,0,425,2,0
충청남도,서산시,팔봉면,팔봉면제1투,1589,1037,272,396,276,36,40,2,0,0,0,0,4,2,0,1028,9,552
충청남도,서산시,팔봉면,팔봉면제2투,887,543,109,218,173,22,16,0,1,0,0,0,1,2,0,542,1,344
충청남도,서산시,팔봉면,팔봉면제3투,83,41,4,14,20,0,1,0,0,1,0,0,1,0,0,41,0,42
충청남도,서산시,지곡면,합계,6649,4535,1706,1142,1120,201,307,0,1,6,2,10,6,6,4,4511,24,2114
충청남도,서산시,지곡면,관내사전투표,966,966,415,225,187,52,74,0,0,0,0,4,1,4,2,964,2,0
충청남도,서산시,지곡면,지곡면제1투,2890,1728,452,630,457,69,93,0,1,3,1,2,4,2,2,1716,12,1162
충청남도,서산시,지곡면,지곡면제2투,2793,1841,839,287,476,80,140,0,0,3,1,4,1,0,0,1831,10,952
충청남도,서산시,성연면,관내사전투표,808,808,389,134,163,40,71,0,0,1,0,0,0,1,3,802,6,0
충청남도,서산시,성연면,합계,3921,2902,1191,625,699,148,204,0,1,3,2,3,2,3,7,2888,14,1019
충청남도,서산시,성연면,성연면제1투,1379,856,228,286,266,28,34,0,1,1,0,1,1,2,1,849,7,523
충청남도,서산시,성연면,성연면제2투,1734,1238,574,205,270,80,99,0,0,1,2,2,1,0,3,1237,1,496
충청남도,서산시,음암면,합계,7964,5369,1827,1397,1477,246,345,12,3,4,2,8,4,7,12,5344,25,2595
충청남도,서산시,음암면,관내사전투표,1050,1050,453,212,237,50,82,1,1,3,0,5,0,1,2,1047,3,0
충청남도,서산시,음암면,음암면제1투,2035,1215,344,409,335,48,58,4,1,0,2,1,2,2,2,1208,7,820
충청남도,서산시,음암면,음암면제2투,2515,1555,499,388,464,84,101,4,1,0,0,0,0,2,4,1547,8,960
충청남도,서산시,음암면,음암면제3투,1522,994,399,202,258,45,78,2,0,1,0,0,1,2,3,991,3,528
충청남도,서산시,음암면,음암면제4투,842,555,132,186,183,19,26,1,0,0,0,2,1,0,1,551,4,287
충청남도,서산시,운산면,합계,4677,3226,819,1340,767,115,135,3,1,4,2,6,0,6,3,3201,25,1451
충청남도,서산시,운산면,관내사전투표,812,812,267,291,164,32,47,0,0,3,0,1,0,1,0,806,6,0
충청남도,서산시,운산면,운산면제1투,2255,1353,323,585,313,51,54,3,1,1,2,3,0,3,1,1340,13,902
충청남도,서산시,운산면,운산면제2투,754,515,90,248,145,12,14,0,0,0,0,1,0,1,2,513,2,239
충청남도,서산시,운산면,운산면제3투,856,546,139,216,145,20,20,0,0,0,0,1,0,1,0,542,4,310
충청남도,서산시,해미면,관내사전투표,1751,1751,621,457,430,116,112,0,1,4,0,1,0,0,3,1745,6,0
충청남도,서산시,해미면,합계,7085,4876,1415,1669,1265,234,236,9,1,9,1,5,1,3,7,4855,21,2209
충청남도,서산시,해미면,해미면제1투,1861,1137,296,399,322,51,56,3,0,3,0,2,0,1,1,1134,3,724
충청남도,서산시,해미면,해미면제2투,1248,754,164,327,193,30,30,1,0,0,1,1,1,1,0,749,5,494
충청남도,서산시,해미면,해미면제3투,2225,1234,334,486,320,37,38,5,0,2,0,1,0,1,3,1227,7,991
충청남도,서산시,고북면,관내사전투표,676,676,250,153,184,42,32,3,0,1,0,1,0,1,1,668,8,0
충청남도,서산시,고북면,합계,5247,3572,1104,1055,1015,182,158,8,0,2,2,7,3,5,6,3547,25,1675
충청남도,서산시,고북면,고북면제1투,1938,1140,261,437,329,41,51,3,0,0,2,2,0,3,4,1133,7,798
충청남도,서산시,고북면,고북면제2투,1528,1024,391,214,278,81,52,1,0,1,0,2,1,0,0,1021,3,504
충청남도,서산시,고북면,고북면제3투,1105,732,202,251,224,18,23,1,0,0,0,2,2,1,1,725,7,373
충청남도,서산시,부춘동,합계,13990,9850,3993,2436,2093,504,749,9,2,14,3,11,2,3,8,9827,23,4140
충청남도,서산시,부춘동,관내사전투표,2998,2998,1406,564,552,171,277,3,0,5,1,9,0,1,2,2991,7,0
충청남도,서산시,부춘동,부춘동제1투,872,501,138,200,109,28,21,0,0,2,0,0,0,0,0,498,3,371
충청남도,서산시,부춘동,부춘동제2투,2099,1341,472,400,299,64,96,1,0,3,1,0,1,0,2,1339,2,758
충청남도,서산시,부춘동,부춘동제3투,3188,2030,813,516,452,104,134,3,0,4,0,1,0,1,1,2029,1,1158
충청남도,서산시,부춘동,부춘동제4투,2248,1465,630,294,332,68,125,2,1,0,1,1,1,0,2,1457,8,783
충청남도,서산시,부춘동,부춘동제5투,2585,1515,534,462,349,69,96,0,1,0,0,0,0,1,1,1513,2,1070
충청남도,서산시,동문1동,관내사전투표,2430,2430,1134,487,426,150,214,1,0,4,0,2,1,0,2,2421,9,0
충청남도,서산시,동문1동,합계,11964,8429,3364,2115,1760,484,643,3,0,8,0,11,2,2,11,8403,26,3535
충청남도,서산시,동문1동,동문1동제1투,3554,2191,852,526,498,110,188,0,0,1,0,7,0,0,2,2184,7,1363
충청남도,서산시,동문1동,동문1동제2투,2059,1115,322,445,238,47,49,1,0,2,0,2,1,1,2,1110,5,944
충청남도,서산시,동문1동,동문1동제3투,3163,2218,926,461,494,156,171,1,0,1,0,0,0,1,4,2215,3,945
충청남도,서산시,동문1동,동문1동제4투,758,475,130,196,104,21,21,0,0,0,0,0,0,0,1,473,2,283
충청남도,서산시,동문2동,합계,7869,5346,1858,1648,1130,309,365,3,0,0,0,3,3,5,4,5328,18,2523
충청남도,서산시,동문2동,관내사전투표,1674,1674,707,387,318,104,150,0,0,0,0,0,0,3,0,1669,5,0
충청남도,서산시,동문2동,동문2동제1투,1231,651,185,244,159,27,33,2,0,0,0,0,0,0,0,650,1,580
충청남도,서산시,동문2동,동문2동제2투,1980,1184,312,502,237,63,59,0,0,0,0,2,1,1,1,1178,6,796
충청남도,서산시,동문2동,동문2동제3투,2984,1837,654,515,416,115,123,1,0,0,0,1,2,1,3,1831,6,1147
충청남도,서산시,수석동,합계,11360,8026,3017,2062,1868,458,545,6,3,6,2,6,4,3,7,7987,39,3334
충청남도,서산시,수석동,관내사전투표,2421,2421,1106,459,476,165,192,3,1,0,2,3,1,1,2,2411,10,0
충청남도,서산시,수석동,수석동제1투,1556,979,367,249,234,44,75,1,1,1,0,0,0,0,2,974,5,577
충청남도,서산시,수석동,수석동제2투,3612,2200,782,630,509,118,146,0,0,3,0,1,1,0,0,2190,10,1412
충청남도,서산시,수석동,수석동제3투,1172,694,191,252,179,32,32,1,1,1,0,0,0,1,2,692,2,478
충청남도,서산시,수석동,수석동제4투,2599,1732,571,472,470,99,100,1,0,1,0,2,2,1,1,1720,12,867
충청남도,서산시,석남동,관내사전투표,3899,3899,1967,571,728,260,344,3,0,4,1,4,1,0,4,3887,12,0
충청남도,서산시,석남동,합계,20396,14691,6349,2726,3372,935,1195,10,2,11,5,18,8,4,13,14648,43,5705
충청남도,서산시,석남동,석남동제1투,3924,2472,915,573,601,152,209,1,0,4,1,2,1,0,3,2462,10,1452
충청남도,서산시,석남동,석남동제2투,2997,1974,821,375,476,132,161,3,0,0,0,0,1,1,2,1972,2,1023
충청남도,서산시,석남동,석남동제3투,1880,1486,769,155,309,112,132,0,1,0,1,1,0,0,1,1481,5,394
충청남도,서산시,석남동,석남동제4투,2862,1843,694,440,459,104,132,0,1,0,0,4,2,0,1,1837,6,1019
충청남도,서산시,석남동,석남동제5투,1303,732,184,245,216,39,36,1,0,0,0,3,2,3,0,729,3,571
충청남도,서산시,석남동,석남동제6투,3531,2285,999,367,583,136,181,2,0,3,2,4,1,0,2,2280,5,1246
충청남도,서산시,잘못 투입·구분된 투표지,,0,0,0,0,0,0,0,0,0,0,0,0,0,0,0,0,0,0
충청남도,태안군,합계,,55379,38740,12881,12666,8940,1626,2093,39,5,31,12,42,39,47,48,38469,271,16639
충청남도,태안군,거소·선상투표,,180,171,58,32,48,12,5,1,0,1,1,0,1,0,3,162,9,9
충청남도,태안군,관외사전투표,,4699,4699,2019,848,969,360,429,3,2,6,1,4,4,3,8,4656,43,0
충청남도,태안군,재외투표,,221,165,105,8,30,6,16,0,0,0,0,0,0,0,0,165,0,56
충청남도,태안군,태안읍,합계,21825,14960,5432,4686,3138,637,908,15,1,5,2,20,9,12,14,14879,81,6865
충청남도,태안군,태안읍,관내사전투표,4537,4538,1933,1177,817,220,346,5,1,1,0,8,1,2,4,4515,23,-1
충청남도,태안군,태안읍,태안읍제1투,1656,922,254,393,193,26,51,0,0,0,0,0,0,0,2,919,3,734
충청남도,태안군,태안읍,태안읍제2투,1241,752,220,266,208,18,26,3,0,0,0,1,2,0,0,744,8,489
충청남도,태안군,태안읍,태안읍제3투,1571,978,280,369,247,32,36,1,0,1,0,3,0,3,0,972,6,593
충청남도,태안군,태안읍,태안읍제4투,723,487,130,195,121,10,18,1,0,0,0,0,2,3,1,481,6,236
충청남도,태안군,태안읍,태안읍제5투,2273,1374,436,470,306,57,90,0,0,0,1,1,3,1,1,1366,8,899
충청남도,태안군,태안읍,태안읍제6투,3439,2012,722,628,432,98,115,1,0,1,0,1,1,1,2,2002,10,1427
충청남도,태안군,태안읍,태안읍제7투,2108,1175,353,442,274,53,42,1,0,0,1,4,0,0,2,1172,3,933
충청남도,태안군,태안읍,태안읍제8투,4277,2722,1104,746,540,123,184,3,0,2,0,2,0,2,2,2708,14,1555
충청남도,태안군,안면읍,관내사전투표,1084,1084,366,339,258,50,58,0,0,1,1,2,2,0,0,1077,7,0
충청남도,태안군,안면읍,합계,7499,4651,1319,1698,1212,160,205,4,0,4,2,4,6,4,2,4620,31,2848
충청남도,태안군,안면읍,안면읍제1투,2675,1453,402,535,360,57,81,3,0,0,0,2,1,2,0,1443,10,1222
충청남도,태안군,안면읍,안면읍제2투,1274,703,170,297,188,19,20,0,0,1,0,0,1,1,1,698,5,571
충청남도,태안군,안면읍,안면읍제3투,1844,1037,259,407,305,26,28,1,0,2,0,0,1,1,0,1030,7,807
충청남도,태안군,안면읍,안면읍제4투,622,374,122,120,101,8,18,0,0,0,1,0,1,0,1,372,2,248
충청남도,태안군,고남면,합계,2128,1329,379,496,342,42,58,0,0,0,0,0,1,0,1,1319,10,799
충청남도,태안군,고남면,관내사전투표,309,309,95,110,72,12,15,0,0,0,0,0,1,0,0,305,4,0
충청남도,태안군,고남면,고남면투표소,1819,1020,284,386,270,30,43,0,0,0,0,0,0,0,1,1014,6,799
충청남도,태안군,남면,관내사전투표,423,423,178,127,72,23,20,1,0,0,0,1,1,0,0,423,0,0
충청남도,태안군,남면,합계,3718,2423,816,825,586,78,87,2,0,2,1,2,2,6,3,2410,13,1295
충청남도,태안군,남면,남면제1투,1186,783,273,279,184,20,16,0,0,0,0,0,0,4,0,776,7,403
충청남도,태안군,남면,남면제2투,820,501,166,171,128,13,12,0,0,2,1,0,1,1,3,498,3,319
충청남도,태안군,남면,남면제3투,1289,716,199,248,202,22,39,1,0,0,0,1,0,1,0,713,3,573
충청남도,태안군,근흥면,관내사전투표,764,764,229,291,174,29,33,0,0,0,0,1,0,2,1,760,4,0
충청남도,태안군,근흥면,합계,4718,3124,805,1327,748,99,103,0,0,3,1,3,4,7,5,3105,19,1594
충청남도,태안군,근흥면,근흥면제1투,1405,776,178,315,218,30,23,0,0,0,1,1,3,1,2,772,4,629
충청남도,태안군,근흥면,근흥면제2투,890,552,148,227,129,18,20,0,0,3,0,0,1,1,0,547,5,338
충청남도,태안군,근흥면,근흥면제3투,1597,980,247,461,217,21,26,0,0,0,0,1,0,3,0,976,4,617
충청남도,태안군,근흥면,근흥면제4투,62,52,3,33,10,1,1,0,0,0,0,0,0,0,2,50,2,10
충청남도,태안군,소원면,합계,4703,3206,865,1220,857,89,112,6,0,5,3,2,5,5,4,3173,33,1497
충청남도,태안군,소원면,관내사전투표,1023,1023,278,368,287,26,37,2,0,2,2,0,2,4,0,1008,15,0
충청남도,태안군,소원면,소원면제1투,2008,1129,302,405,331,30,42,4,0,2,0,1,2,1,2,1122,7,879
충청남도,태안군,소원면,소원면제2투,1672,1054,285,447,239,33,33,0,0,1,1,1,1,0,2,1043,11,618
충청남도,태안군,원북면,합계,3741,2640,726,1042,597,98,126,7,1,2,1,6,3,7,4,2620,20,1101
충청남도,태안군,원북면,관내사전투표,551,551,226,149,103,28,38,2,0,2,0,1,0,0,0,549,2,0
충청남도,태안군,원북면,원북면제1투,1406,922,241,374,211,31,47,1,0,0,0,1,1,3,1,911,11,484
충청남도,태안군,원북면,원북면제2투,920,599,131,253,157,22,20,3,1,0,1,1,1,3,2,595,4,321
충청남도,태안군,원북면,원북면제3투,864,568,128,266,126,17,21,1,0,0,0,3,1,1,1,565,3,296
충청남도,태안군,이원면,관내사전투표,341,341,93,116,99,15,12,0,1,0,0,0,1,1,2,340,1,0
충청남도,태안군,이원면,합계,1947,1372,357,484,413,45,44,1,1,3,0,1,4,3,4,1360,12,575
충청남도,태안군,이원면,이원면제1투,876,560,148,210,155,16,16,1,0,3,0,0,2,1,2,554,6,316
충청남도,태안군,이원면,이원면제2투,730,471,116,158,159,14,16,0,0,0,0,1,1,1,0,466,5,259
충청남도,태안군,잘못 투입·구분된 투표지,,0,0,0,0,0,0,0,0,0,0,0,0,0,0,0,0,0,0
충청남도,금산군,합계,,46637,32968,11182,9416,8787,1312,1679,39,19,37,15,49,50,45,87,32717,251,13669
충청남도,금산군,거소·선상투표,,133,122,31,37,39,2,2,2,0,1,0,0,0,1,0,115,7,11
충청남도,금산군,관외사전투표,,3932,3931,1791,667,792,282,345,5,1,2,2,5,6,0,10,3908,23,1
충청남도,금산군,재외투표,,186,130,63,22,22,2,17,1,0,0,1,0,0,0,1,129,1,56
충청남도,금산군,금산읍,관내사전투표,3833,3833,1684,803,844,164,289,5,0,5,1,7,2,6,5,3815,18,0
충청남도,금산군,금산읍,합계,18263,12668,4574,3432,3288,503,716,9,1,11,2,21,11,12,16,12596,72,5595
충청남도,금산군,금산읍,금산읍제1투,2135,1198,337,429,338,39,45,0,1,1,0,0,2,0,1,1193,5,937
충청남도,금산군,금산읍,금산읍제2투,1463,947,291,302,291,16,38,0,0,1,0,2,1,1,0,943,4,516
충청남도,금산군,금산읍,금산읍제3투,2650,1577,614,395,379,79,90,1,0,0,0,4,2,1,4,1569,8,1073
충청남도,금산군,금산읍,금산읍제4투,1245,790,199,282,227,31,27,1,0,3,0,4,2,2,3,781,9,455
충청남도,금산군,금산읍,금산읍제5투,709,427,149,110,143,8,8,0,0,0,0,0,1,0,1,420,7,282
충청남도,금산군,금산읍,금산읍제6투,1354,815,236,270,237,19,45,0,0,0,0,2,0,0,0,809,6,539
충청남도,금산군,금산읍,금산읍제7투,3153,1956,776,409,528,101,127,2,0,1,0,1,1,1,1,1948,8,1197
충청남도,금산군,금산읍,금산읍제8투,1721,1125,288,432,301,46,47,0,0,0,1,1,0,1,1,1118,7,596
충청남도,금산군,금성면,합계,2871,1859,542,572,541,68,78,2,1,3,2,4,4,1,10,1828,31,1012
충청남도,금산군,금성면,관내사전투표,409,409,149,88,104,19,29,0,1,2,1,2,0,0,1,396,13,0
충청남도,금산군,금성면,금성면제1투,1575,928,268,293,281,31,36,0,0,0,0,2,3,1,5,920,8,647
충청남도,금산군,금성면,금성면제2투,887,522,125,191,156,18,13,2,0,1,1,0,1,0,4,512,10,365
충청남도,금산군,제원면,합계,2522,1661,469,598,451,54,52,5,2,5,1,2,3,4,7,1653,8,861
충청남도,금산군,제원면,관내사전투표,507,507,166,150,139,23,16,2,0,3,1,0,0,1,4,505,2,0
충청남도,금산군,제원면,제원면제1투,1462,825,210,332,215,27,28,1,2,0,0,2,1,1,2,821,4,637
충청남도,금산군,제원면,제원면제2투,553,329,93,116,97,4,8,2,0,2,0,0,2,2,1,327,2,224
충청남도,금산군,부리면,관내사전투표,219,219,67,73,52,8,16,0,1,0,1,0,0,0,0,218,1,0
충청남도,금산군,부리면,합계,2233,1477,414,498,418,37,69,3,1,1,2,1,3,5,9,1461,16,756
충청남도,금산군,부리면,부리면제1투,1289,786,196,276,234,20,34,3,0,1,1,0,3,3,6,777,9,503
충청남도,금산군,부리면,부리면제2투,725,472,151,149,132,9,19,0,0,0,0,1,0,2,3,466,6,253
충청남도,금산군,군북면,관내사전투표,168,168,73,35,44,6,6,0,2,1,0,0,0,0,0,167,1,0
충청남도,금산군,군북면,합계,2077,1401,418,463,397,47,46,2,2,2,0,2,3,3,5,1390,11,676
충청남도,금산군,군북면,군북면제1투,610,382,104,135,111,12,9,2,0,0,0,2,1,1,2,379,3,228
충청남도,금산군,군북면,군북면제2투,901,583,158,205,164,24,20,0,0,1,0,0,1,1,3,577,6,318
충청남도,금산군,군북면,군북면제3투,398,268,83,88,78,5,11,0,0,0,0,0,1,1,0,267,1,130
충청남도,금산군,남일면,합계,2168,1488,395,473,490,37,60,0,0,2,1,3,3,4,6,1474,14,680
충청남도,금산군,남일면,관내사전투표,347,347,123,98,100,6,10,0,0,2,0,1,0,1,3,344,3,0
충청남도,금산군,남일면,남일면제1투,1303,825,203,263,286,19,36,0,0,0,0,2,2,3,2,816,9,478
충청남도,금산군,남일면,남일면제2투,518,316,69,112,104,12,14,0,0,0,1,0,1,0,1,314,2,202
충청남도,금산군,남이면,합계,1692,1114,318,360,335,26,48,2,1,1,1,1,4,3,3,1103,11,578
충청남도,금산군,남이면,관내사전투표,187,187,64,53,55,4,7,0,0,1,0,0,2,0,0,186,1,0
충청남도,금산군,남이면,남이면제1투,949,570,149,186,185,14,19,2,1,0,0,0,2,2,2,562,8,379
충청남도,금산군,남이면,남이면제2투,556,357,105,121,95,8,22,0,0,0,1,1,0,1,1,355,2,199
충청남도,금산군,진산면,합계,2656,1822,558,592,517,61,47,1,4,4,1,3,5,4,8,1805,17,834
충청남도,금산군,진산면,관내사전투표,400,400,141,121,99,17,15,0,1,0,0,0,2,0,3,399,1,0
충청남도,금산군,진산면,진산면제1투,1498,918,271,308,256,34,22,1,2,2,1,2,2,3,0,904,14,580
충청남도,금산군,진산면,진산면제2투,758,504,146,163,162,10,10,0,1,2,0,1,1,1,5,502,2,254
충청남도,금산군,복수면,합계,2733,1865,536,652,520,61,65,5,1,4,0,3,1,2,4,1854,11,868
충청남도,금산군,복수면,관내사전투표,345,345,130,98,90,16,8,1,0,1,0,0,0,0,0,344,1,0
충청남도,금산군,복수면,복수면제1투,1196,746,192,278,211,30,21,3,1,2,0,1,0,0,3,742,4,450
충청남도,금산군,복수면,복수면제2투,1192,774,214,276,219,15,36,1,0,1,0,2,1,2,1,768,6,418
충청남도,금산군,추부면,합계,5171,3430,1073,1050,977,132,134,2,5,1,2,4,7,6,8,3401,29,1741
충청남도,금산군,추부면,관내사전투표,783,783,319,180,194,37,41,0,1,0,0,2,1,0,1,776,7,0
충청남도,금산군,추부면,추부면제1투,1900,1068,329,335,312,39,43,0,0,0,1,1,1,1,1,1063,5,832
충청남도,금산군,추부면,추부면제2투,1294,819,238,278,226,25,24,0,2,1,1,1,3,4,5,808,11,475
충청남도,금산군,추부면,추부면제3투,1194,760,187,257,245,31,26,2,2,0,0,0,2,1,1,754,6,434
충청남도,금산군,잘못 투입·구분된 투표지,,0,0,0,0,0,0,0,0,0,0,0,0,0,0,0,0,0,0
충청남도,논산시,합계,,103557,72434,28265,16948,18844,3503,3897,82,21,87,31,117,57,62,123,72037,397,31123
충청남도,논산시,거소·선상투표,,384,351,137,51,99,18,11,6,2,2,1,1,1,2,3,334,17,33
충청남도,논산시,관외사전투표,,8150,8150,3771,1213,1688,627,725,12,3,5,6,6,4,4,23,8087,63,0
충청남도,논산시,재외투표,,398,260,166,14,39,11,27,1,0,0,0,0,0,0,0,258,2,138
충청남도,논산시,강경읍,합계,7699,5038,2168,988,1428,183,200,5,2,12,1,4,2,4,7,5004,34,2661
충청남도,논산시,강경읍,관내사전투표,1132,1132,599,179,230,47,62,0,0,3,0,1,0,2,3,1126,6,0
충청남도,논산시,강경읍,강경읍제1투,1254,678,262,148,210,26,18,2,0,2,0,1,1,2,0,672,6,576
충청남도,논산시,강경읍,강경읍제2투,756,513,205,120,144,15,20,1,0,2,0,1,0,0,1,509,4,243
충청남도,논산시,강경읍,강경읍제3투,2656,1663,674,319,527,60,70,0,0,5,0,1,0,0,0,1656,7,993
충청남도,논산시,강경읍,강경읍제4투,1901,1052,428,222,317,35,30,2,2,0,1,0,1,0,3,1041,11,849
충청남도,논산시,연무읍,합계,11488,7518,2890,1706,2102,389,310,9,4,10,3,36,5,4,14,7482,36,3970
충청남도,논산시,연무읍,관내사전투표,2206,2206,947,415,535,153,123,5,0,4,1,6,3,0,4,2196,10,0
충청남도,논산시,연무읍,연무읍제1투,3088,1717,625,416,470,89,87,1,2,3,0,3,1,1,7,1705,12,1371
충청남도,논산시,연무읍,연무읍제2투,2756,1566,566,382,472,71,59,2,1,0,1,5,1,0,1,1561,5,1190
충청남도,논산시,연무읍,연무읍제3투,1748,957,342,234,298,52,23,1,0,1,1,1,0,2,0,955,2,791
충청남도,논산시,연무읍,연무읍제4투,1690,1072,410,259,327,24,18,0,1,2,0,21,0,1,2,1065,7,618
충청남도,논산시,성동면,합계,3911,2592,834,718,803,94,108,5,0,5,0,2,3,2,4,2578,14,1319
충청남도,논산시,성동면,관내사전투표,505,505,182,101,166,22,20,1,0,3,0,0,1,0,0,496,9,0
충청남도,논산시,성동면,성동면제1투,893,494,154,127,167,19,24,0,0,0,0,0,0,1,0,492,2,399
충청남도,논산시,성동면,성동면제2투,1130,693,247,178,206,27,29,2,0,0,0,0,0,0,3,692,1,437
충청남도,논산시,성동면,성동면제3투,1383,900,251,312,264,26,35,2,0,2,0,2,2,1,1,898,2,483
충청남도,논산시,광석면,합계,3915,2638,841,814,747,84,120,0,1,1,2,1,2,4,7,2624,14,1277
충청남도,논산시,광석면,관내사전투표,451,451,179,128,97,18,25,0,1,0,0,0,1,1,1,451,0,0
충청남도,논산시,광석면,광석면제1투,1451,916,270,314,254,29,36,0,0,1,1,0,0,1,1,907,9,535
충청남도,논산시,광석면,광석면제2투,798,507,162,124,181,16,18,0,0,0,0,0,1,1,1,504,3,291
충청남도,논산시,광석면,광석면제3투,1215,764,230,248,215,21,41,0,0,0,1,1,0,1,4,762,2,451
충청남도,논산시,노성면,합계,2786,1907,600,595,504,77,96,4,0,6,1,3,2,2,6,1896,11,879
충청남도,논산시,노성면,관내사전투표,386,386,148,98,82,22,32,0,0,2,0,0,0,0,0,384,2,0
충청남도,논산시,노성면,노성면제1투,1434,922,267,322,241,36,37,1,0,2,1,2,1,1,4,915,7,512
충청남도,논산시,노성면,노성면제2투,966,599,185,175,181,19,27,3,0,2,0,1,1,1,2,597,2,367
충청남도,논산시,상월면,합계,3232,2095,781,593,521,61,98,1,1,2,0,8,5,8,4,2083,12,1137
충청남도,논산시,상월면,관내사전투표,514,514,216,120,119,12,26,1,1,1,0,2,3,4,0,505,9,0
충청남도,논산시,상월면,상월면제1투,1389,812,281,252,209,28,32,0,0,1,0,6,1,0,2,812,0,577
충청남도,논산시,상월면,상월면제2투,1329,769,284,221,193,21,40,0,0,0,0,0,1,4,2,766,3,560
충청남도,논산시,부적면,합계,3368,2342,772,638,696,89,107,5,0,0,2,7,1,9,3,2329,13,1026
충청남도,논산시,부적면,관내사전투표,593,593,236,113,163,26,40,2,0,0,1,1,0,2,1,585,8,0
충청남도,논산시,부적면,부적면제1투,1302,796,261,202,248,41,33,2,0,0,0,4,0,2,1,794,2,506
충청남도,논산시,부적면,부적면제2투,796,525,147,178,164,11,17,1,0,0,1,0,1,2,1,523,2,271
충청남도,논산시,부적면,부적면제3투,677,428,128,145,121,11,17,0,0,0,0,2,0,3,0,427,1,249
충청남도,논산시,연산면,합계,5446,3649,1117,1179,973,146,171,8,3,5,5,5,8,6,1,3627,22,1797
충청남도,논산시,연산면,관내사전투표,868,868,331,240,200,30,44,3,1,1,2,0,5,2,0,859,9,0
충청남도,논산시,연산면,연산면제1투,1889,1171,342,387,327,55,47,0,1,1,1,1,2,1,0,1165,6,718
충청남도,논산시,연산면,연산면제2투,1538,871,242,278,253,37,47,3,1,1,1,2,1,2,0,868,3,667
충청남도,논산시,연산면,연산면제3투,1151,739,202,274,193,24,33,2,0,2,1,2,0,1,1,735,4,412
충청남도,논산시,벌곡면,합계,2125,1510,422,541,433,56,43,1,0,1,0,1,0,1,3,1502,8,615
충청남도,논산시,벌곡면,관내사전투표,337,337,119,110,82,10,14,1,0,0,0,0,0,0,0,336,1,0
충청남도,논산시,벌곡면,벌곡면제1투,1034,670,170,259,195,21,20,0,0,0,0,1,0,1,0,667,3,364
충청남도,논산시,벌곡면,벌곡면제2투,754,503,133,172,156,25,9,0,0,1,0,0,0,0,3,499,4,251
충청남도,논산시,양촌면,합계,4559,2916,943,810,914,96,96,1,0,7,2,6,2,7,5,2889,27,1643
충청남도,논산시,양촌면,관내사전투표,750,750,245,214,209,30,37,0,0,3,1,1,1,1,1,743,7,0
충청남도,논산시,양촌면,양촌면제1투,1326,758,246,222,231,30,17,0,0,1,0,0,0,3,1,751,7,568
충청남도,논산시,양촌면,양촌면제2투,1119,645,209,169,219,19,15,0,0,3,0,2,0,0,1,637,8,474
충청남도,논산시,양촌면,양촌면제3투,1364,763,243,205,255,17,27,1,0,0,1,3,1,3,2,758,5,601
충청남도,논산시,가야곡면,합계,3253,2144,685,688,605,53,77,2,1,5,1,4,5,0,7,2133,11,1109
충청남도,논산시,가야곡면,관내사전투표,555,555,219,128,161,15,27,0,0,0,0,1,0,0,1,552,3,0
충청남도,논산시,가야곡면,가야곡면제1투,1040,581,191,187,168,12,16,0,0,1,0,0,1,0,3,579,2,459
충청남도,논산시,가야곡면,가야곡면제2투,705,439,120,179,106,9,14,0,1,4,0,3,0,0,2,438,1,266
충청남도,논산시,가야곡면,가야곡면제3투,953,569,155,194,170,17,20,2,0,0,1,0,4,0,1,564,5,384
충청남도,논산시,은진면,합계,3570,2339,749,660,677,114,107,3,0,7,1,0,2,2,5,2327,12,1231
충청남도,논산시,은진면,관내사전투표,539,539,202,139,126,33,29,0,0,3,0,0,0,1,2,535,4,0
충청남도,논산시,은진면,은진면제1투,1298,754,207,212,261,39,26,1,0,2,0,0,0,1,2,751,3,544
충청남도,논산시,은진면,은진면제2투,769,493,151,171,139,11,13,2,0,0,1,0,1,0,0,489,4,276
충청남도,논산시,은진면,은진면제3투,964,553,189,138,151,31,39,0,0,2,0,0,1,0,1,552,1,411
충청남도,논산시,채운면,합계,2208,1524,611,373,406,53,55,1,0,1,1,1,6,2,5,1515,9,684
충청남도,논산시,채운면,관내사전투표,396,396,194,81,88,10,14,0,0,0,1,1,2,0,1,392,4,0
충청남도,논산시,채운면,채운면제1투,1034,637,236,175,171,19,26,1,0,1,0,0,2,1,3,635,2,397
충청남도,논산시,채운면,채운면제2투,778,491,181,117,147,24,15,0,0,0,0,0,2,1,1,488,3,287
충청남도,논산시,취암동,관내사전투표,4513,4513,2312,658,872,285,356,2,0,1,1,5,2,1,3,4498,15,0
충청남도,논산시,취암동,합계,24216,16676,7152,3406,4014,917,1071,7,3,10,4,19,5,3,13,16624,52,7540
충청남도,논산시,취암동,취암동제1투,2415,1369,464,424,365,53,56,1,0,0,0,0,1,0,0,1364,5,1046
충청남도,논산시,취암동,취암동제2투,3347,1890,773,375,492,101,136,0,0,1,1,2,0,1,4,1886,4,1457
충청남도,논산시,취암동,취암동제3투,3780,2206,854,490,605,114,124,1,0,6,0,2,0,0,2,2198,8,1574
충청남도,논산시,취암동,취암동제4투,1417,882,240,321,229,41,43,2,1,1,0,0,1,0,0,879,3,535
충청남도,논산시,취암동,취암동제5투,1685,1032,379,275,277,48,45,0,1,0,1,1,0,1,1,1029,3,653
충청남도,논산시,취암동,취암동제6투,1837,1267,521,263,311,87,81,1,0,0,1,1,0,0,0,1266,1,570
충청남도,논산시,취암동,취암동제7투,2758,1851,819,333,483,84,115,0,1,1,0,4,1,0,1,1842,9,907
충청남도,논산시,취암동,취암동제8투,2464,1666,790,267,380,104,115,0,0,0,0,4,0,0,2,1662,4,798
충청남도,논산시,부창동,합계,12849,8785,3626,1961,2195,435,475,11,1,8,1,13,4,2,13,8745,40,4064
충청남도,논산시,부창동,관내사전투표,2036,2036,967,360,437,110,139,5,0,3,0,3,0,0,2,2026,10,0
충청남도,논산시,부창동,부창동제1투,2353,1487,623,321,359,77,94,3,0,2,0,4,0,0,1,1484,3,866
충청남도,논산시,부창동,부창동제2투,1794,1094,354,353,296,39,39,0,1,0,0,1,1,0,2,1086,8,700
충청남도,논산시,부창동,부창동제3투,3605,2267,876,538,623,111,96,2,0,1,1,1,0,1,4,2254,13,1338
충청남도,논산시,부창동,부창동제4투,3061,1901,806,389,480,98,107,1,0,2,0,4,3,1,4,1895,6,1160
충청남도,논산시,잘못 투입·구분된 투표지,,0,0,0,0,0,0,0,0,0,0,0,0,0,0,0,0,0,0
충청남도,계룡시,합계,,32653,26530,9566,6261,6722,2222,1502,34,6,20,6,35,6,13,29,26422,108,6123
충청남도,계룡시,거소·선상투표,,129,121,40,15,38,18,5,0,0,0,0,1,0,1,0,118,3,8
충청남도,계룡시,관외사전투표,,4034,4034,1572,734,996,390,293,4,3,1,2,4,0,0,7,4006,28,0
충청남도,계룡시,재외투표,,237,183,93,17,42,14,16,1,0,0,0,0,0,0,0,183,0,54
충청남도,계룡시,두마면,합계,4703,3724,1421,952,903,239,181,8,0,1,1,1,1,1,5,3714,10,979
충청남도,계룡시,두마면,관내사전투표,1189,1189,531,245,265,73,69,1,0,0,1,1,0,0,0,1186,3,0
충청남도,계룡시,두마면,두마면제1투,1824,1260,444,358,322,78,49,2,0,1,0,0,0,0,1,1255,5,564
충청남도,계룡시,두마면,두마면제2투,1690,1275,446,349,316,88,63,5,0,0,0,0,1,1,4,1273,2,415
충청남도,계룡시,엄사면,합계,12780,9513,3466,2378,2427,595,540,14,2,9,3,19,4,3,10,9470,43,3267
충청남도,계룡시,엄사면,관내사전투표,2834,2834,1148,653,642,184,171,6,0,3,0,4,1,1,4,2817,17,0
충청남도,계룡시,엄사면,엄사면제1투,3084,2104,754,543,561,128,93,4,1,1,1,6,2,1,1,2096,8,980
충청남도,계룡시,엄사면,엄사면제2투,2024,1331,440,357,360,82,78,0,1,1,2,4,0,1,1,1327,4,693
충청남도,계룡시,엄사면,엄사면제3투,1798,1264,429,303,324,107,88,3,0,2,0,3,0,0,2,1261,3,534
충청남도,계룡시,엄사면,엄사면제4투,2370,1549,568,379,414,83,92,0,0,1,0,1,1,0,2,1541,8,821
충청남도,계룡시,엄사면,엄사면제5투,670,431,127,143,126,11,18,1,0,1,0,1,0,0,0,428,3,239
충청남도,계룡시,신도안면,합계,4903,4215,1186,923,1210,658,212,2,1,4,0,3,1,2,4,4206,9,688
충청남도,계룡시,신도안면,관내사전투표,1883,1883,578,421,485,283,100,2,1,3,0,3,0,0,3,1879,4,0
충청남도,계룡시,신도안면,신도안면제1투,1241,910,227,212,295,138,34,0,0,0,0,0,0,1,0,907,3,331
충청남도,계룡시,신도안면,신도안면제2투,1779,1422,381,290,430,237,78,0,0,1,0,0,1,1,1,1420,2,357
충청남도,계룡시,금암동,관내사전투표,1829,1829,751,450,376,135,100,0,0,2,0,6,0,3,0,1823,6,0
충청남도,계룡시,금암동,합계,5867,4740,1788,1242,1106,308,255,5,0,5,0,7,0,6,3,4725,15,1127
충청남도,계룡시,금암동,금암동제1투,2380,1731,666,426,429,107,91,1,0,1,0,0,0,1,3,1725,6,649
충청남도,계룡시,금암동,금암동제2투,1658,1180,371,366,301,66,64,4,0,2,0,1,0,2,0,1177,3,478
충청남도,계룡시,잘못 투입·구분된 투표지,,0,0,0,0,0,0,0,0,0,0,0,0,0,0,0,0,0,0
충청남도,당진시,합계,,134586,95417,37191,23597,20852,4907,7638,107,24,177,31,221,45,68,126,94984,433,39169
충청남도,당진시,거소·선상투표,,307,272,72,68,84,18,9,3,3,0,4,0,1,1,1,264,8,35
충청남도,당진시,관외사전투표,,10515,10515,4649,1792,2148,764,1010,15,3,13,0,15,4,3,23,10439,76,0
충청남도,당진시,재외투표,,433,317,204,14,41,10,44,2,0,0,0,0,0,0,0,315,2,116
충청남도,당진시,당진1동,합계,17723,12363,5200,2725,2489,725,1095,12,1,18,2,27,4,5,10,12313,50,5360
충청남도,당진시,당진1동,관내사전투표,4117,4117,1916,867,712,228,351,3,1,5,0,13,1,1,2,4100,17,0
충청남도,당진시,당진1동,당진1동제1투,2503,1479,631,271,310,102,155,0,0,0,0,3,1,1,3,1477,2,1024
충청남도,당진시,당진1동,당진1동제2투,4178,2440,877,670,543,151,166,2,0,9,0,1,1,3,2,2425,15,1738
충청남도,당진시,당진1동,당진1동제3투,3285,2013,744,524,428,105,186,4,0,3,1,7,1,0,1,2004,9,1272
충청남도,당진시,당진1동,당진1동제4투,3640,2314,1032,393,496,139,237,3,0,1,1,3,0,0,2,2307,7,1326
충청남도,당진시,합덕읍,합계,8408,5486,1635,1980,1303,227,295,1,1,5,2,4,2,3,7,5465,21,2922
충청남도,당진시,합덕읍,관내사전투표,1482,1482,529,407,334,74,125,0,0,2,1,0,1,2,0,1475,7,0
충청남도,당진시,합덕읍,합덕읍제1투,1082,640,167,271,161,18,21,0,0,0,0,0,0,0,0,638,2,442
충청남도,당진시,합덕읍,합덕읍제2투,1457,843,192,367,208,33,38,1,0,0,0,0,1,0,2,842,1,614
충청남도,당진시,합덕읍,합덕읍제3투,2182,1172,343,433,268,51,64,0,0,1,1,1,0,1,2,1165,7,1010
충청남도,당진시,합덕읍,합덕읍제4투,925,558,145,235,134,16,19,0,1,2,0,1,0,0,1,554,4,367
충청남도,당진시,합덕읍,합덕읍제5투,1280,791,259,267,198,35,28,0,0,0,0,2,0,0,2,791,0,489
충청남도,당진시,송악읍,합계,19745,13016,5349,2926,2870,656,1069,11,2,19,4,37,6,8,11,12968,48,6729
충청남도,당진시,송악읍,관내사전투표,3246,3246,1605,565,590,163,297,2,1,3,1,7,0,2,3,3239,7,0
충청남도,당진시,송악읍,송악읍제1투,3738,2316,961,501,484,148,192,0,0,5,0,12,1,2,2,2308,8,1422
충청남도,당진시,송악읍,송악읍제2투,856,494,109,204,137,18,21,1,0,0,0,0,1,0,0,491,3,362
충청남도,당진시,송악읍,송악읍제3투,3101,1880,700,507,451,60,140,4,0,3,0,4,0,1,4,1874,6,1221
충청남도,당진시,송악읍,송악읍제4투,2390,1217,342,458,292,40,73,0,0,1,1,0,2,2,0,1211,6,1173
충청남도,당진시,송악읍,송악읍제5투,2583,1619,699,309,352,100,142,0,0,3,0,6,2,1,0,1614,5,964
충청남도,당진시,송악읍,송악읍제6투,3831,2244,933,382,564,127,204,4,1,4,2,8,0,0,2,2231,13,1587
충청남도,당진시,고대면,관내사전투표,886,886,403,203,147,50,72,0,0,0,0,3,1,0,2,881,5,0
충청남도,당진시,고대면,합계,5016,3360,1112,1144,758,116,184,1,1,8,2,8,2,5,5,3346,14,1656
충청남도,당진시,고대면,고대면제1투,1616,999,284,358,258,27,56,0,0,5,1,3,1,2,2,997,2,617
충청남도,당진시,고대면,고대면제2투,1507,867,224,352,219,26,30,1,1,2,1,2,0,3,1,862,5,640
충청남도,당진시,고대면,고대면제3투,1007,608,201,231,134,13,26,0,0,1,0,0,0,0,0,606,2,399
충청남도,당진시,석문면,합계,7067,4536,1513,1379,1109,186,283,3,1,6,2,16,0,2,7,4507,29,2531
충청남도,당진시,석문면,관내사전투표,833,834,393,176,162,33,61,0,0,0,0,8,0,0,0,833,1,-1
충청남도,당진시,석문면,석문면제1투,2428,1400,501,370,342,67,103,0,0,4,0,4,0,1,3,1395,5,1028
충청남도,당진시,석문면,석문면제2투,3071,1810,493,644,476,75,91,2,1,2,2,3,0,0,3,1792,18,1261
충청남도,당진시,석문면,석문면제3투,147,100,12,59,22,1,4,0,0,0,0,0,0,0,0,98,2,47
충청남도,당진시,석문면,석문면제4투,588,392,114,130,107,10,24,1,0,0,0,1,0,1,1,389,3,196
충청남도,당진시,대호지면,관내사전투표,291,291,108,90,60,14,10,0,1,0,1,1,1,1,2,289,2,0
충청남도,당진시,대호지면,합계,2188,1436,379,589,319,53,67,3,1,1,1,2,1,7,6,1429,7,752
충청남도,당진시,대호지면,대호지면제1투,1155,686,170,312,146,18,28,0,0,1,0,1,0,5,3,684,2,469
충청남도,당진시,대호지면,대호지면제2투,742,459,101,187,113,21,29,3,0,0,0,0,0,1,1,456,3,283
충청남도,당진시,정미면,관내사전투표,370,370,118,115,93,13,25,0,0,1,0,3,1,1,0,370,0,0
충청남도,당진시,정미면,합계,3032,1991,518,740,534,68,93,0,1,5,1,7,6,5,5,1983,8,1041
충청남도,당진시,정미면,정미면제1투,1734,1021,258,404,263,40,41,0,1,1,1,2,3,2,3,1019,2,713
충청남도,당진시,정미면,정미면제2투,928,600,142,221,178,15,27,0,0,3,0,2,2,2,2,594,6,328
충청남도,당진시,면천면,관내사전투표,616,616,205,189,148,33,37,0,0,0,0,0,0,1,0,613,3,0
충청남도,당진시,면천면,합계,3175,2108,592,776,516,85,105,2,0,4,1,2,1,5,5,2094,14,1067
충청남도,당진시,면천면,면천면제1투,1709,981,257,387,241,40,36,2,0,4,0,2,0,3,2,974,7,728
충청남도,당진시,면천면,면천면제2투,850,511,130,200,127,12,32,0,0,0,1,0,1,1,3,507,4,339
충청남도,당진시,순성면,합계,4451,2944,853,973,778,109,188,2,3,3,2,2,3,4,8,2928,16,1507
충청남도,당진시,순성면,관내사전투표,706,706,249,176,185,25,62,0,0,1,1,1,1,2,1,704,2,0
충청남도,당진시,순성면,순성면제1투,1992,1207,344,409,312,42,79,2,2,0,1,1,2,1,3,1198,9,785
충청남도,당진시,순성면,순성면제2투,811,487,108,190,145,24,16,0,0,1,0,0,0,0,1,485,2,324
충청남도,당진시,순성면,순성면제3투,942,544,152,198,136,18,31,0,1,1,0,0,0,1,3,541,3,398
충청남도,당진시,우강면,합계,4492,2957,918,1034,701,103,170,3,2,4,0,1,2,1,2,2941,16,1535
충청남도,당진시,우강면,관내사전투표,614,614,227,183,141,27,31,2,1,0,0,1,0,0,0,613,1,0
충청남도,당진시,우강면,우강면제1투,2094,1245,379,441,282,44,80,1,1,3,0,0,0,1,2,1234,11,849
충청남도,당진시,우강면,우강면제2투,1074,670,165,265,171,20,43,0,0,1,0,0,2,0,0,667,3,404
충청남도,당진시,우강면,우강면제3투,710,428,147,145,107,12,16,0,0,0,0,0,0,0,0,427,1,282
충청남도,당진시,신평면,합계,12419,8281,3071,2279,1806,400,613,15,0,11,3,23,6,7,10,8244,37,4138
충청남도,당진시,신평면,관내사전투표,1984,1984,894,406,372,115,182,1,0,2,2,2,1,1,2,1980,4,0
충청남도,당진시,신평면,신평면제1투,2508,1559,502,534,337,69,95,2,0,1,0,3,1,2,2,1548,11,949
충청남도,당진시,신평면,신평면제2투,4901,2935,1170,605,690,165,261,5,0,5,0,13,2,3,2,2921,14,1966
충청남도,당진시,신평면,신평면제3투,1059,678,158,304,149,24,31,0,0,1,1,5,0,1,2,676,2,381
충청남도,당진시,신평면,신평면제4투,1967,1125,347,430,258,27,44,7,0,2,0,0,2,0,2,1119,6,842
충청남도,당진시,송산면,합계,9080,6285,2636,1350,1283,264,661,8,1,8,2,34,3,5,7,6262,23,2795
충청남도,당진시,송산면,관내사전투표,1697,1697,832,250,299,83,219,1,0,0,1,6,0,3,0,1694,3,0
충청남도,당진시,송산면,송산면제1투,1981,1232,451,336,272,56,98,1,1,2,0,8,2,0,2,1229,3,749
충청남도,당진시,송산면,송산면제2투,1885,1076,321,362,278,29,74,1,0,1,0,3,0,2,2,1073,3,809
충청남도,당진시,송산면,송산면제3투,3517,2280,1032,402,434,96,270,5,0,5,1,17,1,0,3,2266,14,1237
충청남도,당진시,당진2동,합계,13938,9888,4053,2212,2143,505,833,11,1,50,3,23,3,1,10,9848,40,4050
충청남도,당진시,당진2동,관내사전투표,2772,2772,1316,461,523,155,282,2,0,7,1,2,1,0,5,2755,17,0
충청남도,당진시,당진2동,당진2동제1투,573,374,88,156,100,12,15,0,0,1,0,0,0,1,1,374,0,199
충청남도,당진시,당진2동,당진2동제2투,2811,1700,563,534,372,75,132,1,0,6,1,8,1,0,2,1695,5,1111
충청남도,당진시,당진2동,당진2동제3투,1609,1005,373,271,236,40,73,1,0,5,0,4,0,0,1,1004,1,604
충청남도,당진시,당진2동,당진2동제4투,3052,2175,1001,377,475,114,192,1,1,3,0,3,0,0,0,2167,8,877
충청남도,당진시,당진2동,당진2동제5투,3121,1862,712,413,437,109,139,6,0,28,1,6,1,0,1,1853,9,1259
충청남도,당진시,당진3동,합계,12597,9662,4437,1616,1970,618,919,15,3,22,2,20,1,6,9,9638,24,2935
충청남도,당진시,당진3동,관내사전투표,3176,3176,1718,377,534,192,326,4,2,7,0,4,0,0,3,3167,9,0
충청남도,당진시,당진3동,당진3동제1투,3536,2391,969,473,537,177,213,3,0,4,1,3,1,1,1,2383,8,1145
충청남도,당진시,당진3동,당진3동제2투,2309,1648,734,291,342,94,161,6,1,4,0,8,0,2,2,1645,3,661
충청남도,당진시,당진3동,당진3동제3투,1510,1125,505,203,250,63,93,1,0,4,0,3,0,1,0,1123,2,385
충청남도,당진시,당진3동,당진3동제4투,2066,1322,511,272,307,92,126,1,0,3,1,2,0,2,3,1320,2,744
충청남도,당진시,잘못 투입·구분된 투표지,,0,0,0,0,0,0,0,0,0,0,0,0,0,0,0,0,0,0
충청남도,부여군,합계,,61041,43288,13492,13761,11022,1881,2382,52,18,33,23,76,66,90,106,43002,286,17753
충청남도,부여군,거소·선상투표,,255,237,71,45,78,10,10,2,0,1,3,2,0,3,1,226,11,18
충청남도,부여군,관외사전투표,,4750,4750,2163,691,960,381,473,10,2,1,3,9,1,2,7,4703,47,0
충청남도,부여군,재외투표,,268,174,101,18,32,8,15,0,0,0,0,0,0,0,0,174,0,94
충청남도,부여군,부여읍,관내사전투표,3583,3583,1541,808,704,207,282,3,1,1,0,5,4,2,4,3562,21,0
충청남도,부여군,부여읍,합계,17752,12486,4076,4062,2882,572,734,12,4,11,3,19,16,16,15,12422,64,5266
충청남도,부여군,부여읍,부여읍제1투,1774,1028,309,371,239,43,53,2,0,0,0,3,0,1,0,1021,7,746
충청남도,부여군,부여읍,부여읍제2투,1423,910,233,378,209,34,43,1,1,2,1,0,2,1,0,905,5,513
충청남도,부여군,부여읍,부여읍제3투,1469,934,244,379,239,28,29,1,1,2,0,2,2,0,3,930,4,535
충청남도,부여군,부여읍,부여읍제4투,1226,808,207,317,209,39,32,0,0,0,0,1,1,0,1,807,1,418
충청남도,부여군,부여읍,부여읍제5투,2447,1622,506,549,386,69,97,2,1,1,0,3,1,2,1,1618,4,825
충청남도,부여군,부여읍,부여읍제6투,1570,1058,369,273,279,62,67,0,0,2,0,1,1,1,1,1056,2,512
충청남도,부여군,부여읍,부여읍제7투,1487,852,216,338,202,30,46,1,0,1,0,4,2,5,1,846,6,635
충청남도,부여군,부여읍,부여읍제8투,1196,722,151,338,164,22,32,1,0,1,2,0,3,2,2,718,4,474
충청남도,부여군,부여읍,부여읍제9투,1577,969,300,311,251,38,53,1,0,1,0,0,0,2,2,959,10,608
충청남도,부여군,규암면,관내사전투표,1026,1026,355,283,246,45,74,3,0,1,0,2,2,6,5,1022,4,0
충청남도,부여군,규암면,합계,7630,5005,1480,1678,1274,217,291,6,1,4,2,4,7,12,9,4985,20,2625
충청남도,부여군,규암면,규암면제1투,1508,844,193,365,208,30,43,0,0,0,0,0,0,0,1,840,4,664
충청남도,부여군,규암면,규암면제2투,2571,1510,489,453,397,71,86,3,0,1,0,0,0,2,2,1504,6,1061
충청남도,부여군,규암면,규암면제3투,1433,931,271,283,267,38,56,0,1,1,2,1,4,2,1,927,4,502
충청남도,부여군,규암면,규암면제4투,1092,694,172,294,156,33,32,0,0,1,0,1,1,2,0,692,2,398
충청남도,부여군,은산면,관내사전투표,671,671,183,248,173,14,35,3,0,3,0,1,4,2,1,667,4,0
충청남도,부여군,은산면,합계,3448,2293,528,929,610,78,99,3,0,3,0,4,6,7,9,2276,17,1155
충청남도,부여군,은산면,은산면제1투,1504,855,193,366,203,39,38,0,0,0,0,2,0,2,5,848,7,649
충청남도,부여군,은산면,은산면제2투,634,399,94,146,125,14,10,0,0,0,0,1,2,1,2,395,4,235
충청남도,부여군,은산면,은산면제3투,639,368,58,169,109,11,16,0,0,0,0,0,0,2,1,366,2,271
충청남도,부여군,외산면,합계,2192,1614,456,533,469,66,49,2,4,3,3,2,4,7,4,1602,12,578
충청남도,부여군,외산면,관내사전투표,516,516,165,154,147,16,20,0,2,0,2,2,1,3,0,512,4,0
충청남도,부여군,외산면,외산면투표소,1676,1098,291,379,322,50,29,2,2,3,1,0,3,4,4,1090,8,578
충청남도,부여군,내산면,합계,1482,1073,248,418,310,36,44,0,0,3,1,1,3,1,4,1069,4,409
충청남도,부여군,내산면,관내사전투표,251,251,74,71,79,12,13,0,0,1,1,0,0,0,0,251,0,0
충청남도,부여군,내산면,내산면투표소,1231,822,174,347,231,24,31,0,0,2,0,1,3,1,4,818,4,409
충청남도,부여군,구룡면,합계,2149,1426,427,448,417,43,57,2,1,1,0,3,4,6,7,1416,10,723
충청남도,부여군,구룡면,관내사전투표,294,294,106,85,78,8,15,1,0,0,0,0,0,1,0,294,0,0
충청남도,부여군,구룡면,구룡면제1투,1268,748,208,249,238,15,20,1,1,1,0,2,3,2,2,742,6,520
충청남도,부여군,구룡면,구룡면제2투,587,384,113,114,101,20,22,0,0,0,0,1,1,3,5,380,4,203
충청남도,부여군,홍산면,합계,2621,1843,492,652,506,71,85,2,1,0,1,8,3,1,4,1826,17,778
충청남도,부여군,홍산면,관내사전투표,545,545,179,187,129,18,20,1,0,0,0,3,0,1,1,539,6,0
충청남도,부여군,홍산면,홍산면제1투,1520,927,222,334,264,38,55,0,1,0,1,0,1,0,2,918,9,593
충청남도,부여군,홍산면,홍산면제2투,556,371,91,131,113,15,10,1,0,0,0,5,2,0,1,369,2,185
충청남도,부여군,옥산면,관내사전투표,218,218,67,65,52,13,16,1,0,0,0,0,0,1,1,216,2,0
충청남도,부여군,옥산면,합계,1296,906,220,323,265,31,40,2,1,0,0,4,4,5,6,901,5,390
충청남도,부여군,옥산면,옥산면투표소,1078,688,153,258,213,18,24,1,1,0,0,4,4,4,5,685,3,390
충청남도,부여군,남면,합계,1734,1174,338,382,354,39,39,1,0,0,0,2,2,2,5,1164,10,560
충청남도,부여군,남면,관내사전투표,297,297,107,96,68,12,7,0,0,0,0,0,1,0,2,293,4,0
충청남도,부여군,남면,남면투표소,1437,877,231,286,286,27,32,1,0,0,0,2,1,2,3,871,6,560
충청남도,부여군,충화면,관내사전투표,163,163,64,57,29,4,7,0,0,0,0,0,0,0,0,161,2,0
충청남도,부여군,충화면,합계,1061,734,189,296,190,20,28,1,0,0,0,0,0,0,2,726,8,327
충청남도,부여군,충화면,충화면투표소,898,571,125,239,161,16,21,1,0,0,0,0,0,0,2,565,6,327
충청남도,부여군,양화면,관내사전투표,222,222,66,74,56,12,8,4,0,0,0,0,0,1,0,221,1,0
충청남도,부여군,양화면,합계,1618,1117,289,417,307,35,43,5,1,0,0,2,2,7,1,1109,8,501
충청남도,부여군,양화면,양화면제1투,572,357,66,151,110,10,13,1,0,0,0,2,1,1,0,355,2,215
충청남도,부여군,양화면,양화면제2투,824,538,157,192,141,13,22,0,1,0,0,0,1,5,1,533,5,286
충청남도,부여군,임천면,합계,2616,1760,441,644,510,65,74,2,1,1,3,2,2,5,2,1752,8,856
충청남도,부여군,임천면,관내사전투표,443,442,142,148,111,22,16,0,0,0,0,0,0,1,1,441,1,1
충청남도,부여군,임천면,임천면제1투,1303,796,175,292,251,30,34,1,0,0,3,1,1,2,1,791,5,507
충청남도,부여군,임천면,임천면제2투,870,522,124,204,148,13,24,1,1,1,0,1,1,2,0,520,2,348
충청남도,부여군,장암면,관내사전투표,403,403,134,111,118,12,22,0,0,0,0,1,1,0,2,401,2,0
충청남도,부여군,장암면,합계,2577,1669,443,583,491,46,74,1,1,0,2,2,3,5,4,1655,14,908
충청남도,부여군,장암면,장암면제1투,500,275,68,100,80,9,11,0,1,0,0,0,1,0,0,270,5,225
충청남도,부여군,장암면,장암면제2투,790,444,107,184,124,8,12,0,0,0,0,0,1,1,2,439,5,346
충청남도,부여군,장암면,장암면제3투,884,547,134,188,169,17,29,1,0,0,2,1,0,4,0,545,2,337
충청남도,부여군,세도면,관내사전투표,432,432,120,136,132,16,23,1,0,0,0,0,1,1,1,431,1,0
충청남도,부여군,세도면,합계,2973,1924,602,579,574,60,83,1,0,1,1,0,5,1,8,1915,9,1049
충청남도,부여군,세도면,세도면제1투,1225,691,191,218,224,15,31,0,0,1,1,0,4,0,4,689,2,534
충청남도,부여군,세도면,세도면제2투,1316,801,291,225,218,29,29,0,0,0,0,0,0,0,3,795,6,515
충청남도,부여군,석성면,관내사전투표,386,386,151,107,86,10,24,0,0,0,0,1,0,1,4,384,2,0
충청남도,부여군,석성면,합계,2644,1774,541,612,453,57,78,0,1,3,1,3,0,5,9,1763,11,870
충청남도,부여군,석성면,석성면제1투,1386,831,219,334,202,23,40,0,0,2,1,1,0,3,2,827,4,555
충청남도,부여군,석성면,석성면제2투,872,557,171,171,165,24,14,0,1,1,0,1,0,1,3,552,5,315
충청남도,부여군,초촌면,관내사전투표,272,272,81,80,70,12,22,0,0,1,0,1,3,1,0,271,1,0
충청남도,부여군,초촌면,합계,1975,1329,387,451,340,46,66,0,0,1,0,9,4,5,9,1318,11,646
충청남도,부여군,초촌면,초촌면제1투,1082,645,190,212,174,19,29,0,0,0,0,6,0,3,5,638,7,437
충청남도,부여군,초촌면,초촌면제2투,621,412,116,159,96,15,15,0,0,0,0,2,1,1,4,409,3,209
충청남도,부여군,잘못 투입·구분된 투표지,,0,0,0,0,0,0,0,0,0,0,0,0,0,0,0,0,0,0
충청남도,서천군,합계,,48975,34889,12554,9891,8744,1551,1647,37,9,47,10,44,37,43,64,34678,211,14086
충청남도,서천군,거소·선상투표,,118,102,35,21,31,5,3,0,1,0,0,0,0,0,1,97,5,16
충청남도,서천군,관외사전투표,,3619,3619,1761,509,695,282,322,3,0,1,2,4,1,2,9,3591,28,0
충청남도,서천군,재외투표,,202,142,82,16,27,2,15,0,0,0,0,0,0,0,0,142,0,60
충청남도,서천군,장항읍,합계,9478,6395,2270,1736,1703,322,306,3,0,11,2,1,5,4,9,6372,23,3083
충청남도,서천군,장항읍,관내사전투표,1543,1543,732,304,311,82,102,2,0,0,0,0,0,1,3,1537,6,0
충청남도,서천군,장항읍,장항읍제1투,1615,958,252,326,294,44,35,0,0,1,0,0,1,1,0,954,4,657
충청남도,서천군,장항읍,장항읍제2투,2338,1416,489,359,410,72,71,0,0,0,1,1,2,2,4,1411,5,922
충청남도,서천군,장항읍,장항읍제3투,2285,1425,446,448,392,75,51,0,0,6,0,0,2,0,1,1421,4,860
충청남도,서천군,장항읍,장항읍제4투,1697,1053,351,299,296,49,47,1,0,4,1,0,0,0,1,1049,4,644
충청남도,서천군,서천읍,합계,10823,7794,3016,2192,1770,370,364,8,1,7,0,10,3,5,8,7754,40,3029
충청남도,서천군,서천읍,관내사전투표,2590,2590,1194,565,487,150,175,1,1,2,0,5,0,0,2,2582,8,0
충청남도,서천군,서천읍,서천읍제1투,1749,1028,314,360,273,36,35,1,0,0,0,1,0,0,2,1022,6,721
충청남도,서천군,서천읍,서천읍제2투,1388,803,274,246,209,27,30,5,0,2,0,0,0,2,1,796,7,585
충청남도,서천군,서천읍,서천읍제3투,1492,933,268,366,230,29,27,1,0,0,0,0,2,1,2,926,7,559
충청남도,서천군,서천읍,서천읍제4투,1404,943,366,252,237,44,35,0,0,0,0,0,1,1,0,936,7,461
충청남도,서천군,서천읍,서천읍제5투,2200,1497,600,403,334,84,62,0,0,3,0,4,0,1,1,1492,5,703
충청남도,서천군,마서면,합계,4411,2904,1025,806,800,103,127,1,1,3,1,7,4,2,4,2884,20,1507
충청남도,서천군,마서면,관내사전투표,539,539,230,131,112,18,37,0,0,1,1,2,1,0,1,534,5,0
충청남도,서천군,마서면,마서면제1투,1218,746,259,214,210,21,29,1,1,1,0,3,2,1,0,742,4,472
충청남도,서천군,마서면,마서면제2투,1262,726,236,218,207,32,19,0,0,1,0,2,1,1,2,719,7,536
충청남도,서천군,마서면,마서면제3투,1392,893,300,243,271,32,42,0,0,0,0,0,0,0,1,889,4,499
충청남도,서천군,화양면,합계,2129,1467,486,481,387,41,46,1,0,3,1,3,3,3,5,1460,7,662
충청남도,서천군,화양면,관내사전투표,367,367,148,98,89,13,11,1,0,1,0,1,1,0,1,364,3,0
충청남도,서천군,화양면,화양면제1투,1041,636,192,222,176,20,18,0,0,0,1,2,0,1,2,634,2,405
충청남도,서천군,화양면,화양면제2투,721,464,146,161,122,8,17,0,0,2,0,0,2,2,2,462,2,257
충청남도,서천군,기산면,합계,1553,1101,352,405,246,38,47,0,0,2,0,3,0,2,1,1096,5,452
충청남도,서천군,기산면,관내사전투표,346,346,129,102,78,10,23,0,0,2,0,0,0,1,0,345,1,0
충청남도,서천군,기산면,기산면투표소,1207,755,223,303,168,28,24,0,0,0,0,3,0,1,1,751,4,452
충청남도,서천군,한산면,관내사전투표,517,517,199,146,127,16,20,2,0,1,0,0,0,2,0,513,4,0
충청남도,서천군,한산면,합계,2384,1674,568,496,447,66,64,4,1,5,1,0,3,4,4,1663,11,710
충청남도,서천군,한산면,한산면투표소,1867,1157,369,350,320,50,44,2,1,4,1,0,3,2,4,1150,7,710
충청남도,서천군,마산면,합계,1339,933,336,285,234,27,29,2,1,1,1,5,3,1,6,931,2,406
충청남도,서천군,마산면,관내사전투표,263,263,102,83,57,7,7,2,1,0,0,1,1,0,2,263,0,0
충청남도,서천군,마산면,마산면투표소,1076,670,234,202,177,20,22,0,0,1,1,4,2,1,4,668,2,406
충청남도,서천군,시초면,관내사전투표,225,225,64,72,65,7,14,0,0,1,0,0,1,0,1,225,0,0
충청남도,서천군,시초면,합계,1159,799,220,272,236,19,32,2,2,1,0,1,5,3,2,795,4,360
충청남도,서천군,시초면,시초면투표소,934,574,156,200,171,12,18,2,2,0,0,1,4,3,1,570,4,360
충청남도,서천군,문산면,관내사전투표,215,215,71,58,70,10,3,0,0,0,0,1,0,0,0,213,2,0
충청남도,서천군,문산면,합계,1192,830,229,291,252,21,19,1,0,0,0,1,2,1,2,819,11,362
충청남도,서천군,문산면,문산면투표소,977,615,158,233,182,11,16,1,0,0,0,0,2,1,2,606,9,362
충청남도,서천군,판교면,합계,2031,1504,375,606,400,45,53,0,0,0,1,1,2,3,5,1491,13,527
충청남도,서천군,판교면,관내사전투표,480,480,143,171,111,18,29,0,0,0,0,0,1,0,1,474,6,0
충청남도,서천군,판교면,판교면투표소,1551,1024,232,435,289,27,24,0,0,0,1,1,1,3,4,1017,7,527
충청남도,서천군,종천면,관내사전투표,296,296,130,89,54,5,15,1,0,0,0,0,0,0,0,294,2,0
충청남도,서천군,종천면,합계,1888,1278,414,452,312,35,41,3,0,3,0,3,2,4,1,1270,8,610
충청남도,서천군,종천면,종천면제1투,756,451,146,152,115,17,13,1,0,2,0,0,2,1,0,449,2,305
충청남도,서천군,종천면,종천면제2투,836,531,138,211,143,13,13,1,0,1,0,3,0,3,1,527,4,305
충청남도,서천군,비인면,관내사전투표,467,467,172,119,112,22,31,1,0,2,0,3,1,0,1,464,3,0
충청남도,서천군,비인면,합계,2844,1898,582,571,534,85,88,5,1,6,1,3,1,2,3,1882,16,946
충청남도,서천군,비인면,비인면제1투,1547,963,244,333,291,39,38,2,0,3,1,0,0,1,2,954,9,584
충청남도,서천군,비인면,비인면제2투,830,468,166,119,131,24,19,2,1,1,0,0,0,1,0,464,4,362
충청남도,서천군,서면,합계,3805,2449,803,752,670,90,91,4,1,4,0,2,3,7,4,2431,18,1356
충청남도,서천군,서면,관내사전투표,553,553,198,153,146,24,25,1,0,1,0,2,0,0,1,551,2,0
충청남도,서천군,서면,서면제1투,1244,730,189,268,205,28,23,1,0,1,0,0,2,4,1,722,8,514
충청남도,서천군,서면,서면제2투,2008,1166,416,331,319,38,43,2,1,2,0,0,1,3,2,1158,8,842
충청남도,서천군,잘못 투입·구분된 투표지,,0,0,0,0,0,0,0,0,0,0,0,0,0,0,0,0,0,0
충청남도,홍성군,합계,,82972,59645,21021,16682,14251,3133,3845,61,18,50,17,39,57,77,74,59325,320,23327
충청남도,홍성군,거소·선상투표,,258,240,78,46,66,16,9,3,2,0,0,0,5,2,5,232,8,18
충청남도,홍성군,관외사전투표,,6609,6609,3028,988,1321,526,654,7,0,3,0,10,6,2,7,6552,57,0
충청남도,홍성군,재외투표,,287,221,131,15,32,10,30,0,0,0,0,0,1,0,1,220,1,66
충청남도,홍성군,홍성읍,관내사전투표,5172,5172,2325,1054,979,325,441,0,3,5,4,1,1,3,9,5150,22,0
충청남도,홍성군,홍성읍,합계,29367,19750,7083,5525,4590,1078,1299,16,10,18,6,11,11,9,16,19672,78,9617
충청남도,홍성군,홍성읍,홍성읍제1투,2413,1519,410,578,377,72,73,0,0,2,0,3,0,0,0,1515,4,894
충청남도,홍성군,홍성읍,홍성읍제2투,2576,1704,557,511,437,102,87,1,2,1,0,1,0,0,1,1700,4,872
충청남도,홍성군,홍성읍,홍성읍제3투,3290,1953,750,458,497,101,135,1,0,1,1,0,0,1,2,1947,6,1337
충청남도,홍성군,홍성읍,홍성읍제4투,2067,1165,352,418,265,54,65,1,1,2,0,1,2,2,0,1163,2,902
충청남도,홍성군,홍성읍,홍성읍제5투,3347,1943,638,659,411,110,105,6,1,1,0,1,2,1,0,1935,8,1404
충청남도,홍성군,홍성읍,홍성읍제6투,3185,1885,498,734,492,69,69,0,2,2,1,3,1,1,1,1873,12,1300
충청남도,홍성군,홍성읍,홍성읍제7투,3225,1982,687,507,531,118,119,5,1,2,0,1,4,0,0,1975,7,1243
충청남도,홍성군,홍성읍,홍성읍제8투,4092,2427,866,606,601,127,205,2,0,2,0,0,1,1,3,2414,13,1665
충청남도,홍성군,광천읍,관내사전투표,1573,1573,382,622,384,69,102,0,0,0,0,1,1,2,3,1566,7,0
충청남도,홍성군,광천읍,합계,8225,5448,1301,2223,1393,219,240,5,0,4,2,3,4,12,7,5413,35,2777
충청남도,홍성군,광천읍,광천읍제1투,2075,1151,270,520,279,32,33,4,0,3,2,0,0,0,2,1145,6,924
충청남도,홍성군,광천읍,광천읍제2투,2445,1490,380,590,393,57,47,0,0,1,0,0,1,6,0,1475,15,955
충청남도,홍성군,광천읍,광천읍제3투,2132,1234,269,491,337,61,58,1,0,0,0,2,2,4,2,1227,7,898
충청남도,홍성군,홍북면,관내사전투표,3679,3678,1915,473,718,235,313,3,1,3,0,1,0,1,2,3665,13,1
충청남도,홍성군,홍북면,합계,15777,11987,5419,2092,2740,755,912,7,2,5,3,3,6,9,11,11964,23,3790
충청남도,홍성군,홍북면,홍북면제1투,1355,868,254,306,214,42,37,2,0,1,2,0,2,2,3,865,3,487
충청남도,홍성군,홍북면,홍북면제2투,872,573,158,201,171,17,22,0,1,0,0,0,1,1,0,572,1,299
충청남도,홍성군,홍북면,홍북면제3투,810,522,112,195,163,25,23,0,0,1,0,0,1,0,2,522,0,288
충청남도,홍성군,홍북면,홍북면제4투,1919,1204,529,190,291,87,105,0,0,0,0,1,0,0,0,1203,1,715
충청남도,홍성군,홍북면,홍북면제5투,2097,1553,764,225,334,108,116,2,0,0,0,0,0,2,1,1552,1,544
충청남도,홍성군,홍북면,홍북면제6투,2007,1446,703,182,336,106,115,0,0,0,1,0,1,1,0,1445,1,561
충청남도,홍성군,홍북면,홍북면제7투,3038,2143,984,320,513,135,181,0,0,0,0,1,1,2,3,2140,3,895
충청남도,홍성군,금마면,합계,3120,2139,557,739,627,67,107,4,2,5,0,2,5,6,1,2122,17,981
충청남도,홍성군,금마면,관내사전투표,385,385,142,106,89,11,29,2,0,0,0,0,1,1,0,381,4,0
충청남도,홍성군,금마면,금마면제1투,814,545,137,182,177,17,20,0,0,3,0,0,3,2,0,541,4,269
충청남도,홍성군,금마면,금마면제2투,860,529,115,202,162,20,21,1,1,1,0,1,0,1,1,526,3,331
충청남도,홍성군,금마면,금마면제3투,1061,680,163,249,199,19,37,1,1,1,0,1,1,2,0,674,6,381
충청남도,홍성군,홍동면,합계,2940,2094,717,593,530,72,163,1,0,1,1,1,3,2,2,2086,8,846
충청남도,홍성군,홍동면,관내사전투표,389,389,192,58,67,19,51,0,0,0,0,0,0,0,1,388,1,0
충청남도,홍성군,홍동면,홍동면제1투,927,605,215,159,151,22,52,1,0,0,0,1,1,1,1,604,1,322
충청남도,홍성군,홍동면,홍동면제2투,693,488,158,130,141,13,40,0,0,0,0,0,1,1,0,484,4,205
충청남도,홍성군,홍동면,홍동면제3투,931,612,152,246,171,18,20,0,0,1,1,0,1,0,0,610,2,319
충청남도,홍성군,장곡면,합계,2647,1770,423,699,471,66,83,9,1,1,0,0,2,7,1,1763,7,877
충청남도,홍성군,장곡면,관내사전투표,309,309,104,101,61,19,23,0,1,0,0,0,0,0,0,309,0,0
충청남도,홍성군,장곡면,장곡면제1투,1084,641,141,267,165,23,31,8,0,0,0,0,1,1,0,637,4,443
충청남도,홍성군,장곡면,장곡면제2투,433,277,62,102,86,11,9,0,0,1,0,0,0,4,0,275,2,156
충청남도,홍성군,장곡면,장곡면제3투,821,543,116,229,159,13,20,1,0,0,0,0,1,2,1,542,1,278
충청남도,홍성군,은하면,합계,2200,1425,307,631,368,43,51,1,0,2,1,1,2,4,4,1415,10,775
충청남도,홍성군,은하면,관내사전투표,226,226,65,77,53,15,12,1,0,0,0,0,1,0,0,224,2,0
충청남도,홍성군,은하면,은하면제1투,1392,839,200,342,240,17,25,0,0,1,1,1,1,4,3,835,4,553
충청남도,홍성군,은하면,은하면제2투,582,360,42,212,75,11,14,0,0,1,0,0,0,0,1,356,4,222
충청남도,홍성군,결성면,합계,2024,1478,335,612,380,47,53,0,0,5,2,5,2,6,6,1453,25,546
충청남도,홍성군,결성면,관내사전투표,375,375,103,135,86,9,21,0,0,2,2,0,0,4,2,364,11,0
충청남도,홍성군,결성면,결성면제1투,623,412,82,193,95,16,14,0,0,1,0,4,0,2,2,409,3,211
충청남도,홍성군,결성면,결성면제2투,456,315,70,111,105,14,7,0,0,1,0,0,1,0,1,310,5,141
충청남도,홍성군,결성면,결성면제3투,570,376,80,173,94,8,11,0,0,1,0,1,1,0,1,370,6,194
충청남도,홍성군,서부면,합계,2961,2001,448,876,501,68,70,4,0,1,0,2,5,6,1,1982,19,960
충청남도,홍성군,서부면,관내사전투표,464,464,125,181,108,21,22,2,0,0,0,0,0,2,0,461,3,0
충청남도,홍성군,서부면,서부면제1투,1256,758,161,330,194,33,22,0,0,1,0,2,2,3,1,749,9,498
충청남도,홍성군,서부면,서부면제2투,1241,779,162,365,199,14,26,2,0,0,0,0,3,1,0,772,7,462
충청남도,홍성군,갈산면,합계,3293,2285,538,945,609,80,79,1,1,1,2,1,4,9,4,2274,11,1008
충청남도,홍성군,갈산면,관내사전투표,567,567,164,214,141,18,20,0,0,1,1,0,1,2,1,563,4,0
충청남도,홍성군,갈산면,갈산면제1투,1761,1091,238,472,289,39,41,0,1,0,0,1,1,4,3,1089,2,670
충청남도,홍성군,갈산면,갈산면제2투,386,262,63,121,57,8,10,0,0,0,1,0,0,0,0,260,2,124
충청남도,홍성군,갈산면,갈산면제3투,579,365,73,138,122,15,8,1,0,0,0,0,2,3,0,362,3,214
충청남도,홍성군,구항면,합계,3264,2198,656,698,623,86,95,3,0,4,0,0,1,3,8,2177,21,1066
충청남도,홍성군,구항면,관내사전투표,392,392,165,89,103,14,18,0,0,0,0,0,1,0,1,391,1,0
충청남도,홍성군,구항면,구항면제1투,1657,1068,279,345,326,45,48,2,0,3,0,0,0,3,3,1054,14,589
충청남도,홍성군,구항면,구항면제2투,1215,738,212,264,194,27,29,1,0,1,0,0,0,0,4,732,6,477
충청남도,홍성군,잘못 투입·구분된 투표지,,0,0,0,0,0,0,0,0,0,0,0,0,0,0,0,0,0,0
충청남도,청양군,합계,,28528,20667,6185,7104,5140,826,1080,28,7,22,11,15,24,48,42,20532,135,7861
충청남도,청양군,거소·선상투표,,110,89,22,18,32,2,3,1,0,0,1,0,0,1,0,80,9,21
충청남도,청양군,관외사전투표,,2522,2522,1128,448,507,189,219,4,0,2,0,1,0,1,5,2504,18,0
충청남도,청양군,재외투표,,95,70,37,3,18,3,9,0,0,0,0,0,0,0,0,70,0,25
충청남도,청양군,청양읍,합계,7806,5503,1681,1950,1234,263,303,4,0,8,3,3,3,6,10,5468,35,2303
충청남도,청양군,청양읍,관내사전투표,1548,1548,644,349,307,98,125,0,0,3,1,2,2,2,3,1536,12,0
충청남도,청양군,청양읍,청양읍제1투,1307,811,177,350,208,28,37,4,0,0,1,0,0,3,0,808,3,496
충청남도,청양군,청양읍,청양읍제2투,2365,1543,471,534,361,73,87,0,0,2,0,1,0,1,2,1532,11,822
충청남도,청양군,청양읍,청양읍제3투,1265,763,171,358,179,25,22,0,0,1,0,0,0,0,2,758,5,502
충청남도,청양군,청양읍,청양읍제4투,1321,838,218,359,179,39,32,0,0,2,1,0,1,0,3,834,4,483
충청남도,청양군,운곡면,합계,1881,1295,284,599,299,29,53,6,1,1,1,2,5,5,2,1287,8,586
충청남도,청양군,운곡면,관내사전투표,336,336,99,133,65,12,16,6,0,1,0,1,0,2,1,336,0,0
충청남도,청양군,운곡면,운곡면투표소,1545,959,185,466,234,17,37,0,1,0,1,1,5,3,1,951,8,586
충청남도,청양군,대치면,관내사전투표,278,278,85,90,71,17,12,0,1,0,0,0,1,0,1,278,0,0
충청남도,청양군,대치면,합계,1918,1325,329,508,380,45,48,3,2,0,2,1,2,0,2,1322,3,593
충청남도,청양군,대치면,대치면제1투,885,544,135,225,147,9,20,3,1,0,1,1,0,0,1,543,1,341
충청남도,청양군,대치면,대치면제2투,755,503,109,193,162,19,16,0,0,0,1,0,1,0,0,501,2,252
충청남도,청양군,정산면,합계,2967,2054,590,727,495,73,141,3,1,3,1,1,1,2,3,2041,13,913
충청남도,청양군,정산면,관내사전투표,606,606,213,206,101,20,60,0,1,1,0,0,0,0,1,603,3,0
충청남도,청양군,정산면,정산면제1투,1288,799,193,300,206,40,48,2,0,1,1,1,1,0,2,795,4,489
충청남도,청양군,정산면,정산면제2투,1073,649,184,221,188,13,33,1,0,1,0,0,0,2,0,643,6,424
충청남도,청양군,목면,합계,1272,901,257,279,271,29,45,1,0,0,0,0,5,6,3,896,5,371
충청남도,청양군,목면,관내사전투표,174,174,64,38,50,6,10,1,0,0,0,0,1,4,0,174,0,0
충청남도,청양군,목면,목면제1투,590,386,101,130,116,13,19,0,0,0,0,0,1,2,1,383,3,204
충청남도,청양군,목면,목면제2투,508,341,92,111,105,10,16,0,0,0,0,0,3,0,2,339,2,167
충청남도,청양군,청남면,합계,1687,1117,305,448,275,28,47,0,0,2,0,1,1,4,2,1113,4,570
충청남도,청양군,청남면,관내사전투표,259,259,103,80,52,6,16,0,0,0,0,0,0,0,1,258,1,0
충청남도,청양군,청남면,청남면투표소,1428,858,202,368,223,22,31,0,0,2,0,1,1,4,1,855,3,570
충청남도,청양군,장평면,관내사전투표,271,271,98,71,73,7,14,0,0,1,0,0,0,0,3,267,4,0
충청남도,청양군,장평면,합계,2081,1448,410,466,447,44,59,1,1,2,0,2,1,2,7,1442,6,633
충청남도,청양군,장평면,장평면제1투,818,518,149,164,164,15,19,1,1,0,0,2,0,1,1,517,1,300
충청남도,청양군,장평면,장평면제2투,441,303,61,115,96,13,15,0,0,0,0,0,0,1,1,302,1,138
충청남도,청양군,장평면,장평면제3투,551,356,102,116,114,9,11,0,0,1,0,0,1,0,2,356,0,195
충청남도,청양군,남양면,합계,2389,1636,436,632,417,45,68,2,0,1,1,2,1,11,5,1621,15,753
충청남도,청양군,남양면,관내사전투표,375,375,119,135,80,9,24,1,0,1,0,1,0,0,3,373,2,0
충청남도,청양군,남양면,남양면제1투,1402,857,224,326,236,22,30,0,0,0,1,1,1,6,1,848,9,545
충청남도,청양군,남양면,남양면제2투,612,404,93,171,101,14,14,1,0,0,0,0,0,5,1,400,4,208
충청남도,청양군,화성면,관내사전투표,282,282,88,101,65,18,7,2,0,0,0,0,0,0,0,281,1,0
충청남도,청양군,화성면,합계,1948,1328,346,530,343,49,39,2,0,1,1,1,3,4,1,1320,8,620
충청남도,청양군,화성면,화성면제1투,850,541,122,238,137,19,16,0,0,1,1,1,1,1,1,538,3,309
충청남도,청양군,화성면,화성면제2투,816,505,136,191,141,12,16,0,0,0,0,0,2,3,0,501,4,311
충청남도,청양군,비봉면,합계,1852,1379,360,496,422,27,46,1,2,2,1,1,2,6,2,1368,11,473
충청남도,청양군,비봉면,관내사전투표,229,229,70,67,76,7,7,0,0,0,0,0,1,0,0,228,1,0
충청남도,청양군,비봉면,비봉면제1투,1071,760,197,267,244,14,19,0,2,2,0,1,0,5,1,752,8,311
충청남도,청양군,비봉면,비봉면제2투,552,390,93,162,102,6,20,1,0,0,1,0,1,1,1,388,2,162
충청남도,청양군,잘못 투입·구분된 투표지,,0,0,0,0,0,0,0,0,0,0,0,0,0,0,0,0,0,0
충청남도,예산군,합계,,70494,49668,13880,18911,11243,2319,2693,58,16,38,16,35,31,68,79,49387,281,20826
충청남도,예산군,거소·선상투표,,161,148,38,42,41,12,3,2,1,2,0,0,1,1,1,144,4,13
충청남도,예산군,관외사전투표,,5618,5618,2388,1077,1091,482,518,5,1,2,1,6,1,2,7,5581,37,0
충청남도,예산군,재외투표,,292,210,129,17,31,6,25,0,0,0,0,0,1,0,0,209,1,82
충청남도,예산군,예산읍,합계,26457,17922,5173,6817,3829,880,1048,17,5,12,8,12,4,11,17,17833,89,8535
충청남도,예산군,예산읍,관내사전투표,4044,4044,1565,1098,791,246,308,4,1,2,1,4,2,5,1,4028,16,0
충청남도,예산군,예산읍,예산읍제1투,2528,1365,268,687,289,60,48,0,1,1,1,0,0,0,1,1356,9,1163
충청남도,예산군,예산읍,예산읍제2투,1366,851,201,395,173,42,31,1,0,2,0,0,0,1,1,847,4,515
충청남도,예산군,예산읍,예산읍제3투,1730,1160,319,483,232,48,69,1,0,1,1,1,0,0,2,1157,3,570
충청남도,예산군,예산읍,예산읍제4투,2752,1653,354,806,342,64,74,1,0,1,0,0,0,0,1,1643,10,1099
충청남도,예산군,예산읍,예산읍제5투,1774,1119,279,466,250,51,61,1,0,0,0,0,0,0,1,1109,10,655
충청남도,예산군,예산읍,예산읍제6투,2034,1254,387,428,288,56,87,0,0,1,2,2,0,0,0,1251,3,780
충청남도,예산군,예산읍,예산읍제7투,2539,1587,537,472,391,77,96,4,1,0,0,1,0,1,3,1583,4,952
충청남도,예산군,예산읍,예산읍제8투,2626,1705,572,530,364,104,119,1,0,0,2,3,0,0,2,1697,8,921
충청남도,예산군,예산읍,예산읍제9투,2049,1333,273,650,288,52,45,2,2,3,0,0,2,3,2,1322,11,716
충청남도,예산군,예산읍,예산읍제10투,3015,1851,418,802,421,80,110,2,0,1,1,1,0,1,3,1840,11,1164
충청남도,예산군,삽교읍,관내사전투표,1040,1040,294,419,210,49,58,1,0,3,0,1,1,0,2,1038,2,0
충청남도,예산군,삽교읍,합계,6202,4044,988,1724,949,159,173,7,0,5,1,3,3,5,13,4030,14,2158
충청남도,예산군,삽교읍,삽교읍제1투,1689,1002,224,445,241,43,36,2,0,1,1,1,0,1,3,998,4,687
충청남도,예산군,삽교읍,삽교읍제2투,951,524,137,211,128,16,23,1,0,0,0,1,2,3,1,523,1,427
충청남도,예산군,삽교읍,삽교읍제3투,1520,921,210,390,251,26,35,2,0,1,0,0,0,1,3,919,2,599
충청남도,예산군,삽교읍,삽교읍제4투,1002,557,123,259,119,25,21,1,0,0,0,0,0,0,4,552,5,445
충청남도,예산군,대술면,관내사전투표,349,349,106,105,88,21,24,1,0,0,0,0,2,1,0,348,1,0
충청남도,예산군,대술면,합계,2316,1578,349,679,387,68,74,1,2,2,1,0,2,2,3,1570,8,738
충청남도,예산군,대술면,대술면투표소,1967,1229,243,574,299,47,50,0,2,2,1,0,0,1,3,1222,7,738
충청남도,예산군,신양면,관내사전투표,636,636,160,234,185,12,25,0,1,0,1,1,2,2,3,626,10,0
충청남도,예산군,신양면,합계,2922,2039,450,855,557,47,85,3,2,0,1,1,5,7,7,2020,19,883
충청남도,예산군,신양면,신양면투표소,2286,1403,290,621,372,35,60,3,1,0,0,0,3,5,4,1394,9,883
충청남도,예산군,광시면,관내사전투표,475,475,112,200,110,12,34,1,0,0,0,0,0,0,1,470,5,0
충청남도,예산군,광시면,합계,2904,2016,432,938,485,53,79,1,0,1,0,0,0,6,3,1998,18,888
충청남도,예산군,광시면,광시면제1투,1732,1113,237,502,299,34,28,0,0,1,0,0,0,3,1,1105,8,619
충청남도,예산군,광시면,광시면제2투,697,428,83,236,76,7,17,0,0,0,0,0,0,3,1,423,5,269
충청남도,예산군,대흥면,관내사전투표,194,194,62,88,29,6,7,0,0,0,1,0,0,0,0,193,1,0
충청남도,예산군,대흥면,합계,1530,1060,195,552,226,32,35,3,0,0,1,0,2,4,2,1052,8,470
충청남도,예산군,대흥면,대흥면제1투,601,377,55,203,83,14,11,3,0,0,0,0,1,3,1,374,3,224
충청남도,예산군,대흥면,대흥면제2투,735,489,78,261,114,12,17,0,0,0,0,0,1,1,1,485,4,246
충청남도,예산군,응봉면,관내사전투표,408,408,139,148,89,17,14,0,0,0,0,0,0,0,0,407,1,0
충청남도,예산군,응봉면,합계,2220,1504,372,633,362,61,55,3,0,2,0,2,0,6,0,1496,8,716
충청남도,예산군,응봉면,응봉면제1투,1143,666,156,264,177,24,33,2,0,2,0,2,0,2,0,662,4,477
충청남도,예산군,응봉면,응봉면제2투,669,430,77,221,96,20,8,1,0,0,0,0,0,4,0,427,3,239
충청남도,예산군,덕산면,관내사전투표,1013,1013,309,375,229,43,46,3,0,1,1,0,0,2,2,1011,2,0
충청남도,예산군,덕산면,합계,5898,3972,1014,1621,953,167,171,6,1,2,1,1,1,11,9,3958,14,1926
충청남도,예산군,덕산면,덕산면제1투,2520,1427,358,576,358,53,68,0,0,0,0,1,0,2,5,1421,6,1093
충청남도,예산군,덕산면,덕산면제2투,1262,820,193,357,199,39,21,1,0,1,0,0,0,4,2,817,3,442
충청남도,예산군,덕산면,덕산면제3투,1103,712,154,313,167,32,36,2,1,0,0,0,1,3,0,709,3,391
충청남도,예산군,봉산면,합계,2133,1486,320,670,368,42,59,2,3,0,0,4,1,4,5,1478,8,647
충청남도,예산군,봉산면,관내사전투표,315,315,84,124,84,9,8,0,0,0,0,2,0,1,2,314,1,0
충청남도,예산군,봉산면,봉산면제1투,1274,818,172,368,205,23,36,2,1,0,0,2,0,3,2,814,4,456
충청남도,예산군,봉산면,봉산면제2투,544,353,64,178,79,10,15,0,2,0,0,0,1,0,1,350,3,191
충청남도,예산군,고덕면,관내사전투표,626,626,202,220,129,28,33,1,0,1,0,2,1,1,3,621,5,0
충청남도,예산군,고덕면,합계,4130,2832,717,1185,671,96,123,6,0,1,2,2,3,5,6,2817,15,1298
충청남도,예산군,고덕면,고덕면제1투,2098,1253,290,559,296,42,52,4,0,0,1,0,1,1,1,1247,6,845
충청남도,예산군,고덕면,고덕면제2투,753,487,105,225,113,13,23,1,0,0,0,0,1,2,1,484,3,266
충청남도,예산군,고덕면,고덕면제3투,653,466,120,181,133,13,15,0,0,0,1,0,0,1,1,465,1,187
충청남도,예산군,신암면,합계,3556,2479,666,934,623,105,118,0,1,2,0,3,6,1,5,2464,15,1077
충청남도,예산군,신암면,관내사전투표,731,731,228,238,169,40,48,0,0,0,0,0,1,0,2,726,5,0
충청남도,예산군,신암면,신암면제1투,2034,1227,296,499,310,47,58,0,1,2,0,0,3,0,3,1219,8,807
충청남도,예산군,신암면,신암면제2투,791,521,142,197,144,18,12,0,0,0,0,3,2,1,0,519,2,270
충청남도,예산군,오가면,관내사전투표,670,670,198,253,140,35,33,0,0,2,0,0,0,1,0,662,8,0
충청남도,예산군,오가면,합계,4155,2760,649,1167,670,109,127,2,0,7,0,1,1,3,1,2737,23,1395
충청남도,예산군,오가면,오가면제1투,1972,1138,247,502,283,50,46,2,0,1,0,1,0,2,0,1134,4,834
충청남도,예산군,오가면,오가면제2투,1513,952,204,412,247,24,48,0,0,4,0,0,1,0,1,941,11,561
충청남도,예산군,잘못 투입·구분된 투표지,,0,0,0,0,0,0,0,0,0,0,0,0,0,0,0,0,0,0
전라북도,합계,,,1525626,1205794,778747,40231,285467,30802,59296,451,240,1080,345,1186,499,589,2070,1201003,4791,319832
전라북도,전주시완산구,합계,,289452,236383,157637,7003,50506,6977,12678,74,40,300,36,128,44,73,160,235656,727,53069
전라북도,전주시완산구,거소·선상투표,,935,879,466,46,258,24,23,4,2,3,2,5,0,2,4,839,40,56
전라북도,전주시완산구,관외사전투표,,29336,29321,19738,811,5245,1275,2032,12,3,17,4,23,4,14,34,29212,109,15
전라북도,전주시완산구,재외투표,,1560,1263,945,27,144,17,122,3,0,0,0,0,0,0,0,1258,5,297
전라북도,전주시완산구,중앙동,합계,7640,5722,3400,265,1641,159,238,0,1,0,1,1,1,0,3,5710,12,1918
전라북도,전주시완산구,중앙동,관내사전투표,1952,1952,1247,73,480,53,94,0,0,0,0,1,1,0,1,1950,2,0
전라북도,전주시완산구,중앙동,중앙동제1투,1770,1079,644,56,309,26,42,0,0,0,0,0,0,0,1,1078,1,691
전라북도,전주시완산구,중앙동,중앙동제2투,2331,1667,909,105,522,58,63,0,1,0,1,0,0,0,1,1660,7,664
전라북도,전주시완산구,중앙동,중앙동제3투,1587,1024,600,31,330,22,39,0,0,0,0,0,0,0,0,1022,2,563
전라북도,전주시완산구,풍남동,관내사전투표,1244,1244,824,36,244,44,84,2,1,0,1,1,1,0,1,1239,5,0
전라북도,전주시완산구,풍남동,합계,4747,3551,2244,138,890,78,171,4,1,4,2,2,1,3,4,3542,9,1196
전라북도,전주시완산구,풍남동,풍남동제1투,1669,1101,666,56,303,19,49,1,0,3,0,0,0,1,1,1099,2,568
전라북도,전주시완산구,풍남동,풍남동제2투,1834,1206,754,46,343,15,38,1,0,1,1,1,0,2,2,1204,2,628
전라북도,전주시완산구,노송동,합계,9335,6800,4179,253,1868,141,301,2,1,11,3,4,4,5,6,6778,22,2535
전라북도,전주시완산구,노송동,관내사전투표,1418,1418,902,39,364,34,60,0,0,4,1,2,1,1,5,1413,5,0
전라북도,전주시완산구,노송동,노송동제1투,2137,1494,930,51,403,30,73,0,0,2,0,1,0,1,0,1491,3,643
전라북도,전주시완산구,노송동,노송동제2투,1353,945,572,45,262,18,42,0,1,0,1,0,1,1,0,943,2,408
전라북도,전주시완산구,노송동,노송동제3투,1189,781,490,25,222,11,27,1,0,1,0,0,0,0,0,777,4,408
전라북도,전주시완산구,노송동,노송동제4투,1805,1269,782,53,324,36,59,1,0,2,1,1,2,2,1,1264,5,536
전라북도,전주시완산구,노송동,노송동제5투,1433,893,503,40,293,12,40,0,0,2,0,0,0,0,0,890,3,540
전라북도,전주시완산구,완산동,합계,4727,3478,2185,135,892,84,150,2,0,11,1,2,0,1,2,3465,13,1249
전라북도,전주시완산구,완산동,관내사전투표,1126,1126,728,25,264,41,57,0,0,6,1,0,0,0,0,1122,4,0
전라북도,전주시완산구,완산동,완산동제1투,1903,1281,811,61,340,21,39,1,0,2,0,1,0,1,2,1279,2,622
전라북도,전주시완산구,완산동,완산동제2투,1698,1071,646,49,288,22,54,1,0,3,0,1,0,0,0,1064,7,627
전라북도,전주시완산구,동서학동,합계,5850,4400,2795,157,1109,88,218,2,0,3,1,3,1,1,6,4384,16,1450
전라북도,전주시완산구,동서학동,관내사전투표,1368,1368,900,45,303,36,75,2,0,0,0,0,0,0,0,1361,7,0
전라북도,전주시완산구,동서학동,동서학동제1투,1966,1365,864,56,340,29,67,0,0,1,1,0,1,0,1,1360,5,601
전라북도,전주시완산구,동서학동,동서학동제2투,1010,636,372,22,194,9,33,0,0,2,0,1,0,0,2,635,1,374
전라북도,전주시완산구,동서학동,동서학동제3투,1506,1031,659,34,272,14,43,0,0,0,0,2,0,1,3,1028,3,475
전라북도,전주시완산구,서서학동,합계,7872,5980,3880,183,1479,121,276,2,3,9,1,3,1,1,5,5964,16,1892
전라북도,전주시완산구,서서학동,관내사전투표,1748,1748,1144,52,435,33,74,0,1,4,0,0,1,0,0,1744,4,0
전라북도,전주시완산구,서서학동,서서학동제1투,1950,1295,806,48,346,33,54,1,0,1,0,1,0,0,2,1292,3,655
전라북도,전주시완산구,서서학동,서서학동제2투,2208,1554,1025,46,382,24,66,1,0,1,1,1,0,1,2,1550,4,654
전라북도,전주시완산구,서서학동,서서학동제3투,1966,1383,905,37,316,31,82,0,2,3,0,1,0,0,1,1378,5,583
전라북도,전주시완산구,중화산1동,합계,12051,9779,6422,394,2187,251,471,3,1,7,3,6,2,3,3,9753,26,2272
전라북도,전주시완산구,중화산1동,관내사전투표,3480,3480,2397,101,710,91,170,0,0,1,2,2,0,1,0,3475,5,0
전라북도,전주시완산구,중화산1동,중화산1동제1투,2973,2152,1426,84,491,37,101,0,1,2,0,3,0,0,2,2147,5,821
전라북도,전주시완산구,중화산1동,중화산1동제2투,2851,2096,1367,85,455,70,104,3,0,2,0,0,1,2,0,2089,7,755
전라북도,전주시완산구,중화산1동,중화산1동제3투,2747,2051,1232,124,531,53,96,0,0,2,1,1,1,0,1,2042,9,696
전라북도,전주시완산구,중화산2동,관내사전투표,3252,3252,2297,79,597,102,167,0,1,1,0,2,0,2,1,3249,3,0
전라북도,전주시완산구,중화산2동,합계,13689,10604,7105,318,2263,306,562,3,1,8,0,7,1,5,5,10584,20,3085
전라북도,전주시완산구,중화산2동,중화산2동제1투,2646,2174,1418,75,513,62,93,2,0,2,0,3,0,1,2,2171,3,472
전라북도,전주시완산구,중화산2동,중화산2동제2투,3035,1789,1131,64,419,51,106,1,0,2,0,2,1,2,0,1779,10,1246
전라북도,전주시완산구,중화산2동,중화산2동제3투,2550,1746,1145,52,384,45,115,0,0,2,0,0,0,0,2,1745,1,804
전라북도,전주시완산구,중화산2동,중화산2동제4투,2206,1643,1114,48,350,46,81,0,0,1,0,0,0,0,0,1640,3,563
전라북도,전주시완산구,평화1동,관내사전투표,3221,3221,2117,101,735,71,140,2,2,5,3,2,3,3,9,3193,28,0
전라북도,전주시완산구,평화1동,합계,11371,8562,5598,281,2015,202,357,7,2,16,3,4,6,6,19,8516,46,2809
전라북도,전주시완산구,평화1동,평화1동제1투,2877,1857,1178,66,499,43,60,0,0,2,0,0,1,0,2,1851,6,1020
전라북도,전주시완산구,평화1동,평화1동제2투,2441,1460,944,54,369,25,48,0,0,3,0,0,2,2,5,1452,8,981
전라북도,전주시완산구,평화1동,평화1동제3투,2832,2024,1359,60,412,63,109,5,0,6,0,2,0,1,3,2020,4,808
전라북도,전주시완산구,평화2동,합계,30885,25274,17183,634,5471,632,1210,4,3,28,5,11,5,5,16,25207,67,5611
전라북도,전주시완산구,평화2동,관내사전투표,7264,7264,4934,171,1565,191,361,0,2,10,0,3,1,1,3,7242,22,0
전라북도,전주시완산구,평화2동,평화2동제1투,2517,1820,1149,57,471,50,75,3,0,3,1,3,0,0,0,1812,8,697
전라북도,전주시완산구,평화2동,평화2동제2투,2842,2059,1431,61,404,45,103,0,0,4,0,2,2,1,4,2057,2,783
전라북도,전주시완산구,평화2동,평화2동제3투,2146,1440,910,42,396,32,46,0,0,0,3,1,0,0,1,1431,9,706
전라북도,전주시완산구,평화2동,평화2동제4투,3119,2533,1794,66,471,65,129,1,0,2,0,1,0,1,1,2531,2,586
전라북도,전주시완산구,평화2동,평화2동제5투,1254,862,572,17,216,16,35,0,0,1,0,0,0,0,2,859,3,392
전라북도,전주시완산구,평화2동,평화2동제6투,2977,2378,1628,61,483,59,131,0,1,2,0,0,1,1,2,2369,9,599
전라북도,전주시완산구,평화2동,평화2동제7투,2425,1880,1247,43,432,47,103,0,0,1,0,1,0,0,1,1875,5,545
전라북도,전주시완산구,평화2동,평화2동제8투,3310,2608,1807,69,543,61,118,0,0,4,0,0,0,1,0,2603,5,702
전라북도,전주시완산구,평화2동,평화2동제9투,3031,2430,1711,47,490,66,109,0,0,1,1,0,1,0,2,2428,2,601
전라북도,전주시완산구,서신동,합계,30072,24596,16831,659,4875,732,1391,6,3,20,1,13,3,5,13,24552,44,5476
전라북도,전주시완산구,서신동,관내사전투표,7983,7983,5608,170,1448,246,478,2,3,9,0,0,1,0,4,7969,14,0
전라북도,전주시완산구,서신동,서신동제1투,2021,1479,1008,42,309,51,65,0,0,1,1,0,0,0,0,1477,2,542
전라북도,전주시완산구,서신동,서신동제2투,2395,1573,1033,56,353,38,89,0,0,2,0,0,0,0,1,1572,1,822
전라북도,전주시완산구,서신동,서신동제3투,1610,1213,728,65,308,39,66,2,0,0,0,2,0,1,1,1212,1,397
전라북도,전주시완산구,서신동,서신동제4투,1470,1089,679,50,263,29,58,0,0,2,0,3,0,1,0,1085,4,381
전라북도,전주시완산구,서신동,서신동제5투,2459,1734,1181,35,379,42,87,0,0,0,0,3,0,1,0,1728,6,725
전라북도,전주시완산구,서신동,서신동제6투,1682,1376,976,40,251,36,68,0,0,0,0,0,1,0,1,1373,3,306
전라북도,전주시완산구,서신동,서신동제7투,1961,1518,1106,34,256,36,78,0,0,2,0,1,1,0,0,1514,4,443
전라북도,전주시완산구,서신동,서신동제8투,2640,2191,1488,68,422,73,130,0,0,2,0,2,0,1,3,2189,2,449
전라북도,전주시완산구,서신동,서신동제9투,2449,2048,1450,35,358,64,133,2,0,2,0,2,0,1,0,2047,1,401
전라북도,전주시완산구,서신동,서신동제10투,3402,2392,1574,64,528,78,139,0,0,0,0,0,0,0,3,2386,6,1010
전라북도,전주시완산구,삼천1동,합계,10597,8371,5557,255,1812,243,430,0,0,22,0,3,1,0,4,8327,44,2226
전라북도,전주시완산구,삼천1동,관내사전투표,2646,2646,1797,64,541,79,144,0,0,2,0,2,0,0,2,2631,15,0
전라북도,전주시완산구,삼천1동,삼천1동제1투,2131,1431,951,49,311,32,73,0,0,7,0,0,0,0,0,1423,8,700
전라북도,전주시완산구,삼천1동,삼천1동제2투,3179,2480,1651,81,535,83,114,0,0,4,0,1,0,0,0,2469,11,699
전라북도,전주시완산구,삼천1동,삼천1동제3투,2641,1814,1158,61,425,49,99,0,0,9,0,0,1,0,2,1804,10,827
전라북도,전주시완산구,삼천2동,합계,12005,9292,6217,276,2010,250,482,2,3,14,0,3,0,3,2,9262,30,2713
전라북도,전주시완산구,삼천2동,관내사전투표,2828,2828,1957,70,582,77,128,0,3,2,0,0,0,1,0,2820,8,0
전라북도,전주시완산구,삼천2동,삼천2동제1투,2301,1504,1000,35,343,34,83,1,0,0,0,1,0,1,0,1498,6,797
전라북도,전주시완산구,삼천2동,삼천2동제2투,1648,1201,816,20,258,26,73,1,0,2,0,1,0,1,0,1198,3,447
전라북도,전주시완산구,삼천2동,삼천2동제3투,2634,2061,1341,93,431,73,110,0,0,4,0,0,0,0,2,2054,7,573
전라북도,전주시완산구,삼천2동,삼천2동제4투,2594,1698,1103,58,396,40,88,0,0,6,0,1,0,0,0,1692,6,896
전라북도,전주시완산구,삼천3동,합계,17274,14290,9925,339,2776,376,768,3,3,13,3,8,6,5,10,14235,55,2984
전라북도,전주시완산구,삼천3동,관내사전투표,4331,4331,3142,81,745,99,224,2,1,1,2,5,2,2,1,4307,24,0
전라북도,전주시완산구,삼천3동,삼천3동제1투,2222,1686,1181,46,313,45,95,0,0,1,0,1,0,0,0,1682,4,536
전라북도,전주시완산구,삼천3동,삼천3동제2투,950,631,379,33,164,18,27,0,0,4,0,0,0,2,2,629,2,319
전라북도,전주시완산구,삼천3동,삼천3동제3투,2565,2033,1392,42,409,48,127,0,0,2,0,1,1,0,0,2022,11,532
전라북도,전주시완산구,삼천3동,삼천3동제4투,2303,1878,1356,40,332,46,98,0,0,4,0,0,0,0,1,1877,1,425
전라북도,전주시완산구,삼천3동,삼천3동제5투,2378,1668,1061,56,424,46,68,1,1,0,0,0,2,0,2,1661,7,710
전라북도,전주시완산구,삼천3동,삼천3동제6투,2525,2063,1414,41,389,74,129,0,1,1,1,1,1,1,4,2057,6,462
전라북도,전주시완산구,효자1동,관내사전투표,3145,3145,2074,94,694,89,172,0,1,0,0,3,0,0,1,3128,17,0
전라북도,전주시완산구,효자1동,합계,10568,8475,5388,350,2002,250,422,1,1,10,0,5,1,3,6,8439,36,2093
전라북도,전주시완산구,효자1동,효자1동제1투,2670,1976,1256,102,444,69,92,1,0,3,0,0,0,0,1,1968,8,694
전라북도,전주시완산구,효자1동,효자1동제2투,2534,1739,1088,75,437,44,78,0,0,7,0,1,0,3,2,1735,4,795
전라북도,전주시완산구,효자1동,효자1동제3투,2219,1615,970,79,427,48,80,0,0,0,0,1,1,0,2,1608,7,604
전라북도,전주시완산구,효자2동,관내사전투표,2762,2762,1812,93,628,79,137,1,2,3,0,0,0,0,2,2757,5,0
전라북도,전주시완산구,효자2동,합계,9250,7385,4764,262,1758,195,342,3,6,18,2,4,0,2,7,7363,22,1865
전라북도,전주시완산구,효자2동,효자2동제1투,2222,1580,1027,47,380,39,69,1,3,5,0,1,0,0,1,1573,7,642
전라북도,전주시완산구,효자2동,효자2동제2투,1623,1140,689,53,311,28,43,0,1,4,1,2,0,2,3,1137,3,483
전라북도,전주시완산구,효자2동,효자2동제3투,2643,1903,1236,69,439,49,93,1,0,6,1,1,0,0,1,1896,7,740
전라북도,전주시완산구,효자3동,관내사전투표,4252,4252,2904,90,873,127,235,1,1,7,0,1,1,0,0,4240,12,0
전라북도,전주시완산구,효자3동,합계,13070,11080,7316,343,2494,303,563,1,6,17,1,3,2,1,0,11050,30,1990
전라북도,전주시완산구,효자3동,효자3동제1투,1864,1396,822,67,397,38,66,0,0,2,1,0,0,0,0,1393,3,468
전라북도,전주시완산구,효자3동,효자3동제2투,2607,2026,1290,75,480,61,109,0,1,4,0,1,1,0,0,2022,4,581
전라북도,전주시완산구,효자3동,효자3동제3투,2257,1742,1156,63,387,48,78,0,4,0,0,0,0,1,0,1737,5,515
전라북도,전주시완산구,효자3동,효자3동제4투,2090,1664,1144,48,357,29,75,0,0,4,0,1,0,0,0,1658,6,426
전라북도,전주시완산구,효자4동,합계,46618,37277,25497,877,7316,1249,2149,10,0,69,3,18,5,8,11,37212,65,9341
전라북도,전주시완산구,효자4동,관내사전투표,8996,8995,6407,162,1498,338,562,2,0,5,0,3,0,4,1,8982,13,1
전라북도,전주시완산구,효자4동,효자4동제1투,1827,1460,881,48,373,42,65,0,0,45,0,0,0,0,1,1455,5,367
전라북도,전주시완산구,효자4동,효자4동제2투,2782,2300,1469,68,559,80,117,1,0,0,0,2,0,1,0,2297,3,482
전라북도,전주시완산구,효자4동,효자4동제3투,3528,2417,1640,53,489,80,146,0,0,4,0,0,1,0,3,2416,1,1111
전라북도,전주시완산구,효자4동,효자4동제4투,1863,1367,944,29,280,25,81,0,0,2,0,0,0,0,0,1361,6,496
전라북도,전주시완산구,효자4동,효자4동제5투,3075,2347,1577,70,505,83,104,0,0,0,0,1,0,1,1,2342,5,728
전라북도,전주시완산구,효자4동,효자4동제6투,3302,2331,1598,64,428,84,140,1,0,1,2,2,1,1,2,2324,7,971
전라북도,전주시완산구,효자4동,효자4동제7투,3140,1909,1262,45,384,85,129,1,0,1,0,1,0,0,0,1908,1,1231
전라북도,전주시완산구,효자4동,효자4동제8투,3201,2181,1516,62,380,61,147,1,0,5,1,1,1,1,0,2176,5,1020
전라북도,전주시완산구,효자4동,효자4동제9투,3379,2594,1728,73,568,98,119,0,0,1,0,1,1,0,2,2591,3,785
전라북도,전주시완산구,효자4동,효자4동제10투,2561,2192,1593,38,357,55,139,3,0,0,0,3,1,0,0,2189,3,369
전라북도,전주시완산구,효자4동,효자4동제11투,1853,1495,1015,45,315,42,74,0,0,1,0,1,0,0,0,1493,2,358
전라북도,전주시완산구,효자4동,효자4동제12투,2076,1502,987,30,342,34,100,0,0,1,0,1,0,0,1,1496,6,574
전라북도,전주시완산구,효자4동,효자4동제13투,2104,1671,1121,36,369,51,87,1,0,1,0,2,0,0,0,1668,3,433
전라북도,전주시완산구,효자4동,효자4동제14투,2931,2516,1759,54,469,91,139,0,0,2,0,0,0,0,0,2514,2,415
전라북도,전주시완산구,잘못 투입·구분된 투표지,,0,4,2,0,1,1,0,0,0,0,0,0,0,0,0,4,0,-4
전라북도,전주시덕진구,합계,,230552,187921,125375,5183,40188,5286,10773,54,23,154,32,113,34,43,163,187421,500,42631
전라북도,전주시덕진구,거소·선상투표,,626,587,321,34,169,20,13,1,1,3,1,1,1,2,9,576,11,39
전라북도,전주시덕진구,관외사전투표,,23965,23958,16043,634,4406,978,1706,9,7,12,4,21,3,1,32,23856,102,7
전라북도,전주시덕진구,재외투표,,1036,816,591,28,100,16,81,0,0,0,0,0,0,0,0,816,0,220
전라북도,전주시덕진구,진북동,합계,12884,10158,6301,392,2706,250,463,4,1,4,2,4,1,2,7,10137,21,2726
전라북도,전주시덕진구,진북동,관내사전투표,3161,3161,2084,90,702,96,180,2,1,0,1,0,0,0,1,3157,4,0
전라북도,전주시덕진구,진북동,진북동제1투,2064,1310,803,49,381,18,47,2,0,2,1,0,0,0,2,1305,5,754
전라북도,전주시덕진구,진북동,진북동제2투,3132,2202,1275,102,667,48,99,0,0,1,0,4,1,0,2,2199,3,930
전라북도,전주시덕진구,진북동,진북동제3투,2427,1831,1140,71,491,43,78,0,0,1,0,0,0,2,1,1827,4,596
전라북도,전주시덕진구,진북동,진북동제4투,2100,1654,999,80,465,45,59,0,0,0,0,0,0,0,1,1649,5,446
전라북도,전주시덕진구,인후1동,합계,14573,12051,8045,331,2673,304,650,2,1,13,0,5,0,2,3,12029,22,2522
전라북도,전주시덕진구,인후1동,관내사전투표,4704,4704,3200,123,993,114,260,2,1,3,0,1,0,1,1,4699,5,0
전라북도,전주시덕진구,인후1동,인후1동제1투,2946,1972,1268,48,495,49,101,0,0,3,0,2,0,0,0,1966,6,974
전라북도,전주시덕진구,인후1동,인후1동제2투,2017,1481,1006,40,321,36,68,0,0,3,0,0,0,1,1,1476,5,536
전라북도,전주시덕진구,인후1동,인후1동제3투,2383,1875,1221,71,414,51,111,0,0,2,0,2,0,0,0,1872,3,508
전라북도,전주시덕진구,인후1동,인후1동제4투,2523,2019,1350,49,450,54,110,0,0,2,0,0,0,0,1,2016,3,504
전라북도,전주시덕진구,인후2동,합계,9769,7309,4676,246,1877,167,302,4,1,9,0,3,1,1,5,7292,17,2460
전라북도,전주시덕진구,인후2동,관내사전투표,1822,1822,1203,38,450,45,82,0,0,1,0,1,0,0,0,1820,2,0
전라북도,전주시덕진구,인후2동,인후2동제1투,1893,1336,834,54,348,31,57,1,0,3,0,1,1,0,1,1331,5,557
전라북도,전주시덕진구,인후2동,인후2동제2투,1526,948,582,38,268,19,35,0,0,2,0,1,0,1,0,946,2,578
전라북도,전주시덕진구,인후2동,인후2동제3투,2239,1504,956,48,411,25,52,2,1,2,0,0,0,0,2,1499,5,735
전라북도,전주시덕진구,인후2동,인후2동제4투,2289,1699,1101,68,400,47,76,1,0,1,0,0,0,0,2,1696,3,590
전라북도,전주시덕진구,인후3동,합계,22750,17517,12005,433,3469,464,1047,4,1,19,3,14,2,8,14,17483,34,5233
전라북도,전주시덕진구,인후3동,관내사전투표,4689,4689,3324,90,838,122,287,0,0,6,1,7,2,2,3,4682,7,0
전라북도,전주시덕진구,인후3동,인후3동제1투,2882,1666,1063,59,376,47,111,1,0,1,1,1,0,2,1,1663,3,1216
전라북도,전주시덕진구,인후3동,인후3동제2투,2566,1776,1202,43,371,53,92,0,0,3,1,2,0,1,3,1771,5,790
전라북도,전주시덕진구,인후3동,인후3동제3투,2308,1662,1163,37,337,45,75,0,0,2,0,0,0,0,1,1660,2,646
전라북도,전주시덕진구,인후3동,인후3동제4투,2313,1914,1284,68,421,43,93,0,0,0,0,0,0,0,1,1910,4,399
전라북도,전주시덕진구,인후3동,인후3동제5투,2946,2321,1588,35,447,68,169,0,0,2,0,1,0,3,3,2316,5,625
전라북도,전주시덕진구,인후3동,인후3동제6투,2832,2167,1523,64,396,51,125,1,1,1,0,1,0,0,1,2164,3,665
전라북도,전주시덕진구,인후3동,인후3동제7투,2214,1322,858,37,283,35,95,2,0,4,0,2,0,0,1,1317,5,892
전라북도,전주시덕진구,덕진동,합계,14817,11453,7624,302,2523,324,624,2,0,10,2,8,2,6,7,11434,19,3364
전라북도,전주시덕진구,덕진동,관내사전투표,2485,2484,1703,48,486,83,147,1,0,2,0,4,0,2,2,2478,6,1
전라북도,전주시덕진구,덕진동,덕진동제1투,1992,1232,734,55,342,38,56,0,0,1,0,0,1,2,1,1230,2,760
전라북도,전주시덕진구,덕진동,덕진동제2투,2270,1576,975,74,385,43,92,1,0,0,1,0,0,0,2,1573,3,694
전라북도,전주시덕진구,덕진동,덕진동제3투,2409,1759,1131,49,426,40,105,0,0,3,0,2,0,1,0,1757,2,650
전라북도,전주시덕진구,덕진동,덕진동제4투,2700,1948,1325,42,426,42,100,0,0,4,0,2,0,1,2,1944,4,752
전라북도,전주시덕진구,덕진동,덕진동제5투,2961,2454,1756,34,458,78,124,0,0,0,1,0,1,0,0,2452,2,507
전라북도,전주시덕진구,금암1동,합계,7222,5675,3556,188,1273,213,400,1,2,4,4,2,1,0,2,5646,29,1547
전라북도,전주시덕진구,금암1동,관내사전투표,2580,2580,1688,50,433,123,261,0,0,3,2,2,0,0,0,2562,18,0
전라북도,전주시덕진구,금암1동,금암1동제1투,2297,1480,885,68,406,33,78,1,0,1,1,0,0,0,1,1474,6,817
전라북도,전주시덕진구,금암1동,금암1동제2투,2345,1615,983,70,434,57,61,0,2,0,1,0,1,0,1,1610,5,730
전라북도,전주시덕진구,금암2동,관내사전투표,2295,2295,1490,54,560,52,125,2,0,3,0,2,0,0,4,2292,3,0
전라북도,전주시덕진구,금암2동,합계,8555,6727,4243,215,1711,187,324,2,0,14,1,4,0,1,10,6712,15,1828
전라북도,전주시덕진구,금암2동,금암2동제1투,2023,1327,812,56,352,37,59,0,0,4,1,1,0,0,2,1324,3,696
전라북도,전주시덕진구,금암2동,금암2동제2투,2207,1623,1042,48,389,48,83,0,0,5,0,1,0,0,2,1618,5,584
전라북도,전주시덕진구,금암2동,금암2동제3투,2030,1482,899,57,410,50,57,0,0,2,0,0,0,1,2,1478,4,548
전라북도,전주시덕진구,팔복동,관내사전투표,1871,1871,1256,55,409,33,104,0,0,2,1,1,0,0,1,1862,9,0
전라북도,전주시덕진구,팔복동,합계,7608,5528,3625,167,1309,114,270,4,0,5,2,1,1,1,9,5508,20,2080
전라북도,전주시덕진구,팔복동,팔복동제1투,2157,1291,811,42,346,25,55,0,0,0,0,0,1,0,6,1286,5,866
전라북도,전주시덕진구,팔복동,팔복동제2투,2590,1713,1142,45,395,39,81,3,0,2,0,0,0,1,0,1708,5,877
전라북도,전주시덕진구,팔복동,팔복동제3투,990,653,416,25,159,17,30,1,0,1,1,0,0,0,2,652,1,337
전라북도,전주시덕진구,우아1동,관내사전투표,1794,1794,1180,68,399,52,85,0,1,0,0,0,0,0,3,1788,6,0
전라북도,전주시덕진구,우아1동,합계,7603,5507,3468,230,1381,139,262,0,1,4,0,1,1,2,4,5493,14,2096
전라북도,전주시덕진구,우아1동,우아1동제1투,2187,1414,827,80,396,42,61,0,0,4,0,1,0,2,0,1413,1,773
전라북도,전주시덕진구,우아1동,우아1동제2투,1399,926,622,35,194,18,54,0,0,0,0,0,0,0,0,923,3,473
전라북도,전주시덕진구,우아1동,우아1동제3투,2223,1373,839,47,392,27,62,0,0,0,0,0,1,0,1,1369,4,850
전라북도,전주시덕진구,우아2동,합계,11876,8675,5838,250,1858,224,450,1,0,8,1,2,1,1,11,8645,30,3201
전라북도,전주시덕진구,우아2동,관내사전투표,2854,2854,2010,71,535,86,146,0,0,0,0,0,0,0,0,2848,6,0
전라북도,전주시덕진구,우아2동,우아2동제1투,2066,1520,1009,47,344,30,78,1,0,3,0,0,1,1,1,1515,5,546
전라북도,전주시덕진구,우아2동,우아2동제2투,2857,1786,1151,55,403,57,108,0,0,2,1,0,0,0,1,1778,8,1071
전라북도,전주시덕진구,우아2동,우아2동제3투,653,460,290,16,121,4,20,0,0,0,0,0,0,0,7,458,2,193
전라북도,전주시덕진구,우아2동,우아2동제4투,3446,2055,1378,61,455,47,98,0,0,3,0,2,0,0,2,2046,9,1391
전라북도,전주시덕진구,호성동,합계,15723,13267,9085,379,2681,339,700,6,2,6,3,14,5,2,16,13238,29,2456
전라북도,전주시덕진구,호성동,관내사전투표,3865,3865,2757,80,691,98,222,0,0,1,0,5,0,1,3,3858,7,0
전라북도,전주시덕진구,호성동,호성동제1투,1026,751,425,35,221,16,34,1,1,1,1,2,2,1,6,746,5,275
전라북도,전주시덕진구,호성동,호성동제2투,2745,2139,1453,85,443,41,106,0,0,0,2,1,0,0,4,2135,4,606
전라북도,전주시덕진구,호성동,호성동제3투,2273,1812,1283,41,341,56,84,1,1,0,0,2,0,0,0,1809,3,461
전라북도,전주시덕진구,호성동,호성동제4투,2764,2212,1514,50,473,55,109,1,0,1,0,2,2,0,2,2209,3,552
전라북도,전주시덕진구,호성동,호성동제5투,3050,2488,1653,88,512,73,145,3,0,3,0,2,1,0,1,2481,7,562
전라북도,전주시덕진구,송천1동,합계,25237,20978,14354,513,4115,587,1313,6,2,11,4,15,1,7,9,20937,41,4259
전라북도,전주시덕진구,송천1동,관내사전투표,4863,4863,3319,98,967,139,320,0,1,2,3,7,0,0,2,4858,5,0
전라북도,전주시덕진구,송천1동,송천1동제1투,2190,1538,957,53,416,35,72,0,1,1,0,0,0,0,0,1535,3,652
전라북도,전주시덕진구,송천1동,송천1동제2투,2227,1671,1137,37,339,46,100,2,0,1,0,2,1,0,1,1666,5,556
전라북도,전주시덕진구,송천1동,송천1동제3투,2622,1895,1272,52,384,50,122,3,0,1,0,0,0,2,2,1888,7,727
전라북도,전주시덕진구,송천1동,송천1동제4투,2443,1922,1318,64,383,47,106,0,0,3,0,1,0,0,0,1922,0,521
전라북도,전주시덕진구,송천1동,송천1동제5투,2500,2108,1471,62,368,53,145,0,0,0,1,2,0,0,1,2103,5,392
전라북도,전주시덕진구,송천1동,송천1동제6투,2878,2394,1659,47,442,75,158,0,0,2,0,0,0,4,2,2389,5,484
전라북도,전주시덕진구,송천1동,송천1동제7투,2607,2084,1435,44,421,63,115,0,0,1,0,0,0,0,1,2080,4,523
전라북도,전주시덕진구,송천1동,송천1동제8투,2907,2503,1786,56,395,79,175,1,0,0,0,3,0,1,0,2496,7,404
전라북도,전주시덕진구,송천2동,합계,20557,17248,11656,383,3599,441,1097,3,2,12,3,8,6,2,5,17217,31,3309
전라북도,전주시덕진구,송천2동,관내사전투표,6084,6084,4297,110,1070,154,436,0,1,2,1,4,1,0,1,6077,7,0
전라북도,전주시덕진구,송천2동,송천2동제1투,1801,1312,862,30,298,33,82,0,0,0,0,0,1,1,0,1307,5,489
전라북도,전주시덕진구,송천2동,송천2동제2투,2261,1831,1231,45,363,49,136,0,0,1,1,0,0,0,1,1827,4,430
전라북도,전주시덕진구,송천2동,송천2동제3투,1669,1230,786,33,287,40,76,0,0,2,0,1,1,0,0,1226,4,439
전라북도,전주시덕진구,송천2동,송천2동제4투,2232,1676,1096,36,405,35,98,0,0,3,0,1,1,0,1,1676,0,556
전라북도,전주시덕진구,송천2동,송천2동제5투,3019,2401,1575,67,575,63,116,0,0,1,1,1,0,1,0,2400,1,618
전라북도,전주시덕진구,송천2동,송천2동제6투,905,639,405,15,186,12,18,0,0,0,0,0,0,0,1,637,2,266
전라북도,전주시덕진구,송천2동,송천2동제7투,2586,2075,1404,47,415,55,135,3,1,3,0,1,2,0,1,2067,8,511
전라북도,전주시덕진구,조촌동,합계,7983,6156,4172,141,1359,124,308,0,0,11,0,3,3,0,11,6132,24,1827
전라북도,전주시덕진구,조촌동,관내사전투표,2269,2269,1600,38,449,43,118,0,0,5,0,2,2,0,4,2261,8,0
전라북도,전주시덕진구,조촌동,조촌동제1투,2051,1508,1034,28,300,42,93,0,0,4,0,1,0,0,2,1504,4,543
전라북도,전주시덕진구,조촌동,조촌동제2투,2290,1427,929,52,328,28,75,0,0,1,0,0,1,0,3,1417,10,863
전라북도,전주시덕진구,조촌동,조촌동제3투,1373,952,609,23,282,11,22,0,0,1,0,0,0,0,2,950,2,421
전라북도,전주시덕진구,동산동,합계,17768,14311,9772,317,2979,395,763,5,2,9,2,7,5,5,9,14270,41,3457
전라북도,전주시덕진구,동산동,관내사전투표,3426,3426,2412,75,655,74,186,0,0,3,1,0,1,3,3,3413,13,0
전라북도,전주시덕진구,동산동,동산동제1투,2586,1744,1137,46,396,53,98,1,0,2,0,0,1,0,0,1734,10,842
전라북도,전주시덕진구,동산동,동산동제2투,2430,1833,1217,50,424,44,86,0,1,1,0,3,0,0,3,1829,4,597
전라북도,전주시덕진구,동산동,동산동제3투,3110,2166,1445,38,481,53,129,0,0,3,1,2,1,2,3,2158,8,944
전라북도,전주시덕진구,동산동,동산동제4투,1783,1330,886,30,300,33,72,2,1,0,0,1,2,0,0,1327,3,453
전라북도,전주시덕진구,동산동,동산동제5투,4433,3812,2675,78,723,138,192,2,0,0,0,1,0,0,0,3809,3,621
전라북도,전주시덕진구,잘못 투입·구분된 투표지,,0,0,0,0,0,0,0,0,0,0,0,0,0,0,0,0,0,0
전라북도,군산시,합계,,223599,172330,109379,6360,42387,4638,8397,68,28,109,26,147,59,58,169,171825,505,51269
전라북도,군산시,거소·선상투표,,713,677,366,24,213,23,28,2,1,2,1,1,0,3,4,668,9,36
전라북도,군산시,관외사전투표,,15900,15893,9959,636,3206,771,1175,7,5,6,2,15,9,5,15,15811,82,7
전라북도,군산시,재외투표,,935,711,509,28,84,15,71,1,0,0,0,0,0,1,0,709,2,224
전라북도,군산시,옥구읍,합계,2986,2245,1433,83,587,51,71,1,3,0,0,3,1,1,5,2239,6,741
전라북도,군산시,옥구읍,관내사전투표,1011,1011,652,29,251,33,37,1,1,0,0,2,0,1,1,1008,3,0
전라북도,군산시,옥구읍,옥구읍투표소,1975,1234,781,54,336,18,34,0,2,0,0,1,1,0,4,1231,3,741
전라북도,군산시,옥산면,합계,2992,2346,1521,76,586,49,95,1,0,2,1,4,0,2,3,2340,6,646
전라북도,군산시,옥산면,관내사전투표,1029,1029,710,18,222,23,49,0,0,0,0,3,0,1,0,1026,3,0
전라북도,군산시,옥산면,옥산면투표소,1963,1317,811,58,364,26,46,1,0,2,1,1,0,1,3,1314,3,646
전라북도,군산시,회현면,합계,2719,2135,1258,95,621,41,86,0,0,1,0,3,1,4,6,2116,19,584
전라북도,군산시,회현면,관내사전투표,873,873,532,38,227,22,34,0,0,0,0,0,0,3,4,860,13,0
전라북도,군산시,회현면,회현면투표소,1846,1262,726,57,394,19,52,0,0,1,0,3,1,1,2,1256,6,584
전라북도,군산시,임피면,합계,2517,1868,1112,69,582,31,51,0,0,4,1,0,2,2,4,1858,10,649
전라북도,군산시,임피면,관내사전투표,763,763,453,17,239,16,27,0,0,2,0,0,1,2,1,758,5,0
전라북도,군산시,임피면,임피면투표소,1754,1105,659,52,343,15,24,0,0,2,1,0,1,0,3,1100,5,649
전라북도,군산시,서수면,합계,2317,1624,948,54,517,27,52,1,1,0,3,1,1,1,9,1615,9,693
전라북도,군산시,서수면,관내사전투표,521,521,314,9,160,6,24,0,1,0,3,0,0,0,2,519,2,0
전라북도,군산시,서수면,서수면투표소,1796,1103,634,45,357,21,28,1,0,0,0,1,1,1,7,1096,7,693
전라북도,군산시,대야면,관내사전투표,1602,1602,1020,83,419,20,48,2,0,1,0,0,3,0,1,1597,5,0
전라북도,군산시,대야면,합계,4665,3460,2134,160,972,51,108,2,1,4,0,3,5,3,2,3445,15,1205
전라북도,군산시,대야면,대야면제1투,1479,914,542,42,279,15,26,0,1,1,0,0,0,3,1,910,4,565
전라북도,군산시,대야면,대야면제2투,1584,944,572,35,274,16,34,0,0,2,0,3,2,0,0,938,6,640
전라북도,군산시,개정면,관내사전투표,643,643,413,30,171,5,22,0,0,0,0,0,0,0,0,641,2,0
전라북도,군산시,개정면,합계,2686,1941,1159,104,571,33,64,0,0,0,0,0,1,0,1,1933,8,745
전라북도,군산시,개정면,개정면투표소,2043,1298,746,74,400,28,42,0,0,0,0,0,1,0,1,1292,6,745
전라북도,군산시,성산면,관내사전투표,762,762,453,43,210,19,31,0,0,0,1,0,1,0,2,760,2,0
전라북도,군산시,성산면,합계,2656,1981,1123,106,598,44,88,2,1,2,1,3,2,1,2,1973,8,675
전라북도,군산시,성산면,성산면투표소,1894,1219,670,63,388,25,57,2,1,2,0,3,1,1,0,1213,6,675
전라북도,군산시,나포면,합계,2035,1508,869,53,485,27,58,0,0,0,0,0,2,3,5,1502,6,527
전라북도,군산시,나포면,관내사전투표,568,568,332,19,168,16,28,0,0,0,0,0,1,1,0,565,3,0
전라북도,군산시,나포면,나포면투표소,1467,940,537,34,317,11,30,0,0,0,0,0,1,2,5,937,3,527
전라북도,군산시,옥도면,합계,2467,1395,824,44,467,17,27,0,0,1,0,0,2,1,7,1390,5,1072
전라북도,군산시,옥도면,관내사전투표,193,193,110,12,60,6,4,0,0,0,0,0,0,0,1,193,0,0
전라북도,군산시,옥도면,옥도면제1투,441,195,139,3,44,3,4,0,0,0,0,0,0,1,0,194,1,246
전라북도,군산시,옥도면,옥도면제2투,97,55,35,1,17,0,2,0,0,0,0,0,0,0,0,55,0,42
전라북도,군산시,옥도면,옥도면제3투,232,117,60,7,43,3,1,0,0,0,0,0,0,0,1,115,2,115
전라북도,군산시,옥도면,옥도면제4투,167,85,60,4,16,0,4,0,0,0,0,0,0,0,0,84,1,82
전라북도,군산시,옥도면,옥도면제5투,218,151,95,1,52,1,2,0,0,0,0,0,0,0,0,151,0,67
전라북도,군산시,옥도면,옥도면제6투,696,380,203,9,149,3,8,0,0,1,0,0,1,0,5,379,1,316
전라북도,군산시,옥도면,옥도면제7투,53,34,22,2,9,0,1,0,0,0,0,0,0,0,0,34,0,19
전라북도,군산시,옥도면,옥도면제8투,126,62,45,1,16,0,0,0,0,0,0,0,0,0,0,62,0,64
전라북도,군산시,옥도면,옥도면제9투,39,27,15,3,9,0,0,0,0,0,0,0,0,0,0,27,0,12
전라북도,군산시,옥도면,옥도면제10투,205,96,40,1,52,1,1,0,0,0,0,0,1,0,0,96,0,109
전라북도,군산시,옥서면,합계,3222,2391,1468,86,683,45,92,0,0,2,0,2,2,0,1,2381,10,831
전라북도,군산시,옥서면,관내사전투표,919,919,605,34,219,21,38,0,0,0,0,0,0,0,1,918,1,0
전라북도,군산시,옥서면,옥서면투표소,2303,1472,863,52,464,24,54,0,0,2,0,2,2,0,0,1463,9,831
전라북도,군산시,해신동,합계,2465,1760,1076,71,524,24,53,0,0,1,0,0,1,1,0,1751,9,705
전라북도,군산시,해신동,관내사전투표,746,746,474,30,197,9,28,0,0,0,0,0,1,0,0,739,7,0
전라북도,군산시,해신동,해신동투표소,1719,1014,602,41,327,15,25,0,0,1,0,0,0,1,0,1012,2,705
전라북도,군산시,월명동,합계,5793,4160,2423,182,1290,92,146,1,1,3,0,0,4,2,2,4146,14,1633
전라북도,군산시,월명동,관내사전투표,1560,1560,975,57,415,41,60,0,0,2,0,0,1,1,0,1552,8,0
전라북도,군산시,월명동,월명동제1투,816,495,251,28,192,9,13,0,1,1,0,0,0,0,0,495,0,321
전라북도,군산시,월명동,월명동제2투,1360,775,423,42,265,19,22,1,0,0,0,0,0,0,1,773,2,585
전라북도,군산시,월명동,월명동제3투,2057,1330,774,55,418,23,51,0,0,0,0,0,3,1,1,1326,4,727
전라북도,군산시,삼학동,합계,6064,4621,2800,208,1322,99,167,3,0,5,2,1,1,1,2,4611,10,1443
전라북도,군산시,삼학동,관내사전투표,1935,1935,1223,62,512,43,82,1,0,4,1,0,1,0,1,1930,5,0
전라북도,군산시,삼학동,삼학동제1투,1340,830,441,71,261,17,38,1,0,0,0,1,0,0,0,830,0,510
전라북도,군산시,삼학동,삼학동제2투,1206,790,469,41,246,13,18,0,0,0,0,0,0,0,1,788,2,416
전라북도,군산시,삼학동,삼학동제3투,1583,1066,667,34,303,26,29,1,0,1,1,0,0,1,0,1063,3,517
전라북도,군산시,신풍동,합계,6302,4707,2912,210,1260,111,190,2,2,6,0,3,0,1,3,4700,7,1595
전라북도,군산시,신풍동,관내사전투표,1349,1349,877,39,326,36,65,0,1,1,0,1,0,1,0,1347,2,0
전라북도,군산시,신풍동,신풍동제1투,1682,1046,634,56,289,30,29,1,1,3,0,1,0,0,1,1045,1,636
전라북도,군산시,신풍동,신풍동제2투,1366,883,527,42,260,15,35,0,0,2,0,0,0,0,1,882,1,483
전라북도,군산시,신풍동,신풍동제3투,1905,1429,874,73,385,30,61,1,0,0,0,1,0,0,1,1426,3,476
전라북도,군산시,중앙동,합계,3203,2240,1323,112,696,36,58,0,0,1,0,1,2,1,2,2232,8,963
전라북도,군산시,중앙동,관내사전투표,883,883,555,34,246,16,27,0,0,1,0,1,1,0,1,882,1,0
전라북도,군산시,중앙동,중앙동투표소,2320,1357,768,78,450,20,31,0,0,0,0,0,1,1,1,1350,7,963
전라북도,군산시,흥남동,관내사전투표,2381,2381,1505,73,625,61,98,1,0,0,0,2,0,2,8,2375,6,0
전라북도,군산시,흥남동,합계,9095,6884,4221,263,1916,173,261,3,1,3,1,5,1,2,13,6863,21,2211
전라북도,군산시,흥남동,흥남동제1투,812,446,253,21,149,7,12,0,0,1,0,0,0,0,3,446,0,366
전라북도,군산시,흥남동,흥남동제2투,2944,2003,1193,95,571,55,81,1,0,0,1,1,0,0,1,1999,4,941
전라북도,군산시,흥남동,흥남동제3투,1351,956,602,39,250,27,30,1,0,2,0,1,0,0,0,952,4,395
전라북도,군산시,흥남동,흥남동제4투,1607,1098,668,35,321,23,40,0,1,0,0,1,1,0,1,1091,7,509
전라북도,군산시,조촌동,합계,12448,9582,6085,315,2492,225,423,0,0,8,0,4,5,2,4,9563,19,2866
전라북도,군산시,조촌동,관내사전투표,3660,3659,2504,102,785,74,183,0,0,4,0,0,1,1,0,3654,5,1
전라북도,군산시,조촌동,조촌동제1투,2366,1523,901,59,437,53,65,0,0,1,0,0,0,1,1,1518,5,843
전라북도,군산시,조촌동,조촌동제2투,2972,1992,1231,64,556,41,91,0,0,0,0,4,1,0,2,1990,2,980
전라북도,군산시,조촌동,조촌동제3투,1675,1090,631,50,348,19,34,0,0,1,0,0,2,0,1,1086,4,585
전라북도,군산시,조촌동,조촌동제4투,1775,1318,818,40,366,38,50,0,0,2,0,0,1,0,0,1315,3,457
전라북도,군산시,경암동,합계,7088,5240,3141,217,1489,131,220,10,1,7,0,2,1,1,6,5226,14,1848
전라북도,군산시,경암동,관내사전투표,1589,1589,1023,55,387,47,71,0,1,1,0,0,0,0,2,1587,2,0
전라북도,군산시,경암동,경암동제1투,1724,1055,560,44,374,26,34,4,0,2,0,2,0,1,2,1049,6,669
전라북도,군산시,경암동,경암동제2투,2453,1693,1052,59,450,38,83,3,0,3,0,0,1,0,2,1691,2,760
전라북도,군산시,경암동,경암동제3투,1322,903,506,59,278,20,32,3,0,1,0,0,0,0,0,899,4,419
전라북도,군산시,구암동,합계,4707,3649,2239,118,1014,99,156,3,0,3,0,1,1,2,4,3640,9,1058
전라북도,군산시,구암동,관내사전투표,1030,1030,656,33,253,32,54,0,0,0,0,0,0,0,0,1028,2,0
전라북도,군산시,구암동,구암동제1투,1717,1150,701,29,348,19,43,1,0,1,0,1,0,1,2,1146,4,567
전라북도,군산시,구암동,구암동제2투,1960,1469,882,56,413,48,59,2,0,2,0,0,1,1,2,1466,3,491
전라북도,군산시,개정동,합계,2753,2195,1343,70,600,65,99,1,0,2,1,2,2,0,3,2188,7,558
전라북도,군산시,개정동,관내사전투표,962,962,621,30,230,29,49,0,0,0,0,1,0,0,0,960,2,0
전라북도,군산시,개정동,개정동투표소,1791,1233,722,40,370,36,50,1,0,2,1,1,2,0,3,1228,5,558
전라북도,군산시,수송동,합계,35529,28586,19248,883,5878,889,1562,8,2,17,4,18,3,3,13,28528,58,6943
전라북도,군산시,수송동,관내사전투표,8535,8535,5968,209,1512,298,508,3,0,1,2,2,0,2,3,8508,27,0
전라북도,군산시,수송동,수송동제1투,2565,1760,1114,82,400,56,102,1,0,1,0,2,0,0,1,1759,1,805
전라북도,군산시,수송동,수송동제2투,2154,1576,1035,48,362,45,79,0,1,0,0,0,0,1,0,1571,5,578
전라북도,군산시,수송동,수송동제3투,2518,1859,1219,61,454,46,74,0,0,1,0,1,1,0,1,1858,1,659
전라북도,군산시,수송동,수송동제4투,2256,1551,974,62,401,42,65,1,1,3,0,0,0,0,1,1550,1,705
전라북도,군산시,수송동,수송동제5투,3123,2025,1307,72,475,57,107,1,0,0,0,0,0,0,1,2020,5,1098
전라북도,군산시,수송동,수송동제6투,3348,2622,1759,89,512,93,156,0,0,5,1,2,0,0,2,2619,3,726
전라북도,군산시,수송동,수송동제7투,2998,2366,1600,74,477,72,131,0,0,0,1,4,0,0,2,2361,5,632
전라북도,군산시,수송동,수송동제8투,3226,2476,1617,82,588,55,118,2,0,5,0,1,2,0,1,2471,5,750
전라북도,군산시,수송동,수송동제9투,3224,2477,1722,73,451,76,146,0,0,1,0,6,0,0,1,2476,1,747
전라북도,군산시,수송동,수송동제10투,1582,1339,933,31,246,49,76,0,0,0,0,0,0,0,0,1335,4,243
전라북도,군산시,나운1동,합계,11005,8071,5180,339,1948,201,359,1,2,3,1,8,2,2,7,8053,18,2934
전라북도,군산시,나운1동,관내사전투표,2457,2457,1621,85,530,67,133,1,1,1,0,6,1,1,2,2449,8,0
전라북도,군산시,나운1동,나운1동제1투,2286,1500,933,84,379,35,60,0,0,0,1,1,1,0,3,1497,3,786
전라북도,군산시,나운1동,나운1동제2투,3173,2130,1378,91,502,57,97,0,1,0,0,1,0,0,2,2129,1,1043
전라북도,군산시,나운1동,나운1동제3투,2191,1440,926,43,392,29,47,0,0,0,0,0,0,0,0,1437,3,751
전라북도,군산시,나운1동,나운1동제4투,898,544,322,36,145,13,22,0,0,2,0,0,0,1,0,541,3,354
전라북도,군산시,나운2동,합계,19742,16062,10425,561,3677,440,860,8,2,5,1,16,3,4,16,16018,44,3680
전라북도,군산시,나운2동,관내사전투표,5897,5897,3956,147,1236,163,368,2,1,1,0,2,1,0,4,5881,16,0
전라북도,군산시,나운2동,나운2동제1투,2248,1647,1026,79,394,54,92,0,0,0,0,0,0,0,0,1645,2,601
전라북도,군산시,나운2동,나운2동제2투,1978,1303,747,63,427,21,18,1,0,0,0,1,1,2,8,1289,14,675
전라북도,군산시,나운2동,나운2동제3투,2209,1610,1047,69,358,52,63,2,1,4,0,5,0,1,1,1603,7,599
전라북도,군산시,나운2동,나운2동제4투,2759,2137,1434,56,453,57,131,1,0,0,0,3,0,0,1,2136,1,622
전라북도,군산시,나운2동,나운2동제5투,2637,1999,1283,82,469,55,100,2,0,0,1,2,1,0,1,1996,3,638
전라북도,군산시,나운2동,나운2동제6투,2014,1469,932,65,340,38,88,0,0,0,0,3,0,1,1,1468,1,545
전라북도,군산시,나운3동,합계,23547,17728,11677,568,3948,451,976,9,2,7,1,34,2,4,11,17690,38,5819
전라북도,군산시,나운3동,관내사전투표,4137,4137,2863,105,773,113,261,2,0,1,0,7,1,2,2,4130,7,0
전라북도,군산시,나운3동,나운3동제1투,2552,1729,1150,59,398,33,82,0,0,0,0,1,0,1,1,1725,4,823
전라북도,군산시,나운3동,나운3동제2투,1769,1306,820,52,297,37,88,1,0,2,0,4,1,0,0,1302,4,463
전라북도,군산시,나운3동,나운3동제3투,2388,1757,1222,39,337,50,101,0,0,1,0,1,0,0,1,1752,5,631
전라북도,군산시,나운3동,나운3동제4투,2232,1567,991,45,398,42,84,0,1,0,0,3,0,0,0,1564,3,665
전라북도,군산시,나운3동,나운3동제5투,1671,1090,641,53,299,28,62,0,0,2,1,2,0,0,0,1088,2,581
전라북도,군산시,나운3동,나운3동제6투,2212,1155,752,38,273,30,51,1,1,0,0,2,0,0,5,1153,2,1057
전라북도,군산시,나운3동,나운3동제7투,2203,1602,1061,38,383,31,78,2,0,1,0,2,0,1,1,1598,4,601
전라북도,군산시,나운3동,나운3동제8투,1749,1333,885,47,292,20,74,1,0,0,0,9,0,0,1,1329,4,416
전라북도,군산시,나운3동,나운3동제9투,2634,2052,1292,92,498,67,95,2,0,0,0,3,0,0,0,2049,3,582
전라북도,군산시,소룡동,합계,14437,9681,6154,381,2391,234,471,0,0,4,6,6,2,4,9,9662,19,4756
전라북도,군산시,소룡동,관내사전투표,3378,3378,2212,116,779,85,173,0,0,1,2,0,1,2,0,3371,7,0
전라북도,군산시,소룡동,소룡동제1투,2323,1291,805,60,331,28,57,0,0,1,0,3,0,0,2,1287,4,1032
전라북도,군산시,소룡동,소룡동제2투,1572,1018,639,44,275,20,33,0,0,0,0,0,1,1,1,1014,4,554
전라북도,군산시,소룡동,소룡동제3투,2413,1327,803,65,338,34,84,0,0,0,0,0,0,0,2,1326,1,1086
전라북도,군산시,소룡동,소룡동제4투,3463,2111,1364,63,521,42,105,0,0,2,4,3,0,0,4,2108,3,1352
전라북도,군산시,소룡동,소룡동제5투,1288,556,331,33,147,25,19,0,0,0,0,0,0,1,0,556,0,732
전라북도,군산시,미성동,합계,10611,6985,4446,244,1769,143,330,2,3,10,0,11,1,1,10,6970,15,3626
전라북도,군산시,미성동,관내사전투표,1590,1590,1033,49,396,32,74,0,1,1,0,1,0,1,0,1588,2,0
전라북도,군산시,미성동,미성동제1투,1771,937,565,29,294,11,27,2,0,1,0,0,1,0,4,934,3,834
전라북도,군산시,미성동,미성동제2투,2143,1417,898,68,356,26,60,0,1,4,0,1,0,0,1,1415,2,726
전라북도,군산시,미성동,미성동제3투,636,426,261,11,137,3,8,0,0,1,0,3,0,0,1,425,1,210
전라북도,군산시,미성동,미성동제4투,2943,1474,911,63,365,40,81,0,1,2,0,4,0,0,2,1469,5,1469
전라북도,군산시,미성동,미성동제5투,1528,1141,778,24,221,31,80,0,0,1,0,2,0,0,2,1139,2,387
전라북도,군산시,잘못 투입·구분된 투표지,,0,4,3,0,1,0,0,0,0,0,0,0,0,0,0,4,0,-4
전라북도,익산시,합계,,246727,192208,123422,6470,45737,5324,9644,59,30,136,109,196,51,58,242,191478,730,54519
전라북도,익산시,거소·선상투표,,764,698,355,42,236,17,17,2,1,2,2,0,1,1,6,682,16,66
전라북도,익산시,관외사전투표,,19255,19239,12210,659,3765,991,1423,4,6,17,5,28,2,3,27,19140,99,16
전라북도,익산시,재외투표,,1029,793,564,14,113,14,85,1,0,0,0,1,0,0,0,792,1,236
전라북도,익산시,함열읍,관내사전투표,1886,1886,1229,53,477,30,75,0,0,1,5,1,0,2,4,1877,9,0
전라북도,익산시,함열읍,합계,6369,4699,2976,174,1240,74,180,1,0,2,9,5,2,4,10,4677,22,1670
전라북도,익산시,함열읍,함열읍제1투,2538,1623,1008,67,443,23,67,1,0,1,3,0,0,2,2,1617,6,915
전라북도,익산시,함열읍,함열읍제2투,1945,1190,739,54,320,21,38,0,0,0,1,4,2,0,4,1183,7,755
전라북도,익산시,오산면,합계,6083,4369,2831,129,1157,78,147,1,1,1,1,5,2,1,8,4362,7,1714
전라북도,익산시,오산면,관내사전투표,933,933,630,21,215,22,39,1,0,0,1,1,1,0,1,932,1,0
전라북도,익산시,오산면,오산면제1투,1626,1025,641,41,299,19,18,0,1,0,0,1,0,1,2,1023,2,601
전라북도,익산시,오산면,오산면제2투,2530,1718,1117,42,446,24,76,0,0,1,0,3,0,0,5,1714,4,812
전라북도,익산시,오산면,오산면제3투,994,693,443,25,197,13,14,0,0,0,0,0,1,0,0,693,0,301
전라북도,익산시,황등면,합계,6541,4773,3036,152,1233,97,196,2,2,4,2,4,4,2,10,4744,29,1768
전라북도,익산시,황등면,관내사전투표,1602,1602,1027,43,380,37,85,1,2,3,2,3,3,1,3,1590,12,0
전라북도,익산시,황등면,황등면제1투,1733,1042,649,46,278,22,35,1,0,0,0,0,1,0,4,1036,6,691
전라북도,익산시,황등면,황등면제2투,2469,1614,1019,44,441,34,63,0,0,1,0,1,0,1,1,1605,9,855
전라북도,익산시,황등면,황등면제3투,737,515,341,19,134,4,13,0,0,0,0,0,0,0,2,513,2,222
전라북도,익산시,함라면,관내사전투표,499,499,299,13,136,17,22,0,0,2,0,0,0,1,3,493,6,0
전라북도,익산시,함라면,합계,2036,1509,894,63,425,35,62,0,1,4,2,0,0,2,7,1495,14,527
전라북도,익산시,함라면,함라면투표소,1537,1010,595,50,289,18,40,0,1,2,2,0,0,1,4,1002,8,527
전라북도,익산시,웅포면,합계,1491,1131,694,50,331,16,31,0,0,1,0,0,0,0,4,1127,4,360
전라북도,익산시,웅포면,관내사전투표,347,347,214,14,96,7,14,0,0,0,0,0,0,0,1,346,1,0
전라북도,익산시,웅포면,웅포면투표소,1144,784,480,36,235,9,17,0,0,1,0,0,0,0,3,781,3,360
전라북도,익산시,성당면,합계,1714,1208,739,84,307,18,37,0,0,1,5,4,1,0,4,1200,8,506
전라북도,익산시,성당면,관내사전투표,455,455,271,39,115,12,13,0,0,0,1,0,0,0,2,453,2,0
전라북도,익산시,성당면,성당면투표소,1259,753,468,45,192,6,24,0,0,1,4,4,1,0,2,747,6,506
전라북도,익산시,용안면,합계,2409,1743,1016,95,503,30,66,2,0,3,0,1,2,0,7,1725,18,666
전라북도,익산시,용안면,관내사전투표,561,561,344,25,136,5,26,2,0,2,0,0,1,0,6,547,14,0
전라북도,익산시,용안면,용안면투표소,1848,1182,672,70,367,25,40,0,0,1,0,1,1,0,1,1178,4,666
전라북도,익산시,낭산면,합계,2685,1941,1132,72,576,50,65,1,0,2,9,14,0,4,7,1932,9,744
전라북도,익산시,낭산면,관내사전투표,554,554,338,14,158,9,24,0,0,1,4,3,0,0,2,553,1,0
전라북도,익산시,낭산면,낭산면투표소,2131,1387,794,58,418,41,41,1,0,1,5,11,0,4,5,1379,8,744
전라북도,익산시,망성면,관내사전투표,439,439,231,34,138,16,14,1,0,1,0,0,0,0,2,437,2,0
전라북도,익산시,망성면,합계,2709,1826,982,143,585,43,47,1,0,3,0,5,2,0,5,1816,10,883
전라북도,익산시,망성면,망성면투표소,2270,1387,751,109,447,27,33,0,0,2,0,5,2,0,3,1379,8,883
전라북도,익산시,여산면,합계,3036,2249,1305,126,638,77,65,2,1,6,3,8,0,3,5,2239,10,787
전라북도,익산시,여산면,관내사전투표,743,743,444,35,207,23,25,1,0,1,1,2,0,1,1,741,2,0
전라북도,익산시,여산면,여산면투표소,2293,1506,861,91,431,54,40,1,1,5,2,6,0,2,4,1498,8,787
전라북도,익산시,금마면,관내사전투표,1558,1558,910,97,391,64,62,3,2,0,1,3,0,0,7,1540,18,0
전라북도,익산시,금마면,합계,4557,3469,2013,229,909,116,150,3,2,0,1,5,1,0,9,3438,31,1088
전라북도,익산시,금마면,금마면제1투,1848,1147,639,91,312,37,55,0,0,0,0,1,1,0,2,1138,9,701
전라북도,익산시,금마면,금마면제2투,1151,764,464,41,206,15,33,0,0,0,0,1,0,0,0,760,4,387
전라북도,익산시,왕궁면,합계,3880,2767,1679,157,767,45,79,2,2,0,6,2,0,1,9,2749,18,1113
전라북도,익산시,왕궁면,관내사전투표,640,640,412,38,144,13,24,0,1,0,0,0,0,0,2,634,6,0
전라북도,익산시,왕궁면,왕궁면제1투,1599,946,598,39,264,12,27,0,0,0,1,0,0,1,1,943,3,653
전라북도,익산시,왕궁면,왕궁면제2투,886,569,343,22,178,5,12,1,0,0,0,2,0,0,3,566,3,317
전라북도,익산시,왕궁면,왕궁면제3투,755,612,326,58,181,15,16,1,1,0,5,0,0,0,3,606,6,143
전라북도,익산시,춘포면,합계,3697,2665,1740,73,666,40,95,2,1,1,3,3,3,3,10,2640,25,1032
전라북도,익산시,춘포면,관내사전투표,495,495,303,16,120,10,24,0,0,0,1,1,2,0,1,478,17,0
전라북도,익산시,춘포면,춘포면제1투,1095,731,506,12,174,7,24,1,0,1,0,0,1,1,2,729,2,364
전라북도,익산시,춘포면,춘포면제2투,1048,706,446,19,205,7,17,0,1,0,1,0,0,1,4,701,5,342
전라북도,익산시,춘포면,춘포면제3투,1059,733,485,26,167,16,30,1,0,0,1,2,0,1,3,732,1,326
전라북도,익산시,삼기면,합계,2357,1670,1015,66,461,32,65,4,1,1,2,2,2,2,5,1658,12,687
전라북도,익산시,삼기면,관내사전투표,641,641,426,15,151,13,20,3,0,1,2,0,0,0,1,632,9,0
전라북도,익산시,삼기면,삼기면투표소,1716,1029,589,51,310,19,45,1,1,0,0,2,2,2,4,1026,3,687
전라북도,익산시,용동면,합계,1444,1079,647,69,290,23,39,0,1,3,0,0,1,1,4,1078,1,365
전라북도,익산시,용동면,관내사전투표,298,298,178,20,72,9,17,0,0,0,0,0,1,0,0,297,1,0
전라북도,익산시,용동면,용동면투표소,1146,781,469,49,218,14,22,0,1,3,0,0,0,1,4,781,0,365
전라북도,익산시,중앙동,관내사전투표,1467,1467,867,49,449,24,65,4,0,1,3,1,0,1,0,1464,3,0
전라북도,익산시,중앙동,합계,3996,2970,1674,133,954,62,121,4,0,3,5,3,0,1,1,2961,9,1026
전라북도,익산시,중앙동,중앙동제1투,1229,703,396,35,223,21,24,0,0,2,0,0,0,0,0,701,2,526
전라북도,익산시,중앙동,중앙동제2투,1300,800,411,49,282,17,32,0,0,0,2,2,0,0,1,796,4,500
전라북도,익산시,평화동,합계,3810,2903,1834,94,775,79,112,0,0,1,3,1,0,0,1,2900,3,907
전라북도,익산시,평화동,관내사전투표,1160,1160,785,30,263,34,45,0,0,1,2,0,0,0,0,1160,0,0
전라북도,익산시,평화동,평화동제1투,1580,1042,623,35,311,31,39,0,0,0,0,1,0,0,0,1040,2,538
전라북도,익산시,평화동,평화동제2투,1070,701,426,29,201,14,28,0,0,0,1,0,0,0,1,700,1,369
전라북도,익산시,인화동,관내사전투표,1436,1436,896,47,395,27,60,1,0,2,3,1,0,0,1,1433,3,0
전라북도,익산시,인화동,합계,5960,4325,2641,155,1226,101,162,3,0,5,4,3,3,1,4,4308,17,1635
전라북도,익산시,인화동,인화동제1투,2045,1246,759,48,338,37,51,1,0,3,1,1,0,0,2,1241,5,799
전라북도,익산시,인화동,인화동제2투,2479,1643,986,60,493,37,51,1,0,0,0,1,3,1,1,1634,9,836
전라북도,익산시,동산동,합계,16684,12061,7955,337,2866,271,543,4,3,13,4,4,5,3,15,12023,38,4623
전라북도,익산시,동산동,관내사전투표,3635,3635,2475,99,773,91,176,2,2,1,1,0,0,1,2,3623,12,0
전라북도,익산시,동산동,동산동제1투,1943,1211,790,44,309,20,42,0,0,1,0,1,0,1,0,1208,3,732
전라북도,익산시,동산동,동산동제2투,1924,1155,725,49,296,23,56,0,0,3,0,0,1,0,0,1153,2,769
전라북도,익산시,동산동,동산동제3투,2886,1959,1256,58,479,46,95,0,0,5,1,1,2,0,6,1949,10,927
전라북도,익산시,동산동,동산동제4투,2389,1614,1084,37,389,32,60,2,1,0,1,0,1,0,3,1610,4,775
전라북도,익산시,동산동,동산동제5투,1773,1072,706,22,269,25,42,0,0,1,0,0,1,1,2,1069,3,701
전라북도,익산시,동산동,동산동제6투,2134,1415,919,28,351,34,72,0,0,2,1,2,0,0,2,1411,4,719
전라북도,익산시,마동,합계,8793,6456,4126,193,1667,164,256,3,0,4,5,3,1,3,8,6433,23,2337
전라북도,익산시,마동,관내사전투표,2661,2661,1788,70,590,73,120,2,0,3,2,0,0,0,6,2654,7,0
전라북도,익산시,마동,마동제1투,1461,792,482,26,230,22,22,0,0,0,1,1,0,1,2,787,5,669
전라북도,익산시,마동,마동제2투,2198,1355,826,39,393,30,58,1,0,0,1,0,1,1,0,1350,5,843
전라북도,익산시,마동,마동제3투,2473,1648,1030,58,454,39,56,0,0,1,1,2,0,1,0,1642,6,825
전라북도,익산시,남중동,관내사전투표,2805,2805,1676,107,794,76,123,0,0,3,3,3,0,0,5,2790,15,0
전라북도,익산시,남중동,합계,10680,7874,4584,348,2352,214,316,0,0,9,5,5,1,2,8,7844,30,2806
전라북도,익산시,남중동,남중동제1투,1949,1187,702,57,345,30,45,0,0,0,0,1,0,0,2,1182,5,762
전라북도,익산시,남중동,남중동제2투,1912,1284,726,67,402,34,46,0,0,3,1,1,0,1,0,1281,3,628
전라북도,익산시,남중동,남중동제3투,2028,1287,729,58,407,31,54,0,0,1,1,0,1,1,0,1283,4,741
전라북도,익산시,남중동,남중동제4투,1986,1311,751,59,404,43,48,0,0,2,0,0,0,0,1,1308,3,675
전라북도,익산시,모현동,관내사전투표,7133,7133,4955,150,1436,194,366,3,1,7,2,6,1,0,2,7123,10,0
전라북도,익산시,모현동,합계,28656,22830,15256,623,5150,602,1098,5,2,20,6,12,4,3,10,22791,39,5826
전라북도,익산시,모현동,모현동제1투,2136,1291,866,41,299,27,52,0,0,0,0,0,1,0,1,1287,4,845
전라북도,익산시,모현동,모현동제2투,1803,1270,751,66,344,45,56,0,1,1,3,0,1,0,1,1269,1,533
전라북도,익산시,모현동,모현동제3투,1913,1317,864,43,305,36,60,1,0,3,1,0,0,0,0,1313,4,596
전라북도,익산시,모현동,모현동제4투,1946,1373,874,34,368,30,59,0,0,2,0,0,0,0,2,1369,4,573
전라북도,익산시,모현동,모현동제5투,2631,1919,1191,79,519,50,70,0,0,5,0,2,0,1,1,1918,1,712
전라북도,익산시,모현동,모현동제6투,2071,1550,1079,47,312,34,75,0,0,1,0,1,0,0,0,1549,1,521
전라북도,익산시,모현동,모현동제7투,2557,1765,1120,56,443,35,106,0,0,0,0,0,0,0,2,1762,3,792
전라북도,익산시,모현동,모현동제8투,2286,1887,1297,39,397,61,85,0,0,0,0,2,0,2,1,1884,3,399
전라북도,익산시,모현동,모현동제9투,1935,1525,1012,41,342,46,76,1,0,0,0,1,1,0,0,1520,5,410
전라북도,익산시,모현동,모현동제10투,2245,1800,1247,27,385,44,93,0,0,1,0,0,0,0,0,1797,3,445
전라북도,익산시,송학동,합계,7385,5944,3963,161,1366,148,276,0,0,1,4,3,0,1,3,5926,18,1441
전라북도,익산시,송학동,관내사전투표,2517,2517,1749,63,532,49,115,0,0,0,2,2,0,1,1,2514,3,0
전라북도,익산시,송학동,송학동제1투,1204,761,459,27,217,20,31,0,0,0,0,0,0,0,1,755,6,443
전라북도,익산시,송학동,송학동제2투,1320,970,615,25,248,30,47,0,0,0,1,1,0,0,1,968,2,350
전라북도,익산시,송학동,송학동제3투,2344,1696,1140,46,369,49,83,0,0,1,1,0,0,0,0,1689,7,648
전라북도,익산시,신동,합계,12699,9534,6144,326,2179,311,522,2,1,6,5,5,1,4,2,9508,26,3165
전라북도,익산시,신동,관내사전투표,4123,4123,2795,114,819,138,236,0,0,1,4,3,1,2,0,4113,10,0
전라북도,익산시,신동,신동제1투,2281,1420,845,52,366,53,100,0,0,0,0,0,0,0,0,1416,4,861
전라북도,익산시,신동,신동제2투,2172,1366,835,58,357,43,65,0,0,1,0,1,0,1,0,1361,5,806
전라북도,익산시,신동,신동제3투,2517,1741,1117,58,412,60,87,1,1,0,0,1,0,0,1,1738,3,776
전라북도,익산시,신동,신동제4투,1606,884,552,44,225,17,34,1,0,4,1,0,0,1,1,880,4,722
전라북도,익산시,영등1동,합계,18320,14331,9403,477,3262,401,718,3,2,4,4,19,2,1,7,14303,28,3989
전라북도,익산시,영등1동,관내사전투표,4706,4706,3183,124,1029,120,228,0,1,2,1,6,0,1,1,4696,10,0
전라북도,익산시,영등1동,영등1동제1투,1951,1354,838,77,332,36,69,0,0,1,0,1,0,0,0,1354,0,597
전라북도,익산시,영등1동,영등1동제2투,2010,1329,824,54,350,47,48,0,0,1,1,1,0,0,1,1327,2,681
전라북도,익산시,영등1동,영등1동제3투,2366,1567,972,58,393,48,81,0,1,0,1,2,0,0,2,1558,9,799
전라북도,익산시,영등1동,영등1동제4투,1925,1446,969,43,310,40,78,0,0,0,0,3,1,0,0,1444,2,479
전라북도,익산시,영등1동,영등1동제5투,1359,932,621,34,196,26,48,1,0,0,1,2,0,0,2,931,1,427
전라북도,익산시,영등1동,영등1동제6투,1871,1357,897,48,306,34,65,2,0,0,0,3,0,0,0,1355,2,514
전라북도,익산시,영등1동,영등1동제7투,2132,1640,1099,39,346,50,101,0,0,0,0,1,1,0,1,1638,2,492
전라북도,익산시,영등2동,관내사전투표,4366,4366,3079,78,757,128,301,4,0,2,1,2,0,2,4,4358,8,0
전라북도,익산시,영등2동,합계,11651,9648,6689,207,1839,280,591,5,0,3,2,6,1,3,6,9632,16,2003
전라북도,익산시,영등2동,영등2동제1투,2736,2043,1416,50,394,56,123,0,0,1,1,0,1,1,0,2043,0,693
전라북도,익산시,영등2동,영등2동제2투,1946,1420,934,50,324,43,63,1,0,0,0,1,0,0,1,1417,3,526
전라북도,익산시,영등2동,영등2동제3투,2603,1819,1260,29,364,53,104,0,0,0,0,3,0,0,1,1814,5,784
전라북도,익산시,어양동,합계,18390,14478,9590,396,3109,389,912,1,1,7,2,17,1,4,15,14444,34,3912
전라북도,익산시,어양동,관내사전투표,5737,5737,3883,133,1145,176,372,0,0,2,0,5,1,1,5,5723,14,0
전라북도,익산시,어양동,어양동제1투,2310,1429,901,54,328,42,93,1,0,0,0,2,0,0,3,1424,5,881
전라북도,익산시,어양동,어양동제2투,2231,1422,917,42,338,34,83,0,0,2,1,1,0,1,2,1421,1,809
전라북도,익산시,어양동,어양동제3투,2122,1514,953,53,384,30,86,0,0,0,0,2,0,2,2,1512,2,608
전라북도,익산시,어양동,어양동제4투,2589,1922,1307,55,382,46,121,0,0,0,0,5,0,0,2,1918,4,667
전라북도,익산시,어양동,어양동제5투,1870,1369,919,33,289,30,91,0,1,0,1,0,0,0,1,1365,4,501
전라북도,익산시,어양동,어양동제6투,1531,1085,710,26,243,31,66,0,0,3,0,2,0,0,0,1081,4,446
전라북도,익산시,팔봉동,합계,5339,3917,2481,147,920,86,194,0,2,6,5,8,3,2,8,3862,55,1422
전라북도,익산시,팔봉동,관내사전투표,1556,1556,1060,59,317,30,66,0,1,2,1,2,1,0,2,1541,15,0
전라북도,익산시,팔봉동,팔봉동제1투,2744,1695,1046,59,406,39,101,0,1,1,2,5,2,1,3,1666,29,1049
전라북도,익산시,팔봉동,팔봉동제2투,1039,666,375,29,197,17,27,0,0,3,2,1,0,1,3,655,11,373
전라북도,익산시,삼성동,합계,22308,17095,11248,475,3864,419,974,1,0,3,5,20,6,3,17,17035,60,5213
전라북도,익산시,삼성동,관내사전투표,4995,4995,3374,128,984,149,317,0,0,1,3,8,2,2,4,4972,23,0
전라북도,익산시,삼성동,삼성동제1투,2082,1553,1061,28,348,36,73,0,0,0,1,4,0,0,0,1551,2,529
전라북도,익산시,삼성동,삼성동제2투,2221,1325,792,49,407,21,40,1,0,1,0,0,3,0,3,1317,8,896
전라북도,익산시,삼성동,삼성동제3투,2435,1579,975,68,390,57,83,0,0,0,0,1,0,0,0,1574,5,856
전라북도,익산시,삼성동,삼성동제4투,2533,1878,1233,53,423,38,118,0,0,0,0,2,0,0,3,1870,8,655
전라북도,익산시,삼성동,삼성동제5투,2701,1877,1249,63,403,47,108,0,0,1,0,2,0,0,1,1874,3,824
전라북도,익산시,삼성동,삼성동제6투,1832,1393,937,23,305,20,102,0,0,0,0,1,0,1,1,1390,3,439
전라북도,익산시,삼성동,삼성동제7투,1002,728,450,20,213,8,24,0,0,0,0,1,1,0,4,721,7,274
전라북도,익산시,삼성동,삼성동제8투,2507,1767,1177,43,391,43,109,0,0,0,1,1,0,0,1,1766,1,740
전라북도,익산시,잘못 투입·구분된 투표지,,0,14,6,1,6,1,0,0,0,0,0,0,0,0,0,14,0,-14
전라북도,정읍시,합계,,96162,73678,45894,2175,20111,1462,3109,32,17,102,35,116,30,38,170,73291,387,22484
전라북도,정읍시,거소·선상투표,,401,357,176,15,123,11,7,2,1,2,2,2,1,0,3,345,12,44
전라북도,정읍시,관외사전투표,,8016,8015,5146,258,1616,341,565,4,1,10,0,8,0,1,14,7964,51,1
전라북도,정읍시,재외투표,,316,214,167,7,23,3,11,2,0,0,0,0,0,0,0,213,1,102
전라북도,정읍시,신태인읍,합계,5252,3820,2431,105,1034,72,107,3,2,3,5,7,1,4,14,3788,32,1432
전라북도,정읍시,신태인읍,관내사전투표,1263,1263,836,31,313,19,42,1,0,1,1,2,0,2,4,1252,11,0
전라북도,정읍시,신태인읍,신태인읍제1투,1741,1105,710,31,298,22,29,2,1,1,1,2,0,0,1,1098,7,636
전라북도,정읍시,신태인읍,신태인읍제2투,1351,848,518,23,246,22,24,0,1,0,1,1,1,1,3,841,7,503
전라북도,정읍시,신태인읍,신태인읍제3투,897,604,367,20,177,9,12,0,0,1,2,2,0,1,6,597,7,293
전라북도,정읍시,북면,합계,3907,2839,1777,74,771,50,105,1,0,22,3,10,2,2,7,2824,15,1068
전라북도,정읍시,북면,관내사전투표,991,991,639,20,260,23,32,0,0,7,0,2,0,1,1,985,6,0
전라북도,정읍시,북면,북면제1투,1457,907,564,29,244,17,29,0,0,13,3,4,0,0,3,906,1,550
전라북도,정읍시,북면,북면제2투,1459,941,574,25,267,10,44,1,0,2,0,4,2,1,3,933,8,518
전라북도,정읍시,입암면,합계,2639,1946,1148,61,621,32,52,1,0,2,2,3,0,1,11,1934,12,693
전라북도,정읍시,입암면,관내사전투표,466,466,280,12,141,11,17,0,0,0,1,1,0,0,2,465,1,0
전라북도,정읍시,입암면,입암면제1투,1069,698,398,21,236,13,15,0,0,1,1,1,0,1,8,695,3,371
전라북도,정읍시,입암면,입암면제2투,1104,782,470,28,244,8,20,1,0,1,0,1,0,0,1,774,8,322
전라북도,정읍시,소성면,합계,1881,1404,876,43,413,12,39,0,0,1,1,8,1,1,5,1400,4,477
전라북도,정읍시,소성면,관내사전투표,546,546,368,18,130,3,15,0,0,1,0,7,0,0,3,545,1,0
전라북도,정읍시,소성면,소성면투표소,1335,858,508,25,283,9,24,0,0,0,1,1,1,1,2,855,3,477
전라북도,정읍시,고부면,합계,2569,1811,1105,70,507,30,55,0,2,3,1,9,1,2,10,1795,16,758
전라북도,정읍시,고부면,관내사전투표,470,470,284,23,125,10,21,0,0,1,0,2,0,0,3,469,1,0
전라북도,정읍시,고부면,고부면제1투,1412,859,530,36,228,17,19,0,2,2,1,6,1,2,6,850,9,553
전라북도,정읍시,고부면,고부면제2투,687,482,291,11,154,3,15,0,0,0,0,1,0,0,1,476,6,205
전라북도,정읍시,영원면,합계,1651,1238,769,39,363,11,39,0,0,2,1,3,0,0,3,1230,8,413
전라북도,정읍시,영원면,관내사전투표,455,455,288,11,127,4,17,0,0,0,0,2,0,0,1,450,5,0
전라북도,정읍시,영원면,영원면투표소,1196,783,481,28,236,7,22,0,0,2,1,1,0,0,2,780,3,413
전라북도,정읍시,덕천면,합계,1677,1250,730,38,384,24,43,1,1,1,0,9,1,2,6,1240,10,427
전라북도,정읍시,덕천면,관내사전투표,286,286,177,5,76,5,17,0,1,0,0,3,0,0,0,284,2,0
전라북도,정읍시,덕천면,덕천면제1투,779,534,325,15,160,13,11,0,0,1,0,2,0,1,2,530,4,245
전라북도,정읍시,덕천면,덕천면제2투,612,430,228,18,148,6,15,1,0,0,0,4,1,1,4,426,4,182
전라북도,정읍시,이평면,합계,1945,1368,876,41,365,22,45,0,0,1,1,7,1,0,4,1363,5,577
전라북도,정읍시,이평면,관내사전투표,403,403,269,13,96,10,10,0,0,1,0,1,0,0,1,401,2,0
전라북도,정읍시,이평면,이평면제1투,904,553,337,18,153,11,23,0,0,0,0,6,1,0,1,550,3,351
전라북도,정읍시,이평면,이평면제2투,638,412,270,10,116,1,12,0,0,0,1,0,0,0,2,412,0,226
전라북도,정읍시,정우면,합계,2276,1647,925,65,543,27,61,1,0,7,0,3,2,2,4,1640,7,629
전라북도,정읍시,정우면,관내사전투표,510,510,295,22,154,10,19,1,0,0,0,2,0,1,2,506,4,0
전라북도,정읍시,정우면,정우면제1투,1206,779,430,27,271,8,33,0,0,3,0,1,2,0,2,777,2,427
전라북도,정읍시,정우면,정우면제2투,560,358,200,16,118,9,9,0,0,4,0,0,0,1,0,357,1,202
전라북도,정읍시,태인면,합계,3156,2306,1414,60,685,27,70,1,0,12,1,1,2,1,9,2283,23,850
전라북도,정읍시,태인면,관내사전투표,735,735,437,17,218,12,36,0,0,0,1,0,1,1,4,727,8,0
전라북도,정읍시,태인면,태인면제1투,1306,884,540,28,256,11,23,1,0,12,0,0,0,0,2,873,11,422
전라북도,정읍시,태인면,태인면제2투,1115,687,437,15,211,4,11,0,0,0,0,1,1,0,3,683,4,428
전라북도,정읍시,감곡면,합계,2402,1678,1071,62,449,13,50,0,1,0,1,3,1,2,6,1659,19,724
전라북도,정읍시,감곡면,관내사전투표,582,582,394,12,129,6,24,0,0,0,1,2,0,1,2,571,11,0
전라북도,정읍시,감곡면,감곡면투표소,1820,1096,677,50,320,7,26,0,1,0,0,1,1,1,4,1088,8,724
전라북도,정읍시,옹동면,관내사전투표,305,304,169,7,116,2,6,1,0,1,0,0,0,0,0,302,2,1
전라북도,정읍시,옹동면,합계,1453,1038,581,31,382,5,19,1,1,1,0,1,1,1,5,1029,9,415
전라북도,정읍시,옹동면,옹동면투표소,1148,734,412,24,266,3,13,0,1,0,0,1,1,1,5,727,7,414
전라북도,정읍시,칠보면,관내사전투표,495,495,285,17,160,9,18,0,0,0,1,0,2,1,0,493,2,0
전라북도,정읍시,칠보면,합계,2093,1597,944,70,498,16,45,0,1,3,2,1,3,1,4,1588,9,496
전라북도,정읍시,칠보면,칠보면제1투,1162,778,473,39,233,4,17,0,1,3,0,1,1,0,3,775,3,384
전라북도,정읍시,칠보면,칠보면제2투,436,324,186,14,105,3,10,0,0,0,1,0,0,0,1,320,4,112
전라북도,정읍시,산내면,합계,1146,842,478,34,266,10,21,2,2,0,2,5,2,4,7,833,9,304
전라북도,정읍시,산내면,관내사전투표,342,342,209,10,91,6,9,2,1,0,2,3,1,1,3,338,4,0
전라북도,정읍시,산내면,산내면투표소,804,500,269,24,175,4,12,0,1,0,0,2,1,3,4,495,5,304
전라북도,정읍시,산외면,관내사전투표,398,398,250,19,100,8,16,0,0,0,0,0,0,0,4,397,1,0
전라북도,정읍시,산외면,합계,1880,1379,826,60,404,26,42,0,0,2,0,2,1,1,10,1374,5,501
전라북도,정읍시,산외면,산외면투표소,1482,981,576,41,304,18,26,0,0,2,0,2,1,1,6,977,4,501
전라북도,정읍시,수성동,합계,13607,10109,6573,243,2524,207,478,2,1,11,4,8,5,1,15,10072,37,3498
전라북도,정읍시,수성동,관내사전투표,3310,3310,2257,59,717,76,182,0,0,5,0,2,0,0,2,3300,10,0
전라북도,정읍시,수성동,수성동제1투,1354,846,495,32,262,17,31,0,0,1,0,1,2,0,2,843,3,508
전라북도,정읍시,수성동,수성동제2투,1664,1212,738,35,355,25,51,1,0,1,1,0,1,0,1,1209,3,452
전라북도,정읍시,수성동,수성동제3투,1708,1098,659,29,341,20,29,1,0,0,1,0,1,0,7,1088,10,610
전라북도,정읍시,수성동,수성동제4투,2660,1788,1212,48,403,33,81,0,1,2,0,2,1,0,1,1784,4,872
전라북도,정읍시,수성동,수성동제5투,2911,1855,1212,40,446,36,104,0,0,2,2,3,0,1,2,1848,7,1056
전라북도,정읍시,장명동,관내사전투표,753,753,477,25,194,15,34,1,0,0,1,2,0,0,1,750,3,0
전라북도,정읍시,장명동,합계,2677,2002,1205,69,589,31,91,2,0,0,1,5,0,0,2,1995,7,675
전라북도,정읍시,장명동,장명동투표소,1924,1249,728,44,395,16,57,1,0,0,0,3,0,0,1,1245,4,675
전라북도,정읍시,내장상동,관내사전투표,4105,4105,2727,73,960,91,229,0,1,2,0,2,2,1,3,4091,14,0
전라북도,정읍시,내장상동,합계,15064,11654,7451,278,3049,234,558,3,2,6,3,13,3,4,15,11619,35,3410
전라북도,정읍시,내장상동,내장상동제1투,2046,1403,888,36,378,30,59,0,0,0,2,2,0,1,1,1397,6,643
전라북도,정읍시,내장상동,내장상동제2투,2640,1855,1211,55,452,37,87,2,0,1,0,1,0,1,3,1850,5,785
전라북도,정읍시,내장상동,내장상동제3투,1465,1069,668,28,312,17,41,0,0,1,1,0,0,0,1,1069,0,396
전라북도,정읍시,내장상동,내장상동제4투,1806,1203,729,31,365,16,51,1,0,0,0,3,1,0,1,1198,5,603
전라북도,정읍시,내장상동,내장상동제5투,1276,867,510,20,292,13,21,0,1,0,0,2,0,1,6,866,1,409
전라북도,정읍시,내장상동,내장상동제6투,1726,1152,718,35,290,30,70,0,0,2,0,3,0,0,0,1148,4,574
전라북도,정읍시,시기동,합계,3295,2486,1489,59,782,42,98,1,1,0,2,0,0,2,2,2478,8,809
전라북도,정읍시,시기동,관내사전투표,897,897,574,21,242,16,38,1,1,0,0,0,0,0,0,893,4,0
전라북도,정읍시,시기동,시기동제1투,1450,936,529,24,325,19,32,0,0,0,2,0,0,1,1,933,3,514
전라북도,정읍시,시기동,시기동제2투,948,653,386,14,215,7,28,0,0,0,0,0,0,1,1,652,1,295
전라북도,정읍시,초산동,합계,6064,4664,2974,135,1239,85,208,0,0,4,0,5,0,1,1,4652,12,1400
전라북도,정읍시,초산동,관내사전투표,1474,1474,977,43,349,25,75,0,0,1,0,1,0,1,0,1472,2,0
전라북도,정읍시,초산동,초산동제1투,1394,906,584,15,253,16,33,0,0,0,0,2,0,0,0,903,3,488
전라북도,정읍시,초산동,초산동제2투,1415,972,555,43,307,18,41,0,0,2,0,1,0,0,0,967,5,443
전라북도,정읍시,초산동,초산동제3투,1781,1312,858,34,330,26,59,0,0,1,0,1,0,0,1,1310,2,469
전라북도,정읍시,연지동,합계,4288,3370,1987,103,1065,56,128,3,0,5,0,0,1,2,3,3353,17,918
전라북도,정읍시,연지동,관내사전투표,1676,1676,1033,35,490,30,71,1,0,3,0,0,1,1,1,1666,10,0
전라북도,정읍시,연지동,연지동투표소,2612,1694,954,68,575,26,57,2,0,2,0,0,0,1,2,1687,7,918
전라북도,정읍시,농소동,합계,3405,2420,1557,79,622,44,100,0,0,2,1,2,0,1,2,2410,10,985
전라북도,정읍시,농소동,관내사전투표,696,696,454,18,169,16,33,0,0,1,1,1,0,0,0,693,3,0
전라북도,정읍시,농소동,농소동제1투,1104,677,418,21,188,14,31,0,0,0,0,0,0,1,1,674,3,427
전라북도,정읍시,농소동,농소동제2투,1605,1047,685,40,265,14,36,0,0,1,0,1,0,0,1,1043,4,558
전라북도,정읍시,상교동,합계,3102,2223,1217,76,794,31,72,2,1,2,2,1,1,2,8,2209,14,879
전라북도,정읍시,상교동,관내사전투표,675,675,401,22,206,9,23,2,0,0,1,1,0,1,2,668,7,0
전라북도,정읍시,상교동,상교동제1투,1357,831,407,25,357,10,22,0,1,0,1,0,1,1,4,829,2,526
전라북도,정읍시,상교동,상교동제2투,1070,717,409,29,231,12,27,0,0,2,0,0,0,0,2,712,5,353
전라북도,정읍시,잘못 투입·구분된 투표지,,0,1,1,0,0,0,0,0,0,0,0,0,0,0,0,1,0,-1
전라북도,남원시,합계,,70169,55371,35539,1939,13854,1098,2193,32,15,44,21,88,44,54,164,55085,286,14798
전라북도,남원시,거소·선상투표,,310,282,142,11,67,12,6,0,3,3,2,2,0,2,9,259,23,28
전라북도,남원시,관외사전투표,,5308,5308,3379,184,1036,231,406,2,0,4,3,8,6,1,12,5272,36,0
전라북도,남원시,재외투표,,288,204,150,4,24,6,19,0,0,0,0,0,1,0,0,204,0,84
전라북도,남원시,운봉읍,관내사전투표,667,667,482,19,127,16,19,0,0,0,0,0,0,2,1,666,1,0
전라북도,남원시,운봉읍,합계,3303,2490,1696,99,546,44,71,2,0,0,1,1,2,3,14,2479,11,813
전라북도,남원시,운봉읍,운봉읍제1투,1220,846,552,36,206,13,22,0,0,0,1,0,2,1,7,840,6,374
전라북도,남원시,운봉읍,운봉읍제2투,1416,977,662,44,213,15,30,2,0,0,0,1,0,0,6,973,4,439
전라북도,남원시,주천면,관내사전투표,482,482,323,17,120,3,17,0,0,0,0,0,0,0,0,480,2,0
전라북도,남원시,주천면,합계,2014,1601,1001,67,439,22,41,2,0,1,0,2,1,2,8,1586,15,413
전라북도,남원시,주천면,주천면제1투,1289,935,592,36,249,15,20,2,0,1,0,2,1,1,5,924,11,354
전라북도,남원시,주천면,주천면제2투,243,184,86,14,70,4,4,0,0,0,0,0,0,1,3,182,2,59
전라북도,남원시,수지면,합계,992,727,442,40,213,6,14,0,0,0,1,0,1,2,4,723,4,265
전라북도,남원시,수지면,관내사전투표,164,164,101,8,47,1,4,0,0,0,1,0,1,0,1,164,0,0
전라북도,남원시,수지면,수지면투표소,828,563,341,32,166,5,10,0,0,0,0,0,0,2,3,559,4,265
전라북도,남원시,송동면,관내사전투표,386,386,242,8,111,4,11,0,0,0,0,0,2,0,4,382,4,0
전라북도,남원시,송동면,합계,1753,1337,818,52,384,16,33,0,1,0,0,5,6,0,10,1325,12,416
전라북도,남원시,송동면,송동면투표소,1367,951,576,44,273,12,22,0,1,0,0,5,4,0,6,943,8,416
전라북도,남원시,주생면,합계,1616,1254,717,43,420,16,33,1,0,2,0,5,0,1,10,1248,6,362
전라북도,남원시,주생면,관내사전투표,384,384,218,8,132,5,13,0,0,0,0,1,0,0,4,381,3,0
전라북도,남원시,주생면,주생면투표소,1232,870,499,35,288,11,20,1,0,2,0,4,0,1,6,867,3,362
전라북도,남원시,금지면,관내사전투표,357,357,237,12,87,3,11,0,0,1,0,1,0,0,1,353,4,0
전라북도,남원시,금지면,합계,2110,1617,1020,61,460,12,36,0,1,3,0,1,0,3,5,1602,15,493
전라북도,남원시,금지면,금지면투표소,1753,1260,783,49,373,9,25,0,1,2,0,0,0,3,4,1249,11,493
전라북도,남원시,대강면,관내사전투표,247,247,126,6,87,4,14,1,0,1,0,4,0,0,3,246,1,0
전라북도,남원시,대강면,합계,1453,1041,604,39,336,8,28,2,1,3,0,5,1,0,9,1036,5,412
전라북도,남원시,대강면,대강면투표소,1206,794,478,33,249,4,14,1,1,2,0,1,1,0,6,790,4,412
전라북도,남원시,대산면,관내사전투표,400,400,219,22,98,9,22,2,3,2,1,1,1,2,5,387,13,0
전라북도,남원시,대산면,합계,1440,1077,651,46,286,15,38,3,3,3,1,1,3,3,5,1058,19,363
전라북도,남원시,대산면,대산면투표소,1040,677,432,24,188,6,16,1,0,1,0,0,2,1,0,671,6,363
전라북도,남원시,사매면,합계,1321,981,646,30,251,6,29,1,0,1,1,0,1,0,7,973,8,340
전라북도,남원시,사매면,관내사전투표,284,284,181,9,78,2,11,0,0,1,0,0,1,0,0,283,1,0
전라북도,남원시,사매면,사매면투표소,1037,697,465,21,173,4,18,1,0,0,1,0,0,0,7,690,7,340
전라북도,남원시,덕과면,관내사전투표,172,172,118,2,41,1,8,0,0,0,0,1,1,0,0,172,0,0
전라북도,남원시,덕과면,합계,797,612,403,8,162,4,22,0,0,0,0,5,2,1,2,609,3,185
전라북도,남원시,덕과면,덕과면투표소,625,440,285,6,121,3,14,0,0,0,0,4,1,1,2,437,3,185
전라북도,남원시,보절면,합계,1377,1024,554,32,356,15,25,4,0,0,3,18,3,1,6,1017,7,353
전라북도,남원시,보절면,관내사전투표,327,327,178,3,126,3,10,0,0,0,1,4,0,0,0,325,2,0
전라북도,남원시,보절면,보절면투표소,1050,697,376,29,230,12,15,4,0,0,2,14,3,1,6,692,5,353
전라북도,남원시,산동면,합계,1559,1212,836,39,254,20,37,0,0,1,0,5,3,1,7,1203,9,347
전라북도,남원시,산동면,관내사전투표,427,427,291,16,84,6,18,0,0,0,0,4,2,0,3,424,3,0
전라북도,남원시,산동면,산동면투표소,1132,785,545,23,170,14,19,0,0,1,0,1,1,1,4,779,6,347
전라북도,남원시,이백면,합계,1786,1395,883,39,386,25,34,1,0,1,0,0,1,2,11,1383,12,391
전라북도,남원시,이백면,관내사전투표,515,515,324,10,150,8,11,0,0,0,0,0,0,0,6,509,6,0
전라북도,남원시,이백면,이백면투표소,1271,880,559,29,236,17,23,1,0,1,0,0,1,2,5,874,6,391
전라북도,남원시,인월면,합계,2291,1752,1205,100,330,29,66,0,0,3,0,4,0,2,5,1744,8,539
전라북도,남원시,인월면,관내사전투표,516,516,346,13,108,12,30,0,0,1,0,1,0,1,1,513,3,0
전라북도,남원시,인월면,인월면투표소,1775,1236,859,87,222,17,36,0,0,2,0,3,0,1,4,1231,5,539
전라북도,남원시,아영면,합계,1692,1300,852,61,298,20,52,0,0,1,1,1,2,3,5,1296,4,392
전라북도,남원시,아영면,관내사전투표,373,373,225,22,93,11,19,0,0,0,0,0,0,2,0,372,1,0
전라북도,남원시,아영면,아영면투표소,1319,927,627,39,205,9,33,0,0,1,1,1,2,1,5,924,3,392
전라북도,남원시,산내면,합계,1694,1296,832,75,251,26,95,0,0,1,0,1,2,5,5,1293,3,398
전라북도,남원시,산내면,관내사전투표,354,354,241,7,63,10,32,0,0,0,0,0,0,0,0,353,1,0
전라북도,남원시,산내면,산내면투표소,1340,942,591,68,188,16,63,0,0,1,0,1,2,5,5,940,2,398
전라북도,남원시,동충동,합계,3209,2576,1592,99,700,61,105,1,0,1,2,0,2,1,6,2570,6,633
전라북도,남원시,동충동,관내사전투표,1267,1267,812,40,313,29,66,0,0,1,0,0,1,0,2,1264,3,0
전라북도,남원시,동충동,동충동투표소,1942,1309,780,59,387,32,39,1,0,0,2,0,1,1,4,1306,3,633
전라북도,남원시,죽항동,합계,3110,2352,1492,68,664,46,68,3,0,2,1,0,1,0,1,2346,6,758
전라북도,남원시,죽항동,관내사전투표,1023,1023,649,29,293,24,23,1,0,1,0,0,0,0,1,1021,2,0
전라북도,남원시,죽항동,죽항동투표소,2087,1329,843,39,371,22,45,2,0,1,1,0,1,0,0,1325,4,758
전라북도,남원시,노암동,합계,3679,2802,1753,112,753,45,110,2,1,1,0,4,1,3,4,2789,13,877
전라북도,남원시,노암동,관내사전투표,851,851,545,36,205,11,46,0,1,0,0,2,0,1,1,848,3,0
전라북도,남원시,노암동,노암동제1투,1010,707,451,17,202,13,20,1,0,1,0,0,0,0,1,706,1,303
전라북도,남원시,노암동,노암동제2투,1818,1244,757,59,346,21,44,1,0,0,0,2,1,2,2,1235,9,574
전라북도,남원시,금동,합계,5498,4289,2786,163,1118,52,133,3,0,5,4,2,1,2,5,4274,15,1209
전라북도,남원시,금동,관내사전투표,1516,1516,1009,46,371,23,55,0,0,2,1,0,0,0,1,1508,8,0
전라북도,남원시,금동,금동제1투,1506,1018,618,50,310,10,18,2,0,2,2,1,1,0,2,1016,2,488
전라북도,남원시,금동,금동제2투,2476,1755,1159,67,437,19,60,1,0,1,1,1,0,2,2,1750,5,721
전라북도,남원시,왕정동,합계,3371,2619,1696,99,676,48,80,0,1,4,0,1,1,3,1,2610,9,752
전라북도,남원시,왕정동,관내사전투표,840,840,569,32,177,20,35,0,1,2,0,0,0,0,0,836,4,0
전라북도,남원시,왕정동,왕정동제1투,1354,937,591,33,259,18,27,0,0,2,0,1,1,1,0,933,4,417
전라북도,남원시,왕정동,왕정동제2투,1177,842,536,34,240,10,18,0,0,0,0,0,0,2,1,841,1,335
전라북도,남원시,향교동,관내사전투표,1619,1619,1031,36,430,44,69,0,0,0,0,2,0,1,0,1613,6,0
전라북도,남원시,향교동,합계,6082,4497,2784,140,1265,110,162,3,1,1,1,7,1,2,3,4480,17,1585
전라북도,남원시,향교동,향교동제1투,2296,1510,903,67,447,34,50,0,0,1,0,3,0,1,2,1508,2,786
전라북도,남원시,향교동,향교동제2투,1278,835,533,21,229,20,27,0,1,0,1,0,0,0,0,832,3,443
전라북도,남원시,향교동,향교동제3투,889,533,317,16,159,12,16,3,0,0,0,2,1,0,1,527,6,356
전라북도,남원시,도통동,관내사전투표,3972,3972,2794,75,784,80,213,2,0,1,0,6,1,0,3,3959,13,0
전라북도,남원시,도통동,합계,12116,9726,6605,228,2179,203,450,2,3,3,0,10,2,11,10,9706,20,2390
전라북도,남원시,도통동,도통동제1투,1669,1221,802,28,296,35,54,0,1,0,0,2,0,0,2,1220,1,448
전라북도,남원시,도통동,도통동제2투,1612,1106,675,52,310,22,39,0,1,1,0,1,1,3,0,1105,1,506
전라북도,남원시,도통동,도통동제3투,2869,2103,1441,43,471,42,91,0,0,1,0,1,0,7,3,2100,3,766
전라북도,남원시,도통동,도통동제4투,1994,1324,893,30,318,24,53,0,1,0,0,0,0,1,2,1322,2,670
전라북도,남원시,잘못 투입·구분된 투표지,,0,0,0,0,0,0,0,0,0,0,0,0,0,0,0,0,0,0
전라북도,김제시,합계,,75356,57886,35870,2052,15880,1190,2265,22,8,37,21,24,34,37,117,57557,329,17470
전라북도,김제시,거소·선상투표,,455,399,199,20,121,15,7,2,0,0,1,4,1,0,4,374,25,56
전라북도,김제시,관외사전투표,,6844,6843,4376,264,1428,260,447,3,0,4,1,4,1,4,8,6800,43,1
전라북도,김제시,재외투표,,296,217,149,5,38,4,18,1,0,0,0,1,0,1,0,217,0,79
전라북도,김제시,만경읍,합계,2461,1859,1056,77,599,44,60,0,0,2,0,1,2,2,5,1848,11,602
전라북도,김제시,만경읍,관내사전투표,540,540,336,24,140,15,21,0,0,0,0,0,1,0,0,537,3,0
전라북도,김제시,만경읍,만경읍제1투,846,580,333,15,192,14,19,0,0,0,0,0,0,0,4,577,3,266
전라북도,김제시,만경읍,만경읍제2투,1075,739,387,38,267,15,20,0,0,2,0,1,1,2,1,734,5,336
전라북도,김제시,죽산면,합계,2272,1644,951,62,555,19,41,0,0,2,0,0,0,1,3,1634,10,628
전라북도,김제시,죽산면,관내사전투표,546,546,325,16,183,5,16,0,0,0,0,0,0,0,0,545,1,0
전라북도,김제시,죽산면,죽산면투표소,1726,1098,626,46,372,14,25,0,0,2,0,0,0,1,3,1089,9,628
전라북도,김제시,백산면,합계,2188,1607,1014,42,473,30,31,2,0,1,0,1,0,0,6,1600,7,581
전라북도,김제시,백산면,관내사전투표,400,400,254,10,114,8,8,2,0,0,0,1,0,0,1,398,2,0
전라북도,김제시,백산면,백산면제1투,1002,652,412,17,193,13,13,0,0,0,0,0,0,0,1,649,3,350
전라북도,김제시,백산면,백산면제2투,786,555,348,15,166,9,10,0,0,1,0,0,0,0,4,553,2,231
전라북도,김제시,용지면,합계,3236,2309,1463,97,630,33,60,1,1,0,1,2,3,0,4,2295,14,927
전라북도,김제시,용지면,관내사전투표,578,578,367,23,158,10,15,0,0,0,0,2,0,0,1,576,2,0
전라북도,김제시,용지면,용지면제1투,1490,920,578,50,249,8,28,0,0,0,0,0,1,0,2,916,4,570
전라북도,김제시,용지면,용지면제2투,1168,811,518,24,223,15,17,1,1,0,1,0,2,0,1,803,8,357
전라북도,김제시,백구면,합계,3329,2458,1522,110,697,32,73,1,0,0,0,2,2,1,4,2444,14,871
전라북도,김제시,백구면,관내사전투표,804,804,508,31,228,6,24,1,0,0,0,1,1,0,2,802,2,0
전라북도,김제시,백구면,백구면제1투,1328,877,518,52,264,13,21,0,0,0,0,1,1,1,1,872,5,451
전라북도,김제시,백구면,백구면제2투,1197,777,496,27,205,13,28,0,0,0,0,0,0,0,1,770,7,420
전라북도,김제시,부량면,합계,1198,905,577,28,246,13,29,0,0,0,1,1,1,0,3,899,6,293
전라북도,김제시,부량면,관내사전투표,229,229,157,4,52,5,6,0,0,0,0,1,0,0,1,226,3,0
전라북도,김제시,부량면,부량면투표소,969,676,420,24,194,8,23,0,0,0,1,0,1,0,2,673,3,293
전라북도,김제시,공덕면,합계,2179,1646,1041,46,465,22,56,1,1,2,0,0,2,3,4,1643,3,533
전라북도,김제시,공덕면,관내사전투표,506,506,328,13,136,10,13,0,0,1,0,0,0,1,2,504,2,0
전라북도,김제시,공덕면,공덕면투표소,1673,1140,713,33,329,12,43,1,1,1,0,0,2,2,2,1139,1,533
전라북도,김제시,청하면,합계,1584,1215,691,53,405,17,30,0,1,1,2,0,2,2,4,1208,7,369
전라북도,김제시,청하면,관내사전투표,337,337,185,12,115,5,14,0,0,1,0,0,1,0,0,333,4,0
전라북도,김제시,청하면,청하면투표소,1247,878,506,41,290,12,16,0,1,0,2,0,1,2,4,875,3,369
전라북도,김제시,성덕면,합계,1598,1141,640,45,381,20,37,2,0,0,0,0,1,1,3,1130,11,457
전라북도,김제시,성덕면,관내사전투표,269,269,177,13,60,4,9,0,0,0,0,0,1,0,2,266,3,0
전라북도,김제시,성덕면,성덕면투표소,1329,872,463,32,321,16,28,2,0,0,0,0,0,1,1,864,8,457
전라북도,김제시,진봉면,합계,2336,1695,991,55,572,15,40,2,1,1,0,2,0,0,1,1680,15,641
전라북도,김제시,진봉면,관내사전투표,406,406,225,12,138,8,13,1,1,1,0,1,0,0,1,401,5,0
전라북도,김제시,진봉면,진봉면제1투,1294,854,500,23,291,5,24,1,0,0,0,1,0,0,0,845,9,440
전라북도,김제시,진봉면,진봉면제2투,636,435,266,20,143,2,3,0,0,0,0,0,0,0,0,434,1,201
전라북도,김제시,금구면,합계,3943,2916,1872,77,772,47,108,0,0,1,3,0,2,6,12,2900,16,1027
전라북도,김제시,금구면,관내사전투표,779,779,510,23,192,11,37,0,0,0,0,0,0,1,2,776,3,0
전라북도,김제시,금구면,금구면제1투,1611,1079,682,32,285,20,39,0,0,1,2,0,1,2,7,1071,8,532
전라북도,김제시,금구면,금구면제2투,594,397,259,9,103,4,17,0,0,0,0,0,0,1,2,395,2,197
전라북도,김제시,금구면,금구면제3투,959,661,421,13,192,12,15,0,0,0,1,0,1,2,1,658,3,298
전라북도,김제시,봉남면,합계,2047,1525,924,45,475,25,39,0,0,1,0,0,3,1,4,1517,8,522
전라북도,김제시,봉남면,관내사전투표,441,441,263,15,139,6,13,0,0,0,0,0,1,0,1,438,3,0
전라북도,김제시,봉남면,봉남면투표소,1606,1084,661,30,336,19,26,0,0,1,0,0,2,1,3,1079,5,522
전라북도,김제시,황산면,합계,1759,1320,770,45,402,27,48,0,0,6,0,1,2,1,5,1307,13,439
전라북도,김제시,황산면,관내사전투표,346,346,201,19,95,9,19,0,0,0,0,0,0,0,0,343,3,0
전라북도,김제시,황산면,황산면투표소,1413,974,569,26,307,18,29,0,0,6,0,1,2,1,5,964,10,439
전라북도,김제시,금산면,관내사전투표,773,773,481,31,212,13,30,1,0,0,0,0,2,0,1,771,2,0
전라북도,김제시,금산면,합계,4038,2947,1779,139,874,47,76,1,0,2,2,0,3,2,8,2933,14,1091
전라북도,김제시,금산면,금산면제1투,1704,1104,639,75,324,21,26,0,0,0,2,0,1,2,4,1094,10,600
전라북도,김제시,금산면,금산면제2투,1561,1070,659,33,338,13,20,0,0,2,0,0,0,0,3,1068,2,491
전라북도,김제시,광활면,관내사전투표,238,238,156,6,62,2,11,0,0,0,0,0,0,1,0,238,0,0
전라북도,김제시,광활면,합계,1233,930,592,20,270,12,22,0,0,1,0,0,0,1,6,924,6,303
전라북도,김제시,광활면,광활면투표소,995,692,436,14,208,10,11,0,0,1,0,0,0,0,6,686,6,303
전라북도,김제시,요촌동,합계,9018,6921,4289,265,1905,144,274,4,0,3,5,0,0,2,5,6896,25,2097
전라북도,김제시,요촌동,관내사전투표,2617,2617,1732,76,603,55,135,3,0,0,4,0,0,1,0,2609,8,0
전라북도,김제시,요촌동,요촌동제1투,2384,1492,918,57,412,36,61,1,0,1,0,0,0,0,3,1489,3,892
전라북도,김제시,요촌동,요촌동제2투,1629,1123,650,55,361,26,23,0,0,0,0,0,0,0,0,1115,8,506
전라북도,김제시,요촌동,요촌동제3투,1727,1241,741,51,375,23,43,0,0,1,1,0,0,0,1,1236,5,486
전라북도,김제시,요촌동,요촌동제4투,661,448,248,26,154,4,12,0,0,1,0,0,0,1,1,447,1,213
전라북도,김제시,신풍동,관내사전투표,1770,1770,1131,63,454,28,79,0,0,3,1,0,0,1,4,1764,6,0
전라북도,김제시,신풍동,합계,9450,6997,4376,267,1885,125,285,0,0,4,1,0,5,4,13,6965,32,2453
전라북도,김제시,신풍동,신풍동제1투,1409,944,550,53,277,17,38,0,0,0,0,0,0,0,1,936,8,465
전라북도,김제시,신풍동,신풍동제2투,1556,1091,671,45,295,20,48,0,0,1,0,0,0,2,2,1084,7,465
전라북도,김제시,신풍동,신풍동제3투,2035,1344,855,47,353,28,55,0,0,0,0,0,1,1,1,1341,3,691
전라북도,김제시,신풍동,신풍동제4투,1354,919,607,35,207,20,46,0,0,0,0,0,1,0,2,918,1,435
전라북도,김제시,신풍동,신풍동제5투,621,429,258,13,139,5,6,0,0,0,0,0,2,0,3,426,3,192
전라북도,김제시,신풍동,신풍동제6투,705,500,304,11,160,7,13,0,0,0,0,0,1,0,0,496,4,205
전라북도,김제시,검산동,관내사전투표,2279,2279,1530,50,482,61,143,0,0,0,0,1,1,1,2,2271,8,0
전라북도,김제시,검산동,합계,8561,6505,4204,164,1588,162,332,0,4,2,3,3,3,1,8,6474,31,2056
전라북도,김제시,검산동,검산동제1투,3043,2025,1287,60,533,47,88,0,2,0,0,0,0,0,2,2019,6,1018
전라북도,김제시,검산동,검산동제2투,1505,1005,615,29,292,16,29,0,1,2,0,0,2,0,4,990,15,500
전라북도,김제시,검산동,검산동제3투,1734,1196,772,25,281,38,72,0,1,0,3,2,0,0,0,1194,2,538
전라북도,김제시,교월동,합계,5331,3887,2394,126,1099,77,152,2,0,4,1,2,1,4,7,3869,18,1444
전라북도,김제시,교월동,관내사전투표,1234,1234,793,29,308,31,61,1,0,1,1,0,0,3,2,1230,4,0
전라북도,김제시,교월동,교월동제1투,1520,957,577,31,294,14,36,1,0,0,0,0,1,1,0,955,2,563
전라북도,김제시,교월동,교월동제2투,1243,832,506,36,238,15,26,0,0,1,0,1,0,0,2,825,7,411
전라북도,김제시,교월동,교월동제3투,1334,864,518,30,259,17,29,0,0,2,0,1,0,0,3,859,5,470
전라북도,김제시,잘못 투입·구분된 투표지,,0,0,0,0,0,0,0,0,0,0,0,0,0,0,0,0,0,0
전라북도,완주군,합계,,78249,62470,41057,2107,13897,1515,3306,20,16,52,13,67,25,35,120,62230,240,15779
전라북도,완주군,거소·선상투표,,272,255,153,14,59,7,6,1,2,1,0,0,0,1,5,249,6,17
전라북도,완주군,관외사전투표,,9491,9491,6186,361,1833,377,664,1,2,5,0,4,2,5,10,9450,41,0
전라북도,완주군,재외투표,,322,248,179,8,23,7,30,0,0,0,0,0,0,1,0,248,0,74
전라북도,완주군,삼례읍,합계,11111,8105,5261,238,2028,168,355,4,2,5,0,3,2,6,9,8081,24,3006
전라북도,완주군,삼례읍,관내사전투표,2340,2340,1491,68,600,50,115,2,1,2,0,1,0,0,4,2334,6,0
전라북도,완주군,삼례읍,삼례읍제1투,2339,1445,927,47,380,26,53,0,0,2,0,0,0,2,1,1438,7,894
전라북도,완주군,삼례읍,삼례읍제2투,2335,1532,1030,52,331,35,77,0,0,1,0,0,0,1,2,1529,3,803
전라북도,완주군,삼례읍,삼례읍제3투,2439,1637,1039,41,447,38,62,2,0,0,0,0,1,2,1,1633,4,802
전라북도,완주군,삼례읍,삼례읍제4투,1658,1151,774,30,270,19,48,0,1,0,0,2,1,1,1,1147,4,507
전라북도,완주군,봉동읍,합계,17815,14094,9516,422,2788,351,929,1,3,6,3,17,2,3,13,14054,40,3721
전라북도,완주군,봉동읍,관내사전투표,4499,4498,3114,108,809,110,337,0,3,3,1,4,0,1,0,4490,8,1
전라북도,완주군,봉동읍,봉동읍제1투,2523,1657,1051,64,409,47,73,0,0,1,1,0,0,1,5,1652,5,866
전라북도,완주군,봉동읍,봉동읍제2투,2966,2064,1370,59,480,46,92,0,0,1,0,3,1,0,3,2055,9,902
전라북도,완주군,봉동읍,봉동읍제3투,911,614,406,20,138,11,31,0,0,0,1,2,0,0,2,611,3,297
전라북도,완주군,봉동읍,봉동읍제4투,1427,973,619,24,221,26,71,0,0,0,0,6,1,0,2,970,3,454
전라북도,완주군,봉동읍,봉동읍제5투,2617,2132,1460,62,363,59,177,1,0,0,0,1,0,1,0,2124,8,485
전라북도,완주군,봉동읍,봉동읍제6투,2872,2156,1496,85,368,52,148,0,0,1,0,1,0,0,1,2152,4,716
전라북도,완주군,용진읍,합계,5446,4144,2629,116,1072,83,201,4,1,2,0,5,3,3,8,4127,17,1302
전라북도,완주군,용진읍,관내사전투표,976,976,635,21,236,17,58,1,0,1,0,1,1,0,2,973,3,0
전라북도,완주군,용진읍,용진읍제1투,782,534,317,10,163,11,22,2,0,1,0,0,2,2,1,531,3,248
전라북도,완주군,용진읍,용진읍제2투,892,665,442,21,158,9,29,0,0,0,0,0,0,0,2,661,4,227
전라북도,완주군,용진읍,용진읍제3투,1041,755,470,22,208,18,32,0,0,0,0,1,0,0,2,753,2,286
전라북도,완주군,용진읍,용진읍제4투,1755,1214,765,42,307,28,60,1,1,0,0,3,0,1,1,1209,5,541
전라북도,완주군,상관면,합계,3456,2616,1654,99,655,63,116,2,0,3,0,4,2,3,5,2606,10,840
전라북도,완주군,상관면,관내사전투표,884,884,580,34,191,19,50,2,0,1,0,2,1,1,0,881,3,0
전라북도,완주군,상관면,상관면제1투,1981,1336,829,58,353,36,50,0,0,0,0,0,1,2,3,1332,4,645
전라북도,완주군,상관면,상관면제2투,591,396,245,7,111,8,16,0,0,2,0,2,0,0,2,393,3,195
전라북도,완주군,이서면,합계,9854,7859,5351,223,1623,205,405,1,0,14,0,14,0,1,6,7843,16,1995
전라북도,완주군,이서면,관내사전투표,2048,2048,1461,61,355,54,107,1,0,0,0,4,0,0,2,2045,3,0
전라북도,완주군,이서면,이서면제1투,1871,1235,758,43,334,30,55,0,0,9,0,1,0,0,1,1231,4,636
전라북도,완주군,이서면,이서면제2투,2662,1962,1314,52,434,53,97,0,0,3,0,5,0,1,0,1959,3,700
전라북도,완주군,이서면,이서면제3투,3273,2614,1818,67,500,68,146,0,0,2,0,4,0,0,3,2608,6,659
전라북도,완주군,소양면,합계,4980,3746,2504,144,809,77,142,3,1,7,2,2,4,3,12,3710,36,1234
전라북도,완주군,소양면,관내사전투표,1082,1082,683,44,240,23,52,2,1,6,2,2,2,1,2,1060,22,0
전라북도,완주군,소양면,소양면제1투,1083,697,458,25,165,16,25,0,0,0,0,0,1,0,1,691,6,386
전라북도,완주군,소양면,소양면제2투,1068,800,541,23,177,20,30,0,0,0,0,0,0,1,6,798,2,268
전라북도,완주군,소양면,소양면제3투,757,519,363,22,107,8,12,0,0,0,0,0,1,1,2,516,3,238
전라북도,완주군,소양면,소양면제4투,990,648,459,30,120,10,23,1,0,1,0,0,0,0,1,645,3,342
전라북도,완주군,구이면,합계,4494,3486,2101,107,1028,58,152,1,1,3,2,7,2,1,12,3475,11,1008
전라북도,완주군,구이면,관내사전투표,914,914,577,27,235,18,48,0,1,0,1,3,0,0,2,912,2,0
전라북도,완주군,구이면,구이면제1투,1426,1025,606,35,309,16,49,1,0,3,0,0,1,0,1,1021,4,401
전라북도,완주군,구이면,구이면제2투,1176,890,546,25,263,11,36,0,0,0,0,2,0,1,4,888,2,286
전라북도,완주군,구이면,구이면제3투,978,657,372,20,221,13,19,0,0,0,1,2,1,0,5,654,3,321
전라북도,완주군,고산면,관내사전투표,1572,1572,1052,35,360,17,73,1,0,2,3,5,1,1,5,1555,17,0
전라북도,완주군,고산면,합계,4062,3227,2168,96,742,40,134,1,0,2,3,8,4,1,7,3206,21,835
전라북도,완주군,고산면,고산면제1투,1668,1081,732,42,240,16,41,0,0,0,0,3,1,0,2,1077,4,587
전라북도,완주군,고산면,고산면제2투,822,574,384,19,142,7,20,0,0,0,0,0,2,0,0,574,0,248
전라북도,완주군,비봉면,합계,1514,1125,776,27,247,23,34,1,3,0,0,0,1,0,8,1120,5,389
전라북도,완주군,비봉면,관내사전투표,333,333,221,7,81,4,15,0,1,0,0,0,0,0,1,330,3,0
전라북도,완주군,비봉면,비봉면제1투,800,521,368,9,115,11,13,1,1,0,0,0,0,0,1,519,2,279
전라북도,완주군,비봉면,비봉면제2투,381,271,187,11,51,8,6,0,1,0,0,0,1,0,6,271,0,110
전라북도,완주군,운주면,관내사전투표,416,416,249,29,106,8,19,0,0,0,0,1,0,1,1,414,2,0
전라북도,완주군,운주면,합계,1651,1230,704,109,328,25,45,0,0,2,1,1,2,3,6,1226,4,421
전라북도,완주군,운주면,운주면투표소,1235,814,455,80,222,17,26,0,0,2,1,0,2,2,5,812,2,421
전라북도,완주군,화산면,관내사전투표,475,475,338,17,96,3,16,0,0,0,0,0,0,0,4,474,1,0
전라북도,완주군,화산면,합계,2136,1570,1069,57,353,18,51,0,0,1,1,1,1,1,11,1564,6,566
전라북도,완주군,화산면,화산면투표소,1661,1095,731,40,257,15,35,0,0,1,1,1,1,1,7,1090,5,566
전라북도,완주군,동상면,관내사전투표,217,217,124,20,61,1,8,0,0,1,0,1,0,0,0,216,1,0
전라북도,완주군,동상면,합계,760,560,340,45,140,3,20,0,0,1,0,1,0,2,7,559,1,200
전라북도,완주군,동상면,동상면투표소,543,343,216,25,79,2,12,0,0,0,0,0,0,2,7,343,0,200
전라북도,완주군,경천면,관내사전투표,321,321,217,16,68,5,11,0,1,0,0,0,0,1,0,319,2,0
전라북도,완주군,경천면,합계,885,713,466,41,168,10,22,0,1,0,1,0,0,1,1,711,2,172
전라북도,완주군,경천면,경천면투표소,564,392,249,25,100,5,11,0,0,0,1,0,0,0,1,392,0,172
전라북도,완주군,잘못 투입·구분된 투표지,,0,1,0,0,1,0,0,0,0,0,0,0,0,0,0,1,0,-1
전라북도,진안군,합계,,22704,18107,11918,819,3904,392,806,12,3,12,2,13,22,23,83,18009,98,4597
전라북도,진안군,거소·선상투표,,107,101,50,3,32,3,3,0,0,0,0,0,0,0,3,94,7,6
전라북도,진안군,관외사전투표,,3175,3175,2118,129,535,118,256,1,0,2,0,2,1,0,5,3167,8,0
전라북도,진안군,재외투표,,107,79,54,6,7,3,7,1,0,0,0,0,0,0,0,78,1,28
전라북도,진안군,진안읍,관내사전투표,2092,2092,1465,75,370,49,105,1,0,2,1,2,1,1,4,2076,16,0
전라북도,진안군,진안읍,합계,7643,5730,3883,228,1230,109,218,2,0,3,1,3,6,3,15,5701,29,1913
전라북도,진안군,진안읍,진안읍제1투,1541,963,616,49,238,18,30,0,0,1,0,1,3,1,2,959,4,578
전라북도,진안군,진안읍,진안읍제2투,2050,1426,967,37,335,24,51,1,0,0,0,0,0,1,5,1421,5,624
전라북도,진안군,진안읍,진안읍제3투,1960,1249,835,67,287,18,32,0,0,0,0,0,2,0,4,1245,4,711
전라북도,진안군,용담면,합계,659,506,295,43,127,12,16,0,0,1,0,0,2,2,4,502,4,153
전라북도,진안군,용담면,관내사전투표,153,153,89,14,37,2,4,0,0,1,0,0,0,1,2,150,3,0
전라북도,진안군,용담면,용담면투표소,506,353,206,29,90,10,12,0,0,0,0,0,2,1,2,352,1,153
전라북도,진안군,안천면,합계,824,660,387,40,175,14,22,1,0,0,0,0,4,3,8,654,6,164
전라북도,진안군,안천면,관내사전투표,164,164,105,2,43,4,8,0,0,0,0,0,0,0,2,164,0,0
전라북도,진안군,안천면,안천면투표소,660,496,282,38,132,10,14,1,0,0,0,0,4,3,6,490,6,164
전라북도,진안군,동향면,합계,1186,933,616,39,198,18,42,1,0,0,0,1,1,3,7,926,7,253
전라북도,진안군,동향면,관내사전투표,274,274,185,13,53,5,13,0,0,0,0,0,1,0,2,272,2,0
전라북도,진안군,동향면,동향면투표소,912,659,431,26,145,13,29,1,0,0,0,1,0,3,5,654,5,253
전라북도,진안군,상전면,합계,639,481,280,18,153,9,12,0,0,0,0,0,0,2,6,480,1,158
전라북도,진안군,상전면,관내사전투표,137,137,91,2,36,2,5,0,0,0,0,0,0,0,1,137,0,0
전라북도,진안군,상전면,상전면투표소,502,344,189,16,117,7,7,0,0,0,0,0,0,2,5,343,1,158
전라북도,진안군,백운면,관내사전투표,411,411,291,17,64,7,21,0,0,0,0,3,0,0,2,405,6,0
전라북도,진안군,백운면,합계,1554,1207,836,57,221,23,43,0,1,2,0,5,2,1,6,1197,10,347
전라북도,진안군,백운면,백운면투표소,1143,796,545,40,157,16,22,0,1,2,0,2,2,1,4,792,4,347
전라북도,진안군,성수면,합계,1328,993,684,38,220,7,29,1,0,0,1,1,2,2,5,990,3,335
전라북도,진안군,성수면,관내사전투표,274,274,199,11,53,1,7,1,0,0,1,0,1,0,0,274,0,0
전라북도,진안군,성수면,성수면투표소,1054,719,485,27,167,6,22,0,0,0,0,1,1,2,5,716,3,335
전라북도,진안군,마령면,합계,1451,1112,721,46,262,17,45,2,0,0,0,0,2,1,9,1105,7,339
전라북도,진안군,마령면,관내사전투표,326,326,221,12,68,4,16,0,0,0,0,0,0,1,2,324,2,0
전라북도,진안군,마령면,마령면투표소,1125,786,500,34,194,13,29,2,0,0,0,0,2,0,7,781,5,339
전라북도,진안군,부귀면,관내사전투표,481,481,338,15,100,8,17,0,0,0,0,1,1,0,0,480,1,0
전라북도,진안군,부귀면,합계,1983,1510,1030,57,324,29,55,2,0,2,0,1,1,1,4,1506,4,473
전라북도,진안군,부귀면,부귀면투표소,1502,1029,692,42,224,21,38,2,0,2,0,0,0,1,4,1026,3,473
전라북도,진안군,정천면,관내사전투표,209,209,130,4,58,3,6,0,0,1,0,0,0,1,5,208,1,0
전라북도,진안군,정천면,합계,807,650,427,21,157,13,19,1,0,1,0,0,0,1,6,646,4,157
전라북도,진안군,정천면,정천면투표소,598,441,297,17,99,10,13,1,0,0,0,0,0,0,1,438,3,157
전라북도,진안군,주천면,합계,1241,970,537,94,263,17,39,0,2,1,0,0,1,4,5,963,7,271
전라북도,진안군,주천면,관내사전투표,267,267,170,24,48,8,12,0,1,0,0,0,0,1,1,265,2,0
전라북도,진안군,주천면,주천면투표소,974,703,367,70,215,9,27,0,1,1,0,0,1,3,4,698,5,271
전라북도,진안군,잘못 투입·구분된 투표지,,0,0,0,0,0,0,0,0,0,0,0,0,0,0,0,0,0,0
전라북도,무주군,합계,,21591,17019,10381,1225,3998,434,723,8,4,19,8,23,15,17,63,16918,101,4572
전라북도,무주군,거소·선상투표,,157,143,65,15,40,6,1,0,1,2,1,3,0,1,2,137,6,14
전라북도,무주군,관외사전투표,,2129,2129,1285,139,410,98,165,3,2,3,0,4,1,1,4,2115,14,0
전라북도,무주군,재외투표,,91,65,43,0,10,3,7,0,0,0,1,1,0,0,0,65,0,26
전라북도,무주군,무주읍,합계,7162,5534,3429,381,1302,123,243,3,0,5,2,4,2,6,12,5512,22,1628
전라북도,무주군,무주읍,관내사전투표,2386,2386,1563,123,506,53,122,1,0,2,2,2,1,0,3,2378,8,0
전라북도,무주군,무주읍,무주읍제1투,1615,1078,632,82,285,27,48,1,0,0,0,0,0,2,0,1077,1,537
전라북도,무주군,무주읍,무주읍제2투,1779,1205,735,90,299,29,43,0,0,0,0,0,0,0,2,1198,7,574
전라북도,무주군,무주읍,무주읍제3투,1382,865,499,86,212,14,30,1,0,3,0,2,1,4,7,859,6,517
전라북도,무주군,무풍면,관내사전투표,398,398,245,31,92,9,16,0,0,1,0,1,0,0,2,397,1,0
전라북도,무주군,무풍면,합계,1912,1447,789,146,394,47,47,0,0,1,0,5,1,1,5,1436,11,465
전라북도,무주군,무풍면,무풍면제1투,1326,913,465,108,260,37,26,0,0,0,0,4,1,1,2,904,9,413
전라북도,무주군,무풍면,무풍면제2투,188,136,79,7,42,1,5,0,0,0,0,0,0,0,1,135,1,52
전라북도,무주군,설천면,합계,3222,2462,1469,195,591,65,108,0,0,4,1,0,3,1,10,2447,15,760
전라북도,무주군,설천면,관내사전투표,734,734,465,56,152,26,30,0,0,1,0,0,1,1,0,732,2,0
전라북도,무주군,설천면,설천면제1투,1537,1052,611,91,261,21,49,0,0,2,1,0,2,0,5,1043,9,485
전라북도,무주군,설천면,설천면제2투,951,676,393,48,178,18,29,0,0,1,0,0,0,0,5,672,4,275
전라북도,무주군,적상면,관내사전투표,403,403,250,31,103,7,10,0,0,0,0,0,0,0,0,401,2,0
전라북도,무주군,적상면,합계,2143,1641,1002,135,432,26,25,1,0,1,1,1,2,1,4,1631,10,502
전라북도,무주군,적상면,적상면제1투,821,586,374,55,135,7,9,0,0,0,0,0,0,1,2,583,3,235
전라북도,무주군,적상면,적상면제2투,333,237,141,16,70,4,2,0,0,1,1,0,0,0,0,235,2,96
전라북도,무주군,적상면,적상면제3투,586,415,237,33,124,8,4,1,0,0,0,1,2,0,2,412,3,171
전라북도,무주군,안성면,합계,3568,2699,1788,135,571,44,109,1,0,3,2,4,3,5,18,2683,16,869
전라북도,무주군,안성면,관내사전투표,746,746,493,34,158,12,36,0,0,0,0,0,2,1,8,744,2,0
전라북도,무주군,안성면,안성면제1투,1373,980,644,47,217,18,31,0,0,0,0,1,1,3,7,969,11,393
전라북도,무주군,안성면,안성면제2투,1449,973,651,54,196,14,42,1,0,3,2,3,0,1,3,970,3,476
전라북도,무주군,부남면,합계,1207,899,511,79,248,22,18,0,1,0,0,1,3,1,8,892,7,308
전라북도,무주군,부남면,관내사전투표,240,240,147,21,61,4,3,0,0,0,0,0,1,1,1,239,1,0
전라북도,무주군,부남면,부남면투표소,967,659,364,58,187,18,15,0,1,0,0,1,2,0,7,653,6,308
전라북도,무주군,잘못 투입·구분된 투표지,,0,0,0,0,0,0,0,0,0,0,0,0,0,0,0,0,0,0
전라북도,장수군,합계,,20123,16079,10714,717,3353,342,688,8,6,14,3,18,21,17,74,15975,104,4044
전라북도,장수군,거소·선상투표,,48,44,31,3,6,0,0,1,0,0,0,0,0,0,0,41,3,4
전라북도,장수군,관외사전투표,,2345,2344,1575,93,383,100,178,1,0,1,1,1,0,1,2,2336,8,1
전라북도,장수군,재외투표,,91,68,44,0,11,1,12,0,0,0,0,0,0,0,0,68,0,23
전라북도,장수군,장수읍,합계,5562,4332,2843,216,967,88,154,2,1,3,2,5,3,3,15,4302,30,1230
전라북도,장수군,장수읍,관내사전투표,1425,1425,974,42,289,32,67,1,0,1,1,3,1,2,3,1416,9,0
전라북도,장수군,장수읍,장수읍제1투,1266,891,567,51,219,13,31,0,0,0,0,1,0,0,5,887,4,375
전라북도,장수군,장수읍,장수읍제2투,1120,795,519,47,179,15,20,0,0,0,1,1,1,1,5,789,6,325
전라북도,장수군,장수읍,장수읍제3투,1751,1221,783,76,280,28,36,1,1,2,0,0,1,0,2,1210,11,530
전라북도,장수군,산서면,합계,1797,1382,938,39,322,18,38,1,1,1,0,0,5,2,7,1372,10,415
전라북도,장수군,산서면,관내사전투표,421,421,290,12,92,7,11,1,0,1,0,0,2,1,1,418,3,0
전라북도,장수군,산서면,산서면투표소,1376,961,648,27,230,11,27,0,1,0,0,0,3,1,6,954,7,415
전라북도,장수군,번암면,관내사전투표,468,468,315,9,96,13,28,0,0,0,0,1,0,2,2,466,2,0
전라북도,장수군,번암면,합계,1945,1514,1021,60,316,27,52,0,1,1,0,3,4,4,12,1501,13,431
전라북도,장수군,번암면,번암면투표소,1477,1046,706,51,220,14,24,0,1,1,0,2,4,2,10,1035,11,431
전라북도,장수군,장계면,합계,3560,2746,1841,133,566,56,108,1,1,2,0,3,6,1,12,2730,16,814
전라북도,장수군,장계면,관내사전투표,966,966,621,45,216,24,43,0,0,0,0,2,2,0,5,958,8,0
전라북도,장수군,장계면,장계면제1투,1476,991,679,48,188,20,42,0,1,2,0,0,2,1,4,987,4,485
전라북도,장수군,장계면,장계면제2투,1118,789,541,40,162,12,23,1,0,0,0,1,2,0,3,785,4,329
전라북도,장수군,천천면,관내사전투표,378,378,266,11,77,4,13,0,0,0,0,1,1,0,2,375,3,0
전라북도,장수군,천천면,합계,1756,1329,893,65,287,21,39,0,0,4,0,1,1,2,7,1320,9,427
전라북도,장수군,천천면,천천면투표소,1378,951,627,54,210,17,26,0,0,4,0,0,0,2,5,945,6,427
전라북도,장수군,계남면,합계,1745,1335,876,58,291,18,61,2,0,1,0,4,2,4,7,1324,11,410
전라북도,장수군,계남면,관내사전투표,353,353,226,12,87,5,17,1,0,0,0,0,0,1,2,351,2,0
전라북도,장수군,계남면,계남면투표소,1392,982,650,46,204,13,44,1,0,1,0,4,2,3,5,973,9,410
전라북도,장수군,계북면,합계,1274,985,652,50,204,13,46,0,2,1,0,1,0,0,12,981,4,289
전라북도,장수군,계북면,관내사전투표,325,325,211,15,71,3,18,0,1,1,0,1,0,0,3,324,1,0
전라북도,장수군,계북면,계북면투표소,949,660,441,35,133,10,28,0,1,0,0,0,0,0,9,657,3,289
전라북도,장수군,잘못 투입·구분된 투표지,,0,0,0,0,0,0,0,0,0,0,0,0,0,0,0,0,0,0
전라북도,임실군,합계,,25863,20381,12893,771,5009,403,904,6,10,20,11,17,23,32,127,20226,155,5482
전라북도,임실군,거소·선상투표,,141,126,59,14,25,4,8,1,3,1,0,0,1,2,0,118,8,15
전라북도,임실군,관외사전투표,,3474,3473,2256,111,693,133,240,1,0,3,3,4,2,1,8,3455,18,1
전라북도,임실군,재외투표,,90,63,44,1,9,2,7,0,0,0,0,0,0,0,0,63,0,27
전라북도,임실군,임실읍,합계,5510,4195,2629,191,1006,99,211,2,1,4,0,1,6,3,14,4167,28,1315
전라북도,임실군,임실읍,관내사전투표,1573,1573,1042,63,288,49,110,0,1,3,0,1,0,0,4,1561,12,0
전라북도,임실군,임실읍,임실읍제1투,1398,929,518,57,276,28,37,2,0,0,0,0,1,1,2,922,7,469
전라북도,임실군,임실읍,임실읍제2투,1347,929,608,34,222,15,44,0,0,1,0,0,1,0,2,927,2,418
전라북도,임실군,임실읍,임실읍제3투,1192,764,461,37,220,7,20,0,0,0,0,0,4,2,6,757,7,428
전라북도,임실군,청웅면,합계,1156,870,504,32,276,8,26,0,1,3,1,1,2,0,10,864,6,286
전라북도,임실군,청웅면,관내사전투표,261,261,145,8,93,5,5,0,1,0,0,0,0,0,1,258,3,0
전라북도,임실군,청웅면,청웅면투표소,895,609,359,24,183,3,21,0,0,3,1,1,2,0,9,606,3,286
전라북도,임실군,운암면,관내사전투표,91,91,64,1,20,1,4,0,0,0,0,0,0,0,1,91,0,0
전라북도,임실군,운암면,합계,1166,829,530,32,192,10,27,0,1,3,0,2,3,5,19,824,5,337
전라북도,임실군,운암면,운암면제1투,323,228,139,11,58,6,7,0,0,2,0,1,0,0,1,225,3,95
전라북도,임실군,운암면,운암면제2투,272,198,141,4,30,1,8,0,1,0,0,0,3,2,7,197,1,74
전라북도,임실군,운암면,운암면제3투,480,312,186,16,84,2,8,0,0,1,0,1,0,3,10,311,1,168
전라북도,임실군,신평면,합계,1176,876,545,32,231,12,33,1,2,0,1,1,1,2,5,866,10,300
전라북도,임실군,신평면,관내사전투표,329,329,211,15,84,1,10,0,2,0,0,0,1,1,2,327,2,0
전라북도,임실군,신평면,신평면투표소,847,547,334,17,147,11,23,1,0,0,1,1,0,1,3,539,8,300
전라북도,임실군,성수면,관내사전투표,205,205,131,3,47,2,21,0,0,0,0,0,0,0,0,204,1,0
전라북도,임실군,성수면,합계,1349,1006,656,43,228,12,42,0,1,0,3,1,1,2,8,997,9,343
전라북도,임실군,성수면,성수면제1투,797,540,339,35,130,9,14,0,1,0,3,1,0,0,3,535,5,257
전라북도,임실군,성수면,성수면제2투,347,261,186,5,51,1,7,0,0,0,0,0,1,2,5,258,3,86
전라북도,임실군,오수면,합계,3327,2530,1674,88,614,26,89,0,0,3,0,3,1,3,12,2513,17,797
전라북도,임실군,오수면,관내사전투표,843,843,558,31,195,6,39,0,0,0,0,2,1,1,5,838,5,0
전라북도,임실군,오수면,오수면제1투,1196,810,555,25,181,7,33,0,0,1,0,0,0,0,4,806,4,386
전라북도,임실군,오수면,오수면제2투,1288,877,561,32,238,13,17,0,0,2,0,1,0,2,3,869,8,411
전라북도,임실군,신덕면,합계,1040,776,507,19,198,12,18,0,0,1,1,0,2,1,7,766,10,264
전라북도,임실군,신덕면,관내사전투표,196,196,142,5,36,5,7,0,0,0,0,0,0,0,0,195,1,0
전라북도,임실군,신덕면,신덕면투표소,844,580,365,14,162,7,11,0,0,1,1,0,2,1,7,571,9,264
전라북도,임실군,삼계면,합계,1223,895,576,31,227,10,34,0,1,0,0,0,1,3,7,890,5,328
전라북도,임실군,삼계면,관내사전투표,220,220,141,10,52,4,9,0,1,0,0,0,1,1,1,220,0,0
전라북도,임실군,삼계면,삼계면투표소,1003,675,435,21,175,6,25,0,0,0,0,0,0,2,6,670,5,328
전라북도,임실군,관촌면,합계,2947,2277,1379,87,627,46,100,0,0,1,1,2,1,0,14,2258,19,670
전라북도,임실군,관촌면,관내사전투표,1070,1070,676,44,264,24,47,0,0,0,1,0,0,0,6,1062,8,0
전라북도,임실군,관촌면,관촌면제1투,1188,750,433,36,222,14,33,0,0,0,0,2,0,0,7,747,3,438
전라북도,임실군,관촌면,관촌면제2투,689,457,270,7,141,8,20,0,0,1,0,0,1,0,1,449,8,232
전라북도,임실군,강진면,관내사전투표,308,308,201,7,82,1,13,0,0,1,0,1,0,1,1,308,0,0
전라북도,임실군,강진면,합계,1336,992,613,40,279,11,25,0,0,1,0,1,0,6,11,987,5,344
전라북도,임실군,강진면,강진면투표소,1028,684,412,33,197,10,12,0,0,0,0,0,0,5,10,679,5,344
전라북도,임실군,덕치면,합계,917,696,424,28,188,5,26,0,0,0,1,0,2,3,6,683,13,221
전라북도,임실군,덕치면,관내사전투표,140,140,91,1,33,0,12,0,0,0,0,0,0,0,1,138,2,0
전라북도,임실군,덕치면,덕치면제1투,479,345,204,15,95,4,12,0,0,0,1,0,2,1,4,338,7,134
전라북도,임실군,덕치면,덕치면제2투,298,211,129,12,60,1,2,0,0,0,0,0,0,2,1,207,4,87
전라북도,임실군,지사면,관내사전투표,179,179,114,10,49,2,4,0,0,0,0,0,0,0,0,179,0,0
전라북도,임실군,지사면,합계,1011,777,497,22,216,13,18,1,0,0,0,1,0,1,6,775,2,234
전라북도,임실군,지사면,지사면투표소,832,598,383,12,167,11,14,1,0,0,0,1,0,1,6,596,2,234
전라북도,임실군,잘못 투입·구분된 투표지,,0,0,0,0,0,0,0,0,0,0,0,0,0,0,0,0,0,0
전라북도,순창군,합계,,25319,20126,12309,688,5624,324,755,15,9,11,7,114,23,22,107,20008,118,5193
전라북도,순창군,거소·선상투표,,208,193,99,15,56,1,3,1,3,1,0,3,1,2,2,187,6,15
전라북도,순창군,관외사전투표,,3122,3122,1987,106,700,91,215,0,0,1,1,13,0,0,1,3115,7,0
전라북도,순창군,재외투표,,130,78,42,10,16,0,10,0,0,0,0,0,0,0,0,78,0,52
전라북도,순창군,순창읍,합계,7141,5553,3381,164,1620,95,221,5,0,3,1,20,2,1,16,5529,24,1588
전라북도,순창군,순창읍,관내사전투표,2016,2016,1325,47,492,26,98,2,0,1,0,7,1,1,7,2007,9,0
전라북도,순창군,순창읍,순창읍제1투,1529,1083,658,37,311,26,44,0,0,0,0,2,0,0,3,1081,2,446
전라북도,순창군,순창읍,순창읍제2투,1711,1152,666,42,367,26,34,1,0,1,1,6,1,0,3,1148,4,559
전라북도,순창군,순창읍,순창읍제3투,1885,1302,732,38,450,17,45,2,0,1,0,5,0,0,3,1293,9,583
전라북도,순창군,인계면,관내사전투표,287,287,177,12,84,3,3,0,0,0,0,1,0,2,2,284,3,0
전라북도,순창군,인계면,합계,1267,953,595,38,264,12,17,1,1,0,0,5,2,5,6,946,7,314
전라북도,순창군,인계면,인계면투표소,980,666,418,26,180,9,14,1,1,0,0,4,2,3,4,662,4,314
전라북도,순창군,동계면,합계,1703,1304,793,49,376,12,42,1,0,0,0,7,2,3,12,1297,7,399
전라북도,순창군,동계면,관내사전투표,461,461,300,9,124,4,17,0,0,0,0,2,0,2,1,459,2,0
전라북도,순창군,동계면,동계면제1투,799,551,333,26,158,3,12,1,0,0,0,3,2,1,7,546,5,248
전라북도,순창군,동계면,동계면제2투,443,292,160,14,94,5,13,0,0,0,0,2,0,0,4,292,0,151
전라북도,순창군,적성면,관내사전투표,355,355,228,16,86,5,10,0,0,0,0,3,3,0,2,353,2,0
전라북도,순창군,적성면,합계,1127,865,541,36,214,17,27,0,0,0,0,9,5,2,6,857,8,262
전라북도,순창군,적성면,적성면투표소,772,510,313,20,128,12,17,0,0,0,0,6,2,2,4,504,6,262
전라북도,순창군,유등면,합계,1001,732,464,21,180,14,32,0,0,0,0,8,1,1,4,725,7,269
전라북도,순창군,유등면,관내사전투표,217,217,155,10,32,2,13,0,0,0,0,2,0,0,1,215,2,0
전라북도,순창군,유등면,유등면투표소,784,515,309,11,148,12,19,0,0,0,0,6,1,1,3,510,5,269
전라북도,순창군,풍산면,관내사전투표,298,298,181,9,85,4,13,0,0,0,0,2,0,0,3,297,1,0
전라북도,순창군,풍산면,합계,1458,1138,726,35,294,9,28,0,1,4,0,17,2,0,13,1129,9,320
전라북도,순창군,풍산면,풍산면제1투,606,429,276,15,120,1,4,0,0,0,0,4,2,0,3,425,4,177
전라북도,순창군,풍산면,풍산면제2투,554,411,269,11,89,4,11,0,1,4,0,11,0,0,7,407,4,143
전라북도,순창군,금과면,관내사전투표,381,381,230,12,117,6,15,0,0,0,0,0,0,0,0,380,1,0
전라북도,순창군,금과면,합계,1398,1063,649,29,312,16,37,1,0,0,2,1,2,2,7,1058,5,335
전라북도,순창군,금과면,금과면투표소,1017,682,419,17,195,10,22,1,0,0,2,1,2,2,7,678,4,335
전라북도,순창군,팔덕면,관내사전투표,278,278,185,6,76,2,5,0,0,0,0,1,0,0,1,276,2,0
전라북도,순창군,팔덕면,합계,1217,924,583,30,265,8,26,0,0,0,0,2,1,0,3,918,6,293
전라북도,순창군,팔덕면,팔덕면투표소,939,646,398,24,189,6,21,0,0,0,0,1,1,0,2,642,4,293
전라북도,순창군,복흥면,합계,1838,1377,863,41,395,17,35,1,2,0,1,2,0,1,13,1371,6,461
전라북도,순창군,복흥면,관내사전투표,385,385,256,11,97,4,10,0,0,0,0,1,0,0,4,383,2,0
전라북도,순창군,복흥면,복흥면제1투,965,647,410,15,186,11,16,0,2,0,0,1,0,0,5,646,1,318
전라북도,순창군,복흥면,복흥면제2투,488,345,197,15,112,2,9,1,0,0,1,0,0,1,4,342,3,143
전라북도,순창군,쌍치면,관내사전투표,429,429,256,23,111,7,12,1,0,0,2,1,0,2,5,420,9,0
전라북도,순창군,쌍치면,합계,1663,1245,712,60,390,14,28,3,1,1,2,6,1,5,9,1232,13,418
전라북도,순창군,쌍치면,쌍치면제1투,678,436,262,20,130,2,11,2,1,1,0,1,1,2,1,434,2,242
전라북도,순창군,쌍치면,쌍치면제2투,556,380,194,17,149,5,5,0,0,0,0,4,0,1,3,378,2,176
전라북도,순창군,구림면,합계,2046,1579,874,54,542,18,34,2,1,1,0,21,4,0,15,1566,13,467
전라북도,순창군,구림면,관내사전투표,517,517,276,17,183,10,12,0,1,0,0,3,2,0,5,509,8,0
전라북도,순창군,구림면,구림면제1투,1017,681,380,21,243,4,13,2,0,0,0,7,1,0,8,679,2,336
전라북도,순창군,구림면,구림면제2투,512,381,218,16,116,4,9,0,0,1,0,11,1,0,2,378,3,131
전라북도,순창군,잘못 투입·구분된 투표지,,0,0,0,0,0,0,0,0,0,0,0,0,0,0,0,0,0,0
전라북도,고창군,합계,,50734,39188,23877,1215,11182,722,1433,31,20,30,11,95,47,53,183,38899,289,11546
전라북도,고창군,거소·선상투표,,241,223,119,12,66,4,6,2,2,0,0,0,0,0,2,213,10,18
전라북도,고창군,관외사전투표,,5175,5175,3308,155,1104,190,373,1,1,2,1,9,2,1,6,5153,22,0
전라북도,고창군,재외투표,,161,122,86,11,15,1,9,0,0,0,0,0,0,0,0,122,0,39
전라북도,고창군,고창읍,합계,14963,11345,7150,327,3095,238,430,7,1,7,0,13,4,3,19,11294,51,3618
전라북도,고창군,고창읍,관내사전투표,3949,3949,2618,91,899,115,204,0,0,0,0,5,1,0,4,3937,12,0
전라북도,고창군,고창읍,고창읍제1투,1293,833,506,32,243,7,34,1,0,1,0,1,0,0,2,827,6,460
전라북도,고창군,고창읍,고창읍제2투,1550,1050,715,24,240,27,38,0,0,0,0,1,0,1,1,1047,3,500
전라북도,고창군,고창읍,고창읍제3투,1817,1211,725,48,387,17,27,0,0,0,0,0,0,0,2,1206,5,606
전라북도,고창군,고창읍,고창읍제4투,1344,879,514,30,295,13,19,1,0,1,0,0,0,2,1,876,3,465
전라북도,고창군,고창읍,고창읍제5투,1094,709,400,31,234,11,19,0,0,1,0,2,2,0,4,704,5,385
전라북도,고창군,고창읍,고창읍제6투,1484,1056,629,25,334,19,32,1,1,1,0,2,1,0,4,1049,7,428
전라북도,고창군,고창읍,고창읍제7투,2432,1658,1043,46,463,29,57,4,0,3,0,2,0,0,1,1648,10,774
전라북도,고창군,고수면,관내사전투표,793,793,475,15,236,8,33,0,0,0,0,1,2,2,7,779,14,0
전라북도,고창군,고수면,합계,2148,1681,956,43,563,19,63,0,1,1,0,1,5,2,11,1665,16,467
전라북도,고창군,고수면,고수면제1투,636,401,221,13,144,5,13,0,1,0,0,0,1,0,3,401,0,235
전라북도,고창군,고수면,고수면제2투,719,487,260,15,183,6,17,0,0,1,0,0,2,0,1,485,2,232
전라북도,고창군,아산면,관내사전투표,664,664,385,30,190,12,24,0,1,0,0,12,0,1,6,661,3,0
전라북도,고창군,아산면,합계,2458,1826,1036,72,568,37,58,1,1,0,1,18,1,4,16,1813,13,632
전라북도,고창군,아산면,아산면제1투,1152,738,426,27,232,14,19,0,0,0,0,6,1,1,6,732,6,414
전라북도,고창군,아산면,아산면제2투,642,424,225,15,146,11,15,1,0,0,1,0,0,2,4,420,4,218
전라북도,고창군,무장면,관내사전투표,608,608,365,21,188,3,16,0,0,2,0,1,0,0,2,598,10,0
전라북도,고창군,무장면,합계,2487,1782,1074,64,553,12,38,1,0,3,0,7,2,3,10,1767,15,705
전라북도,고창군,무장면,무장면제1투,864,525,313,25,157,6,12,1,0,1,0,2,0,3,2,522,3,339
전라북도,고창군,무장면,무장면제2투,1015,649,396,18,208,3,10,0,0,0,0,4,2,0,6,647,2,366
전라북도,고창군,공음면,관내사전투표,623,623,361,15,196,7,19,1,0,0,0,6,1,1,10,617,6,0
전라북도,고창군,공음면,합계,2317,1716,968,40,592,16,42,2,1,1,0,14,2,3,15,1696,20,601
전라북도,고창군,공음면,공음면제1투,943,618,341,15,216,6,16,1,1,1,0,5,1,1,5,609,9,325
전라북도,고창군,공음면,공음면제2투,751,475,266,10,180,3,7,0,0,0,0,3,0,1,0,470,5,276
전라북도,고창군,상하면,관내사전투표,625,625,371,20,164,9,21,0,1,0,1,6,2,1,10,606,19,0
전라북도,고창군,상하면,합계,2189,1628,959,46,482,22,48,0,1,0,1,9,5,5,22,1600,28,561
전라북도,고창군,상하면,상하면제1투,723,477,281,17,148,6,11,0,0,0,0,2,1,1,7,474,3,246
전라북도,고창군,상하면,상하면제2투,841,526,307,9,170,7,16,0,0,0,0,1,2,3,5,520,6,315
전라북도,고창군,해리면,관내사전투표,764,764,466,22,228,14,17,1,0,0,0,1,1,0,9,759,5,0
전라북도,고창군,해리면,합계,2624,1921,1166,53,595,21,37,1,2,2,3,2,6,2,16,1906,15,703
전라북도,고창군,해리면,해리면제1투,1087,648,393,27,194,4,13,0,1,2,2,0,4,2,3,645,3,439
전라북도,고창군,해리면,해리면제2투,773,509,307,4,173,3,7,0,1,0,1,1,1,0,4,502,7,264
전라북도,고창군,성송면,합계,1670,1237,745,44,367,20,35,2,0,1,0,2,0,3,8,1227,10,433
전라북도,고창군,성송면,관내사전투표,400,400,244,19,114,4,15,0,0,1,0,0,0,1,0,398,2,0
전라북도,고창군,성송면,성송면제1투,747,512,311,14,152,11,10,2,0,0,0,2,0,2,4,508,4,235
전라북도,고창군,성송면,성송면제2투,523,325,190,11,101,5,10,0,0,0,0,0,0,0,4,321,4,198
전라북도,고창군,대산면,합계,3120,2272,1302,72,762,26,65,3,1,0,1,1,3,6,11,2253,19,848
전라북도,고창군,대산면,관내사전투표,774,774,470,29,227,11,24,0,0,0,0,1,0,2,2,766,8,0
전라북도,고창군,대산면,대산면제1투,1380,838,474,20,294,11,26,3,1,0,0,0,1,2,3,835,3,542
전라북도,고창군,대산면,대산면제2투,966,660,358,23,241,4,15,0,0,0,1,0,2,2,6,652,8,306
전라북도,고창군,심원면,합계,2272,1648,990,56,487,29,49,6,0,3,0,0,5,5,7,1637,11,624
전라북도,고창군,심원면,관내사전투표,598,598,358,19,177,10,23,2,0,1,0,0,3,2,2,597,1,0
전라북도,고창군,심원면,심원면제1투,890,542,327,18,153,11,17,2,0,2,0,0,2,3,2,537,5,348
전라북도,고창군,심원면,심원면제2투,784,508,305,19,157,8,9,2,0,0,0,0,0,0,3,503,5,276
전라북도,고창군,흥덕면,관내사전투표,698,698,467,22,158,9,28,0,0,1,0,3,0,1,2,691,7,0
전라북도,고창군,흥덕면,합계,2916,2169,1360,74,588,29,68,0,1,5,0,6,0,6,14,2151,18,747
전라북도,고창군,흥덕면,흥덕면제1투,1189,794,479,33,223,12,27,0,1,2,0,3,0,4,4,788,6,395
전라북도,고창군,흥덕면,흥덕면제2투,1029,677,414,19,207,8,13,0,0,2,0,0,0,1,8,672,5,352
전라북도,고창군,성내면,관내사전투표,571,571,349,21,156,7,22,1,1,1,0,3,2,0,4,567,4,0
전라북도,고창군,성내면,합계,1755,1320,784,40,394,13,51,2,6,2,0,7,5,1,6,1311,9,435
전라북도,고창군,성내면,성내면제1투,613,384,210,14,125,3,21,1,4,0,0,0,1,1,2,382,2,229
전라북도,고창군,성내면,성내면제2투,571,365,225,5,113,3,8,0,1,1,0,4,2,0,0,362,3,206
전라북도,고창군,신림면,합계,1908,1386,870,41,393,22,26,2,0,0,0,3,2,4,13,1376,10,522
전라북도,고창군,신림면,관내사전투표,508,508,315,13,147,9,13,0,0,0,0,1,2,1,3,504,4,0
전라북도,고창군,신림면,신림면제1투,823,498,323,16,131,5,5,1,0,0,0,1,0,3,8,493,5,325
전라북도,고창군,신림면,신림면제2투,577,380,232,12,115,8,8,1,0,0,0,1,0,0,2,379,1,197
전라북도,고창군,부안면,합계,2330,1737,1004,65,558,23,35,1,2,3,4,3,5,5,7,1715,22,593
전라북도,고창군,부안면,관내사전투표,661,661,386,17,213,6,16,0,1,1,4,0,2,2,3,651,10,0
전라북도,고창군,부안면,부안면제1투,915,586,332,29,185,10,14,1,1,1,0,1,1,2,4,581,5,329
전라북도,고창군,부안면,부안면제2투,754,490,286,19,160,7,5,0,0,1,0,2,2,1,0,483,7,264
전라북도,고창군,잘못 투입·구분된 투표지,,0,0,0,0,0,0,0,0,0,0,0,0,0,0,0,0,0,0
전라북도,부안군,합계,,49026,36647,22482,1507,9837,695,1622,10,11,40,10,27,27,29,128,36425,222,12379
전라북도,부안군,거소·선상투표,,184,164,73,16,54,5,0,1,2,0,0,1,0,1,1,154,10,20
전라북도,부안군,관외사전투표,,4943,4943,3119,199,1040,170,366,2,0,3,2,7,2,1,10,4921,22,0
전라북도,부안군,재외투표,,164,128,83,8,17,4,16,0,0,0,0,0,0,0,0,128,0,36
전라북도,부안군,부안읍,관내사전투표,4317,4317,2776,149,1005,100,247,2,0,4,0,3,1,1,6,4294,23,0
전라북도,부안군,부안읍,합계,15735,11514,7138,461,3044,231,540,3,1,13,1,5,5,8,17,11467,47,4221
전라북도,부안군,부안읍,부안읍제1투,1076,619,346,39,210,9,12,0,0,0,0,1,1,1,0,619,0,457
전라북도,부안군,부안읍,부안읍제2투,1014,667,390,42,195,12,21,0,0,2,0,0,0,1,1,664,3,347
전라북도,부안군,부안읍,부안읍제3투,1975,1230,755,62,325,20,55,0,0,1,0,0,1,1,1,1221,9,745
전라북도,부안군,부안읍,부안읍제4투,1676,1000,597,39,288,14,55,0,0,3,0,0,1,0,0,997,3,676
전라북도,부안군,부안읍,부안읍제5투,2124,1343,842,57,355,25,54,1,0,1,1,0,0,1,5,1342,1,781
전라북도,부안군,부안읍,부안읍제6투,2657,1737,1064,53,486,41,85,0,1,1,0,0,0,1,1,1733,4,920
전라북도,부안군,부안읍,부안읍제7투,896,601,368,20,180,10,11,0,0,1,0,1,1,2,3,597,4,295
전라북도,부안군,주산면,합계,1819,1293,763,42,421,11,32,1,1,3,1,0,1,2,5,1283,10,526
전라북도,부안군,주산면,관내사전투표,427,427,269,12,123,3,13,1,1,1,1,0,0,0,1,425,2,0
전라북도,부안군,주산면,주산면투표소,1392,866,494,30,298,8,19,0,0,2,0,0,1,2,4,858,8,526
전라북도,부안군,동진면,관내사전투표,367,367,210,16,112,8,16,0,1,0,0,0,0,1,1,365,2,0
전라북도,부안군,동진면,합계,2546,1770,1118,81,451,22,66,0,2,0,1,1,0,2,12,1756,14,776
전라북도,부안군,동진면,동진면제1투,1007,628,408,29,149,10,26,0,0,0,0,0,0,0,1,623,5,379
전라북도,부안군,동진면,동진면제2투,485,313,198,18,76,2,10,0,1,0,0,0,0,0,4,309,4,172
전라북도,부안군,동진면,동진면제3투,687,462,302,18,114,2,14,0,0,0,1,1,0,1,6,459,3,225
전라북도,부안군,행안면,합계,2210,1644,1005,70,445,28,75,0,3,1,0,0,0,3,6,1636,8,566
전라북도,부안군,행안면,관내사전투표,723,723,459,27,171,17,46,0,0,0,0,0,0,0,2,722,1,0
전라북도,부안군,행안면,행안면투표소,1487,921,546,43,274,11,29,0,3,1,0,0,0,3,4,914,7,566
전라북도,부안군,계화면,관내사전투표,481,481,293,13,129,8,31,1,0,0,0,1,1,0,2,479,2,0
전라북도,부안군,계화면,합계,3229,2319,1412,82,676,24,81,1,0,2,2,3,3,2,13,2301,18,910
전라북도,부안군,계화면,계화면제1투,892,560,357,27,148,5,14,0,0,0,0,1,0,2,3,557,3,332
전라북도,부안군,계화면,계화면제2투,728,507,332,18,131,3,15,0,0,2,0,0,0,0,2,503,4,221
전라북도,부안군,계화면,계화면제3투,677,454,227,8,187,6,14,0,0,0,0,0,2,0,2,446,8,223
전라북도,부안군,계화면,계화면제4투,451,317,203,16,81,2,7,0,0,0,2,1,0,0,4,316,1,134
전라북도,부안군,보안면,관내사전투표,426,426,242,12,128,13,24,0,0,0,0,1,0,0,2,422,4,0
전라북도,부안군,보안면,합계,2251,1596,881,60,532,33,64,0,0,3,0,1,0,1,8,1583,13,655
전라북도,부안군,보안면,보안면제1투,1097,682,356,31,252,12,16,0,0,3,0,0,0,1,4,675,7,415
전라북도,부안군,보안면,보안면제2투,728,488,283,17,152,8,24,0,0,0,0,0,0,0,2,486,2,240
전라북도,부안군,변산면,관내사전투표,685,685,418,34,168,18,33,1,1,0,0,0,0,1,6,680,5,0
전라북도,부안군,변산면,합계,3800,2681,1602,106,763,51,114,1,1,4,0,2,3,4,14,2665,16,1119
전라북도,부안군,변산면,변산면제1투,1313,819,457,38,263,12,34,0,0,1,0,0,3,3,5,816,3,494
전라북도,부안군,변산면,변산면제2투,1802,1177,727,34,332,21,47,0,0,3,0,2,0,0,3,1169,8,625
전라북도,부안군,진서면,합계,2086,1490,880,61,447,31,50,0,0,1,0,0,2,2,4,1478,12,596
전라북도,부안군,진서면,관내사전투표,358,358,206,15,106,12,16,0,0,1,0,0,0,0,0,356,2,0
전라북도,부안군,진서면,진서면제1투,1040,652,394,25,199,8,17,0,0,0,0,0,2,1,1,647,5,388
전라북도,부안군,진서면,진서면제2투,688,480,280,21,142,11,17,0,0,0,0,0,0,1,3,475,5,208
전라북도,부안군,백산면,합계,2332,1675,1065,67,443,21,48,0,0,4,1,1,3,1,6,1660,15,657
전라북도,부안군,백산면,관내사전투표,491,491,306,17,133,1,20,0,0,3,0,1,0,0,4,485,6,0
전라북도,부안군,백산면,백산면제1투,1070,673,447,29,163,11,15,0,0,1,0,0,1,0,1,668,5,397
전라북도,부안군,백산면,백산면제2투,771,511,312,21,147,9,13,0,0,0,1,0,2,1,1,507,4,260
전라북도,부안군,상서면,합계,1938,1364,823,59,388,15,56,1,0,2,1,1,1,0,8,1355,9,574
전라북도,부안군,상서면,관내사전투표,459,459,286,23,109,4,32,0,0,2,1,1,0,0,1,459,0,0
전라북도,부안군,상서면,상서면투표소,1479,905,537,36,279,11,24,1,0,0,0,0,1,0,7,896,9,574
전라북도,부안군,하서면,합계,2469,1743,1096,76,478,23,39,0,0,3,0,1,3,1,10,1730,13,726
전라북도,부안군,하서면,관내사전투표,578,578,363,29,156,5,18,0,0,2,0,0,1,0,1,575,3,0
전라북도,부안군,하서면,하서면제1투,719,416,265,15,112,5,9,0,0,0,0,1,1,0,2,410,6,303
전라북도,부안군,하서면,하서면제2투,585,388,230,20,114,9,6,0,0,0,0,0,1,1,5,386,2,197
전라북도,부안군,하서면,하서면제3투,587,361,238,12,96,4,6,0,0,1,0,0,0,0,2,359,2,226
전라북도,부안군,줄포면,합계,2403,1722,1064,101,457,23,56,0,1,1,1,2,3,0,6,1715,7,681
전라북도,부안군,줄포면,관내사전투표,539,539,333,33,132,12,24,0,0,1,0,0,1,0,1,537,2,0
전라북도,부안군,줄포면,줄포면제1투,1265,801,489,51,225,5,21,0,0,0,0,2,1,0,3,797,4,464
전라북도,부안군,줄포면,줄포면제2투,599,382,242,17,100,6,11,0,1,0,1,0,1,0,2,381,1,217
전라북도,부안군,위도면,합계,917,601,360,18,181,3,19,0,0,0,0,2,1,1,8,593,8,316
전라북도,부안군,위도면,관내사전투표,215,215,142,6,54,1,6,0,0,0,0,1,0,0,3,213,2,0
전라북도,부안군,위도면,위도면제1투,557,312,189,10,88,2,12,0,0,0,0,1,0,1,5,308,4,245
전라북도,부안군,위도면,위도면제2투,145,74,29,2,39,0,1,0,0,0,0,0,1,0,0,72,2,71
전라북도,부안군,잘못 투입·구분된 투표지,,0,0,0,0,0,0,0,0,0,0,0,0,0,0,0,0,0,0
전라남도,합계,,,1572838,1238738,737921,30221,378179,25819,49509,454,272,1319,315,3817,839,782,2965,1232412,6326,334100
전라남도,목포시,합계,,187620,145476,77896,2584,53303,3013,7529,60,21,93,21,216,47,36,142,144961,515,42144
전라남도,목포시,거소·선상투표,,831,784,403,23,274,37,28,3,2,1,2,3,0,1,3,780,4,47
전라남도,목포시,관외사전투표,,15591,15591,9419,330,3937,576,1151,6,8,8,2,29,2,4,21,15493,98,0
전라남도,목포시,재외투표,,618,458,329,7,64,9,46,1,0,0,0,0,0,1,0,457,1,160
전라남도,목포시,용당1동,합계,9636,6902,3187,162,3157,100,237,1,2,2,0,8,4,4,10,6874,28,2734
전라남도,목포시,용당1동,관내사전투표,2179,2179,1040,36,957,38,89,0,0,2,0,2,0,1,3,2168,11,0
전라남도,목포시,용당1동,용당1동제1투,1998,1322,625,25,612,17,32,0,1,0,0,2,1,2,2,1319,3,676
전라남도,목포시,용당1동,용당1동제2투,1857,1092,492,34,510,16,34,0,0,0,0,1,0,0,2,1089,3,765
전라남도,목포시,용당1동,용당1동제3투,1728,1161,526,28,543,15,43,0,0,0,0,0,1,0,0,1156,5,567
전라남도,목포시,용당1동,용당1동제4투,1874,1148,504,39,535,14,39,1,1,0,0,3,2,1,3,1142,6,726
전라남도,목포시,용당2동,합계,4911,3508,1631,65,1603,57,119,1,0,1,2,5,1,2,3,3490,18,1403
전라남도,목포시,용당2동,관내사전투표,1310,1310,638,12,581,24,43,0,0,0,1,2,0,2,1,1304,6,0
전라남도,목포시,용당2동,용당2동제1투,1958,1206,519,31,588,18,42,0,0,0,1,2,0,0,1,1202,4,752
전라남도,목포시,용당2동,용당2동제2투,1643,992,474,22,434,15,34,1,0,1,0,1,1,0,1,984,8,651
전라남도,목포시,연동,합계,4425,3089,1332,67,1525,51,79,2,0,1,0,2,3,1,7,3070,19,1336
전라남도,목포시,연동,관내사전투표,1082,1082,464,26,522,15,38,1,0,0,0,1,3,1,3,1074,8,0
전라남도,목포시,연동,연동제1투,1614,873,338,29,461,19,15,1,0,1,0,1,0,0,1,866,7,741
전라남도,목포시,연동,연동제2투,1729,1134,530,12,542,17,26,0,0,0,0,0,0,0,3,1130,4,595
전라남도,목포시,산정동,합계,6528,5001,2601,103,1934,92,232,2,0,5,0,5,3,3,7,4987,14,1527
전라남도,목포시,산정동,관내사전투표,1970,1970,1039,32,748,38,93,0,0,2,0,2,2,3,3,1962,8,0
전라남도,목포시,산정동,산정동제1투,2261,1438,741,33,552,31,74,1,0,2,0,1,1,0,0,1436,2,823
전라남도,목포시,산정동,산정동제2투,2297,1593,821,38,634,23,65,1,0,1,0,2,0,0,4,1589,4,704
전라남도,목포시,연산동,합계,4556,3631,1989,54,1291,61,202,1,1,2,1,9,2,1,5,3619,12,925
전라남도,목포시,연산동,관내사전투표,1518,1518,840,21,522,22,91,0,1,1,1,5,1,0,2,1507,11,0
전라남도,목포시,연산동,연산동제1투,1589,1045,554,19,400,13,53,0,0,0,0,2,0,0,3,1044,1,544
전라남도,목포시,연산동,연산동제2투,1449,1068,595,14,369,26,58,1,0,1,0,2,1,1,0,1068,0,381
전라남도,목포시,원산동,합계,10204,7597,4059,138,2761,153,433,3,0,6,1,9,1,0,8,7572,25,2607
전라남도,목포시,원산동,관내사전투표,2410,2410,1311,41,830,52,154,0,0,3,1,6,0,0,4,2402,8,0
전라남도,목포시,원산동,원산동제1투,1524,933,453,15,396,22,37,1,0,0,0,2,0,0,1,927,6,591
전라남도,목포시,원산동,원산동제2투,2090,1456,843,26,471,30,81,1,0,0,0,1,0,0,2,1455,1,634
전라남도,목포시,원산동,원산동제3투,2323,1496,770,31,590,26,67,1,0,2,0,0,0,0,1,1488,8,827
전라남도,목포시,원산동,원산동제4투,1857,1302,682,25,474,23,94,0,0,1,0,0,1,0,0,1300,2,555
전라남도,목포시,대성동,합계,4285,3267,1759,55,1229,48,150,3,1,2,0,4,0,1,1,3253,14,1018
전라남도,목포시,대성동,관내사전투표,1392,1392,744,31,507,30,68,1,0,2,0,3,0,0,0,1386,6,0
전라남도,목포시,대성동,대성동투표소,2893,1875,1015,24,722,18,82,2,1,0,0,1,0,1,1,1867,8,1018
전라남도,목포시,목원동,합계,7667,5295,2345,108,2553,67,183,0,0,5,1,7,1,1,7,5278,17,2372
전라남도,목포시,목원동,관내사전투표,2054,2054,950,32,941,32,85,0,0,3,1,2,1,0,2,2049,5,0
전라남도,목포시,목원동,목원동제1투,1805,1115,519,23,515,7,39,0,0,2,0,1,0,0,3,1109,6,690
전라남도,목포시,목원동,목원동제2투,1871,1040,427,29,521,22,37,0,0,0,0,0,0,1,1,1038,2,831
전라남도,목포시,목원동,목원동제3투,1937,1086,449,24,576,6,22,0,0,0,0,4,0,0,1,1082,4,851
전라남도,목포시,동명동,합계,5082,3606,1595,65,1732,55,119,0,0,4,0,2,3,1,3,3579,27,1476
전라남도,목포시,동명동,관내사전투표,1157,1157,507,22,552,20,41,0,0,0,0,0,2,1,2,1147,10,0
전라남도,목포시,동명동,동명동제1투,2027,1205,545,24,570,15,40,0,0,3,0,0,0,0,0,1197,8,822
전라남도,목포시,동명동,동명동제2투,1898,1244,543,19,610,20,38,0,0,1,0,2,1,0,1,1235,9,654
전라남도,목포시,삼학동,관내사전투표,1750,1750,892,17,726,27,77,0,0,1,0,5,0,0,0,1745,5,0
전라남도,목포시,삼학동,합계,5280,4099,2045,40,1745,60,185,2,0,2,0,8,1,1,0,4089,10,1181
전라남도,목포시,삼학동,삼학동제1투,1909,1256,653,9,496,22,65,2,0,1,0,3,0,1,0,1252,4,653
전라남도,목포시,삼학동,삼학동제2투,1621,1093,500,14,523,11,43,0,0,0,0,0,1,0,0,1092,1,528
전라남도,목포시,만호동,합계,3057,1916,810,19,986,24,55,0,0,0,1,3,3,1,6,1908,8,1141
전라남도,목포시,만호동,관내사전투표,742,742,327,3,362,11,29,0,0,0,0,3,1,0,2,738,4,0
전라남도,목포시,만호동,만호동투표소,2315,1174,483,16,624,13,26,0,0,0,1,0,2,1,4,1170,4,1141
전라남도,목포시,유달동,합계,4685,3173,1432,66,1478,44,93,3,1,3,0,5,6,1,13,3145,28,1512
전라남도,목포시,유달동,관내사전투표,1285,1285,604,33,567,18,38,1,0,2,0,2,0,1,4,1270,15,0
전라남도,목포시,유달동,유달동제1투,1541,813,368,16,384,13,25,0,0,0,0,1,2,0,0,809,4,728
전라남도,목포시,유달동,유달동제2투,1370,752,334,6,360,11,24,0,1,1,0,2,3,0,7,749,3,618
전라남도,목포시,유달동,유달동제3투,155,117,42,3,58,0,4,2,0,0,0,0,1,0,1,111,6,38
전라남도,목포시,유달동,유달동제4투,188,106,40,8,53,2,2,0,0,0,0,0,0,0,1,106,0,82
전라남도,목포시,유달동,유달동제5투,146,100,44,0,56,0,0,0,0,0,0,0,0,0,0,100,0,46
전라남도,목포시,죽교동,합계,3180,2219,1012,53,977,37,97,14,0,3,0,4,1,1,3,2202,17,961
전라남도,목포시,죽교동,관내사전투표,901,901,425,18,373,20,46,10,0,1,0,1,0,1,1,896,5,0
전라남도,목포시,죽교동,죽교동제1투,1064,607,265,11,297,3,21,0,0,1,0,3,0,0,0,601,6,457
전라남도,목포시,죽교동,죽교동제2투,1215,711,322,24,307,14,30,4,0,1,0,0,1,0,2,705,6,504
전라남도,목포시,북항동,합계,8057,6062,3177,110,2312,106,320,3,0,1,1,12,1,0,3,6046,16,1995
전라남도,목포시,북항동,관내사전투표,2319,2319,1243,42,842,50,133,0,0,0,1,4,1,0,2,2318,1,0
전라남도,목포시,북항동,북항동제1투,2980,2017,1101,33,735,30,110,1,0,0,0,2,0,0,0,2012,5,963
전라남도,목포시,북항동,북항동제2투,1400,835,407,15,345,14,45,1,0,1,0,1,0,0,0,829,6,565
전라남도,목포시,북항동,북항동제3투,1358,891,426,20,390,12,32,1,0,0,0,5,0,0,1,887,4,467
전라남도,목포시,용해동,합계,12453,9472,5322,149,3250,172,524,2,1,3,4,10,1,3,6,9447,25,2981
전라남도,목포시,용해동,관내사전투표,3329,3329,1983,50,1024,75,172,1,0,1,4,2,0,0,3,3315,14,0
전라남도,목포시,용해동,용해동제1투,809,523,235,16,230,10,29,0,0,1,0,0,0,0,0,521,2,286
전라남도,목포시,용해동,용해동제2투,1383,870,435,27,356,10,41,0,0,0,0,0,0,1,0,870,0,513
전라남도,목포시,용해동,용해동제3투,2224,1546,878,12,533,27,88,0,1,0,0,2,0,1,0,1542,4,678
전라남도,목포시,용해동,용해동제4투,2679,1777,964,29,636,26,111,0,0,1,0,5,1,0,2,1775,2,902
전라남도,목포시,용해동,용해동제5투,2029,1427,827,15,471,24,83,1,0,0,0,1,0,1,1,1424,3,602
전라남도,목포시,이로동,합계,7332,5808,3029,102,2230,123,286,0,0,5,1,11,1,2,5,5795,13,1524
전라남도,목포시,이로동,관내사전투표,1917,1917,987,30,737,43,105,0,0,2,1,4,0,1,2,1912,5,0
전라남도,목포시,이로동,이로동제1투,1463,987,479,30,419,21,33,0,0,0,0,1,1,0,2,986,1,476
전라남도,목포시,이로동,이로동제2투,1582,1082,521,26,462,19,50,0,0,0,0,2,0,0,0,1080,2,500
전라남도,목포시,이로동,이로동제3투,2370,1822,1042,16,612,40,98,0,0,3,0,4,0,1,1,1817,5,548
전라남도,목포시,상동,합계,12982,9871,5225,159,3760,198,442,6,1,10,1,13,7,0,9,9831,40,3111
전라남도,목포시,상동,관내사전투표,2977,2976,1531,55,1156,59,141,3,1,4,0,6,5,0,1,2962,14,1
전라남도,목포시,상동,상동제1투,1400,801,392,11,347,13,33,0,0,1,0,1,1,0,1,800,1,599
전라남도,목포시,상동,상동제2투,1391,868,453,8,346,24,28,0,0,1,0,0,1,0,3,864,4,523
전라남도,목포시,상동,상동제3투,1307,699,297,22,336,9,23,0,0,1,0,0,0,0,2,690,9,608
전라남도,목포시,상동,상동제4투,4268,3362,1910,39,1149,75,166,3,0,3,1,5,0,0,1,3352,10,906
전라남도,목포시,상동,상동제5투,1639,1165,642,24,426,18,51,0,0,0,0,1,0,0,1,1163,2,474
전라남도,목포시,하당동,합계,9381,6709,3748,127,2193,165,427,1,2,9,1,16,1,1,0,6691,18,2672
전라남도,목포시,하당동,관내사전투표,2965,2965,1701,39,917,86,188,0,2,7,1,8,1,1,0,2951,14,0
전라남도,목포시,하당동,하당동제1투,1854,921,489,25,326,23,55,0,0,0,0,0,0,0,0,918,3,933
전라남도,목포시,하당동,하당동제2투,2653,1311,700,39,463,22,85,0,0,0,0,2,0,0,0,1311,0,1342
전라남도,목포시,하당동,하당동제3투,1909,1512,858,24,487,34,99,1,0,2,0,6,0,0,0,1511,1,397
전라남도,목포시,신흥동,합계,12256,9740,5417,133,3383,210,552,3,1,4,2,11,3,3,9,9731,9,2516
전라남도,목포시,신흥동,관내사전투표,3312,3312,1891,42,1080,67,217,0,1,0,1,5,1,1,4,3310,2,0
전라남도,목포시,신흥동,신흥동제1투,2127,1507,848,19,532,35,68,0,0,0,0,1,0,2,1,1506,1,620
전라남도,목포시,신흥동,신흥동제2투,1889,1354,741,21,489,28,67,0,0,0,0,3,1,0,2,1352,2,535
전라남도,목포시,신흥동,신흥동제3투,2328,1730,967,22,596,46,91,0,0,1,1,0,1,0,2,1727,3,598
전라남도,목포시,신흥동,신흥동제4투,2600,1837,970,29,686,34,109,3,0,3,0,2,0,0,0,1836,1,763
전라남도,목포시,삼향동,합계,4035,3097,1684,51,1134,56,156,0,0,3,0,2,0,1,2,3089,8,938
전라남도,목포시,삼향동,관내사전투표,1237,1237,710,16,426,26,55,0,0,1,0,1,0,0,2,1237,0,0
전라남도,목포시,삼향동,삼향동제1투,1375,925,476,10,358,13,61,0,0,1,0,0,0,1,0,920,5,450
전라남도,목포시,삼향동,삼향동제2투,1423,935,498,25,350,17,40,0,0,1,0,1,0,0,0,932,3,488
전라남도,목포시,옥암동,합계,7896,6445,3696,92,2154,117,356,1,0,3,1,10,0,0,3,6433,12,1451
전라남도,목포시,옥암동,관내사전투표,2865,2865,1711,38,879,58,165,0,0,1,1,4,0,0,1,2858,7,0
전라남도,목포시,옥암동,옥암동제1투,2627,1891,1097,31,627,34,95,0,0,0,0,5,0,0,0,1889,2,736
전라남도,목포시,옥암동,옥암동제2투,2404,1689,888,23,648,25,96,1,0,2,0,1,0,0,2,1686,3,715
전라남도,목포시,부흥동,합계,8463,6669,3713,111,2246,137,419,1,0,7,0,10,2,2,3,6651,18,1794
전라남도,목포시,부흥동,관내사전투표,2832,2832,1637,42,875,69,188,1,0,5,0,6,1,0,2,2826,6,0
전라남도,목포시,부흥동,부흥동제1투,1983,1258,676,23,458,20,73,0,0,1,0,1,1,0,1,1254,4,725
전라남도,목포시,부흥동,부흥동제2투,1602,1054,585,18,348,19,76,0,0,1,0,2,0,2,0,1051,3,548
전라남도,목포시,부흥동,부흥동제3투,2046,1525,815,28,565,29,82,0,0,0,0,1,0,0,0,1520,5,521
전라남도,목포시,부주동,관내사전투표,4100,4100,2558,60,1120,88,258,0,1,1,0,6,0,0,0,4092,8,0
전라남도,목포시,부주동,합계,14229,11467,6937,195,3395,258,638,1,1,3,0,18,0,0,5,11451,16,2762
전라남도,목포시,부주동,부주동제1투,3554,2701,1645,41,806,54,149,0,0,0,0,2,0,0,2,2699,2,853
전라남도,목포시,부주동,부주동제2투,3613,2591,1476,53,850,75,126,1,0,1,0,3,0,0,1,2586,5,1022
전라남도,목포시,부주동,부주동제3투,2962,2075,1258,41,619,41,105,0,0,1,0,7,0,0,2,2074,1,887
전라남도,목포시,잘못 투입·구분된 투표지,,0,0,0,0,0,0,0,0,0,0,0,0,0,0,0,0,0,0
전라남도,여수시,합계,,235605,185487,117586,4281,50228,4207,7384,48,20,148,26,441,78,60,283,184790,697,50118
전라남도,여수시,거소·선상투표,,876,807,452,39,215,35,28,2,0,1,3,6,1,1,2,785,22,69
전라남도,여수시,관외사전투표,,17631,17628,11236,464,3701,842,1195,3,5,9,2,39,7,1,29,17533,95,3
전라남도,여수시,재외투표,,992,733,515,17,105,18,72,2,0,0,0,2,0,0,0,731,2,259
전라남도,여수시,돌산읍,합계,10251,7085,4176,181,2364,97,168,4,0,6,1,20,3,8,20,7048,37,3166
전라남도,여수시,돌산읍,관내사전투표,954,954,565,32,307,15,18,0,0,2,0,5,1,1,1,947,7,0
전라남도,여수시,돌산읍,돌산읍제1투,983,573,328,10,204,9,13,1,0,4,0,0,0,1,2,572,1,410
전라남도,여수시,돌산읍,돌산읍제2투,816,524,307,13,187,4,6,0,0,0,0,1,0,1,0,519,5,292
전라남도,여수시,돌산읍,돌산읍제3투,1595,1095,672,25,356,8,16,2,0,0,1,0,0,2,6,1088,7,500
전라남도,여수시,돌산읍,돌산읍제4투,1260,866,511,19,291,12,22,0,0,0,0,3,1,1,3,863,3,394
전라남도,여수시,돌산읍,돌산읍제5투,1178,784,473,16,261,7,13,0,0,0,0,4,0,1,5,780,4,394
전라남도,여수시,돌산읍,돌산읍제6투,3465,2289,1320,66,758,42,80,1,0,0,0,7,1,1,3,2279,10,1176
전라남도,여수시,소라면,관내사전투표,2364,2364,1562,46,585,46,95,1,1,4,3,10,1,1,5,2360,4,0
전라남도,여수시,소라면,합계,12269,9136,5841,205,2488,145,336,3,1,12,3,32,3,2,28,9099,37,3133
전라남도,여수시,소라면,소라면제1투,1366,885,514,29,291,9,26,0,0,2,0,2,0,1,5,879,6,481
전라남도,여수시,소라면,소라면제2투,823,561,352,17,161,10,13,0,0,0,0,0,0,0,4,557,4,262
전라남도,여수시,소라면,소라면제3투,1151,728,439,13,236,5,21,0,0,1,0,3,1,0,5,724,4,423
전라남도,여수시,소라면,소라면제4투,914,592,335,20,201,7,12,1,0,1,0,0,0,0,6,583,9,322
전라남도,여수시,소라면,소라면제5투,2495,1681,1117,34,421,22,73,1,0,3,0,4,0,0,3,1678,3,814
전라남도,여수시,소라면,소라면제6투,3156,2325,1522,46,593,46,96,0,0,1,0,13,1,0,0,2318,7,831
전라남도,여수시,율촌면,합계,5282,3830,2336,112,1163,63,92,1,0,0,1,16,3,3,18,3808,22,1452
전라남도,여수시,율촌면,관내사전투표,1268,1268,749,29,407,27,35,0,0,0,1,7,0,1,5,1261,7,0
전라남도,여수시,율촌면,율촌면제1투,2255,1402,858,38,419,28,38,1,0,0,0,6,1,2,2,1393,9,853
전라남도,여수시,율촌면,율촌면제2투,769,512,326,29,138,5,5,0,0,0,0,2,1,0,4,510,2,257
전라남도,여수시,율촌면,율촌면제3투,806,501,312,9,152,3,12,0,0,0,0,1,1,0,7,497,4,305
전라남도,여수시,율촌면,율촌면제4투,184,147,91,7,47,0,2,0,0,0,0,0,0,0,0,147,0,37
전라남도,여수시,화양면,합계,5376,3649,2089,91,1229,64,86,3,3,4,2,11,9,4,20,3615,34,1727
전라남도,여수시,화양면,관내사전투표,996,996,586,28,314,16,36,2,1,0,1,3,2,0,4,993,3,0
전라남도,여수시,화양면,화양면제1투,1246,746,396,19,280,12,22,0,0,1,0,1,2,0,3,736,10,500
전라남도,여수시,화양면,화양면제2투,930,597,351,11,199,10,10,0,0,1,1,5,2,3,3,596,1,333
전라남도,여수시,화양면,화양면제3투,1166,718,383,19,263,14,8,1,2,2,0,2,2,1,7,704,14,448
전라남도,여수시,화양면,화양면제4투,1038,592,373,14,173,12,10,0,0,0,0,0,1,0,3,586,6,446
전라남도,여수시,남면,합계,2415,1769,1046,45,578,13,37,3,0,2,2,0,3,5,16,1750,19,646
전라남도,여수시,남면,관내사전투표,507,507,293,14,165,3,22,2,0,1,1,0,0,0,2,503,4,0
전라남도,여수시,남면,남면제1투,735,397,220,10,148,5,1,0,0,0,1,0,1,2,3,391,6,338
전라남도,여수시,남면,남면제2투,142,104,68,4,29,1,0,0,0,1,0,0,0,0,0,103,1,38
전라남도,여수시,남면,남면제3투,265,212,141,4,58,1,3,0,0,0,0,0,1,0,3,211,1,53
전라남도,여수시,남면,남면제4투,109,88,66,0,21,0,0,0,0,0,0,0,0,0,1,88,0,21
전라남도,여수시,남면,남면제5투,303,201,110,5,70,2,7,0,0,0,0,0,1,0,3,198,3,102
전라남도,여수시,남면,남면제6투,354,260,148,8,87,1,4,1,0,0,0,0,0,3,4,256,4,94
전라남도,여수시,화정면,합계,1872,1364,882,34,375,9,15,0,2,3,0,6,4,5,15,1350,14,508
전라남도,여수시,화정면,관내사전투표,217,217,130,8,64,4,6,0,1,0,0,1,0,1,1,216,1,0
전라남도,여수시,화정면,화정면제1투,155,102,73,2,20,0,2,0,0,1,0,0,2,0,2,102,0,53
전라남도,여수시,화정면,화정면제2투,535,357,241,9,89,2,4,0,0,1,0,0,0,2,3,351,6,178
전라남도,여수시,화정면,화정면제3투,207,140,89,0,46,1,0,0,1,0,0,1,0,0,1,139,1,67
전라남도,여수시,화정면,화정면제4투,54,44,33,1,8,0,0,0,0,0,0,0,1,1,0,44,0,10
전라남도,여수시,화정면,화정면제5투,227,184,115,7,52,0,1,0,0,0,0,2,0,1,3,181,3,43
전라남도,여수시,화정면,화정면제6투,22,19,15,0,4,0,0,0,0,0,0,0,0,0,0,19,0,3
전라남도,여수시,화정면,화정면제7투,86,59,32,2,22,0,0,0,0,1,0,0,0,0,1,58,1,27
전라남도,여수시,화정면,화정면제8투,185,112,79,3,24,1,2,0,0,0,0,2,0,0,0,111,1,73
전라남도,여수시,화정면,화정면제9투,78,58,38,1,17,1,0,0,0,0,0,0,0,0,1,58,0,20
전라남도,여수시,화정면,화정면제10투,37,23,13,0,9,0,0,0,0,0,0,0,0,0,0,22,1,14
전라남도,여수시,화정면,화정면제11투,33,26,11,0,12,0,0,0,0,0,0,0,0,0,3,26,0,7
전라남도,여수시,화정면,화정면제12투,36,23,13,1,8,0,0,0,0,0,0,0,1,0,0,23,0,13
전라남도,여수시,삼산면,합계,1606,1065,656,43,304,23,23,1,1,3,0,0,2,0,3,1059,6,541
전라남도,여수시,삼산면,관내사전투표,314,314,224,6,67,9,8,0,0,0,0,0,0,0,0,314,0,0
전라남도,여수시,삼산면,삼산면제1투,278,124,85,9,24,2,2,0,0,0,0,0,0,0,0,122,2,154
전라남도,여수시,삼산면,삼산면제2투,170,110,63,5,35,0,3,0,0,1,0,0,0,0,1,108,2,60
전라남도,여수시,삼산면,삼산면제3투,216,137,82,4,39,6,2,0,1,1,0,0,0,0,1,136,1,79
전라남도,여수시,삼산면,삼산면제4투,181,127,82,6,36,2,1,0,0,0,0,0,0,0,0,127,0,54
전라남도,여수시,삼산면,삼산면제5투,282,166,87,9,58,4,5,0,0,1,0,0,2,0,0,166,0,116
전라남도,여수시,삼산면,삼산면제6투,165,87,33,4,45,0,2,1,0,0,0,0,0,0,1,86,1,78
전라남도,여수시,동문동,관내사전투표,1108,1108,710,30,299,25,36,0,0,1,0,1,0,0,2,1104,4,0
전라남도,여수시,동문동,합계,4270,3110,1776,102,1060,61,85,0,0,1,0,5,1,1,5,3097,13,1160
전라남도,여수시,동문동,동문동제1투,1219,711,376,25,265,13,26,0,0,0,0,1,1,0,1,708,3,508
전라남도,여수시,동문동,동문동제2투,1137,724,370,33,282,17,19,0,0,0,0,0,0,0,2,723,1,413
전라남도,여수시,동문동,동문동제3투,806,567,320,14,214,6,4,0,0,0,0,3,0,1,0,562,5,239
전라남도,여수시,한려동,합계,2976,2202,1300,58,732,42,52,1,0,2,0,2,2,0,3,2194,8,774
전라남도,여수시,한려동,관내사전투표,765,765,468,17,232,19,23,0,0,1,0,1,1,0,0,762,3,0
전라남도,여수시,한려동,한려동제1투,748,483,283,16,162,8,11,0,0,0,0,0,0,0,2,482,1,265
전라남도,여수시,한려동,한려동제2투,1463,954,549,25,338,15,18,1,0,1,0,1,1,0,1,950,4,509
전라남도,여수시,중앙동,합계,4699,3600,2106,93,1228,56,92,0,0,5,0,5,0,0,6,3591,9,1099
전라남도,여수시,중앙동,관내사전투표,1462,1462,857,37,487,27,45,0,0,1,0,2,0,0,3,1459,3,0
전라남도,여수시,중앙동,중앙동제1투,1610,1100,670,29,348,14,32,0,0,2,0,1,0,0,0,1096,4,510
전라남도,여수시,중앙동,중앙동제2투,1627,1038,579,27,393,15,15,0,0,2,0,2,0,0,3,1036,2,589
전라남도,여수시,충무동,합계,4181,3058,1852,60,1001,31,78,1,1,3,1,6,2,2,6,3044,14,1123
전라남도,여수시,충무동,관내사전투표,1274,1274,782,26,394,14,47,0,0,0,1,1,1,1,0,1267,7,0
전라남도,여수시,충무동,충무동제1투,1394,866,525,19,291,6,14,0,0,3,0,2,1,0,3,864,2,528
전라남도,여수시,충무동,충무동제2투,1513,918,545,15,316,11,17,1,1,0,0,3,0,1,3,913,5,595
전라남도,여수시,광림동,합계,5705,4167,2561,84,1322,63,112,1,0,5,0,3,1,1,2,4155,12,1538
전라남도,여수시,광림동,관내사전투표,1241,1241,805,13,357,19,36,0,0,3,0,0,1,1,1,1236,5,0
전라남도,여수시,광림동,광림동제1투,1604,988,568,24,352,15,23,0,0,2,0,1,0,0,1,986,2,616
전라남도,여수시,광림동,광림동제2투,1042,722,468,14,216,10,9,1,0,0,0,2,0,0,0,720,2,320
전라남도,여수시,광림동,광림동제3투,1818,1216,720,33,397,19,44,0,0,0,0,0,0,0,0,1213,3,602
전라남도,여수시,서강동,합계,3784,2863,1645,74,972,42,94,1,0,4,1,7,2,0,5,2847,16,921
전라남도,여수시,서강동,관내사전투표,1224,1224,718,26,404,15,47,0,0,2,1,2,1,0,2,1218,6,0
전라남도,여수시,서강동,서강동제1투,1211,739,402,24,276,9,15,1,0,1,0,2,0,0,2,732,7,472
전라남도,여수시,서강동,서강동제2투,1349,900,525,24,292,18,32,0,0,1,0,3,1,0,1,897,3,449
전라남도,여수시,대교동,합계,5340,3738,2175,89,1323,36,78,0,0,6,0,4,1,0,11,3723,15,1602
전라남도,여수시,대교동,관내사전투표,1136,1136,685,30,363,16,29,0,0,3,0,1,0,0,6,1133,3,0
전라남도,여수시,대교동,대교동제1투,1616,1005,549,25,398,8,14,0,0,2,0,2,1,0,1,1000,5,611
전라남도,여수시,대교동,대교동제2투,1434,827,469,22,307,8,16,0,0,0,0,1,0,0,0,823,4,607
전라남도,여수시,대교동,대교동제3투,1154,770,472,12,255,4,19,0,0,1,0,0,0,0,4,767,3,384
전라남도,여수시,국동,합계,10323,7586,4731,156,2301,110,225,0,1,12,1,15,2,0,3,7557,29,2737
전라남도,여수시,국동,관내사전투표,2787,2787,1782,62,788,38,91,0,1,5,0,5,0,0,2,2774,13,0
전라남도,여수시,국동,국동제1투,1434,871,542,23,271,14,19,0,0,0,0,0,1,0,0,870,1,563
전라남도,여수시,국동,국동제2투,1832,1045,637,25,335,8,33,0,0,1,0,1,0,0,0,1040,5,787
전라남도,여수시,국동,국동제3투,2268,1549,978,25,460,25,48,0,0,3,0,4,0,0,0,1543,6,719
전라남도,여수시,국동,국동제4투,2002,1334,792,21,447,25,34,0,0,3,1,5,1,0,1,1330,4,668
전라남도,여수시,월호동,합계,6121,4878,3050,111,1436,103,143,0,0,2,1,9,2,1,10,4868,10,1243
전라남도,여수시,월호동,관내사전투표,1926,1927,1268,24,511,49,66,0,0,0,0,5,0,0,1,1924,3,-1
전라남도,여수시,월호동,월호동제1투,1879,1258,744,41,409,19,36,0,0,1,0,2,1,0,3,1256,2,621
전라남도,여수시,월호동,월호동제2투,1693,1267,785,34,379,29,34,0,0,1,0,1,0,0,2,1265,2,426
전라남도,여수시,월호동,월호동제3투,533,367,223,10,112,6,6,0,0,0,1,1,1,1,4,365,2,166
전라남도,여수시,월호동,월호동제4투,90,59,30,2,25,0,1,0,0,0,0,0,0,0,0,58,1,31
전라남도,여수시,여서동,관내사전투표,4280,4280,2832,69,1065,107,173,0,1,4,1,13,1,1,3,4270,10,0
전라남도,여수시,여서동,합계,15948,12845,8150,270,3595,287,472,0,1,9,2,19,4,3,8,12820,25,3103
전라남도,여수시,여서동,여서동제1투,2189,1342,800,36,425,27,49,0,0,0,0,2,0,1,2,1342,0,847
전라남도,여수시,여서동,여서동제2투,1738,1338,803,39,428,30,33,0,0,0,0,0,1,0,1,1335,3,400
전라남도,여수시,여서동,여서동제3투,2169,1686,1011,46,525,36,62,0,0,1,0,0,2,1,0,1684,2,483
전라남도,여수시,여서동,여서동제4투,2041,1522,970,29,424,32,60,0,0,1,0,1,0,0,2,1519,3,519
전라남도,여수시,여서동,여서동제5투,1714,1379,875,36,386,30,45,0,0,0,1,2,0,0,0,1375,4,335
전라남도,여수시,여서동,여서동제6투,1817,1298,859,15,342,25,50,0,0,3,0,1,0,0,0,1295,3,519
전라남도,여수시,문수동,합계,15941,12291,7955,245,3248,255,504,2,0,3,3,32,1,4,9,12261,30,3650
전라남도,여수시,문수동,관내사전투표,4065,4065,2770,62,911,102,195,1,0,1,1,8,0,0,3,4054,11,0
전라남도,여수시,문수동,문수동제1투,1260,907,523,28,308,11,28,0,0,0,0,1,0,1,2,902,5,353
전라남도,여수시,문수동,문수동제2투,1799,1311,804,26,391,27,58,0,0,0,1,3,0,0,0,1310,1,488
전라남도,여수시,문수동,문수동제3투,2770,1881,1206,41,503,41,77,1,0,0,0,8,0,1,0,1878,3,889
전라남도,여수시,문수동,문수동제4투,1112,867,544,13,269,11,28,0,0,0,0,1,0,1,0,867,0,245
전라남도,여수시,문수동,문수동제5투,2020,1259,733,40,413,22,31,0,0,1,1,5,1,1,4,1252,7,761
전라남도,여수시,문수동,문수동제6투,2915,2001,1375,35,453,41,87,0,0,1,0,6,0,0,0,1998,3,914
전라남도,여수시,미평동,합계,10183,8021,5157,161,2138,163,334,0,1,6,0,13,1,4,10,7988,33,2162
전라남도,여수시,미평동,관내사전투표,3239,3239,2177,50,758,71,157,0,1,2,0,5,0,1,4,3226,13,0
전라남도,여수시,미평동,미평동제1투,2092,1402,874,31,394,32,64,0,0,1,0,4,0,1,0,1401,1,690
전라남도,여수시,미평동,미평동제2투,1931,1264,768,31,388,18,39,0,0,0,0,2,1,1,4,1252,12,667
전라남도,여수시,미평동,미평동제3투,1524,1036,631,29,322,20,28,0,0,0,0,2,0,0,0,1032,4,488
전라남도,여수시,미평동,미평동제4투,1397,1080,707,20,276,22,46,0,0,3,0,0,0,1,2,1077,3,317
전라남도,여수시,둔덕동,합계,7455,5958,3860,118,1532,135,271,2,0,3,0,11,1,3,2,5938,20,1497
전라남도,여수시,둔덕동,관내사전투표,1766,1766,1177,31,420,42,76,2,0,1,0,5,0,2,0,1756,10,0
전라남도,여수시,둔덕동,둔덕동제1투,1273,815,512,20,226,17,35,0,0,1,0,1,0,0,0,812,3,458
전라남도,여수시,둔덕동,둔덕동제2투,2855,2173,1338,49,643,48,83,0,0,1,0,4,0,1,1,2168,5,682
전라남도,여수시,둔덕동,둔덕동제3투,1561,1204,833,18,243,28,77,0,0,0,0,1,1,0,1,1202,2,357
전라남도,여수시,만덕동,합계,6796,5398,3316,123,1639,116,166,0,2,1,0,9,3,2,5,5382,16,1398
전라남도,여수시,만덕동,관내사전투표,1710,1710,1122,37,439,43,60,0,0,1,0,2,0,0,1,1705,5,0
전라남도,여수시,만덕동,만덕동제1투,2322,1634,953,46,551,30,40,0,1,0,0,5,1,0,2,1629,5,688
전라남도,여수시,만덕동,만덕동제2투,1848,1387,875,34,395,29,49,0,0,0,0,0,0,1,0,1383,4,461
전라남도,여수시,만덕동,만덕동제3투,916,667,366,6,254,14,17,0,1,0,0,2,2,1,2,665,2,249
전라남도,여수시,쌍봉동,합계,26117,21367,14108,507,5057,553,1000,8,1,16,1,57,3,1,6,21318,49,4750
전라남도,여수시,쌍봉동,관내사전투표,8179,8179,5529,138,1832,221,405,0,1,9,1,28,0,0,1,8165,14,0
전라남도,여수시,쌍봉동,쌍봉동제1투,1501,934,590,25,246,31,36,0,0,1,0,4,0,0,0,933,1,567
전라남도,여수시,쌍봉동,쌍봉동제2투,2192,1383,879,40,389,23,47,1,0,0,0,1,0,0,0,1380,3,809
전라남도,여수시,쌍봉동,쌍봉동제3투,2324,1685,1115,58,379,46,74,4,0,0,0,3,1,0,0,1680,5,639
전라남도,여수시,쌍봉동,쌍봉동제4투,2026,1562,989,38,390,50,82,0,0,1,0,5,0,0,0,1555,7,464
전라남도,여수시,쌍봉동,쌍봉동제5투,2723,2108,1351,37,550,44,109,0,0,2,0,8,1,0,1,2103,5,615
전라남도,여수시,쌍봉동,쌍봉동제6투,1934,1391,891,48,341,31,69,2,0,0,0,2,0,0,1,1385,6,543
전라남도,여수시,쌍봉동,쌍봉동제7투,2620,1978,1304,63,447,54,99,0,0,2,0,3,0,0,1,1973,5,642
전라남도,여수시,쌍봉동,쌍봉동제8투,2618,2147,1460,60,483,53,79,1,0,1,0,3,1,1,2,2144,3,471
전라남도,여수시,시전동,합계,20505,16514,10956,314,3997,418,717,3,0,13,0,41,1,2,14,16476,38,3991
전라남도,여수시,시전동,관내사전투표,5394,5394,3640,83,1207,152,274,0,0,7,0,14,0,1,4,5382,12,0
전라남도,여수시,시전동,시전동제1투,1893,1214,728,35,382,23,34,0,0,2,0,3,0,0,3,1210,4,679
전라남도,여수시,시전동,시전동제2투,3754,3045,2094,51,692,74,116,1,0,3,0,6,0,1,1,3039,6,709
전라남도,여수시,시전동,시전동제3투,1633,1134,747,22,235,33,83,2,0,0,0,7,0,0,3,1132,2,499
전라남도,여수시,시전동,시전동제4투,1584,1032,633,22,315,25,29,0,0,0,0,4,0,0,2,1030,2,552
전라남도,여수시,시전동,시전동제5투,1311,980,653,30,238,14,40,0,0,1,0,1,0,0,1,978,2,331
전라남도,여수시,시전동,시전동제6투,2024,1441,918,40,391,31,53,0,0,0,0,3,0,0,0,1436,5,583
전라남도,여수시,시전동,시전동제7투,2912,2274,1543,31,537,66,88,0,0,0,0,3,1,0,0,2269,5,638
전라남도,여수시,여천동,합계,17842,13870,9012,339,3444,297,650,3,1,9,2,42,10,3,12,13824,46,3972
전라남도,여수시,여천동,관내사전투표,5567,5566,3720,108,1228,144,313,2,0,5,0,22,3,2,4,5551,15,1
전라남도,여수시,여천동,여천동제1투,1514,1039,616,34,303,15,61,1,0,0,0,0,1,0,2,1033,6,475
전라남도,여수시,여천동,여천동제2투,2570,1871,1237,42,463,35,86,0,1,0,0,3,0,0,1,1868,3,699
전라남도,여수시,여천동,여천동제3투,2368,1465,980,33,357,26,53,0,0,1,0,6,1,1,1,1459,6,903
전라남도,여수시,여천동,여천동제4투,3303,2169,1385,66,590,38,70,0,0,2,0,2,2,0,2,2157,12,1134
전라남도,여수시,여천동,여천동제5투,2520,1760,1074,56,503,39,67,0,0,1,2,9,3,0,2,1756,4,760
전라남도,여수시,주삼동,합계,5654,4591,3125,87,1057,93,196,2,0,3,0,12,1,0,3,4579,12,1063
전라남도,여수시,주삼동,관내사전투표,1596,1596,1092,27,355,27,76,1,0,2,0,7,0,0,1,1588,8,0
전라남도,여수시,주삼동,주삼동제1투,769,488,280,9,179,1,13,0,0,0,0,0,1,0,2,485,3,281
전라남도,여수시,주삼동,주삼동제2투,1358,1035,744,17,202,27,42,1,0,0,0,2,0,0,0,1035,0,323
전라남도,여수시,주삼동,주삼동제3투,1931,1472,1009,34,321,38,65,0,0,1,0,3,0,0,0,1471,1,459
전라남도,여수시,삼일동,합계,2245,1664,1082,40,427,29,48,2,0,5,0,8,4,2,9,1656,8,581
전라남도,여수시,삼일동,관내사전투표,750,750,507,17,171,15,22,0,0,1,0,6,2,1,1,743,7,0
전라남도,여수시,삼일동,삼일동투표소,1495,914,575,23,256,14,26,2,0,4,0,2,2,1,8,913,1,581
전라남도,여수시,묘도동,합계,950,700,440,19,197,8,15,0,0,0,0,9,1,2,3,694,6,250
전라남도,여수시,묘도동,관내사전투표,264,264,174,4,66,4,5,0,0,0,0,5,1,0,1,260,4,0
전라남도,여수시,묘도동,묘도동투표소,686,436,266,15,131,4,10,0,0,0,0,4,0,2,2,434,2,250
전라남도,여수시,잘못 투입·구분된 투표지,,0,0,0,0,0,0,0,0,0,0,0,0,0,0,0,0,0,0
전라남도,순천시,합계,,223756,181451,122595,4525,40429,4326,7475,55,33,100,36,879,55,75,201,180784,667,42305
전라남도,순천시,거소·선상투표,,637,604,326,37,163,22,13,1,1,5,1,10,2,1,4,586,18,33
전라남도,순천시,관외사전투표,,19759,19759,13001,518,3856,854,1282,9,5,14,9,75,1,7,17,19648,111,0
전라남도,순천시,재외투표,,970,735,534,12,92,14,73,1,1,0,0,1,0,0,1,729,6,235
전라남도,순천시,승주읍,합계,2584,1891,1225,58,475,25,60,1,2,2,0,12,2,5,8,1875,16,693
전라남도,순천시,승주읍,관내사전투표,704,704,491,16,146,10,27,0,1,2,0,4,1,0,1,699,5,0
전라남도,순천시,승주읍,승주읍제1투,1506,922,570,31,255,12,27,1,1,0,0,4,1,3,7,912,10,584
전라남도,순천시,승주읍,승주읍제2투,374,265,164,11,74,3,6,0,0,0,0,4,0,2,0,264,1,109
전라남도,순천시,주암면,합계,2925,2183,1186,72,757,22,51,1,1,0,1,45,1,4,11,2152,31,742
전라남도,순천시,주암면,관내사전투표,691,691,377,26,240,9,17,0,0,0,0,10,0,1,2,682,9,0
전라남도,순천시,주암면,주암면제1투,1008,722,396,23,238,3,10,1,1,0,1,32,1,2,4,712,10,286
전라남도,순천시,주암면,주암면제2투,1226,770,413,23,279,10,24,0,0,0,0,3,0,1,5,758,12,456
전라남도,순천시,송광면,합계,1381,1018,578,38,325,15,29,0,1,2,1,3,3,1,16,1012,6,363
전라남도,순천시,송광면,관내사전투표,403,403,242,13,120,6,14,0,0,1,1,3,0,0,3,403,0,0
전라남도,순천시,송광면,송광면투표소,978,615,336,25,205,9,15,0,1,1,0,0,3,1,13,609,6,363
전라남도,순천시,외서면,합계,816,622,398,17,174,7,6,1,0,0,0,5,0,4,4,616,6,194
전라남도,순천시,외서면,관내사전투표,229,229,153,7,59,0,2,1,0,0,0,2,0,1,1,226,3,0
전라남도,순천시,외서면,외서면투표소,587,393,245,10,115,7,4,0,0,0,0,3,0,3,3,390,3,194
전라남도,순천시,낙안면,합계,2941,2194,1380,50,640,30,50,0,3,1,0,7,6,2,11,2180,14,747
전라남도,순천시,낙안면,관내사전투표,1015,1015,674,20,268,8,22,0,2,0,0,5,3,1,6,1009,6,0
전라남도,순천시,낙안면,낙안면제1투,1172,702,441,18,199,12,21,0,0,0,0,2,2,1,2,698,4,470
전라남도,순천시,낙안면,낙안면제2투,754,477,265,12,173,10,7,0,1,1,0,0,1,0,3,473,4,277
전라남도,순천시,별량면,합계,4884,3569,2315,98,965,46,79,3,4,5,0,17,5,4,10,3551,18,1315
전라남도,순천시,별량면,관내사전투표,1378,1379,916,36,356,15,29,2,3,2,0,5,1,1,6,1372,7,-1
전라남도,순천시,별량면,별량면제1투,1345,812,524,22,207,17,23,1,1,2,0,6,1,1,3,808,4,533
전라남도,순천시,별량면,별량면제2투,1268,757,461,28,234,8,12,0,0,0,0,6,3,1,0,753,4,511
전라남도,순천시,별량면,별량면제3투,893,621,414,12,168,6,15,0,0,1,0,0,0,1,1,618,3,272
전라남도,순천시,상사면,합계,2342,1783,1155,54,462,22,47,1,2,1,0,11,1,4,9,1769,14,559
전라남도,순천시,상사면,관내사전투표,593,593,413,4,137,6,23,1,1,0,0,2,0,1,3,591,2,0
전라남도,순천시,상사면,상사면제1투,630,425,267,14,113,8,12,0,0,1,0,3,0,2,3,423,2,205
전라남도,순천시,상사면,상사면제2투,1119,765,475,36,212,8,12,0,1,0,0,6,1,1,3,755,10,354
전라남도,순천시,해룡면,합계,27160,21570,15648,408,3954,495,882,10,2,8,2,101,4,7,11,21532,38,5590
전라남도,순천시,해룡면,관내사전투표,4203,4203,3175,59,659,112,171,2,0,0,0,18,1,2,2,4201,2,0
전라남도,순천시,해룡면,해룡면제1투,2239,1352,894,35,361,14,35,0,0,2,0,4,0,0,3,1348,4,887
전라남도,순천시,해룡면,해룡면제2투,2091,1678,1243,28,303,33,59,0,0,0,0,6,1,0,0,1673,5,413
전라남도,순천시,해룡면,해룡면제3투,3283,2724,1988,47,501,73,102,1,0,1,0,8,0,1,0,2722,2,559
전라남도,순천시,해룡면,해룡면제4투,755,485,345,6,111,3,11,1,0,0,0,2,0,0,2,481,4,270
전라남도,순천시,해룡면,해룡면제5투,2547,1825,1228,50,400,37,82,0,1,2,0,16,0,1,3,1820,5,722
전라남도,순천시,해룡면,해룡면제6투,2504,1863,1330,44,348,34,84,3,0,2,0,9,2,0,0,1856,7,641
전라남도,순천시,해룡면,해룡면제7투,2471,1812,1275,38,328,47,106,3,0,0,0,13,0,0,0,1810,2,659
전라남도,순천시,해룡면,해룡면제8투,2559,2029,1528,35,325,50,81,0,1,0,0,5,0,1,0,2026,3,530
전라남도,순천시,해룡면,해룡면제9투,2414,1996,1460,44,344,56,82,0,0,1,0,7,0,0,0,1994,2,418
전라남도,순천시,해룡면,해룡면제10투,2094,1603,1182,22,274,36,69,0,0,0,2,13,0,2,1,1601,2,491
전라남도,순천시,서면,합계,8633,6598,4476,162,1521,126,217,0,1,0,0,31,2,3,12,6551,47,2035
전라남도,순천시,서면,관내사전투표,1709,1709,1199,33,349,36,71,0,1,0,0,10,0,1,1,1701,8,0
전라남도,순천시,서면,서면제1투,767,509,334,14,133,7,7,0,0,0,0,7,0,0,2,504,5,258
전라남도,순천시,서면,서면제2투,1152,801,475,36,233,14,28,0,0,0,0,2,0,1,3,792,9,351
전라남도,순천시,서면,서면제3투,1503,1145,815,17,229,29,39,0,0,0,0,3,1,0,1,1134,11,358
전라남도,순천시,서면,서면제4투,2668,1851,1283,48,414,23,60,0,0,0,0,8,1,0,3,1840,11,817
전라남도,순천시,서면,서면제5투,834,583,370,14,163,17,12,0,0,0,0,1,0,1,2,580,3,251
전라남도,순천시,황전면,합계,2822,2080,1408,51,457,38,31,0,0,2,0,65,0,2,9,2063,17,742
전라남도,순천시,황전면,관내사전투표,773,773,529,22,147,21,15,0,0,1,0,28,0,1,3,767,6,0
전라남도,순천시,황전면,황전면제1투,986,603,387,21,156,9,7,0,0,1,0,13,0,1,2,597,6,383
전라남도,순천시,황전면,황전면제2투,1063,704,492,8,154,8,9,0,0,0,0,24,0,0,4,699,5,359
전라남도,순천시,월등면,합계,1497,1109,764,29,231,35,31,0,0,1,0,4,1,2,6,1104,5,388
전라남도,순천시,월등면,관내사전투표,443,443,302,12,95,15,16,0,0,0,0,1,0,0,1,442,1,0
전라남도,순천시,월등면,월등면투표소,1054,666,462,17,136,20,15,0,0,1,0,3,1,2,5,662,4,388
전라남도,순천시,향동,합계,3783,2938,1839,99,795,59,102,0,0,2,1,21,1,1,5,2925,13,845
전라남도,순천시,향동,관내사전투표,1608,1608,1037,41,423,27,53,0,0,0,1,15,0,1,3,1601,7,0
전라남도,순천시,향동,향동투표소,2175,1330,802,58,372,32,49,0,0,2,0,6,1,0,2,1324,6,845
전라남도,순천시,매곡동,합계,4448,3476,2197,124,871,83,166,3,0,2,0,11,1,1,5,3464,12,972
전라남도,순천시,매곡동,관내사전투표,1613,1613,1058,36,388,37,78,2,0,1,0,9,0,0,2,1611,2,0
전라남도,순천시,매곡동,매곡동제1투,1426,943,584,53,251,16,30,1,0,1,0,0,1,0,1,938,5,483
전라남도,순천시,매곡동,매곡동제2투,1409,920,555,35,232,30,58,0,0,0,0,2,0,1,2,915,5,489
전라남도,순천시,삼산동,합계,17595,14352,9622,355,3290,314,665,2,0,9,2,38,2,2,7,14308,44,3243
전라남도,순천시,삼산동,관내사전투표,5335,5335,3632,99,1117,152,293,2,0,5,0,14,0,1,3,5318,17,0
전라남도,순천시,삼산동,삼산동제1투,1109,739,452,20,200,15,44,0,0,0,0,2,0,0,0,733,6,370
전라남도,순천시,삼산동,삼산동제2투,1659,1270,848,36,299,27,55,0,0,2,0,2,0,0,0,1269,1,389
전라남도,순천시,삼산동,삼산동제3투,1373,934,602,28,249,16,29,0,0,1,0,4,0,0,1,930,4,439
전라남도,순천시,삼산동,삼산동제4투,2473,1927,1287,63,470,23,69,0,0,1,1,5,0,0,2,1921,6,546
전라남도,순천시,삼산동,삼산동제5투,2893,1978,1287,54,502,28,92,0,0,0,1,6,2,0,0,1972,6,915
전라남도,순천시,삼산동,삼산동제6투,1281,946,654,26,205,27,28,0,0,0,0,5,0,0,1,946,0,335
전라남도,순천시,삼산동,삼산동제7투,1472,1223,860,29,248,26,55,0,0,0,0,0,0,1,0,1219,4,249
전라남도,순천시,조곡동,합계,5810,4635,2993,127,1196,93,183,1,0,5,0,17,3,2,2,4622,13,1175
전라남도,순천시,조곡동,관내사전투표,1743,1743,1198,32,389,39,65,0,0,3,0,9,2,0,0,1737,6,0
전라남도,순천시,조곡동,조곡동제1투,1869,1429,892,48,373,30,73,0,0,1,0,7,0,2,2,1428,1,440
전라남도,순천시,조곡동,조곡동제2투,789,470,285,19,137,10,14,1,0,1,0,1,0,0,0,468,2,319
전라남도,순천시,조곡동,조곡동제3투,1409,993,618,28,297,14,31,0,0,0,0,0,1,0,0,989,4,416
전라남도,순천시,덕연동,합계,32842,26457,18280,626,5715,592,1012,10,4,12,5,118,4,4,13,26395,62,6385
전라남도,순천시,덕연동,관내사전투표,7441,7441,5360,132,1414,174,298,4,1,2,2,33,0,0,4,7424,17,0
전라남도,순천시,덕연동,덕연동제1투,2463,1787,1188,64,434,34,60,0,0,0,0,1,1,0,1,1783,4,676
전라남도,순천시,덕연동,덕연동제2투,3031,2104,1423,65,471,43,77,1,0,0,0,13,0,2,1,2096,8,927
전라남도,순천시,덕연동,덕연동제3투,2400,1871,1232,40,457,49,66,0,0,2,0,18,0,0,2,1866,5,529
전라남도,순천시,덕연동,덕연동제4투,2114,1635,1044,63,430,40,44,1,0,0,0,7,1,0,0,1630,5,479
전라남도,순천시,덕연동,덕연동제5투,1912,1453,985,32,346,34,44,1,0,3,1,2,2,1,0,1451,2,459
전라남도,순천시,덕연동,덕연동제6투,2022,1553,1026,43,389,24,60,1,1,1,0,4,0,0,1,1550,3,469
전라남도,순천시,덕연동,덕연동제7투,2038,1429,970,35,339,29,44,0,0,0,1,6,0,0,1,1425,4,609
전라남도,순천시,덕연동,덕연동제8투,2403,1743,1246,26,321,53,89,0,0,1,0,3,0,0,0,1739,4,660
전라남도,순천시,덕연동,덕연동제9투,2263,1805,1337,35,288,44,84,2,1,2,1,9,0,0,0,1803,2,458
전라남도,순천시,덕연동,덕연동제10투,1953,1514,1067,29,307,29,63,0,1,0,0,13,0,0,1,1510,4,439
전라남도,순천시,덕연동,덕연동제11투,2802,2122,1402,62,519,39,83,0,0,1,0,9,0,1,2,2118,4,680
전라남도,순천시,풍덕동,합계,7240,5644,3631,153,1547,95,160,2,2,1,0,25,3,0,5,5624,20,1596
전라남도,순천시,풍덕동,관내사전투표,1998,1998,1349,42,503,28,58,2,1,0,0,9,0,0,1,1993,5,0
전라남도,순천시,풍덕동,풍덕동제1투,1271,789,508,26,209,20,16,0,0,0,0,4,0,0,1,784,5,482
전라남도,순천시,풍덕동,풍덕동제2투,1603,1115,703,39,312,18,32,0,1,1,0,3,2,0,1,1112,3,488
전라남도,순천시,풍덕동,풍덕동제3투,2368,1742,1071,46,523,29,54,0,0,0,0,9,1,0,2,1735,7,626
전라남도,순천시,남제동,합계,7831,5752,3629,164,1585,116,200,0,0,4,3,22,2,3,9,5737,15,2079
전라남도,순천시,남제동,관내사전투표,2133,2133,1348,55,578,47,83,0,0,1,1,9,0,2,4,2128,5,0
전라남도,순천시,남제동,남제동제1투,1395,878,550,27,254,10,23,0,0,3,1,3,1,0,1,873,5,517
전라남도,순천시,남제동,남제동제2투,1371,865,550,29,232,20,29,0,0,0,1,3,0,0,0,864,1,506
전라남도,순천시,남제동,남제동제3투,1651,1025,624,30,294,24,40,0,0,0,0,7,1,0,1,1021,4,626
전라남도,순천시,남제동,남제동제4투,1281,851,557,23,227,15,25,0,0,0,0,0,0,1,3,851,0,430
전라남도,순천시,저전동,합계,3136,2592,1647,66,703,49,97,1,0,4,1,16,0,1,0,2585,7,544
전라남도,순천시,저전동,관내사전투표,1477,1477,983,31,349,36,60,0,0,3,1,11,0,0,0,1474,3,0
전라남도,순천시,저전동,저전동투표소,1659,1115,664,35,354,13,37,1,0,1,0,5,0,1,0,1111,4,544
전라남도,순천시,장천동,합계,2915,2185,1397,74,578,41,77,0,1,2,1,8,1,0,1,2181,4,730
전라남도,순천시,장천동,관내사전투표,1164,1164,786,30,262,26,51,0,0,1,0,4,1,0,1,1162,2,0
전라남도,순천시,장천동,장천동투표소,1751,1021,611,44,316,15,26,0,1,1,1,4,0,0,0,1019,2,730
전라남도,순천시,중앙동,합계,3877,3041,1925,83,848,65,92,2,0,2,0,12,1,1,1,3032,9,836
전라남도,순천시,중앙동,관내사전투표,1761,1761,1132,42,449,47,70,1,0,2,0,10,1,0,1,1755,6,0
전라남도,순천시,중앙동,중앙동투표소,2116,1280,793,41,399,18,22,1,0,0,0,2,0,1,0,1277,3,836
전라남도,순천시,도사동,합계,10151,7903,5374,169,1835,164,287,0,1,3,3,28,2,3,9,7878,25,2248
전라남도,순천시,도사동,관내사전투표,2605,2605,1789,45,577,54,106,0,1,1,2,14,1,1,4,2595,10,0
전라남도,순천시,도사동,도사동제1투,2519,1593,1080,43,369,36,54,0,0,1,1,4,0,1,0,1589,4,926
전라남도,순천시,도사동,도사동제2투,1337,859,595,14,200,19,24,0,0,1,0,0,1,0,1,855,4,478
전라남도,순천시,도사동,도사동제3투,1136,771,474,25,231,11,22,0,0,0,0,2,0,0,3,768,3,365
전라남도,순천시,도사동,도사동제4투,1501,1214,832,29,274,27,46,0,0,0,0,2,0,0,0,1210,4,287
전라남도,순천시,도사동,도사동제5투,1053,861,604,13,184,17,35,0,0,0,0,6,0,1,1,861,0,192
전라남도,순천시,왕조1동,합계,26864,21255,14431,581,4625,524,899,4,1,8,4,96,4,6,7,21190,65,5609
전라남도,순천시,왕조1동,관내사전투표,5886,5886,4174,111,1122,136,266,1,1,4,3,31,2,5,2,5858,28,0
전라남도,순천시,왕조1동,왕조1동제1투,2119,1660,1140,37,368,36,67,0,0,0,0,5,1,1,2,1657,3,459
전라남도,순천시,왕조1동,왕조1동제2투,2172,1435,1000,38,275,43,68,0,0,0,0,8,0,0,1,1433,2,737
전라남도,순천시,왕조1동,왕조1동제3투,3090,2132,1372,89,520,45,93,0,0,0,0,9,0,0,0,2128,4,958
전라남도,순천시,왕조1동,왕조1동제4투,1361,1037,703,23,233,30,42,0,0,0,0,6,0,0,0,1037,0,324
전라남도,순천시,왕조1동,왕조1동제5투,1611,1084,681,31,298,24,32,1,0,2,1,8,0,0,0,1078,6,527
전라남도,순천시,왕조1동,왕조1동제6투,2395,1456,946,52,334,35,72,1,0,1,0,12,0,0,0,1453,3,939
전라남도,순천시,왕조1동,왕조1동제7투,2038,1545,1053,46,332,29,72,1,0,0,0,2,1,0,1,1537,8,493
전라남도,순천시,왕조1동,왕조1동제8투,2331,1902,1334,46,377,49,80,0,0,1,0,7,0,0,1,1895,7,429
전라남도,순천시,왕조1동,왕조1동제9투,3861,3118,2028,108,766,97,107,0,0,0,0,8,0,0,0,3114,4,743
전라남도,순천시,왕조2동,관내사전투표,8588,8588,6398,148,1372,200,390,0,1,3,2,50,2,2,3,8571,17,0
전라남도,순천시,왕조2동,합계,17913,15506,11236,300,2769,380,684,2,1,5,2,80,3,5,8,15475,31,2407
전라남도,순천시,왕조2동,왕조2동제1투,1840,1429,1053,29,249,26,61,0,0,1,0,6,1,1,0,1427,2,411
전라남도,순천시,왕조2동,왕조2동제2투,1789,1196,800,35,263,36,49,1,0,1,0,6,0,0,1,1192,4,593
전라남도,순천시,왕조2동,왕조2동제3투,1469,1143,773,11,264,32,55,0,0,0,0,4,0,0,2,1141,2,326
전라남도,순천시,왕조2동,왕조2동제4투,1865,1378,984,36,254,38,55,0,0,0,0,7,0,0,1,1375,3,487
전라남도,순천시,왕조2동,왕조2동제5투,2362,1772,1228,41,367,48,74,1,0,0,0,7,0,2,1,1769,3,590
전라남도,순천시,잘못 투입·구분된 투표지,,0,0,0,0,0,0,0,0,0,0,0,0,0,0,0,0,0,0
전라남도,나주시,합계,,89312,71599,43967,1448,21011,1484,2686,34,14,50,20,147,63,67,199,71190,409,17713
전라남도,나주시,거소·선상투표,,509,464,209,35,114,7,13,3,0,3,4,0,2,0,4,394,70,45
전라남도,나주시,관외사전투표,,11165,11162,7067,228,2694,400,660,6,1,6,2,27,2,3,8,11104,58,3
전라남도,나주시,재외투표,,367,237,168,8,33,5,20,1,0,0,0,1,0,0,0,236,1,130
전라남도,나주시,남평읍,합계,6208,4715,2804,76,1567,69,142,1,0,2,2,4,3,7,13,4690,25,1493
전라남도,나주시,남평읍,관내사전투표,1822,1822,1065,30,608,33,63,1,0,0,1,1,2,4,5,1813,9,0
전라남도,나주시,남평읍,남평읍제1투,1630,1038,639,14,348,15,18,0,0,0,0,0,0,1,0,1035,3,592
전라남도,나주시,남평읍,남평읍제2투,2181,1455,862,23,475,20,55,0,0,2,1,3,1,1,3,1446,9,726
전라남도,나주시,남평읍,남평읍제3투,575,400,238,9,136,1,6,0,0,0,0,0,0,1,5,396,4,175
전라남도,나주시,세지면,관내사전투표,669,669,411,15,214,4,18,0,0,1,0,0,0,2,2,667,2,0
전라남도,나주시,세지면,합계,2423,1783,1043,32,634,14,38,0,0,1,0,2,3,3,8,1778,5,640
전라남도,나주시,세지면,세지면투표소,1754,1114,632,17,420,10,20,0,0,0,0,2,3,1,6,1111,3,640
전라남도,나주시,왕곡면,합계,2490,1891,1088,40,662,22,40,0,1,3,0,4,2,3,11,1876,15,599
전라남도,나주시,왕곡면,관내사전투표,724,724,458,13,219,7,13,0,0,0,0,2,1,1,4,718,6,0
전라남도,나주시,왕곡면,왕곡면제1투,881,557,309,12,204,6,11,0,1,1,0,1,1,2,4,552,5,324
전라남도,나주시,왕곡면,왕곡면제2투,885,610,321,15,239,9,16,0,0,2,0,1,0,0,3,606,4,275
전라남도,나주시,반남면,합계,1301,990,594,16,327,14,20,1,0,0,0,0,0,1,6,979,11,311
전라남도,나주시,반남면,관내사전투표,410,410,268,5,118,5,6,1,0,0,0,0,0,0,2,405,5,0
전라남도,나주시,반남면,반남면투표소,891,580,326,11,209,9,14,0,0,0,0,0,0,1,4,574,6,311
전라남도,나주시,공산면,합계,2043,1613,887,29,602,20,35,1,0,0,0,11,1,3,17,1606,7,430
전라남도,나주시,공산면,관내사전투표,615,615,347,6,227,3,16,1,0,0,0,6,1,1,5,613,2,0
전라남도,나주시,공산면,공산면제1투,1007,693,388,14,245,13,13,0,0,0,0,5,0,2,9,689,4,314
전라남도,나주시,공산면,공산면제2투,421,305,152,9,130,4,6,0,0,0,0,0,0,0,3,304,1,116
전라남도,나주시,동강면,관내사전투표,841,841,488,23,281,12,17,0,1,0,0,2,2,2,7,835,6,0
전라남도,나주시,동강면,합계,2282,1718,955,48,607,19,40,1,2,1,0,3,3,7,16,1702,16,564
전라남도,나주시,동강면,동강면투표소,1441,877,467,25,326,7,23,1,1,1,0,1,1,5,9,867,10,564
전라남도,나주시,다시면,합계,3297,2571,1401,54,982,34,59,0,0,2,0,3,6,1,6,2548,23,726
전라남도,나주시,다시면,관내사전투표,1197,1197,678,15,437,19,29,0,0,2,0,2,2,0,4,1188,9,0
전라남도,나주시,다시면,다시면제1투,1582,1033,541,31,411,11,22,0,0,0,0,0,4,1,1,1022,11,549
전라남도,나주시,다시면,다시면제2투,518,341,182,8,134,4,8,0,0,0,0,1,0,0,1,338,3,177
전라남도,나주시,문평면,합계,1673,1263,707,28,459,8,27,0,2,0,1,1,2,1,12,1248,15,410
전라남도,나주시,문평면,관내사전투표,476,476,270,14,164,5,8,0,1,0,0,1,2,0,6,471,5,0
전라남도,나주시,문평면,문평면제1투,725,479,274,12,158,2,15,0,1,0,1,0,0,1,6,470,9,246
전라남도,나주시,문평면,문평면제2투,472,308,163,2,137,1,4,0,0,0,0,0,0,0,0,307,1,164
전라남도,나주시,노안면,합계,3969,2930,1768,48,957,30,64,3,1,3,1,18,4,6,10,2913,17,1039
전라남도,나주시,노안면,관내사전투표,892,892,566,15,260,10,20,2,0,0,1,8,2,2,1,887,5,0
전라남도,나주시,노안면,노안면제1투,712,433,251,10,149,3,11,0,0,0,0,4,1,1,1,431,2,279
전라남도,나주시,노안면,노안면제2투,1058,782,460,11,271,9,17,1,1,1,0,2,1,1,4,779,3,276
전라남도,나주시,노안면,노안면제3투,1307,823,491,12,277,8,16,0,0,2,0,4,0,2,4,816,7,484
전라남도,나주시,금천면,합계,3718,2739,1575,45,982,25,58,4,1,2,1,3,10,5,15,2726,13,979
전라남도,나주시,금천면,관내사전투표,955,955,544,16,342,13,24,3,1,1,0,1,1,1,6,953,2,0
전라남도,나주시,금천면,금천면제1투,1005,631,326,12,264,4,13,1,0,1,0,0,2,2,3,628,3,374
전라남도,나주시,금천면,금천면제2투,779,505,313,8,160,4,7,0,0,0,1,1,5,1,3,503,2,274
전라남도,나주시,금천면,금천면제3투,979,648,392,9,216,4,14,0,0,0,0,1,2,1,3,642,6,331
전라남도,나주시,산포면,관내사전투표,713,713,465,7,201,7,21,0,0,0,1,0,1,3,3,709,4,0
전라남도,나주시,산포면,합계,2978,2285,1358,35,763,26,65,1,0,3,1,0,2,5,10,2269,16,693
전라남도,나주시,산포면,산포면제1투,1324,865,489,13,322,10,21,1,0,0,0,0,1,0,0,857,8,459
전라남도,나주시,산포면,산포면제2투,222,168,98,6,55,2,4,0,0,0,0,0,0,1,2,168,0,54
전라남도,나주시,산포면,산포면제3투,719,539,306,9,185,7,19,0,0,3,0,0,0,1,5,535,4,180
전라남도,나주시,다도면,관내사전투표,538,538,312,18,148,9,23,2,3,2,2,2,2,1,5,529,9,0
전라남도,나주시,다도면,합계,1700,1198,692,31,384,12,30,2,3,3,3,6,3,3,8,1180,18,502
전라남도,나주시,다도면,다도면투표소,1162,660,380,13,236,3,7,0,0,1,1,4,1,2,3,651,9,502
전라남도,나주시,봉황면,관내사전투표,1002,1002,602,13,346,7,19,1,0,1,0,3,2,2,5,1001,1,0
전라남도,나주시,봉황면,합계,3478,2564,1510,44,883,20,55,1,0,2,1,3,10,8,14,2551,13,914
전라남도,나주시,봉황면,봉황면제1투,1733,1097,652,25,371,7,22,0,0,1,0,0,5,4,4,1091,6,636
전라남도,나주시,봉황면,봉황면제2투,743,465,256,6,166,6,14,0,0,0,1,0,3,2,5,459,6,278
전라남도,나주시,송월동,합계,4561,3509,2227,65,973,73,147,0,0,1,3,6,1,4,2,3502,7,1052
전라남도,나주시,송월동,관내사전투표,1064,1064,730,14,233,25,55,0,0,0,1,3,0,1,0,1062,2,0
전라남도,나주시,송월동,송월동제1투,474,295,156,3,120,5,7,0,0,0,0,0,0,2,1,294,1,179
전라남도,나주시,송월동,송월동제2투,1603,1149,723,20,330,16,55,0,0,1,0,2,1,0,0,1148,1,454
전라남도,나주시,송월동,송월동제3투,1420,1001,618,28,290,27,30,0,0,0,2,1,0,1,1,998,3,419
전라남도,나주시,영강동,합계,2359,1723,1062,28,535,22,50,1,1,1,0,6,2,3,5,1716,7,636
전라남도,나주시,영강동,관내사전투표,910,910,586,11,262,11,19,1,0,0,0,6,2,1,5,904,6,0
전라남도,나주시,영강동,영강동투표소,1449,813,476,17,273,11,31,0,1,1,0,0,0,2,0,812,1,636
전라남도,나주시,금남동,합계,4355,3194,1882,64,1045,60,106,0,0,3,0,7,0,2,7,3176,18,1161
전라남도,나주시,금남동,관내사전투표,1223,1223,773,14,352,18,54,0,0,1,0,3,0,0,2,1217,6,0
전라남도,나주시,금남동,금남동제1투,1165,748,387,25,285,21,22,0,0,0,0,0,0,0,2,742,6,417
전라남도,나주시,금남동,금남동제2투,863,519,297,11,184,12,10,0,0,2,0,0,0,0,1,517,2,344
전라남도,나주시,금남동,금남동제3투,1104,704,425,14,224,9,20,0,0,0,0,4,0,2,2,700,4,400
전라남도,나주시,성북동,합계,7255,5887,3563,120,1779,127,255,1,1,6,0,15,2,0,3,5872,15,1368
전라남도,나주시,성북동,관내사전투표,2588,2588,1589,54,749,53,128,0,1,3,0,2,1,0,1,2581,7,0
전라남도,나주시,성북동,성북동제1투,1148,690,373,21,256,15,19,0,0,0,0,3,1,0,1,689,1,458
전라남도,나주시,성북동,성북동제2투,1103,757,427,15,254,21,30,0,0,2,0,3,0,0,0,752,5,346
전라남도,나주시,성북동,성북동제3투,2416,1852,1174,30,520,38,78,1,0,1,0,7,0,0,1,1850,2,564
전라남도,나주시,영산동,합계,2974,2140,1278,55,701,27,45,2,0,1,1,3,3,1,13,2130,10,834
전라남도,나주시,영산동,관내사전투표,825,825,507,16,263,10,17,1,0,0,0,2,1,1,5,823,2,0
전라남도,나주시,영산동,영산동제1투,906,563,327,18,191,8,10,1,0,0,1,0,0,0,3,559,4,343
전라남도,나주시,영산동,영산동제2투,1243,752,444,21,247,9,18,0,0,1,0,1,2,0,5,748,4,491
전라남도,나주시,이창동,합계,3557,2635,1613,44,846,43,65,1,0,3,0,2,2,1,7,2627,8,922
전라남도,나주시,이창동,관내사전투표,1376,1376,887,25,399,24,36,0,0,3,0,0,0,0,1,1375,1,0
전라남도,나주시,이창동,이창동투표소,2181,1259,726,19,447,19,29,1,0,0,0,2,2,1,6,1252,7,922
전라남도,나주시,빛가람동,합계,14650,12388,8516,275,2482,407,652,4,1,4,0,22,0,0,4,12367,21,2262
전라남도,나주시,빛가람동,관내사전투표,4539,4539,3240,83,766,156,276,3,1,4,0,5,0,0,1,4535,4,0
전라남도,나주시,빛가람동,빛가람동제1투,2222,1753,1183,52,332,88,92,1,0,0,0,2,0,0,0,1750,3,469
전라남도,나주시,빛가람동,빛가람동제2투,1767,1415,972,29,316,39,55,0,0,0,0,2,0,0,0,1413,2,352
전라남도,나주시,빛가람동,빛가람동제3투,1446,1086,716,17,265,28,55,0,0,0,0,3,0,0,0,1084,2,360
전라남도,나주시,빛가람동,빛가람동제4투,2110,1677,1171,48,323,53,70,0,0,0,0,6,0,0,0,1671,6,433
전라남도,나주시,빛가람동,빛가람동제5투,1134,828,512,20,228,18,42,0,0,0,0,4,0,0,2,826,2,306
전라남도,나주시,빛가람동,빛가람동제6투,1432,1090,722,26,252,25,62,0,0,0,0,0,0,0,1,1088,2,342
전라남도,나주시,잘못 투입·구분된 투표지,,0,0,0,0,0,0,0,0,0,0,0,0,0,0,0,0,0,0
전라남도,광양시,합계,,120767,96384,63544,4100,20080,3145,4553,48,15,61,22,270,22,38,151,96049,335,24383
전라남도,광양시,거소·선상투표,,338,315,158,17,95,10,10,1,2,2,1,0,0,3,3,302,13,23
전라남도,광양시,관외사전투표,,12445,12442,7905,522,2254,713,908,8,5,6,1,35,0,6,22,12385,57,3
전라남도,광양시,재외투표,,543,389,245,9,71,13,47,2,0,0,0,0,0,0,0,387,2,154
전라남도,광양시,광양읍,합계,34916,26868,18313,769,5848,586,1090,11,1,15,3,104,6,7,31,26784,84,8048
전라남도,광양시,광양읍,관내사전투표,8724,8724,6222,217,1630,185,375,2,1,3,1,36,5,1,8,8686,38,0
전라남도,광양시,광양읍,광양읍제1투,2062,1346,872,57,345,23,40,0,0,1,1,3,0,1,0,1343,3,716
전라남도,광양시,광양읍,광양읍제2투,2242,1337,849,38,356,26,56,2,0,0,0,4,0,1,2,1334,3,905
전라남도,광양시,광양읍,광양읍제3투,729,485,320,25,124,5,8,1,0,0,0,1,1,0,0,485,0,244
전라남도,광양시,광양읍,광양읍제4투,2880,1921,1249,61,494,32,67,1,0,0,0,8,0,0,3,1915,6,959
전라남도,광양시,광양읍,광양읍제5투,470,328,247,4,65,2,8,0,0,0,0,0,0,1,1,328,0,142
전라남도,광양시,광양읍,광양읍제6투,536,379,250,13,89,4,14,0,0,1,0,3,0,0,4,378,1,157
전라남도,광양시,광양읍,광양읍제7투,912,640,441,6,170,5,14,0,0,0,0,1,0,0,1,638,2,272
전라남도,광양시,광양읍,광양읍제8투,2318,1436,874,68,368,41,70,0,0,0,0,3,0,0,4,1428,8,882
전라남도,광양시,광양읍,광양읍제9투,2765,1903,1300,40,396,56,97,1,0,2,0,4,0,0,2,1898,5,862
전라남도,광양시,광양읍,광양읍제10투,1739,1174,796,34,265,31,32,0,0,2,1,3,0,0,2,1166,8,565
전라남도,광양시,광양읍,광양읍제11투,2416,1701,1082,66,428,37,70,3,0,2,0,8,0,0,1,1697,4,715
전라남도,광양시,광양읍,광양읍제12투,2918,2152,1491,56,427,58,91,0,0,3,0,21,0,0,1,2148,4,766
전라남도,광양시,광양읍,광양읍제13투,2685,2143,1488,52,438,51,103,0,0,0,0,7,0,1,2,2142,1,542
전라남도,광양시,광양읍,광양읍제14투,1520,1199,832,32,253,30,45,1,0,1,0,2,0,2,0,1198,1,321
전라남도,광양시,봉강면,관내사전투표,349,349,208,8,98,11,18,0,0,1,1,0,0,0,1,346,3,0
전라남도,광양시,봉강면,합계,1607,1192,723,49,338,28,33,0,1,2,4,0,1,1,8,1188,4,415
전라남도,광양시,봉강면,봉강면제1투,451,316,183,22,96,7,5,0,0,0,0,0,1,1,1,316,0,135
전라남도,광양시,봉강면,봉강면제2투,807,527,332,19,144,10,10,0,1,1,3,0,0,0,6,526,1,280
전라남도,광양시,옥룡면,관내사전투표,579,579,373,18,150,6,20,0,0,2,0,2,0,0,3,574,5,0
전라남도,광양시,옥룡면,합계,2432,1842,1152,71,520,24,39,0,0,3,0,3,0,2,16,1830,12,590
전라남도,광양시,옥룡면,옥룡면제1투,1024,681,411,31,202,12,11,0,0,1,0,1,0,1,6,676,5,343
전라남도,광양시,옥룡면,옥룡면제2투,829,582,368,22,168,6,8,0,0,0,0,0,0,1,7,580,2,247
전라남도,광양시,옥곡면,합계,2568,2003,1350,50,475,44,46,1,0,1,2,4,3,1,14,1991,12,565
전라남도,광양시,옥곡면,관내사전투표,802,802,541,24,186,18,22,0,0,0,1,1,0,0,3,796,6,0
전라남도,광양시,옥곡면,옥곡면제1투,676,459,314,9,104,9,5,1,0,0,1,3,3,1,7,457,2,217
전라남도,광양시,옥곡면,옥곡면제2투,1090,742,495,17,185,17,19,0,0,1,0,0,0,0,4,738,4,348
전라남도,광양시,진상면,합계,2540,1960,1399,68,406,20,40,1,1,0,3,2,1,1,8,1950,10,580
전라남도,광양시,진상면,관내사전투표,749,749,559,27,128,8,19,1,0,0,1,1,0,1,3,748,1,0
전라남도,광양시,진상면,진상면제1투,1143,780,549,28,171,9,13,0,1,0,0,0,1,0,4,776,4,363
전라남도,광양시,진상면,진상면제2투,648,431,291,13,107,3,8,0,0,0,2,1,0,0,1,426,5,217
전라남도,광양시,진월면,합계,2585,1883,1205,92,480,37,41,0,0,3,2,4,0,1,7,1872,11,702
전라남도,광양시,진월면,관내사전투표,607,607,390,21,161,18,12,0,0,0,0,1,0,1,2,606,1,0
전라남도,광양시,진월면,진월면제1투,1042,630,405,29,162,10,14,0,0,1,0,2,0,0,1,624,6,412
전라남도,광양시,진월면,진월면제2투,469,319,222,12,72,2,5,0,0,1,1,0,0,0,2,317,2,150
전라남도,광양시,진월면,진월면제3투,467,327,188,30,85,7,10,0,0,1,1,1,0,0,2,325,2,140
전라남도,광양시,다압면,합계,1406,1077,711,86,216,22,30,1,2,2,0,0,0,2,2,1074,3,329
전라남도,광양시,다압면,관내사전투표,239,239,156,20,44,7,8,1,1,1,0,0,0,0,0,238,1,0
전라남도,광양시,다압면,다압면제1투,578,434,293,42,78,6,12,0,1,0,0,0,0,1,0,433,1,144
전라남도,광양시,다압면,다압면제2투,589,404,262,24,94,9,10,0,0,1,0,0,0,1,2,403,1,185
전라남도,광양시,골약동,합계,1682,1318,914,60,277,26,25,0,0,0,0,3,1,2,4,1312,6,364
전라남도,광양시,골약동,관내사전투표,536,536,374,24,115,8,10,0,0,0,0,0,0,1,1,533,3,0
전라남도,광양시,골약동,골약동제1투,571,412,315,7,66,8,10,0,0,0,0,1,1,0,3,411,1,159
전라남도,광양시,골약동,골약동제2투,575,370,225,29,96,10,5,0,0,0,0,2,0,1,0,368,2,205
전라남도,광양시,중마동,합계,37671,29266,19691,1247,5598,1019,1499,11,3,11,4,83,4,10,17,29197,69,8405
전라남도,광양시,중마동,관내사전투표,10208,10208,7131,354,1726,383,537,7,0,2,2,28,1,5,9,10185,23,0
전라남도,광양시,중마동,중마동제1투,3113,2135,1396,93,455,91,86,2,1,1,0,4,1,0,0,2130,5,978
전라남도,광양시,중마동,중마동제2투,3058,1919,1269,91,388,52,98,0,0,1,1,11,0,0,3,1914,5,1139
전라남도,광양시,중마동,중마동제3투,3333,2250,1437,113,499,86,96,1,1,1,0,14,0,0,1,2249,1,1083
전라남도,광양시,중마동,중마동제4투,3226,2279,1467,114,498,67,119,1,0,2,1,5,0,0,1,2275,4,947
전라남도,광양시,중마동,중마동제5투,3374,2250,1453,103,469,80,129,0,1,0,0,7,1,0,0,2243,7,1124
전라남도,광양시,중마동,중마동제6투,2952,2066,1411,86,377,64,111,0,0,2,0,5,1,0,0,2057,9,886
전라남도,광양시,중마동,중마동제7투,2717,2059,1412,83,373,65,117,0,0,1,0,5,0,0,1,2057,2,658
전라남도,광양시,중마동,중마동제8투,2863,2237,1470,121,455,74,105,0,0,0,0,1,0,4,0,2230,7,626
전라남도,광양시,중마동,중마동제9투,2827,1863,1245,89,358,57,101,0,0,1,0,3,0,1,2,1857,6,964
전라남도,광양시,광영동,합계,9182,6675,4244,379,1544,156,277,2,0,10,0,23,2,1,11,6649,26,2507
전라남도,광양시,광영동,관내사전투표,2258,2258,1526,93,467,50,100,1,0,4,0,8,1,0,3,2253,5,0
전라남도,광양시,광영동,광영동제1투,2431,1423,829,91,397,30,53,1,0,3,0,2,1,1,5,1413,10,1008
전라남도,광양시,광영동,광영동제2투,1719,1151,750,71,248,22,40,0,0,1,0,9,0,0,2,1143,8,568
전라남도,광양시,광영동,광영동제3투,2774,1843,1139,124,432,54,84,0,0,2,0,4,0,0,1,1840,3,931
전라남도,광양시,태인동,합계,1807,1389,1027,49,234,24,39,0,0,1,0,4,0,0,3,1381,8,418
전라남도,광양시,태인동,관내사전투표,660,660,487,15,114,12,26,0,0,1,0,3,0,0,0,658,2,0
전라남도,광양시,태인동,태인동투표소,1147,729,540,34,120,12,13,0,0,0,0,1,0,0,3,723,6,418
전라남도,광양시,금호동,합계,9045,7765,4507,632,1724,423,429,10,0,5,2,5,4,1,5,7747,18,1280
전라남도,광양시,금호동,관내사전투표,3329,3329,2033,221,682,170,205,4,0,1,2,2,1,0,1,3322,7,0
전라남도,광양시,금호동,금호동제1투,1352,1042,599,88,230,62,50,3,0,3,0,1,2,0,0,1038,4,310
전라남도,광양시,금호동,금호동제2투,984,744,402,87,180,34,36,0,0,0,0,1,1,1,0,742,2,240
전라남도,광양시,금호동,금호동제3투,1101,854,504,74,171,59,38,2,0,0,0,0,0,0,2,850,4,247
전라남도,광양시,금호동,금호동제4투,1096,821,466,81,181,38,50,1,0,1,0,1,0,0,2,821,0,275
전라남도,광양시,금호동,금호동제5투,1183,975,503,81,280,60,50,0,0,0,0,0,0,0,0,974,1,208
전라남도,광양시,잘못 투입·구분된 투표지,,0,0,0,0,0,0,0,0,0,0,0,0,0,0,0,0,0,0
전라남도,담양군,합계,,41434,33020,19961,698,10017,597,1212,10,12,25,10,121,30,29,104,32826,194,8414
전라남도,담양군,거소·선상투표,,110,99,50,3,33,1,2,0,0,1,0,0,1,0,1,92,7,11
전라남도,담양군,관외사전투표,,5802,5800,3592,122,1477,193,357,1,2,6,0,17,1,1,4,5773,27,2
전라남도,담양군,재외투표,,202,136,99,1,22,2,11,0,0,0,0,0,0,0,0,135,1,66
전라남도,담양군,담양읍,관내사전투표,2790,2790,1772,57,775,48,99,0,0,4,3,10,1,3,5,2777,13,0
전라남도,담양군,담양읍,합계,10689,8212,5056,202,2467,113,272,0,0,7,3,31,7,6,20,8184,28,2477
전라남도,담양군,담양읍,담양읍제1투,1635,1078,664,20,348,5,29,0,0,0,0,3,0,1,4,1074,4,557
전라남도,담양군,담양읍,담양읍제2투,1362,953,598,20,286,7,30,0,0,0,0,6,0,0,1,948,5,409
전라남도,담양군,담양읍,담양읍제3투,2163,1535,915,58,447,29,65,0,0,2,0,9,3,0,3,1531,4,628
전라남도,담양군,담양읍,담양읍제4투,1069,719,407,15,247,16,30,0,0,1,0,0,0,0,1,717,2,350
전라남도,담양군,담양읍,담양읍제5투,1670,1137,700,32,364,8,19,0,0,0,0,3,3,2,6,1137,0,533
전라남도,담양군,봉산면,합계,2203,1655,965,26,585,24,29,0,0,0,0,3,2,2,8,1644,11,548
전라남도,담양군,봉산면,관내사전투표,567,567,333,12,198,11,7,0,0,0,0,0,0,0,3,564,3,0
전라남도,담양군,봉산면,봉산면제1투,1096,694,418,10,229,10,13,0,0,0,0,1,2,2,4,689,5,402
전라남도,담양군,봉산면,봉산면제2투,540,394,214,4,158,3,9,0,0,0,0,2,0,0,1,391,3,146
전라남도,담양군,고서면,합계,2650,2065,1212,38,687,33,61,1,2,0,2,5,1,3,10,2055,10,585
전라남도,담양군,고서면,관내사전투표,846,846,497,15,275,13,27,1,0,0,1,3,0,2,5,839,7,0
전라남도,담양군,고서면,고서면제1투,954,626,376,10,207,9,16,0,1,0,1,2,0,0,2,624,2,328
전라남도,담양군,고서면,고서면제2투,850,593,339,13,205,11,18,0,1,0,0,0,1,1,3,592,1,257
전라남도,담양군,남면,합계,960,729,414,11,248,19,20,0,1,0,1,0,2,3,2,721,8,231
전라남도,담양군,남면,관내사전투표,278,278,155,3,99,9,7,0,0,0,0,0,0,1,0,274,4,0
전라남도,담양군,남면,남면제1투,350,232,130,6,77,6,9,0,1,0,1,0,0,0,1,231,1,118
전라남도,담양군,남면,남면제2투,332,219,129,2,72,4,4,0,0,0,0,0,2,2,1,216,3,113
전라남도,담양군,창평면,관내사전투표,902,902,528,13,294,17,37,1,1,0,1,3,0,1,2,898,4,0
전라남도,담양군,창평면,합계,2974,2253,1319,34,745,33,78,1,1,1,1,15,1,1,8,2238,15,721
전라남도,담양군,창평면,창평면제1투,1422,907,540,11,291,12,30,0,0,0,0,12,1,0,3,900,7,515
전라남도,담양군,창평면,창평면제2투,650,444,251,10,160,4,11,0,0,1,0,0,0,0,3,440,4,206
전라남도,담양군,대덕면,합계,1434,1048,557,23,377,13,44,0,1,3,2,14,2,1,0,1037,11,386
전라남도,담양군,대덕면,관내사전투표,326,326,174,9,101,7,23,0,1,2,0,3,0,1,0,321,5,0
전라남도,담양군,대덕면,대덕면제1투,878,572,289,11,237,6,16,0,0,1,2,3,1,0,0,566,6,306
전라남도,담양군,대덕면,대덕면제2투,230,150,94,3,39,0,5,0,0,0,0,8,1,0,0,150,0,80
전라남도,담양군,무정면,합계,2026,1482,893,38,453,24,43,2,0,3,0,4,1,1,9,1471,11,544
전라남도,담양군,무정면,관내사전투표,491,491,299,14,138,16,15,0,0,1,0,3,0,0,1,487,4,0
전라남도,담양군,무정면,무정면제1투,991,631,386,15,200,1,19,1,0,0,0,1,0,0,6,629,2,360
전라남도,담양군,무정면,무정면제2투,544,360,208,9,115,7,9,1,0,2,0,0,1,1,2,355,5,184
전라남도,담양군,금성면,합계,2117,1615,976,34,514,27,40,1,1,0,0,2,1,3,6,1605,10,502
전라남도,담양군,금성면,관내사전투표,625,625,394,15,171,15,19,0,1,0,0,1,1,0,4,621,4,0
전라남도,담양군,금성면,금성면제1투,1105,715,428,14,236,9,18,0,0,0,0,1,0,1,2,709,6,390
전라남도,담양군,금성면,금성면제2투,387,275,154,5,107,3,3,1,0,0,0,0,0,2,0,275,0,112
전라남도,담양군,용면,관내사전투표,429,429,266,8,131,4,14,0,0,0,0,1,0,2,2,428,1,0
전라남도,담양군,용면,합계,1552,1239,718,28,426,16,26,0,0,0,0,2,2,5,7,1230,9,313
전라남도,담양군,용면,용면제1투,813,573,313,17,214,8,9,0,0,0,0,0,2,2,1,566,7,240
전라남도,담양군,용면,용면제2투,310,237,139,3,81,4,3,0,0,0,0,1,0,1,4,236,1,73
전라남도,담양군,월산면,합계,2027,1562,909,48,465,32,57,2,3,3,0,9,3,0,14,1545,17,465
전라남도,담양군,월산면,관내사전투표,620,620,362,21,177,13,24,0,3,1,0,2,1,0,5,609,11,0
전라남도,담양군,월산면,월산면제1투,1019,656,381,21,203,13,24,0,0,0,0,4,0,0,5,651,5,363
전라남도,담양군,월산면,월산면제2투,388,286,166,6,85,6,9,2,0,2,0,3,2,0,4,285,1,102
전라남도,담양군,수북면,합계,3361,2605,1558,43,843,29,85,0,1,0,1,17,5,2,8,2592,13,756
전라남도,담양군,수북면,관내사전투표,978,978,625,14,274,12,34,0,1,0,1,8,1,0,3,973,5,0
전라남도,담양군,수북면,수북면제1투,1805,1206,718,21,397,13,37,0,0,0,0,8,2,1,3,1200,6,599
전라남도,담양군,수북면,수북면제2투,578,421,215,8,172,4,14,0,0,0,0,1,2,1,2,419,2,157
전라남도,담양군,대전면,관내사전투표,835,835,569,16,194,14,31,1,0,0,0,1,0,1,1,828,7,0
전라남도,담양군,대전면,합계,3327,2520,1643,47,675,38,87,2,0,1,0,2,1,1,7,2504,16,807
전라남도,담양군,대전면,대전면제1투,1764,1154,736,24,332,17,31,0,0,1,0,1,1,0,4,1147,7,610
전라남도,담양군,대전면,대전면제2투,728,531,338,7,149,7,25,1,0,0,0,0,0,0,2,529,2,197
전라남도,담양군,잘못 투입·구분된 투표지,,0,0,0,0,0,0,0,0,0,0,0,0,0,0,0,0,0,0
전라남도,장성군,합계,,39083,30670,17378,851,10167,674,1190,17,13,46,13,47,23,16,85,30520,150,8413
전라남도,장성군,거소·선상투표,,135,123,58,8,44,7,2,1,0,1,0,0,0,0,0,121,2,12
전라남도,장성군,관외사전투표,,5449,5449,3226,142,1494,191,339,4,0,3,1,8,1,1,6,5416,33,0
전라남도,장성군,재외투표,,144,105,66,2,17,3,17,0,0,0,0,0,0,0,0,105,0,39
전라남도,장성군,장성읍,관내사전투표,2742,2742,1594,45,915,44,112,0,1,11,1,4,1,2,1,2731,11,0
전라남도,장성군,장성읍,합계,9817,7284,4147,160,2522,109,256,0,2,21,2,8,4,2,15,7248,36,2533
전라남도,장성군,장성읍,장성읍제1투,1771,1152,658,36,403,16,27,0,0,1,0,1,1,0,4,1147,5,619
전라남도,장성군,장성읍,장성읍제2투,1568,1032,565,22,387,21,29,0,0,2,0,1,0,0,1,1028,4,536
전라남도,장성군,장성읍,장성읍제3투,1913,1131,650,29,370,11,51,0,0,5,1,2,1,0,2,1122,9,782
전라남도,장성군,장성읍,장성읍제4투,1823,1227,680,28,447,17,37,0,1,2,0,0,1,0,7,1220,7,596
전라남도,장성군,진원면,관내사전투표,636,636,393,12,200,4,23,1,0,1,0,0,0,0,2,636,0,0
전라남도,장성군,진원면,합계,2456,1901,1180,40,585,17,61,1,1,2,1,4,1,1,5,1899,2,555
전라남도,장성군,진원면,진원면제1투,1098,753,448,17,244,6,30,0,1,0,1,2,0,1,1,751,2,345
전라남도,장성군,진원면,진원면제2투,722,512,339,11,141,7,8,0,0,1,0,2,1,0,2,512,0,210
전라남도,장성군,남면,합계,2661,2018,1146,32,704,16,84,1,2,6,2,4,1,1,9,2008,10,643
전라남도,장성군,남면,관내사전투표,573,573,322,4,215,2,25,0,0,0,0,0,0,0,1,569,4,0
전라남도,장성군,남면,남면제1투,901,619,358,10,220,6,16,0,0,2,0,3,0,0,3,618,1,282
전라남도,장성군,남면,남면제2투,1187,826,466,18,269,8,43,1,2,4,2,1,1,1,5,821,5,361
전라남도,장성군,동화면,관내사전투표,436,436,246,14,155,3,12,0,0,0,0,0,1,1,1,433,3,0
전라남도,장성군,동화면,합계,1652,1239,648,41,491,14,31,0,0,0,0,0,2,1,3,1231,8,413
전라남도,장성군,동화면,동화면제1투,843,542,285,19,208,8,16,0,0,0,0,0,0,0,1,537,5,301
전라남도,장성군,동화면,동화면제2투,373,261,117,8,128,3,3,0,0,0,0,0,1,0,1,261,0,112
전라남도,장성군,삼서면,합계,2540,1934,1097,57,633,54,65,0,0,4,0,3,1,0,8,1922,12,606
전라남도,장성군,삼서면,관내사전투표,809,809,423,39,263,40,30,0,0,1,0,1,1,0,3,801,8,0
전라남도,장성군,삼서면,삼서면투표소,1731,1125,674,18,370,14,35,0,0,3,0,2,0,0,5,1121,4,606
전라남도,장성군,삼계면,관내사전투표,1165,1165,625,78,341,64,50,0,0,0,0,4,0,0,1,1163,2,0
전라남도,장성군,삼계면,합계,4199,3210,1685,178,1023,161,128,3,1,1,1,6,4,3,5,3199,11,989
전라남도,장성군,삼계면,삼계면제1투,1242,840,500,21,271,14,21,0,0,1,1,1,2,2,1,835,5,402
전라남도,장성군,삼계면,삼계면제2투,1107,755,303,72,245,77,47,3,1,0,0,0,1,1,3,753,2,352
전라남도,장성군,삼계면,삼계면제3투,685,450,257,7,166,6,10,0,0,0,0,1,1,0,0,448,2,235
전라남도,장성군,황룡면,관내사전투표,956,956,571,28,307,10,27,1,2,2,1,2,0,0,2,953,3,0
전라남도,장성군,황룡면,합계,3341,2401,1364,60,832,27,76,4,4,4,1,4,2,1,11,2390,11,940
전라남도,장성군,황룡면,황룡면제1투,880,501,276,7,183,5,17,0,0,2,0,1,1,0,4,496,5,379
전라남도,장성군,황룡면,황룡면제2투,1505,944,517,25,342,12,32,3,2,0,0,1,1,1,5,941,3,561
전라남도,장성군,서삼면,합계,1171,892,439,22,370,14,34,0,0,2,0,1,1,1,3,887,5,279
전라남도,장성군,서삼면,관내사전투표,248,248,125,5,93,7,16,0,0,0,0,0,0,0,1,247,1,0
전라남도,장성군,서삼면,서삼면투표소,923,644,314,17,277,7,18,0,0,2,0,1,1,1,2,640,4,279
전라남도,장성군,북일면,합계,1218,917,539,22,317,10,17,0,0,0,0,3,0,0,6,914,3,301
전라남도,장성군,북일면,관내사전투표,423,423,251,8,146,6,8,0,0,0,0,2,0,0,2,423,0,0
전라남도,장성군,북일면,북일면투표소,795,494,288,14,171,4,9,0,0,0,0,1,0,0,4,491,3,301
전라남도,장성군,북이면,관내사전투표,830,830,462,19,303,19,17,0,0,0,0,3,1,1,3,828,2,0
전라남도,장성군,북이면,합계,2410,1808,1028,46,642,33,39,0,0,0,0,3,1,3,5,1800,8,602
전라남도,장성군,북이면,북이면제1투,727,456,267,11,165,5,6,0,0,0,0,0,0,1,0,455,1,271
전라남도,장성군,북이면,북이면제2투,853,522,299,16,174,9,16,0,0,0,0,0,0,1,2,517,5,331
전라남도,장성군,북하면,관내사전투표,504,504,260,23,194,6,15,1,0,0,1,0,0,0,2,502,2,0
전라남도,장성군,북하면,합계,1890,1389,755,41,493,18,41,3,3,2,5,3,5,2,9,1380,9,501
전라남도,장성군,북하면,북하면투표소,1386,885,495,18,299,12,26,2,3,2,4,3,5,2,7,878,7,501
전라남도,장성군,잘못 투입·구분된 투표지,,0,0,0,0,0,0,0,0,0,0,0,0,0,0,0,0,0,0
전라남도,곡성군,합계,,26671,21247,12152,624,6850,340,795,9,6,44,6,86,26,16,94,21048,199,5424
전라남도,곡성군,거소·선상투표,,82,79,42,1,26,0,2,0,0,1,0,0,1,0,1,74,5,3
전라남도,곡성군,관외사전투표,,3440,3440,2056,95,928,108,211,1,0,6,2,13,1,2,3,3426,14,0
전라남도,곡성군,재외투표,,123,81,50,3,17,3,8,0,0,0,0,0,0,0,0,81,0,42
전라남도,곡성군,곡성읍,합계,6359,4972,2916,147,1529,66,163,2,0,14,1,25,5,1,30,4899,73,1387
전라남도,곡성군,곡성읍,관내사전투표,2001,2001,1218,59,518,33,77,2,0,2,0,12,4,0,19,1944,57,0
전라남도,곡성군,곡성읍,곡성읍제1투,1051,709,373,17,275,6,19,0,0,4,0,6,0,0,4,704,5,342
전라남도,곡성군,곡성읍,곡성읍제2투,1113,771,435,30,259,14,20,0,0,2,0,4,0,1,2,767,4,342
전라남도,곡성군,곡성읍,곡성읍제3투,1316,922,541,32,298,9,33,0,0,4,0,0,0,0,3,920,2,394
전라남도,곡성군,곡성읍,곡성읍제4투,878,569,349,9,179,4,14,0,0,2,1,3,1,0,2,564,5,309
전라남도,곡성군,오곡면,관내사전투표,467,467,277,12,162,4,6,0,0,1,0,1,0,0,2,465,2,0
전라남도,곡성군,오곡면,합계,1565,1246,694,48,444,16,27,0,0,3,0,1,1,0,5,1239,7,319
전라남도,곡성군,오곡면,오곡면투표소,1098,779,417,36,282,12,21,0,0,2,0,0,1,0,3,774,5,319
전라남도,곡성군,삼기면,합계,1383,997,557,42,342,9,26,0,0,0,0,0,1,2,5,984,13,386
전라남도,곡성군,삼기면,관내사전투표,347,347,188,18,115,6,14,0,0,0,0,0,0,1,1,343,4,0
전라남도,곡성군,삼기면,삼기면투표소,1036,650,369,24,227,3,12,0,0,0,0,0,1,1,4,641,9,386
전라남도,곡성군,석곡면,합계,2179,1668,1007,45,534,10,33,0,1,2,0,3,5,3,10,1653,15,511
전라남도,곡성군,석곡면,관내사전투표,817,817,527,22,234,2,14,0,1,0,0,1,2,2,5,810,7,0
전라남도,곡성군,석곡면,석곡면투표소,1362,851,480,23,300,8,19,0,0,2,0,2,3,1,5,843,8,511
전라남도,곡성군,목사동면,합계,1104,792,405,25,309,10,19,1,0,1,0,2,1,3,3,779,13,312
전라남도,곡성군,목사동면,관내사전투표,339,339,174,14,132,3,5,0,0,1,0,2,0,2,1,334,5,0
전라남도,곡성군,목사동면,목사동면투표소,765,453,231,11,177,7,14,1,0,0,0,0,1,1,2,445,8,312
전라남도,곡성군,죽곡면,합계,1520,1173,695,45,371,19,26,1,0,1,1,1,2,0,3,1165,8,347
전라남도,곡성군,죽곡면,관내사전투표,519,519,314,9,172,9,6,0,0,0,1,1,1,0,1,514,5,0
전라남도,곡성군,죽곡면,죽곡면투표소,1001,654,381,36,199,10,20,1,0,1,0,0,1,0,2,651,3,347
전라남도,곡성군,고달면,합계,1023,788,457,25,242,9,30,1,1,1,0,4,1,1,7,779,9,235
전라남도,곡성군,고달면,관내사전투표,230,230,127,7,75,4,10,0,1,0,0,2,1,0,2,229,1,0
전라남도,곡성군,고달면,고달면투표소,793,558,330,18,167,5,20,1,0,1,0,2,0,1,5,550,8,235
전라남도,곡성군,옥과면,합계,3397,2585,1430,51,896,40,114,1,0,10,0,14,2,1,7,2566,19,812
전라남도,곡성군,옥과면,관내사전투표,1051,1051,576,15,373,20,50,0,0,1,0,6,0,0,5,1046,5,0
전라남도,곡성군,옥과면,옥과면제1투,1550,991,569,20,316,17,48,0,0,5,0,4,2,1,1,983,8,559
전라남도,곡성군,옥과면,옥과면제2투,796,543,285,16,207,3,16,1,0,4,0,4,0,0,1,537,6,253
전라남도,곡성군,입면,관내사전투표,644,644,362,12,224,11,18,0,1,0,0,2,1,1,5,637,7,0
전라남도,곡성군,입면,합계,1902,1476,890,23,444,19,62,0,2,0,1,12,1,1,11,1466,10,426
전라남도,곡성군,입면,입면투표소,1258,832,528,11,220,8,44,0,1,0,1,10,0,0,6,829,3,426
전라남도,곡성군,겸면,관내사전투표,560,560,286,22,197,10,26,0,2,0,1,3,1,1,3,552,8,0
전라남도,곡성군,겸면,합계,1442,1107,556,45,401,18,51,1,2,4,1,9,2,2,5,1097,10,335
전라남도,곡성군,겸면,겸면투표소,882,547,270,23,204,8,25,1,0,4,0,6,1,1,2,545,2,335
전라남도,곡성군,오산면,관내사전투표,408,408,211,13,160,5,13,1,0,1,0,0,1,0,0,405,3,0
전라남도,곡성군,오산면,합계,1152,843,397,29,367,13,23,1,0,1,0,2,3,0,4,840,3,309
전라남도,곡성군,오산면,오산면투표소,744,435,186,16,207,8,10,0,0,0,0,2,2,0,4,435,0,309
전라남도,곡성군,잘못 투입·구분된 투표지,,0,0,0,0,0,0,0,0,0,0,0,0,0,0,0,0,0,0
전라남도,구례군,합계,,23487,18924,11873,628,5188,285,639,4,3,20,2,93,13,13,50,18811,113,4563
전라남도,구례군,거소·선상투표,,75,69,32,9,17,2,3,0,0,0,0,0,1,0,1,65,4,6
전라남도,구례군,관외사전투표,,2551,2550,1644,70,572,92,143,1,0,3,0,10,0,0,3,2538,12,1
전라남도,구례군,재외투표,,102,75,45,5,12,0,10,0,0,0,0,0,0,1,0,73,2,27
전라남도,구례군,구례읍,합계,8418,6597,4107,191,1898,87,225,1,0,8,1,33,2,3,11,6567,30,1821
전라남도,구례군,구례읍,관내사전투표,2599,2599,1682,70,666,40,107,0,0,2,0,14,2,1,4,2588,11,0
전라남도,구례군,구례읍,구례읍제1투,735,549,352,16,152,8,13,0,0,3,0,3,0,0,0,547,2,186
전라남도,구례군,구례읍,구례읍제2투,1305,932,546,28,308,11,27,1,0,1,0,3,0,1,1,927,5,373
전라남도,구례군,구례읍,구례읍제3투,1384,905,545,25,286,10,23,0,0,2,0,7,0,0,2,900,5,479
전라남도,구례군,구례읍,구례읍제4투,975,660,414,17,203,6,17,0,0,0,0,2,0,0,0,659,1,315
전라남도,구례군,구례읍,구례읍제5투,1420,952,568,35,283,12,38,0,0,0,1,4,0,1,4,946,6,468
전라남도,구례군,문척면,합계,1038,811,477,30,257,7,22,0,0,1,0,6,3,1,2,806,5,227
전라남도,구례군,문척면,관내사전투표,278,278,177,5,74,4,11,0,0,0,0,4,1,0,0,276,2,0
전라남도,구례군,문척면,문척면투표소,760,533,300,25,183,3,11,0,0,1,0,2,2,1,2,530,3,227
전라남도,구례군,간전면,관내사전투표,348,348,224,11,90,7,10,0,0,0,0,3,0,1,1,347,1,0
전라남도,구례군,간전면,합계,1299,1030,652,39,277,15,22,0,0,1,0,7,2,2,7,1024,6,269
전라남도,구례군,간전면,간전면제1투,451,303,183,12,91,4,4,0,0,1,0,2,0,0,2,299,4,148
전라남도,구례군,간전면,간전면제2투,270,211,151,6,41,2,6,0,0,0,0,1,1,1,1,210,1,59
전라남도,구례군,간전면,간전면제3투,230,168,94,10,55,2,2,0,0,0,0,1,1,0,3,168,0,62
전라남도,구례군,토지면,합계,2072,1621,1077,64,378,17,48,1,1,0,0,7,0,0,11,1604,17,451
전라남도,구례군,토지면,관내사전투표,696,696,491,19,147,8,16,0,1,0,0,2,0,0,3,687,9,0
전라남도,구례군,토지면,토지면제1투,769,497,309,20,136,6,14,0,0,0,0,4,0,0,4,493,4,272
전라남도,구례군,토지면,토지면제2투,287,189,114,13,50,2,7,0,0,0,0,1,0,0,0,187,2,98
전라남도,구례군,토지면,토지면제3투,320,239,163,12,45,1,11,1,0,0,0,0,0,0,4,237,2,81
전라남도,구례군,마산면,합계,2234,1719,1070,77,451,27,59,1,2,2,0,12,2,2,4,1709,10,515
전라남도,구례군,마산면,관내사전투표,678,678,447,21,158,13,25,1,1,1,0,6,0,0,2,675,3,0
전라남도,구례군,마산면,마산면투표소,1556,1041,623,56,293,14,34,0,1,1,0,6,2,2,2,1034,7,515
전라남도,구례군,광의면,관내사전투표,376,376,259,8,89,7,7,0,0,0,0,2,0,1,1,374,2,0
전라남도,구례군,광의면,합계,1890,1454,918,38,433,15,26,0,0,1,1,5,1,2,1,1441,13,436
전라남도,구례군,광의면,광의면제1투,872,609,376,15,194,3,12,0,0,0,1,2,1,0,0,604,5,263
전라남도,구례군,광의면,광의면제2투,642,469,283,15,150,5,7,0,0,1,0,1,0,1,0,463,6,173
전라남도,구례군,용방면,합계,1299,1070,651,24,333,11,32,0,0,4,0,8,0,0,3,1066,4,229
전라남도,구례군,용방면,관내사전투표,448,448,297,11,116,7,9,0,0,2,0,5,0,0,1,448,0,0
전라남도,구례군,용방면,용방면투표소,851,622,354,13,217,4,23,0,0,2,0,3,0,0,2,618,4,229
전라남도,구례군,산동면,관내사전투표,512,512,329,23,132,4,20,0,0,0,0,2,0,0,0,510,2,0
전라남도,구례군,산동면,합계,2509,1928,1200,81,560,12,49,0,0,0,0,5,2,2,7,1918,10,581
전라남도,구례군,산동면,산동면제1투,984,682,432,18,202,3,16,0,0,0,0,2,2,1,3,679,3,302
전라남도,구례군,산동면,산동면제2투,670,487,274,30,165,5,9,0,0,0,0,1,0,0,1,485,2,183
전라남도,구례군,산동면,산동면제3투,343,247,165,10,61,0,4,0,0,0,0,0,0,1,3,244,3,96
전라남도,구례군,잘못 투입·구분된 투표지,,0,0,0,0,0,0,0,0,0,0,0,0,0,0,0,0,0,0
전라남도,고흥군,합계,,60101,47036,26882,1349,15614,703,1195,14,17,266,8,202,59,54,251,46614,422,13065
전라남도,고흥군,거소·선상투표,,357,326,114,33,136,7,7,3,0,1,0,2,0,0,0,303,23,31
전라남도,고흥군,관외사전투표,,5275,5274,3323,143,1243,187,295,0,2,25,1,20,0,2,4,5245,29,1
전라남도,고흥군,재외투표,,239,130,82,7,24,2,11,0,0,2,0,2,0,0,0,130,0,109
전라남도,고흥군,고흥읍,관내사전투표,2777,2777,1754,56,736,57,119,0,2,20,2,19,1,0,2,2768,9,0
전라남도,고흥군,고흥읍,합계,9029,6983,4060,196,2231,125,219,0,2,44,3,35,3,6,21,6945,38,2046
전라남도,고흥군,고흥읍,고흥읍제1투,487,358,183,9,148,3,3,0,0,1,0,0,0,0,3,350,8,129
전라남도,고흥군,고흥읍,고흥읍제2투,652,479,271,16,154,8,14,0,0,5,0,5,0,1,1,475,4,173
전라남도,고흥군,고흥읍,고흥읍제3투,1694,1151,618,33,437,10,18,0,0,11,0,5,2,3,7,1144,7,543
전라남도,고흥군,고흥읍,고흥읍제4투,1742,1165,653,39,398,31,31,0,0,3,1,1,0,0,3,1160,5,577
전라남도,고흥군,고흥읍,고흥읍제5투,1677,1053,581,43,358,16,34,0,0,4,0,5,0,2,5,1048,5,624
전라남도,고흥군,도양읍,관내사전투표,1909,1909,1120,47,604,52,54,2,0,15,0,6,1,1,2,1904,5,0
전라남도,고흥군,도양읍,합계,8743,6651,3691,252,2318,100,131,2,0,61,1,18,5,5,25,6609,42,2092
전라남도,고흥군,도양읍,도양읍제1투,1485,1000,534,22,404,10,14,0,0,7,0,1,1,0,1,994,6,485
전라남도,고흥군,도양읍,도양읍제2투,1561,1055,611,22,374,10,16,0,0,11,0,0,0,0,5,1049,6,506
전라남도,고흥군,도양읍,도양읍제3투,2295,1556,889,29,539,22,37,0,0,17,1,6,0,1,5,1546,10,739
전라남도,고흥군,도양읍,도양읍제4투,392,290,162,5,100,1,4,0,0,4,0,5,2,0,4,287,3,102
전라남도,고흥군,도양읍,도양읍제5투,484,364,178,9,154,2,5,0,0,4,0,0,1,1,4,358,6,120
전라남도,고흥군,도양읍,도양읍제6투,417,327,87,117,111,2,1,0,0,3,0,0,0,1,0,322,5,90
전라남도,고흥군,도양읍,도양읍제7투,200,150,110,1,32,1,0,0,0,0,0,0,0,1,4,149,1,50
전라남도,고흥군,풍양면,합계,2924,2251,1376,47,721,16,39,1,1,8,0,1,3,5,10,2228,23,673
전라남도,고흥군,풍양면,관내사전투표,768,768,489,13,222,6,20,0,1,4,0,0,1,2,2,760,8,0
전라남도,고흥군,풍양면,풍양면제1투,716,447,247,13,169,2,7,0,0,1,0,1,0,1,3,444,3,269
전라남도,고흥군,풍양면,풍양면제2투,782,587,381,10,171,7,7,0,0,1,0,0,2,2,2,583,4,195
전라남도,고흥군,풍양면,풍양면제3투,658,449,259,11,159,1,5,1,0,2,0,0,0,0,3,441,8,209
전라남도,고흥군,도덕면,합계,2556,1986,1058,38,736,17,42,1,1,49,0,5,5,3,13,1968,18,570
전라남도,고흥군,도덕면,관내사전투표,681,681,375,6,248,8,16,1,1,16,0,1,2,0,5,679,2,0
전라남도,고흥군,도덕면,도덕면제1투,1081,725,409,22,252,6,19,0,0,4,0,0,2,2,4,720,5,356
전라남도,고흥군,도덕면,도덕면제2투,794,580,274,10,236,3,7,0,0,29,0,4,1,1,4,569,11,214
전라남도,고흥군,금산면,합계,3878,2919,1761,51,972,26,48,1,2,8,0,5,1,4,11,2890,29,959
전라남도,고흥군,금산면,관내사전투표,1214,1214,792,22,344,11,19,0,2,5,0,3,0,3,3,1204,10,0
전라남도,고흥군,금산면,금산면제1투,1488,914,511,10,354,7,19,0,0,1,0,2,0,0,2,906,8,574
전라남도,고흥군,금산면,금산면제2투,1176,791,458,19,274,8,10,1,0,2,0,0,1,1,6,780,11,385
전라남도,고흥군,도화면,합계,3522,2606,1391,70,963,25,44,1,1,3,0,56,7,1,18,2580,26,916
전라남도,고흥군,도화면,관내사전투표,773,773,418,16,271,10,23,0,0,1,0,23,0,0,5,767,6,0
전라남도,고흥군,도화면,도화면제1투,446,321,165,8,126,1,2,0,0,1,0,4,4,0,4,315,6,125
전라남도,고흥군,도화면,도화면제2투,1064,696,380,19,253,4,5,0,1,0,0,22,1,1,5,691,5,368
전라남도,고흥군,도화면,도화면제3투,1239,816,428,27,313,10,14,1,0,1,0,7,2,0,4,807,9,423
전라남도,고흥군,포두면,관내사전투표,778,778,472,20,237,7,30,0,0,1,0,2,0,1,2,772,6,0
전라남도,고흥군,포두면,합계,4449,3349,1921,90,1137,31,72,1,1,7,0,17,4,6,23,3310,39,1100
전라남도,고흥군,포두면,포두면제1투,459,346,176,20,123,5,5,0,0,0,0,5,0,1,4,339,7,113
전라남도,고흥군,포두면,포두면제2투,665,448,257,6,152,5,7,0,0,2,0,1,2,3,7,442,6,217
전라남도,고흥군,포두면,포두면제3투,1608,1093,653,25,355,10,21,0,1,3,0,3,1,1,6,1079,14,515
전라남도,고흥군,포두면,포두면제4투,939,684,363,19,270,4,9,1,0,1,0,6,1,0,4,678,6,255
전라남도,고흥군,봉래면,합계,1654,1203,665,51,399,18,32,0,1,3,0,5,3,1,13,1191,12,451
전라남도,고흥군,봉래면,관내사전투표,478,478,272,11,154,9,20,0,1,1,0,2,0,1,3,474,4,0
전라남도,고흥군,봉래면,봉래면제1투,756,459,244,27,154,7,10,0,0,1,0,1,3,0,5,452,7,297
전라남도,고흥군,봉래면,봉래면제2투,420,266,149,13,91,2,2,0,0,1,0,2,0,0,5,265,1,154
전라남도,고흥군,동일면,관내사전투표,336,336,187,14,106,4,10,0,0,3,0,0,1,3,2,330,6,0
전라남도,고흥군,동일면,합계,1310,982,576,37,305,7,18,0,1,6,0,4,1,5,10,970,12,328
전라남도,고흥군,동일면,동일면투표소,974,646,389,23,199,3,8,0,1,3,0,4,0,2,8,640,6,328
전라남도,고흥군,점암면,합계,2344,1815,982,44,668,13,37,0,0,12,1,8,6,2,17,1790,25,529
전라남도,고흥군,점암면,관내사전투표,428,428,226,13,153,3,21,0,0,5,0,0,2,0,1,424,4,0
전라남도,고흥군,점암면,점암면제1투,919,654,362,12,236,6,6,0,0,6,0,6,4,2,7,647,7,265
전라남도,고흥군,점암면,점암면제2투,506,382,224,11,133,0,3,0,0,0,1,0,0,0,3,375,7,124
전라남도,고흥군,점암면,점암면제3투,491,351,170,8,146,4,7,0,0,1,0,2,0,0,6,344,7,140
전라남도,고흥군,영남면,합계,1150,887,518,29,277,5,15,0,0,6,0,2,1,3,20,876,11,263
전라남도,고흥군,영남면,관내사전투표,290,290,169,10,90,2,6,0,0,3,0,0,0,1,5,286,4,0
전라남도,고흥군,영남면,영남면제1투,421,327,202,11,92,1,6,0,0,2,0,1,0,0,7,322,5,94
전라남도,고흥군,영남면,영남면제2투,439,270,147,8,95,2,3,0,0,1,0,1,1,2,8,268,2,169
전라남도,고흥군,과역면,관내사전투표,1142,1142,627,29,415,15,27,0,1,9,0,3,2,3,5,1136,6,0
전라남도,고흥군,과역면,합계,3144,2462,1348,74,892,30,50,2,2,12,1,7,3,5,11,2437,25,682
전라남도,고흥군,과역면,과역면제1투,1251,816,445,31,299,7,12,1,0,2,1,4,0,2,2,806,10,435
전라남도,고흥군,과역면,과역면제2투,751,504,276,14,178,8,11,1,1,1,0,0,1,0,4,495,9,247
전라남도,고흥군,남양면,관내사전투표,440,440,237,12,167,7,9,0,1,1,0,0,0,0,1,435,5,0
전라남도,고흥군,남양면,합계,1982,1471,767,32,581,19,23,0,3,3,1,3,6,2,16,1456,15,511
전라남도,고흥군,남양면,남양면제1투,875,547,293,14,215,2,9,0,0,1,0,1,3,1,4,543,4,328
전라남도,고흥군,남양면,남양면제2투,667,484,237,6,199,10,5,0,2,1,1,2,3,1,11,478,6,183
전라남도,고흥군,동강면,합계,2767,2131,1223,66,705,28,52,1,0,4,0,7,3,2,17,2108,23,636
전라남도,고흥군,동강면,관내사전투표,794,794,477,24,241,10,24,0,0,3,0,5,1,0,2,787,7,0
전라남도,고흥군,동강면,동강면제1투,1016,700,389,22,239,11,17,0,0,1,0,1,1,2,9,692,8,316
전라남도,고흥군,동강면,동강면제2투,957,637,357,20,225,7,11,1,0,0,0,1,1,0,6,629,8,320
전라남도,고흥군,대서면,합계,2035,1542,853,32,585,16,30,0,0,5,0,2,2,1,7,1533,9,493
전라남도,고흥군,대서면,관내사전투표,488,488,244,13,205,8,11,0,0,3,0,0,1,0,0,485,3,0
전라남도,고흥군,대서면,대서면제1투,956,635,380,9,213,4,17,0,0,1,0,2,1,0,5,632,3,321
전라남도,고흥군,대서면,대서면제2투,591,419,229,10,167,4,2,0,0,1,0,0,0,1,2,416,3,172
전라남도,고흥군,두원면,합계,2743,2068,1173,57,721,31,30,1,0,7,0,3,6,1,15,2045,23,675
전라남도,고흥군,두원면,관내사전투표,739,739,431,12,253,12,16,0,0,2,0,1,1,0,4,732,7,0
전라남도,고흥군,두원면,두원면제1투,1079,718,406,28,243,15,8,0,0,2,0,0,3,1,3,709,9,361
전라남도,고흥군,두원면,두원면제2투,925,611,336,17,225,4,6,1,0,3,0,2,2,0,8,604,7,314
전라남도,고흥군,잘못 투입·구분된 투표지,,0,0,0,0,0,0,0,0,0,0,0,0,0,0,0,0,0,0
전라남도,보성군,합계,,38902,29967,16666,732,10514,537,945,13,6,51,14,94,34,48,127,29781,186,8935
전라남도,보성군,거소·선상투표,,163,148,80,3,48,1,8,1,0,0,1,2,0,0,1,145,3,15
전라남도,보성군,관외사전투표,,4339,4339,2650,113,1113,160,253,2,0,5,1,12,0,3,3,4315,24,0
전라남도,보성군,재외투표,,199,121,80,4,19,4,12,0,0,1,0,0,0,1,0,121,0,78
전라남도,보성군,보성읍,관내사전투표,2072,2072,1167,53,680,51,106,0,0,2,0,6,0,0,2,2067,5,0
전라남도,보성군,보성읍,합계,7082,5452,2933,115,2035,110,199,4,0,6,0,16,2,3,9,5432,20,1630
전라남도,보성군,보성읍,보성읍제1투,879,551,258,19,243,13,16,0,0,0,0,0,1,0,0,550,1,328
전라남도,보성군,보성읍,보성읍제2투,840,558,288,6,234,9,11,3,0,0,0,2,0,1,2,556,2,282
전라남도,보성군,보성읍,보성읍제3투,1229,864,465,18,322,14,31,1,0,3,0,4,0,1,0,859,5,365
전라남도,보성군,보성읍,보성읍제4투,376,254,145,1,88,7,10,0,0,1,0,0,0,0,2,254,0,122
전라남도,보성군,보성읍,보성읍제5투,1071,739,379,10,313,12,18,0,0,0,0,2,1,0,2,737,2,332
전라남도,보성군,보성읍,보성읍제6투,615,414,231,8,155,4,7,0,0,0,0,2,0,1,1,409,5,201
전라남도,보성군,벌교읍,합계,10434,7433,4187,205,2620,98,182,2,3,9,2,14,10,13,36,7381,52,3001
전라남도,보성군,벌교읍,관내사전투표,1973,1972,1139,45,672,36,56,0,1,2,0,5,1,1,4,1962,10,1
전라남도,보성군,벌교읍,벌교읍제1투,942,443,228,16,176,5,12,0,0,1,1,0,1,0,2,442,1,499
전라남도,보성군,벌교읍,벌교읍제2투,951,641,345,13,252,8,14,0,0,0,0,0,1,0,3,636,5,310
전라남도,보성군,벌교읍,벌교읍제3투,1130,748,372,18,307,13,14,1,1,0,0,2,3,3,3,737,11,382
전라남도,보성군,벌교읍,벌교읍제4투,950,620,338,21,235,7,9,0,0,1,0,0,0,1,6,618,2,330
전라남도,보성군,벌교읍,벌교읍제5투,636,450,261,13,148,4,16,0,0,1,0,2,0,1,0,446,4,186
전라남도,보성군,벌교읍,벌교읍제6투,810,545,315,14,187,2,8,0,0,0,0,1,1,4,6,538,7,265
전라남도,보성군,벌교읍,벌교읍제7투,302,174,110,4,53,1,1,0,0,0,0,1,1,0,1,172,2,128
전라남도,보성군,벌교읍,벌교읍제8투,1850,1272,736,47,412,18,41,1,1,3,1,2,0,2,2,1266,6,578
전라남도,보성군,벌교읍,벌교읍제9투,632,415,248,14,131,2,9,0,0,0,0,1,0,1,6,412,3,217
전라남도,보성군,벌교읍,벌교읍제10투,258,153,95,0,47,2,2,0,0,1,0,0,2,0,3,152,1,105
전라남도,보성군,노동면,합계,919,698,358,16,262,14,18,0,0,3,1,9,5,0,6,692,6,221
전라남도,보성군,노동면,관내사전투표,256,256,139,6,90,5,9,0,0,0,0,3,1,0,1,254,2,0
전라남도,보성군,노동면,노동면투표소,663,442,219,10,172,9,9,0,0,3,1,6,4,0,5,438,4,221
전라남도,보성군,미력면,합계,1180,881,500,22,310,13,19,0,0,0,2,3,1,3,3,876,5,299
전라남도,보성군,미력면,관내사전투표,363,363,208,12,121,5,11,0,0,0,1,1,0,1,0,360,3,0
전라남도,보성군,미력면,미력면투표소,817,518,292,10,189,8,8,0,0,0,1,2,1,2,3,516,2,299
전라남도,보성군,겸백면,관내사전투표,255,255,134,6,104,3,3,0,0,2,0,1,1,1,0,255,0,0
전라남도,보성군,겸백면,합계,1035,773,428,21,285,5,12,1,0,2,0,6,2,3,5,770,3,262
전라남도,보성군,겸백면,겸백면투표소,780,518,294,15,181,2,9,1,0,0,0,5,1,2,5,515,3,262
전라남도,보성군,율어면,관내사전투표,254,254,154,4,86,1,7,0,0,2,0,0,0,0,0,254,0,0
전라남도,보성군,율어면,합계,985,729,397,16,281,4,13,1,0,4,1,3,1,2,3,726,3,256
전라남도,보성군,율어면,율어면투표소,731,475,243,12,195,3,6,1,0,2,1,3,1,2,3,472,3,256
전라남도,보성군,복내면,합계,1438,1103,528,20,475,18,27,0,1,4,2,6,2,2,12,1097,6,335
전라남도,보성군,복내면,관내사전투표,431,431,202,5,185,9,11,0,1,4,1,3,1,0,6,428,3,0
전라남도,보성군,복내면,복내면투표소,1007,672,326,15,290,9,16,0,0,0,1,3,1,2,6,669,3,335
전라남도,보성군,문덕면,합계,734,567,298,13,216,8,20,0,0,0,0,3,0,3,4,565,2,167
전라남도,보성군,문덕면,관내사전투표,212,212,118,4,75,3,8,0,0,0,0,1,0,1,1,211,1,0
전라남도,보성군,문덕면,문덕면투표소,522,355,180,9,141,5,12,0,0,0,0,2,0,2,3,354,1,167
전라남도,보성군,조성면,합계,3269,2460,1350,56,895,33,68,1,0,4,1,4,4,7,20,2443,17,809
전라남도,보성군,조성면,관내사전투표,833,833,420,21,331,18,28,0,0,2,1,2,0,1,5,829,4,0
전라남도,보성군,조성면,조성면제1투,998,655,364,10,248,2,18,0,0,0,0,1,4,2,3,652,3,343
전라남도,보성군,조성면,조성면제2투,609,432,255,9,132,8,10,1,0,0,0,1,0,3,7,426,6,177
전라남도,보성군,조성면,조성면제3투,829,540,311,16,184,5,12,0,0,2,0,0,0,1,5,536,4,289
전라남도,보성군,득량면,관내사전투표,701,701,407,17,239,7,14,0,0,3,1,4,0,1,4,697,4,0
전라남도,보성군,득량면,합계,3445,2511,1377,68,932,28,49,0,0,9,1,12,2,2,13,2493,18,934
전라남도,보성군,득량면,득량면제1투,880,582,298,19,228,6,12,0,0,3,0,5,0,1,5,577,5,298
전라남도,보성군,득량면,득량면제2투,1169,753,438,22,255,12,16,0,0,3,0,1,0,0,2,749,4,416
전라남도,보성군,득량면,득량면제3투,695,475,234,10,210,3,7,0,0,0,0,2,2,0,2,470,5,220
전라남도,보성군,회천면,합계,2657,1934,1052,45,720,25,47,1,1,4,1,4,3,4,9,1916,18,723
전라남도,보성군,회천면,관내사전투표,631,631,339,13,232,8,26,0,1,2,1,2,1,1,1,627,4,0
전라남도,보성군,회천면,회천면제1투,628,354,175,13,150,7,4,0,0,1,0,0,0,0,0,350,4,274
전라남도,보성군,회천면,회천면제2투,657,440,274,5,145,1,4,1,0,1,0,0,1,1,3,436,4,217
전라남도,보성군,회천면,회천면제3투,741,509,264,14,193,9,13,0,0,0,0,2,1,2,5,503,6,232
전라남도,보성군,웅치면,합계,1023,818,448,15,303,16,18,0,1,0,1,0,2,2,3,809,9,205
전라남도,보성군,웅치면,관내사전투표,281,281,159,3,101,5,10,0,1,0,0,0,0,0,0,279,2,0
전라남도,보성군,웅치면,웅치면투표소,742,537,289,12,202,11,8,0,0,0,1,0,2,2,3,530,7,205
전라남도,보성군,잘못 투입·구분된 투표지,,0,0,0,0,0,0,0,0,0,0,0,0,0,0,0,0,0,0
전라남도,화순군,합계,,54493,43572,25867,770,13832,727,1662,12,11,35,10,170,47,46,153,43342,230,10921
전라남도,화순군,거소·선상투표,,161,154,75,6,52,7,0,1,1,0,0,1,0,0,3,146,8,7
전라남도,화순군,관외사전투표,,6638,6635,4161,116,1706,208,388,0,1,4,2,15,0,4,6,6611,24,3
전라남도,화순군,재외투표,,199,145,104,7,17,2,14,0,0,0,0,1,0,0,0,145,0,54
전라남도,화순군,화순읍,관내사전투표,6620,6620,4261,66,1775,121,303,1,0,7,0,32,5,1,13,6585,35,0
전라남도,화순군,화순읍,합계,28042,21953,13161,345,6896,377,896,3,3,22,2,99,10,7,36,21857,96,6089
전라남도,화순군,화순읍,화순읍제1투,1498,1176,710,14,374,19,56,0,0,0,0,0,0,0,0,1173,3,322
전라남도,화순군,화순읍,화순읍제2투,1779,1289,760,16,426,16,56,0,1,1,1,7,0,0,2,1286,3,490
전라남도,화순군,화순읍,화순읍제3투,2303,1611,958,35,504,27,70,0,0,2,0,6,0,0,0,1602,9,692
전라남도,화순군,화순읍,화순읍제4투,2267,1605,923,28,553,25,52,1,1,2,0,8,1,1,2,1597,8,662
전라남도,화순군,화순읍,화순읍제5투,1195,909,472,17,359,14,31,0,0,2,0,7,0,0,3,905,4,286
전라남도,화순군,화순읍,화순읍제6투,677,492,292,7,162,4,22,1,0,0,0,0,0,0,1,489,3,185
전라남도,화순군,화순읍,화순읍제7투,521,366,207,6,136,7,8,0,0,0,0,0,0,1,1,366,0,155
전라남도,화순군,화순읍,화순읍제8투,2124,1461,854,35,479,24,41,0,0,2,0,4,1,0,5,1445,16,663
전라남도,화순군,화순읍,화순읍제9투,1498,984,559,25,352,13,24,0,0,2,0,3,2,0,0,980,4,514
전라남도,화순군,화순읍,화순읍제10투,2343,1558,918,20,501,36,63,0,0,2,0,13,0,1,1,1555,3,785
전라남도,화순군,화순읍,화순읍제11투,1792,1306,722,34,463,26,51,0,1,2,1,1,1,0,3,1305,1,486
전라남도,화순군,화순읍,화순읍제12투,1066,753,416,17,259,18,34,0,0,0,0,4,0,2,1,751,2,313
전라남도,화순군,화순읍,화순읍제13투,2359,1823,1109,25,553,27,85,0,0,0,0,14,0,1,4,1818,5,536
전라남도,화순군,한천면,합계,1070,775,424,22,282,10,15,1,0,0,0,1,5,1,8,769,6,295
전라남도,화순군,한천면,관내사전투표,235,235,144,8,74,0,5,1,0,0,0,0,2,0,0,234,1,0
전라남도,화순군,한천면,한천면제1투,487,297,151,7,119,6,6,0,0,0,0,0,2,0,5,296,1,190
전라남도,화순군,한천면,한천면제2투,348,243,129,7,89,4,4,0,0,0,0,1,1,1,3,239,4,105
전라남도,화순군,춘양면,관내사전투표,616,616,405,18,165,2,7,0,0,2,0,3,3,0,5,610,6,0
전라남도,화순군,춘양면,합계,1591,1206,747,33,372,7,19,0,0,2,0,7,3,1,7,1198,8,385
전라남도,화순군,춘양면,춘양면투표소,975,590,342,15,207,5,12,0,0,0,0,4,0,1,2,588,2,385
전라남도,화순군,청풍면,관내사전투표,290,290,180,7,90,1,4,0,0,0,0,0,1,0,4,287,3,0
전라남도,화순군,청풍면,합계,845,633,376,17,206,2,6,0,0,0,0,0,3,2,13,625,8,212
전라남도,화순군,청풍면,청풍면투표소,555,343,196,10,116,1,2,0,0,0,0,0,2,2,9,338,5,212
전라남도,화순군,이양면,합계,1567,1165,714,21,365,12,25,1,0,0,0,1,2,4,17,1162,3,402
전라남도,화순군,이양면,관내사전투표,638,638,397,11,190,9,16,0,0,0,0,0,2,3,8,636,2,0
전라남도,화순군,이양면,이양면투표소,929,527,317,10,175,3,9,1,0,0,0,1,0,1,9,526,1,402
전라남도,화순군,능주면,합계,2815,2195,1278,39,754,24,68,1,0,0,2,8,1,6,4,2185,10,620
전라남도,화순군,능주면,관내사전투표,918,918,544,22,298,8,33,1,0,0,0,4,1,3,1,915,3,0
전라남도,화순군,능주면,능주면제1투,1195,798,462,13,281,13,20,0,0,0,0,4,0,0,2,795,3,397
전라남도,화순군,능주면,능주면제2투,702,479,272,4,175,3,15,0,0,0,2,0,0,3,1,475,4,223
전라남도,화순군,도곡면,합계,2339,1812,1036,32,633,15,59,1,1,1,0,6,1,5,10,1800,12,527
전라남도,화순군,도곡면,관내사전투표,801,801,460,21,263,10,26,1,1,1,0,5,1,0,4,793,8,0
전라남도,화순군,도곡면,도곡면제1투,744,481,247,4,197,3,23,0,0,0,0,1,0,3,1,479,2,263
전라남도,화순군,도곡면,도곡면제2투,794,530,329,7,173,2,10,0,0,0,0,0,0,2,5,528,2,264
전라남도,화순군,도암면,관내사전투표,404,403,207,4,171,3,12,0,0,0,1,1,1,1,1,402,1,1
전라남도,화순군,도암면,합계,1215,924,443,17,420,5,17,0,0,0,2,8,4,2,3,921,3,291
전라남도,화순군,도암면,도암면제1투,577,348,170,9,154,1,5,0,0,0,0,6,1,1,1,348,0,229
전라남도,화순군,도암면,도암면제2투,234,173,66,4,95,1,0,0,0,0,1,1,2,0,1,171,2,61
전라남도,화순군,이서면,관내사전투표,212,212,116,6,68,1,10,0,0,1,0,1,0,0,6,209,3,0
전라남도,화순군,이서면,합계,721,571,317,13,196,4,21,0,0,2,0,1,3,0,8,565,6,150
전라남도,화순군,이서면,이서면투표소,509,359,201,7,128,3,11,0,0,1,0,0,3,0,2,356,3,150
전라남도,화순군,북면,합계,1280,956,608,11,284,10,17,1,1,3,1,1,1,6,7,951,5,324
전라남도,화순군,북면,관내사전투표,433,433,293,5,118,2,5,1,1,3,0,0,1,1,1,431,2,0
전라남도,화순군,북면,북면투표소,847,523,315,6,166,8,12,0,0,0,1,1,0,5,6,520,3,324
전라남도,화순군,동복면,관내사전투표,356,356,208,6,119,5,8,0,0,0,0,0,2,1,3,352,4,0
전라남도,화순군,동복면,합계,1389,1064,588,23,390,13,16,2,0,1,0,2,5,3,10,1053,11,325
전라남도,화순군,동복면,동복면투표소,1033,708,380,17,271,8,8,2,0,1,0,2,3,2,7,701,7,325
전라남도,화순군,남면,관내사전투표,647,647,374,14,236,6,9,0,1,0,0,1,0,0,1,642,5,0
전라남도,화순군,남면,합계,1868,1391,766,29,518,10,35,0,3,0,1,3,4,3,6,1378,13,477
전라남도,화순군,남면,남면제1투,788,472,273,6,161,2,13,0,1,0,0,2,2,3,4,467,5,316
전라남도,화순군,남면,남면제2투,433,272,119,9,121,2,13,0,1,0,1,0,2,0,1,269,3,161
전라남도,화순군,동면,관내사전투표,801,801,430,13,303,8,28,1,1,0,0,4,1,0,7,796,5,0
전라남도,화순군,동면,합계,2753,1993,1069,39,741,21,66,1,1,0,0,16,5,2,15,1976,17,760
전라남도,화순군,동면,동면제1투,1291,751,397,20,279,8,26,0,0,0,0,5,3,2,4,744,7,540
전라남도,화순군,동면,동면제2투,661,441,242,6,159,5,12,0,0,0,0,7,1,0,4,436,5,220
전라남도,화순군,잘못 투입·구분된 투표지,,0,0,0,0,0,0,0,0,0,0,0,0,0,0,0,0,0,0
전라남도,장흥군,합계,,34688,27149,14821,636,9593,513,975,11,4,29,12,204,37,26,127,26988,161,7539
전라남도,장흥군,거소·선상투표,,135,114,53,5,40,4,3,0,0,0,1,1,1,1,2,111,3,21
전라남도,장흥군,관외사전투표,,3786,3785,2375,88,915,140,230,0,0,1,0,11,2,0,6,3768,17,1
전라남도,장흥군,재외투표,,179,114,69,5,29,2,7,0,1,1,0,0,0,0,0,114,0,65
전라남도,장흥군,장흥읍,관내사전투표,3507,3506,2076,66,1111,72,140,1,0,8,2,15,2,3,3,3499,7,1
전라남도,장흥군,장흥읍,합계,11183,8516,4878,185,2853,150,326,3,0,11,4,45,5,5,25,8490,26,2667
전라남도,장흥군,장흥읍,장흥읍제1투,1380,813,417,33,300,15,27,0,0,1,1,8,1,2,3,808,5,567
전라남도,장흥군,장흥읍,장흥읍제2투,965,610,368,15,187,9,14,0,0,0,1,3,2,0,7,606,4,355
전라남도,장흥군,장흥읍,장흥읍제3투,1455,973,510,24,375,17,38,1,0,0,0,3,0,0,2,970,3,482
전라남도,장흥군,장흥읍,장흥읍제4투,1969,1355,812,23,425,15,69,1,0,1,0,6,0,0,2,1354,1,614
전라남도,장흥군,장흥읍,장흥읍제5투,1375,910,510,18,324,19,31,0,0,1,0,3,0,0,1,907,3,465
전라남도,장흥군,장흥읍,장흥읍제6투,532,349,185,6,131,3,7,0,0,0,0,7,0,0,7,346,3,183
전라남도,장흥군,관산읍,합계,4404,3217,1673,59,1274,38,85,0,0,1,0,34,3,4,16,3187,30,1187
전라남도,장흥군,관산읍,관내사전투표,1060,1060,549,19,409,20,40,0,0,0,0,15,0,1,3,1056,4,0
전라남도,장흥군,관산읍,관산읍제1투,1321,797,403,15,328,11,18,0,0,1,0,4,0,2,6,788,9,524
전라남도,장흥군,관산읍,관산읍제2투,954,610,321,14,237,4,15,0,0,0,0,5,2,1,3,602,8,344
전라남도,장흥군,관산읍,관산읍제3투,1069,750,400,11,300,3,12,0,0,0,0,10,1,0,4,741,9,319
전라남도,장흥군,대덕읍,합계,3065,2273,1013,61,1028,45,67,2,2,1,2,10,5,1,19,2256,17,792
전라남도,장흥군,대덕읍,관내사전투표,843,843,392,23,376,16,18,0,1,0,0,6,2,0,4,838,5,0
전라남도,장흥군,대덕읍,대덕읍제1투,1761,1096,462,35,506,26,40,2,1,0,2,4,3,0,7,1088,8,665
전라남도,장흥군,대덕읍,대덕읍제2투,461,334,159,3,146,3,9,0,0,1,0,0,0,1,8,330,4,127
전라남도,장흥군,용산면,합계,1931,1517,825,34,528,14,39,0,0,6,2,38,3,2,10,1501,16,414
전라남도,장흥군,용산면,관내사전투표,578,578,315,11,210,5,12,0,0,5,0,11,2,0,3,574,4,0
전라남도,장흥군,용산면,용산면투표소,1353,939,510,23,318,9,27,0,0,1,2,27,1,2,7,927,12,414
전라남도,장흥군,안양면,합계,2508,1895,1026,37,697,19,69,1,0,4,1,3,5,2,11,1875,20,613
전라남도,장흥군,안양면,관내사전투표,798,798,442,11,283,10,29,0,0,4,1,2,2,2,3,789,9,0
전라남도,장흥군,안양면,안양면제1투,840,506,263,16,187,1,24,0,0,0,0,1,2,0,5,499,7,334
전라남도,장흥군,안양면,안양면제2투,870,591,321,10,227,8,16,1,0,0,0,0,1,0,3,587,4,279
전라남도,장흥군,장동면,합계,1034,814,391,25,342,20,23,0,0,0,1,0,2,2,6,812,2,220
전라남도,장흥군,장동면,관내사전투표,290,290,146,7,121,6,8,0,0,0,0,0,0,0,1,289,1,0
전라남도,장흥군,장동면,장동면투표소,744,524,245,18,221,14,15,0,0,0,1,0,2,2,5,523,1,220
전라남도,장흥군,장평면,합계,1876,1440,779,29,519,20,34,1,0,2,0,27,3,3,11,1428,12,436
전라남도,장흥군,장평면,관내사전투표,502,502,266,7,190,9,18,1,0,0,0,5,2,0,2,500,2,0
전라남도,장흥군,장평면,장평면제1투,969,633,327,17,239,7,15,0,0,1,0,15,0,1,7,629,4,336
전라남도,장흥군,장평면,장평면제2투,405,305,186,5,90,4,1,0,0,1,0,7,1,2,2,299,6,100
전라남도,장흥군,유치면,합계,918,681,365,49,197,18,24,2,1,0,0,15,2,0,5,678,3,237
전라남도,장흥군,유치면,관내사전투표,357,357,194,25,102,13,9,1,0,0,0,6,1,0,4,355,2,0
전라남도,장흥군,유치면,유치면투표소,561,324,171,24,95,5,15,1,1,0,0,9,1,0,1,323,1,237
전라남도,장흥군,부산면,합계,1229,928,510,21,326,14,27,2,0,0,1,15,1,2,4,923,5,301
전라남도,장흥군,부산면,관내사전투표,363,363,201,9,138,4,7,1,0,0,1,0,0,0,0,361,2,0
전라남도,장흥군,부산면,부산면투표소,866,565,309,12,188,10,20,1,0,0,0,15,1,2,4,562,3,301
전라남도,장흥군,회진면,합계,2440,1855,864,38,845,29,41,0,0,2,0,5,5,4,12,1845,10,585
전라남도,장흥군,회진면,관내사전투표,715,715,362,9,310,13,12,0,0,0,0,1,1,1,2,711,4,0
전라남도,장흥군,회진면,회진면투표소,1725,1140,502,29,535,16,29,0,0,2,0,4,4,3,10,1134,6,585
전라남도,장흥군,잘못 투입·구분된 투표지,,0,0,0,0,0,0,0,0,0,0,0,0,0,0,0,0,0,0
전라남도,강진군,합계,,32299,25175,12476,753,10152,489,890,15,6,45,9,70,17,21,63,25006,169,7124
전라남도,강진군,거소·선상투표,,124,114,49,3,46,3,1,0,0,0,0,0,1,1,1,105,9,10
전라남도,강진군,관외사전투표,,3638,3636,2194,101,947,139,219,1,0,3,1,10,1,0,2,3618,18,2
전라남도,강진군,재외투표,,159,97,64,1,24,2,5,0,0,0,0,0,0,0,0,96,1,62
전라남도,강진군,강진읍,합계,10895,8296,4009,242,3437,166,315,5,1,23,4,17,4,4,22,8249,47,2599
전라남도,강진군,강진읍,관내사전투표,3381,3381,1710,90,1288,76,163,3,0,15,1,11,1,1,7,3366,15,0
전라남도,강진군,강진읍,강진읍제1투,1315,737,325,23,342,14,20,0,0,6,0,0,0,1,2,733,4,578
전라남도,강진군,강진읍,강진읍제2투,1611,1041,459,33,493,13,32,1,1,1,0,1,1,0,0,1035,6,570
전라남도,강진군,강진읍,강진읍제3투,1357,950,444,46,397,22,33,0,0,1,1,0,0,1,2,947,3,407
전라남도,강진군,강진읍,강진읍제4투,758,542,245,13,246,8,14,0,0,0,1,0,1,0,7,535,7,216
전라남도,강진군,강진읍,강진읍제5투,781,513,250,7,224,4,15,1,0,0,1,1,1,1,2,507,6,268
전라남도,강진군,강진읍,강진읍제6투,1692,1132,576,30,447,29,38,0,0,0,0,4,0,0,2,1126,6,560
전라남도,강진군,군동면,관내사전투표,621,621,257,22,299,10,21,0,2,0,0,1,1,1,0,614,7,0
전라남도,강진군,군동면,합계,2969,2148,975,82,940,39,69,3,2,3,2,6,2,3,7,2133,15,821
전라남도,강진군,군동면,군동면제1투,772,471,223,20,193,10,16,1,0,1,0,1,0,1,4,470,1,301
전라남도,강진군,군동면,군동면제2투,993,675,330,16,275,15,26,1,0,1,0,2,1,1,1,669,6,318
전라남도,강진군,군동면,군동면제3투,583,381,165,24,173,4,6,1,0,1,2,2,0,0,2,380,1,202
전라남도,강진군,칠량면,합계,2059,1508,675,70,672,29,38,0,0,1,1,3,1,1,6,1497,11,551
전라남도,강진군,칠량면,관내사전투표,641,641,319,20,265,14,15,0,0,0,1,0,0,0,2,636,5,0
전라남도,강진군,칠량면,칠량면투표소,1418,867,356,50,407,15,23,0,0,1,0,3,1,1,4,861,6,551
전라남도,강진군,대구면,관내사전투표,299,299,151,3,124,6,8,1,0,0,0,1,1,1,2,298,1,0
전라남도,강진군,대구면,합계,1026,781,397,32,304,13,19,1,1,1,0,2,1,1,5,777,4,245
전라남도,강진군,대구면,대구면투표소,727,482,246,29,180,7,11,0,1,1,0,1,0,0,3,479,3,245
전라남도,강진군,마량면,관내사전투표,483,483,208,7,238,8,18,1,0,0,0,0,1,1,0,482,1,0
전라남도,강진군,마량면,합계,1629,1226,563,24,583,19,27,1,0,1,0,2,1,1,1,1223,3,403
전라남도,강진군,마량면,마량면투표소,1146,743,355,17,345,11,9,0,0,1,0,2,0,0,1,741,2,403
전라남도,강진군,도암면,합계,2165,1571,718,41,716,24,42,0,0,2,0,7,3,1,4,1558,13,594
전라남도,강진군,도암면,관내사전투표,487,487,220,9,227,8,13,0,0,1,0,3,1,0,1,483,4,0
전라남도,강진군,도암면,도암면제1투,1159,720,322,20,336,9,20,0,0,1,0,2,1,0,2,713,7,439
전라남도,강진군,도암면,도암면제2투,519,364,176,12,153,7,9,0,0,0,0,2,1,1,1,362,2,155
전라남도,강진군,신전면,합계,1563,1217,559,36,551,11,35,0,0,3,0,4,0,1,5,1205,12,346
전라남도,강진군,신전면,관내사전투표,355,355,162,15,158,5,13,0,0,0,0,1,0,0,0,354,1,0
전라남도,강진군,신전면,신전면제1투,715,497,237,11,215,4,17,0,0,3,0,2,0,1,3,493,4,218
전라남도,강진군,신전면,신전면제2투,493,365,160,10,178,2,5,0,0,0,0,1,0,0,2,358,7,128
전라남도,강진군,성전면,합계,2369,1804,851,46,795,10,59,2,1,3,0,14,0,2,4,1787,17,565
전라남도,강진군,성전면,관내사전투표,693,693,325,19,309,5,18,1,0,3,0,3,0,1,2,686,7,0
전라남도,강진군,성전면,성전면투표소,1676,1111,526,27,486,5,41,1,1,0,0,11,0,1,2,1101,10,565
전라남도,강진군,작천면,합계,1654,1225,637,33,500,17,21,1,0,2,0,4,0,3,3,1221,4,429
전라남도,강진군,작천면,관내사전투표,533,533,292,12,203,10,11,0,0,0,0,2,0,2,0,532,1,0
전라남도,강진군,작천면,작천면투표소,1121,692,345,21,297,7,10,1,0,2,0,2,0,1,3,689,3,429
전라남도,강진군,병영면,관내사전투표,411,411,211,13,164,7,12,0,0,0,0,0,2,0,0,409,2,0
전라남도,강진군,병영면,합계,1509,1127,551,39,473,14,30,0,0,2,0,1,3,3,2,1118,9,382
전라남도,강진군,병영면,병영면투표소,1098,716,340,26,309,7,18,0,0,2,0,1,1,3,2,709,7,382
전라남도,강진군,옴천면,합계,540,425,234,3,164,3,10,1,1,1,1,0,0,0,1,419,6,115
전라남도,강진군,옴천면,관내사전투표,194,194,95,1,86,1,5,0,1,0,1,0,0,0,0,190,4,0
전라남도,강진군,옴천면,옴천면투표소,346,231,139,2,78,2,5,1,0,1,0,0,0,0,1,229,2,115
전라남도,강진군,잘못 투입·구분된 투표지,,0,0,0,0,0,0,0,0,0,0,0,0,0,0,0,0,0,0
전라남도,완도군,합계,,44989,34886,20945,762,11021,521,975,12,5,32,8,87,31,33,161,34593,293,10103
전라남도,완도군,거소·선상투표,,787,741,422,16,234,10,15,4,1,2,0,2,1,0,3,710,31,46
전라남도,완도군,관외사전투표,,4127,4127,2619,114,937,141,264,2,0,4,0,8,2,3,9,4103,24,0
전라남도,완도군,재외투표,,138,90,58,5,16,5,6,0,0,0,0,0,0,0,0,90,0,48
전라남도,완도군,완도읍,합계,14296,10579,6398,251,3311,167,329,2,1,9,2,38,1,3,18,10530,49,3717
전라남도,완도군,완도읍,관내사전투표,3703,3703,2358,72,1005,75,150,0,1,1,1,17,0,0,4,3684,19,0
전라남도,완도군,완도읍,완도읍제1투,2888,1839,1126,36,572,32,61,0,0,1,0,6,0,0,2,1836,3,1049
전라남도,완도군,완도읍,완도읍제2투,2131,1349,784,32,471,16,27,0,0,2,1,5,0,0,4,1342,7,782
전라남도,완도군,완도읍,완도읍제3투,1145,747,418,23,278,2,16,0,0,1,0,0,0,2,3,743,4,398
전라남도,완도군,완도읍,완도읍제4투,2463,1628,972,44,519,25,47,1,0,3,0,8,1,0,1,1621,7,835
전라남도,완도군,완도읍,완도읍제5투,1007,694,376,22,258,15,17,0,0,0,0,0,0,1,2,691,3,313
전라남도,완도군,완도읍,완도읍제6투,959,619,364,22,208,2,11,1,0,1,0,2,0,0,2,613,6,340
전라남도,완도군,금일읍,합계,2985,2169,1437,37,581,23,32,0,0,3,0,3,7,2,21,2146,23,816
전라남도,완도군,금일읍,관내사전투표,563,563,398,5,122,8,13,0,0,2,0,2,1,0,9,560,3,0
전라남도,완도군,금일읍,금일읍제1투,556,326,212,5,96,3,3,0,0,0,0,1,0,0,1,321,5,230
전라남도,완도군,금일읍,금일읍제2투,852,606,382,16,186,3,9,0,0,1,0,0,2,0,2,601,5,246
전라남도,완도군,금일읍,금일읍제3투,1014,674,445,11,177,9,7,0,0,0,0,0,4,2,9,664,10,340
전라남도,완도군,노화읍,관내사전투표,994,994,551,22,364,14,17,0,0,0,0,4,0,1,12,985,9,0
전라남도,완도군,노화읍,합계,4102,3099,1805,54,1084,28,57,0,0,1,3,11,5,4,26,3078,21,1003
전라남도,완도군,노화읍,노화읍제1투,1609,1060,637,17,360,7,22,0,0,1,1,5,2,0,3,1055,5,549
전라남도,완도군,노화읍,노화읍제2투,915,651,376,9,230,1,12,0,0,0,2,1,2,2,11,646,5,264
전라남도,완도군,노화읍,노화읍제3투,584,394,241,6,130,6,6,0,0,0,0,1,1,1,0,392,2,190
전라남도,완도군,군외면,합계,2667,1912,923,51,843,20,38,0,0,1,1,3,2,4,8,1894,18,755
전라남도,완도군,군외면,관내사전투표,546,546,278,16,223,5,15,0,0,1,0,1,1,1,2,543,3,0
전라남도,완도군,군외면,군외면제1투,1232,763,349,23,356,8,11,0,0,0,0,1,1,3,2,754,9,469
전라남도,완도군,군외면,군외면제2투,889,603,296,12,264,7,12,0,0,0,1,1,0,0,4,597,6,286
전라남도,완도군,신지면,합계,2852,2104,1253,40,718,18,38,3,1,1,0,4,0,0,7,2083,21,748
전라남도,완도군,신지면,관내사전투표,749,749,465,13,235,10,16,2,0,0,0,1,0,0,0,742,7,0
전라남도,완도군,신지면,신지면제1투,1079,717,426,16,247,2,15,1,1,0,0,1,0,0,5,714,3,362
전라남도,완도군,신지면,신지면제2투,1024,638,362,11,236,6,7,0,0,1,0,2,0,0,2,627,11,386
전라남도,완도군,고금면,합계,3596,2735,1553,49,992,32,50,1,0,2,1,5,4,6,17,2712,23,861
전라남도,완도군,고금면,관내사전투표,1149,1149,664,19,402,15,23,0,0,1,0,1,2,2,8,1137,12,0
전라남도,완도군,고금면,고금면제1투,1384,860,477,11,326,11,21,0,0,0,0,3,0,2,3,854,6,524
전라남도,완도군,고금면,고금면제2투,474,321,188,7,109,3,3,1,0,0,0,1,2,1,3,318,3,153
전라남도,완도군,고금면,고금면제3투,589,405,224,12,155,3,3,0,0,1,1,0,0,1,3,403,2,184
전라남도,완도군,약산면,관내사전투표,530,530,340,13,146,6,16,0,1,1,0,1,0,1,2,527,3,0
전라남도,완도군,약산면,합계,1976,1578,914,32,555,13,26,0,1,3,0,5,2,4,7,1562,16,398
전라남도,완도군,약산면,약산면제1투,937,661,336,9,284,6,8,0,0,2,0,2,1,2,5,655,6,276
전라남도,완도군,약산면,약산면제2투,509,387,238,10,125,1,2,0,0,0,0,2,1,1,0,380,7,122
전라남도,완도군,청산면,관내사전투표,343,343,222,14,83,5,7,0,0,3,0,0,0,0,1,335,8,0
전라남도,완도군,청산면,합계,1925,1410,852,52,421,14,27,0,1,4,1,2,1,3,10,1388,22,515
전라남도,완도군,청산면,청산면제1투,1019,649,370,19,222,6,13,0,1,1,0,2,1,2,5,642,7,370
전라남도,완도군,청산면,청산면제2투,408,296,178,16,86,3,6,0,0,0,1,0,0,1,2,293,3,112
전라남도,완도군,청산면,청산면제3투,155,122,82,3,30,0,1,0,0,0,0,0,0,0,2,118,4,33
전라남도,완도군,소안면,합계,2000,1560,950,26,498,18,30,0,0,1,0,3,3,1,6,1536,24,440
전라남도,완도군,소안면,관내사전투표,487,487,295,10,152,5,16,0,0,1,0,0,1,0,0,480,7,0
전라남도,완도군,소안면,소안면제1투,934,652,404,8,205,10,6,0,0,0,0,1,2,1,3,640,12,282
전라남도,완도군,소안면,소안면제2투,579,421,251,8,141,3,8,0,0,0,0,2,0,0,3,416,5,158
전라남도,완도군,금당면,관내사전투표,338,338,226,5,96,1,6,0,0,0,0,0,1,1,0,336,2,0
전라남도,완도군,금당면,합계,816,645,395,10,208,7,12,0,0,1,0,0,1,1,3,638,7,171
전라남도,완도군,금당면,금당면투표소,478,307,169,5,112,6,6,0,0,1,0,0,0,0,3,302,5,171
전라남도,완도군,보길면,합계,2122,1682,1087,21,474,19,46,0,0,0,0,3,1,2,18,1671,11,440
전라남도,완도군,보길면,관내사전투표,556,556,369,6,141,11,17,0,0,0,0,3,1,1,2,551,5,0
전라남도,완도군,보길면,보길면제1투,762,524,331,8,164,4,11,0,0,0,0,0,0,0,4,522,2,238
전라남도,완도군,보길면,보길면제2투,804,602,387,7,169,4,18,0,0,0,0,0,0,1,12,598,4,202
전라남도,완도군,생일면,합계,600,455,279,4,149,6,5,0,0,0,0,0,1,0,8,452,3,145
전라남도,완도군,생일면,관내사전투표,177,177,105,3,57,2,1,0,0,0,0,0,1,0,6,175,2,0
전라남도,완도군,생일면,생일면투표소,423,278,174,1,92,4,4,0,0,0,0,0,0,0,2,277,1,145
전라남도,완도군,잘못 투입·구분된 투표지,,0,0,0,0,0,0,0,0,0,0,0,0,0,0,0,0,0,0
전라남도,해남군,합계,,63440,48351,25901,1158,18157,778,1581,14,6,61,14,134,42,36,129,48011,340,15089
전라남도,해남군,거소·선상투표,,272,257,124,10,86,6,9,1,1,2,1,2,1,0,1,244,13,15
전라남도,해남군,관외사전투표,,6456,6456,3958,156,1640,224,410,2,0,4,1,12,1,0,5,6413,43,0
전라남도,해남군,재외투표,,193,133,90,5,30,3,5,0,0,0,0,0,0,0,0,133,0,60
전라남도,해남군,해남읍,합계,17667,13228,7264,313,4714,245,499,4,3,29,2,44,7,3,20,13147,81,4439
전라남도,해남군,해남읍,관내사전투표,4915,4915,2904,100,1509,85,227,3,2,14,2,22,2,1,8,4879,36,0
전라남도,해남군,해남읍,해남읍제1투,1165,681,346,23,276,9,17,0,0,0,0,0,0,1,3,675,6,484
전라남도,해남군,해남읍,해남읍제2투,877,548,280,17,227,6,11,0,0,1,0,0,0,0,1,543,5,329
전라남도,해남군,해남읍,해남읍제3투,1473,961,481,24,400,22,26,0,0,1,0,1,1,0,1,957,4,512
전라남도,해남군,해남읍,해남읍제4투,2427,1662,925,36,592,28,59,0,0,9,0,6,0,0,0,1655,7,765
전라남도,해남군,해남읍,해남읍제5투,925,607,328,14,214,13,29,0,0,0,0,3,1,0,0,602,5,318
전라남도,해남군,해남읍,해남읍제6투,1222,831,444,42,303,14,18,0,0,2,0,5,0,0,1,829,2,391
전라남도,해남군,해남읍,해남읍제7투,1316,830,392,20,362,20,23,0,0,0,0,3,0,1,1,822,8,486
전라남도,해남군,해남읍,해남읍제8투,2475,1588,894,23,544,40,75,1,0,2,0,4,1,0,3,1587,1,887
전라남도,해남군,해남읍,해남읍제9투,872,605,270,14,287,8,14,0,1,0,0,0,2,0,2,598,7,267
전라남도,해남군,삼산면,합계,2600,1929,968,50,796,26,60,0,0,3,2,7,2,2,3,1919,10,671
전라남도,해남군,삼산면,관내사전투표,676,676,339,11,278,17,26,0,0,2,0,1,0,0,0,674,2,0
전라남도,해남군,삼산면,삼산면제1투,1209,755,370,26,317,5,26,0,0,1,1,4,1,0,1,752,3,454
전라남도,해남군,삼산면,삼산면제2투,715,498,259,13,201,4,8,0,0,0,1,2,1,2,2,493,5,217
전라남도,해남군,화산면,합계,2967,2120,1040,57,923,27,42,0,0,3,0,5,2,5,8,2112,8,847
전라남도,해남군,화산면,관내사전투표,709,709,336,27,301,14,21,0,0,1,0,2,2,1,0,705,4,0
전라남도,해남군,화산면,화산면제1투,891,516,260,14,216,10,5,0,0,2,0,0,0,4,4,515,1,375
전라남도,해남군,화산면,화산면제2투,620,408,189,6,201,1,6,0,0,0,0,1,0,0,1,405,3,212
전라남도,해남군,화산면,화산면제3투,747,487,255,10,205,2,10,0,0,0,0,2,0,0,3,487,0,260
전라남도,해남군,현산면,합계,2655,1956,957,48,830,21,51,0,0,3,1,6,4,4,15,1940,16,699
전라남도,해남군,현산면,관내사전투표,570,570,285,10,239,7,20,0,0,2,0,1,1,0,3,568,2,0
전라남도,해남군,현산면,현산면제1투,669,410,168,10,200,8,14,0,0,0,0,3,0,3,1,407,3,259
전라남도,해남군,현산면,현산면제2투,545,364,183,8,154,0,7,0,0,0,1,0,2,0,4,359,5,181
전라남도,해남군,현산면,현산면제3투,871,612,321,20,237,6,10,0,0,1,0,2,1,1,7,606,6,259
전라남도,해남군,송지면,합계,5329,3856,1995,92,1564,49,77,2,0,2,0,12,7,4,21,3825,31,1473
전라남도,해남군,송지면,관내사전투표,1323,1323,708,34,507,21,32,0,0,1,0,5,0,1,4,1313,10,0
전라남도,해남군,송지면,송지면제1투,1377,778,355,23,352,7,19,2,0,0,0,2,3,1,6,770,8,599
전라남도,해남군,송지면,송지면제2투,900,612,298,21,262,5,7,0,0,1,0,4,1,1,5,605,7,288
전라남도,해남군,송지면,송지면제3투,880,569,316,9,221,8,9,0,0,0,0,0,1,0,2,566,3,311
전라남도,해남군,송지면,송지면제4투,849,574,318,5,222,8,10,0,0,0,0,1,2,1,4,571,3,275
전라남도,해남군,북평면,합계,2446,1870,1034,38,676,28,54,0,0,2,0,6,4,1,5,1848,22,576
전라남도,해남군,북평면,관내사전투표,688,688,393,14,232,14,21,0,0,1,0,1,2,0,2,680,8,0
전라남도,해남군,북평면,북평면제1투,1020,631,323,18,247,12,21,0,0,0,0,2,2,1,0,626,5,389
전라남도,해남군,북평면,북평면제2투,738,551,318,6,197,2,12,0,0,1,0,3,0,0,3,542,9,187
전라남도,해남군,북일면,합계,1823,1371,784,33,489,10,34,0,0,0,1,0,0,2,5,1358,13,452
전라남도,해남군,북일면,관내사전투표,514,514,301,9,177,4,15,0,0,0,1,0,0,2,2,511,3,0
전라남도,해남군,북일면,북일면제1투,838,542,294,18,201,5,17,0,0,0,0,0,0,0,3,538,4,296
전라남도,해남군,북일면,북일면제2투,471,315,189,6,111,1,2,0,0,0,0,0,0,0,0,309,6,156
전라남도,해남군,옥천면,합계,2764,2055,1104,60,779,25,51,0,0,0,1,9,2,6,4,2041,14,709
전라남도,해남군,옥천면,관내사전투표,886,886,514,20,297,15,25,0,0,0,0,4,2,3,1,881,5,0
전라남도,해남군,옥천면,옥천면제1투,1150,698,363,22,280,8,16,0,0,0,1,3,0,1,1,695,3,452
전라남도,해남군,옥천면,옥천면제2투,728,471,227,18,202,2,10,0,0,0,0,2,0,2,2,465,6,257
전라남도,해남군,계곡면,합계,1919,1416,666,28,649,16,36,2,0,0,0,0,2,0,4,1403,13,503
전라남도,해남군,계곡면,관내사전투표,467,467,225,4,208,5,18,1,0,0,0,0,0,0,2,463,4,0
전라남도,해남군,계곡면,계곡면제1투,703,407,198,10,179,6,10,0,0,0,0,0,0,0,1,404,3,296
전라남도,해남군,계곡면,계곡면제2투,749,542,243,14,262,5,8,1,0,0,0,0,2,0,1,536,6,207
전라남도,해남군,마산면,합계,2085,1541,893,35,546,11,35,0,0,2,2,4,0,1,4,1533,8,544
전라남도,해남군,마산면,관내사전투표,391,391,230,8,129,5,13,0,0,1,1,3,0,1,0,391,0,0
전라남도,해남군,마산면,마산면제1투,915,604,340,14,224,3,14,0,0,1,1,0,0,0,2,599,5,311
전라남도,해남군,마산면,마산면제2투,779,546,323,13,193,3,8,0,0,0,0,1,0,0,2,543,3,233
전라남도,해남군,황산면,합계,4394,3152,1599,63,1350,27,62,0,1,5,1,7,5,0,10,3130,22,1242
전라남도,해남군,황산면,관내사전투표,699,699,369,12,279,8,24,0,0,1,0,2,0,0,0,695,4,0
전라남도,해남군,황산면,황산면제1투,1314,813,418,14,350,5,17,0,0,1,0,0,2,0,0,807,6,501
전라남도,해남군,황산면,황산면제2투,897,595,305,21,247,5,7,0,1,1,0,0,2,0,3,592,3,302
전라남도,해남군,황산면,황산면제3투,606,444,221,7,204,2,4,0,0,0,0,1,1,0,1,441,3,162
전라남도,해남군,황산면,황산면제4투,878,601,286,9,270,7,10,0,0,2,1,4,0,0,6,595,6,277
전라남도,해남군,산이면,합계,3185,2252,1142,48,958,20,48,0,0,1,1,7,2,5,6,2238,14,933
전라남도,해남군,산이면,관내사전투표,716,716,376,12,295,7,14,0,0,0,0,2,0,3,1,710,6,0
전라남도,해남군,산이면,산이면제1투,815,471,251,10,184,5,13,0,0,0,0,4,0,1,1,469,2,344
전라남도,해남군,산이면,산이면제2투,660,434,205,9,205,3,6,0,0,0,0,1,1,0,1,431,3,226
전라남도,해남군,산이면,산이면제3투,994,631,310,17,274,5,15,0,0,1,1,0,1,1,3,628,3,363
전라남도,해남군,문내면,합계,3558,2545,1263,71,1090,22,60,1,0,4,1,5,1,0,8,2526,19,1013
전라남도,해남군,문내면,관내사전투표,809,809,392,18,352,10,21,0,0,4,0,3,0,0,3,803,6,0
전라남도,해남군,문내면,문내면제1투,1484,955,460,27,425,7,21,0,0,0,1,1,1,0,1,944,11,529
전라남도,해남군,문내면,문내면제2투,592,345,163,9,158,3,8,1,0,0,0,0,0,0,3,345,0,247
전라남도,해남군,문내면,문내면제3투,673,436,248,17,155,2,10,0,0,0,0,1,0,0,1,434,2,237
전라남도,해남군,화원면,합계,3127,2214,1020,51,1037,18,48,2,1,1,0,8,2,3,10,2201,13,913
전라남도,해남군,화원면,관내사전투표,916,916,442,21,409,9,19,1,0,1,0,4,1,2,2,911,5,0
전라남도,해남군,화원면,화원면제1투,916,517,249,14,233,2,12,0,1,0,0,1,0,0,1,513,4,399
전라남도,해남군,화원면,화원면제2투,563,376,146,7,200,6,6,0,0,0,0,2,0,1,5,373,3,187
전라남도,해남군,화원면,화원면제3투,732,405,183,9,195,1,11,1,0,0,0,1,1,0,2,404,1,327
전라남도,해남군,잘못 투입·구분된 투표지,,0,0,0,0,0,0,0,0,0,0,0,0,0,0,0,0,0,0
전라남도,진도군,합계,,27614,21189,10392,511,8855,323,686,10,11,25,8,57,29,22,81,21010,179,6425
전라남도,진도군,거소·선상투표,,171,153,63,4,75,2,4,0,0,0,1,0,0,0,0,149,4,18
전라남도,진도군,관외사전투표,,2749,2748,1672,76,697,83,189,1,1,1,2,5,1,1,1,2730,18,1
전라남도,진도군,재외투표,,158,97,64,3,20,2,8,0,0,0,0,0,0,0,0,97,0,61
전라남도,진도군,진도읍,관내사전투표,2564,2564,1315,51,998,53,114,0,1,4,0,10,1,1,1,2549,15,0
전라남도,진도군,진도읍,합계,7820,6071,2930,134,2591,98,216,2,3,13,1,26,9,4,6,6033,38,1749
전라남도,진도군,진도읍,진도읍제1투,2126,1384,637,25,631,24,42,1,0,1,1,10,2,1,1,1376,8,742
전라남도,진도군,진도읍,진도읍제2투,2363,1603,776,44,683,20,51,1,2,3,0,5,2,1,2,1590,13,760
전라남도,진도군,진도읍,진도읍제3투,767,520,202,14,279,1,9,0,0,5,0,1,4,1,2,518,2,247
전라남도,진도군,군내면,합계,2587,1933,928,37,857,26,46,1,0,3,1,7,4,1,11,1922,11,654
전라남도,진도군,군내면,관내사전투표,505,505,267,10,197,7,17,0,0,0,0,3,0,0,3,504,1,0
전라남도,진도군,군내면,군내면제1투,606,411,173,10,208,5,9,0,0,1,0,0,2,0,0,408,3,195
전라남도,진도군,군내면,군내면제2투,796,536,246,9,239,11,14,1,0,1,1,4,0,1,4,531,5,260
전라남도,진도군,군내면,군내면제3투,680,481,242,8,213,3,6,0,0,1,0,0,2,0,4,479,2,199
전라남도,진도군,고군면,합계,3025,2223,975,53,1087,22,53,0,0,0,1,3,2,2,8,2206,17,802
전라남도,진도군,고군면,관내사전투표,549,549,229,10,267,10,26,0,0,0,0,3,0,0,1,546,3,0
전라남도,진도군,고군면,고군면제1투,847,528,244,13,250,4,8,0,0,0,0,0,1,0,3,523,5,319
전라남도,진도군,고군면,고군면제2투,833,597,219,13,335,6,14,0,0,0,1,0,1,1,2,592,5,236
전라남도,진도군,고군면,고군면제3투,796,549,283,17,235,2,5,0,0,0,0,0,0,1,2,545,4,247
전라남도,진도군,의신면,관내사전투표,602,602,267,14,281,10,19,1,0,1,0,2,1,1,3,600,2,0
전라남도,진도군,의신면,합계,2964,2157,941,48,1047,22,51,2,1,1,0,2,4,3,15,2137,20,807
전라남도,진도군,의신면,의신면제1투,967,622,272,17,302,5,13,1,0,0,0,0,2,1,4,617,5,345
전라남도,진도군,의신면,의신면제2투,492,333,163,8,140,4,7,0,0,0,0,0,0,1,4,327,6,159
전라남도,진도군,의신면,의신면제3투,903,600,239,9,324,3,12,0,1,0,0,0,1,0,4,593,7,303
전라남도,진도군,임회면,관내사전투표,557,557,288,23,214,9,14,0,0,1,0,1,0,1,2,553,4,0
전라남도,진도군,임회면,합계,3004,2222,1025,69,1004,22,47,0,2,3,1,4,1,4,13,2195,27,782
전라남도,진도군,임회면,임회면제1투,1057,726,346,28,317,2,14,0,0,1,0,3,0,2,3,716,10,331
전라남도,진도군,임회면,임회면제2투,654,482,185,12,257,7,7,0,2,0,0,0,1,0,6,477,5,172
전라남도,진도군,임회면,임회면제3투,736,457,206,6,216,4,12,0,0,1,1,0,0,1,2,449,8,279
전라남도,진도군,지산면,관내사전투표,416,416,227,7,152,8,14,1,0,2,0,2,0,0,1,414,2,0
전라남도,진도군,지산면,합계,2842,2074,985,57,902,25,50,3,1,3,0,5,6,4,11,2052,22,768
전라남도,진도군,지산면,지산면제1투,995,638,278,22,297,4,16,1,1,1,0,2,3,1,4,630,8,357
전라남도,진도군,지산면,지산면제2투,839,600,291,17,268,6,8,0,0,0,0,0,1,2,2,595,5,239
전라남도,진도군,지산면,지산면제3투,592,420,189,11,185,7,12,1,0,0,0,1,2,1,4,413,7,172
전라남도,진도군,조도면,합계,2294,1511,809,30,575,21,22,1,3,1,1,5,2,3,16,1489,22,783
전라남도,진도군,조도면,관내사전투표,318,318,172,6,120,8,8,0,0,0,0,0,0,0,0,314,4,0
전라남도,진도군,조도면,조도면제1투,1096,657,355,13,238,9,14,0,1,0,1,5,0,2,9,647,10,439
전라남도,진도군,조도면,조도면제2투,97,47,32,0,15,0,0,0,0,0,0,0,0,0,0,47,0,50
전라남도,진도군,조도면,조도면제3투,92,65,41,2,17,1,0,1,1,0,0,0,0,0,2,65,0,27
전라남도,진도군,조도면,조도면제4투,194,136,83,5,39,1,0,0,0,0,0,0,1,1,4,134,2,58
전라남도,진도군,조도면,조도면제5투,113,62,23,0,37,0,0,0,0,0,0,0,1,0,0,61,1,51
전라남도,진도군,조도면,조도면제6투,141,57,31,0,24,1,0,0,0,0,0,0,0,0,0,56,1,84
전라남도,진도군,조도면,조도면제7투,28,17,6,3,8,0,0,0,0,0,0,0,0,0,0,17,0,11
전라남도,진도군,조도면,조도면제8투,215,152,66,1,77,1,0,0,1,1,0,0,0,0,1,148,4,63
전라남도,진도군,잘못 투입·구분된 투표지,,0,0,0,0,0,0,0,0,0,0,0,0,0,0,0,0,0,0
전라남도,영암군,합계,,47164,36402,18999,825,13610,674,1773,10,11,47,26,62,32,30,72,36171,231,10762
전라남도,영암군,거소·선상투표,,211,195,95,10,44,10,7,0,1,1,2,1,0,0,3,174,21,16
전라남도,영암군,관외사전투표,,6232,6232,3691,154,1699,202,423,3,1,6,1,16,1,1,3,6201,31,0
전라남도,영암군,재외투표,,178,102,65,2,30,0,5,0,0,0,0,0,0,0,0,102,0,76
전라남도,영암군,영암읍,합계,6349,4872,2455,104,1962,90,210,2,0,2,2,7,5,3,5,4847,25,1477
전라남도,영암군,영암읍,관내사전투표,2039,2039,1081,31,752,41,112,0,0,0,1,5,4,1,2,2030,9,0
전라남도,영암군,영암읍,영암읍제1투,1085,656,339,16,277,5,13,0,0,1,0,0,0,1,2,654,2,429
전라남도,영암군,영암읍,영암읍제2투,966,649,295,16,287,13,34,0,0,0,0,1,0,0,1,647,2,317
전라남도,영암군,영암읍,영암읍제3투,1006,692,329,16,294,19,24,0,0,1,1,1,1,0,0,686,6,314
전라남도,영암군,영암읍,영암읍제4투,1253,836,411,25,352,12,27,2,0,0,0,0,0,1,0,830,6,417
전라남도,영암군,삼호읍,관내사전투표,2654,2654,1463,47,850,63,195,1,0,2,5,12,2,2,1,2643,11,0
전라남도,영암군,삼호읍,합계,13580,9568,5111,221,3227,200,699,5,1,12,13,19,7,4,9,9528,40,4012
전라남도,영암군,삼호읍,삼호읍제1투,2140,1333,639,23,558,24,78,0,0,4,0,2,1,0,0,1329,4,807
전라남도,영암군,삼호읍,삼호읍제2투,2161,1328,673,17,514,21,95,0,0,1,0,2,2,1,0,1326,2,833
전라남도,영암군,삼호읍,삼호읍제3투,921,630,276,20,290,7,23,0,0,0,3,0,1,0,3,623,7,291
전라남도,영암군,삼호읍,삼호읍제4투,1617,965,522,20,337,23,52,1,0,2,1,1,0,0,1,960,5,652
전라남도,영암군,삼호읍,삼호읍제5투,1284,734,344,39,298,19,21,2,0,0,0,0,0,1,4,728,6,550
전라남도,영암군,삼호읍,삼호읍제6투,1369,955,612,26,176,20,116,1,0,2,1,0,0,0,0,954,1,414
전라남도,영암군,삼호읍,삼호읍제7투,1434,969,582,29,204,23,119,0,1,1,3,2,1,0,0,965,4,465
전라남도,영암군,덕진면,합계,1587,1201,581,23,540,11,27,0,0,1,0,0,1,2,1,1187,14,386
전라남도,영암군,덕진면,관내사전투표,368,368,182,7,157,6,13,0,0,0,0,0,0,0,0,365,3,0
전라남도,영암군,덕진면,덕진면제1투,641,415,196,8,197,1,6,0,0,1,0,0,1,0,0,410,5,226
전라남도,영암군,덕진면,덕진면제2투,578,418,203,8,186,4,8,0,0,0,0,0,0,2,1,412,6,160
전라남도,영암군,금정면,관내사전투표,597,597,282,16,273,6,15,0,1,0,0,0,1,1,2,597,0,0
전라남도,영암군,금정면,합계,1706,1287,589,42,593,13,32,0,2,0,0,3,1,4,5,1284,3,419
전라남도,영암군,금정면,금정면투표소,1109,690,307,26,320,7,17,0,1,0,0,3,0,3,3,687,3,419
전라남도,영암군,신북면,합계,3283,2433,1268,46,986,29,65,0,2,1,0,1,3,5,7,2413,20,850
전라남도,영암군,신북면,관내사전투표,958,958,512,15,382,8,29,0,2,1,0,1,0,3,1,954,4,0
전라남도,영암군,신북면,신북면제1투,1079,631,321,14,260,10,17,0,0,0,0,0,1,0,1,624,7,448
전라남도,영암군,신북면,신북면제2투,693,455,214,9,210,5,7,0,0,0,0,0,1,0,4,450,5,238
전라남도,영암군,신북면,신북면제3투,553,389,221,8,134,6,12,0,0,0,0,0,1,2,1,385,4,164
전라남도,영암군,시종면,관내사전투표,941,941,456,17,413,13,25,0,0,1,0,1,1,2,3,932,9,0
전라남도,영암군,시종면,합계,3165,2224,1079,49,974,24,56,0,0,1,2,1,1,7,10,2204,20,941
전라남도,영암군,시종면,시종면제1투,1317,728,353,19,313,8,18,0,0,0,2,0,0,3,4,720,8,589
전라남도,영암군,시종면,시종면제2투,907,555,270,13,248,3,13,0,0,0,0,0,0,2,3,552,3,352
전라남도,영암군,도포면,관내사전투표,431,431,236,6,159,9,9,0,1,6,0,1,0,0,1,428,3,0
전라남도,영암군,도포면,합계,1984,1469,763,34,583,27,31,0,2,8,0,2,4,1,5,1460,9,515
전라남도,영암군,도포면,도포면제1투,816,546,293,18,204,12,12,0,1,1,0,0,2,0,0,543,3,270
전라남도,영암군,도포면,도포면제2투,737,492,234,10,220,6,10,0,0,1,0,1,2,1,4,489,3,245
전라남도,영암군,군서면,관내사전투표,589,589,282,6,259,8,28,0,0,0,0,2,0,0,1,586,3,0
전라남도,영암군,군서면,합계,2696,2104,1049,24,910,20,70,0,0,5,1,5,2,0,8,2094,10,592
전라남도,영암군,군서면,군서면제1투,764,486,244,8,214,7,6,0,0,1,0,1,1,0,3,485,1,278
전라남도,영암군,군서면,군서면제2투,852,652,301,7,307,2,24,0,0,4,1,0,0,0,2,648,4,200
전라남도,영암군,군서면,군서면제3투,491,377,222,3,130,3,12,0,0,0,0,2,1,0,2,375,2,114
전라남도,영암군,서호면,관내사전투표,366,366,161,5,178,3,15,0,0,0,0,0,0,0,0,362,4,0
전라남도,영암군,서호면,합계,1687,1218,527,26,605,7,34,0,0,1,1,3,3,0,1,1208,10,469
전라남도,영암군,서호면,서호면투표소,1321,852,366,21,427,4,19,0,0,1,1,3,3,0,1,846,6,469
전라남도,영암군,학산면,합계,2747,2223,1053,56,960,25,81,0,2,7,2,4,2,3,7,2202,21,524
전라남도,영암군,학산면,관내사전투표,1037,1037,474,24,462,11,40,0,2,6,0,4,0,1,1,1025,12,0
전라남도,영암군,학산면,학산면제1투,708,465,220,8,210,4,16,0,0,1,1,0,1,0,2,463,2,243
전라남도,영암군,학산면,학산면제2투,698,499,238,23,203,8,20,0,0,0,0,0,0,0,1,493,6,199
전라남도,영암군,학산면,학산면제3투,304,222,121,1,85,2,5,0,0,0,1,0,1,2,3,221,1,82
전라남도,영암군,미암면,합계,1759,1274,673,34,497,16,33,0,0,2,2,0,2,0,8,1267,7,485
전라남도,영암군,미암면,관내사전투표,298,298,147,12,115,6,15,0,0,0,0,0,0,0,1,296,2,0
전라남도,영암군,미암면,미암면제1투,942,604,304,15,253,8,16,0,0,2,0,0,0,0,4,602,2,338
전라남도,영암군,미암면,미암면제2투,519,372,222,7,129,2,2,0,0,0,2,0,2,0,3,369,3,147
전라남도,영암군,잘못 투입·구분된 투표지,,0,0,0,0,0,0,0,0,0,0,0,0,0,0,0,0,0,0
전라남도,무안군,합계,,65997,52516,29516,983,18052,979,2366,18,15,38,16,86,47,30,109,52255,261,13481
전라남도,무안군,거소·선상투표,,697,658,298,18,193,22,26,6,3,5,6,5,2,2,10,596,62,39
전라남도,무안군,관외사전투표,,8689,8686,5123,172,2469,295,566,2,2,3,0,11,1,0,8,8652,34,3
전라남도,무안군,재외투표,,247,181,132,4,25,1,16,0,0,2,0,1,0,0,0,181,0,66
전라남도,무안군,무안읍,합계,8533,6578,3788,129,2229,92,276,3,1,4,0,11,2,0,8,6543,35,1955
전라남도,무안군,무안읍,관내사전투표,2949,2949,1841,50,848,48,132,1,1,1,0,9,2,0,2,2935,14,0
전라남도,무안군,무안읍,무안읍제1투,1881,1185,592,25,498,10,47,1,0,1,0,1,0,0,4,1179,6,696
전라남도,무안군,무안읍,무안읍제2투,1978,1264,703,30,440,23,59,0,0,1,0,0,0,0,0,1256,8,714
전라남도,무안군,무안읍,무안읍제3투,433,311,162,1,134,3,10,0,0,0,0,0,0,0,0,310,1,122
전라남도,무안군,무안읍,무안읍제4투,1292,869,490,23,309,8,28,1,0,1,0,1,0,0,2,863,6,423
전라남도,무안군,일로읍,관내사전투표,1596,1596,798,26,688,18,48,1,0,0,0,0,6,2,5,1592,4,0
전라남도,무안군,일로읍,합계,5533,4137,1984,69,1884,41,110,1,0,2,1,2,12,4,11,4121,16,1396
전라남도,무안군,일로읍,일로읍제1투,600,368,156,4,188,5,8,0,0,1,1,0,1,1,0,365,3,232
전라남도,무안군,일로읍,일로읍제2투,495,338,145,2,174,4,10,0,0,0,0,0,1,0,0,336,2,157
전라남도,무안군,일로읍,일로읍제3투,1182,720,353,11,318,7,27,0,0,0,0,1,1,0,0,718,2,462
전라남도,무안군,일로읍,일로읍제4투,329,247,106,9,125,0,4,0,0,0,0,0,2,0,0,246,1,82
전라남도,무안군,일로읍,일로읍제5투,798,529,264,7,235,2,7,0,0,1,0,1,1,1,6,525,4,269
전라남도,무안군,일로읍,일로읍제6투,533,339,162,10,156,5,6,0,0,0,0,0,0,0,0,339,0,194
전라남도,무안군,삼향읍,관내사전투표,5162,5162,3389,48,1265,137,303,4,1,0,0,10,0,3,0,5160,2,0
전라남도,무안군,삼향읍,합계,21720,17109,10640,209,4858,368,950,4,2,5,3,22,3,6,14,17084,25,4611
전라남도,무안군,삼향읍,삼향읍제1투,632,415,183,9,194,13,11,0,0,0,0,0,0,0,1,411,4,217
전라남도,무안군,삼향읍,삼향읍제2투,1054,759,381,16,321,8,24,0,0,0,1,0,0,2,2,755,4,295
전라남도,무안군,삼향읍,삼향읍제3투,1258,701,328,10,328,6,20,0,0,3,1,0,1,0,0,697,4,557
전라남도,무안군,삼향읍,삼향읍제4투,751,516,263,8,222,6,14,0,0,0,0,0,0,0,1,514,2,235
전라남도,무안군,삼향읍,삼향읍제5투,2169,1515,977,21,389,34,87,0,0,1,0,4,0,0,2,1515,0,654
전라남도,무안군,삼향읍,삼향읍제6투,1720,1236,732,14,390,25,72,0,0,0,0,0,0,0,1,1234,2,484
전라남도,무안군,삼향읍,삼향읍제7투,2288,1590,1011,11,433,36,92,0,0,0,1,2,0,0,2,1588,2,698
전라남도,무안군,삼향읍,삼향읍제8투,1933,1439,899,26,380,35,89,0,0,0,0,5,1,0,1,1436,3,494
전라남도,무안군,삼향읍,삼향읍제9투,2555,2053,1373,21,493,36,122,0,1,1,0,1,0,1,2,2051,2,502
전라남도,무안군,삼향읍,삼향읍제10투,2198,1723,1104,25,443,32,116,0,0,0,0,0,1,0,2,1723,0,475
전라남도,무안군,몽탄면,관내사전투표,535,535,290,16,191,2,18,0,0,0,1,9,0,1,3,531,4,0
전라남도,무안군,몽탄면,합계,2559,1899,979,54,761,16,47,0,2,2,1,15,3,3,9,1892,7,660
전라남도,무안군,몽탄면,몽탄면제1투,660,443,211,11,197,2,16,0,0,1,0,1,1,1,2,443,0,217
전라남도,무안군,몽탄면,몽탄면제2투,431,279,141,9,120,2,3,0,1,0,0,1,0,1,0,278,1,152
전라남도,무안군,몽탄면,몽탄면제3투,480,308,173,8,104,8,7,0,0,0,0,4,1,0,2,307,1,172
전라남도,무안군,몽탄면,몽탄면제4투,453,334,164,10,149,2,3,0,1,1,0,0,1,0,2,333,1,119
전라남도,무안군,청계면,합계,5213,3920,1933,93,1658,52,124,0,0,2,1,3,8,4,14,3892,28,1293
전라남도,무안군,청계면,관내사전투표,1233,1233,665,30,452,21,41,0,0,2,0,1,1,2,6,1221,12,0
전라남도,무안군,청계면,청계면제1투,593,415,192,10,193,7,8,0,0,0,0,0,0,0,1,411,4,178
전라남도,무안군,청계면,청계면제2투,1137,692,373,18,260,6,33,0,0,0,0,1,0,0,0,691,1,445
전라남도,무안군,청계면,청계면제3투,738,546,224,10,275,7,17,0,0,0,0,0,3,1,3,540,6,192
전라남도,무안군,청계면,청계면제4투,682,481,212,7,236,3,15,0,0,0,1,0,1,0,3,478,3,201
전라남도,무안군,청계면,청계면제5투,830,553,267,18,242,8,10,0,0,0,0,1,3,1,1,551,2,277
전라남도,무안군,현경면,합계,3996,2899,1412,78,1254,22,76,0,1,9,1,9,6,3,6,2877,22,1097
전라남도,무안군,현경면,관내사전투표,587,587,323,11,217,8,20,0,0,0,0,3,0,1,0,583,4,0
전라남도,무안군,현경면,현경면제1투,367,251,120,1,119,5,2,0,0,1,0,0,2,0,0,250,1,116
전라남도,무안군,현경면,현경면제2투,1052,682,383,19,255,1,15,0,0,1,0,1,1,0,2,678,4,370
전라남도,무안군,현경면,현경면제3투,717,498,237,28,202,2,17,0,1,1,1,1,0,0,2,492,6,219
전라남도,무안군,현경면,현경면제4투,696,482,193,11,251,4,11,0,0,3,0,0,0,1,2,476,6,214
전라남도,무안군,현경면,현경면제5투,577,399,156,8,210,2,11,0,0,3,0,4,3,1,0,398,1,178
전라남도,무안군,망운면,합계,1784,1326,698,34,538,10,32,1,0,0,0,0,3,1,3,1320,6,458
전라남도,무안군,망운면,관내사전투표,338,338,174,9,129,4,19,0,0,0,0,0,1,1,0,337,1,0
전라남도,무안군,망운면,망운면제1투,1036,708,367,18,303,5,10,1,0,0,0,0,1,0,0,705,3,328
전라남도,무안군,망운면,망운면제2투,410,280,157,7,106,1,3,0,0,0,0,0,1,0,3,278,2,130
전라남도,무안군,해제면,관내사전투표,1405,1404,760,32,538,11,37,0,3,0,1,4,2,3,6,1397,7,1
전라남도,무안군,해제면,합계,4515,3283,1670,84,1350,32,89,1,4,3,2,6,5,6,15,3267,16,1232
전라남도,무안군,해제면,해제면제1투,767,433,209,11,190,5,9,0,1,0,0,1,1,1,4,432,1,334
전라남도,무안군,해제면,해제면제2투,1077,669,324,26,278,8,24,1,0,1,1,0,1,0,2,666,3,408
전라남도,무안군,해제면,해제면제3투,531,337,180,8,135,3,5,0,0,1,0,1,0,1,1,335,2,194
전라남도,무안군,해제면,해제면제4투,735,440,197,7,209,5,14,0,0,1,0,0,1,1,2,437,3,295
전라남도,무안군,운남면,관내사전투표,419,419,226,10,152,9,18,0,0,0,0,0,0,0,2,417,2,0
전라남도,무안군,운남면,합계,2511,1840,859,39,833,28,54,0,0,1,1,1,2,1,11,1830,10,671
전라남도,무안군,운남면,운남면제1투,636,440,216,6,198,6,8,0,0,0,0,0,0,1,3,438,2,196
전라남도,무안군,운남면,운남면제2투,1104,737,294,20,381,10,22,0,0,1,0,0,1,0,5,734,3,367
전라남도,무안군,운남면,운남면제3투,352,244,123,3,102,3,6,0,0,0,1,1,1,0,1,241,3,108
전라남도,무안군,잘못 투입·구분된 투표지,,0,0,0,0,0,0,0,0,0,0,0,0,0,0,0,0,0,0
전라남도,영광군,합계,,46884,35919,20595,819,11675,686,1320,16,20,57,11,282,39,30,165,35715,204,10965
전라남도,영광군,거소·선상투표,,199,183,91,4,62,5,4,2,2,0,0,0,0,0,3,173,10,16
전라남도,영광군,관외사전투표,,5391,5389,3459,131,1222,208,318,1,0,7,2,15,2,1,7,5373,16,2
전라남도,영광군,재외투표,,144,112,79,2,16,6,9,0,0,0,0,0,0,0,0,112,0,32
전라남도,영광군,영광읍,합계,15538,11447,6478,248,3876,210,471,1,5,25,2,53,5,5,23,11402,45,4091
전라남도,영광군,영광읍,관내사전투표,4218,4218,2540,66,1287,87,189,0,0,9,1,18,0,1,6,4204,14,0
전라남도,영광군,영광읍,영광읍제1투,1381,772,425,13,281,11,36,0,0,0,0,1,0,0,2,769,3,609
전라남도,영광군,영광읍,영광읍제2투,1743,1168,641,47,401,25,45,0,0,2,0,2,0,1,1,1165,3,575
전라남도,영광군,영광읍,영광읍제3투,1742,1114,572,29,433,19,38,0,2,4,1,5,0,2,2,1107,7,628
전라남도,영광군,영광읍,영광읍제4투,1879,1129,634,27,388,27,32,1,2,1,0,10,0,0,2,1124,5,750
전라남도,영광군,영광읍,영광읍제5투,814,511,283,6,194,2,18,0,1,0,0,0,1,1,3,509,2,303
전라남도,영광군,영광읍,영광읍제6투,312,215,100,2,93,2,9,0,0,2,0,3,1,0,1,213,2,97
전라남도,영광군,영광읍,영광읍제7투,451,318,156,6,135,3,10,0,0,2,0,2,1,0,1,316,2,133
전라남도,영광군,영광읍,영광읍제8투,1942,1289,774,35,381,17,67,0,0,4,0,3,0,0,4,1285,4,653
전라남도,영광군,영광읍,영광읍제9투,1056,713,353,17,283,17,27,0,0,1,0,9,2,0,1,710,3,343
전라남도,영광군,백수읍,합계,3986,2866,1568,58,1031,35,75,0,1,4,0,40,9,5,21,2847,19,1120
전라남도,영광군,백수읍,관내사전투표,767,767,464,16,235,9,24,0,1,2,0,9,1,0,2,763,4,0
전라남도,영광군,백수읍,백수읍제1투,625,393,193,12,152,4,8,0,0,2,0,13,2,2,1,389,4,232
전라남도,영광군,백수읍,백수읍제2투,1053,687,356,16,266,8,20,0,0,0,0,3,4,0,10,683,4,366
전라남도,영광군,백수읍,백수읍제3투,839,567,297,7,221,9,16,0,0,0,0,6,2,3,3,564,3,272
전라남도,영광군,백수읍,백수읍제4투,702,452,258,7,157,5,7,0,0,0,0,9,0,0,5,448,4,250
전라남도,영광군,홍농읍,합계,5124,3938,2420,95,1094,73,131,3,2,1,1,77,0,3,19,3919,19,1186
전라남도,영광군,홍농읍,관내사전투표,1557,1557,983,35,388,27,64,1,2,1,0,43,0,1,4,1549,8,0
전라남도,영광군,홍농읍,홍농읍제1투,927,546,304,18,182,10,16,2,0,0,0,9,0,0,2,543,3,381
전라남도,영광군,홍농읍,홍농읍제2투,306,211,114,2,79,2,4,0,0,0,0,5,0,2,1,209,2,95
전라남도,영광군,홍농읍,홍농읍제3투,413,280,174,10,81,3,2,0,0,0,0,5,0,0,5,280,0,133
전라남도,영광군,홍농읍,홍농읍제4투,695,450,234,17,173,2,11,0,0,0,1,6,0,0,4,448,2,245
전라남도,영광군,홍농읍,홍농읍제5투,1226,894,611,13,191,29,34,0,0,0,0,9,0,0,3,890,4,332
전라남도,영광군,대마면,합계,1366,1009,524,23,365,13,24,0,0,3,2,39,2,0,6,1001,8,357
전라남도,영광군,대마면,관내사전투표,281,281,162,7,98,2,9,0,0,0,0,3,0,0,0,281,0,0
전라남도,영광군,대마면,대마면제1투,722,478,217,14,189,6,11,0,0,2,2,24,2,0,4,471,7,244
전라남도,영광군,대마면,대마면제2투,363,250,145,2,78,5,4,0,0,1,0,12,0,0,2,249,1,113
전라남도,영광군,묘량면,합계,1434,1068,552,35,401,15,29,1,3,5,1,3,2,3,14,1064,4,366
전라남도,영광군,묘량면,관내사전투표,362,362,211,5,124,4,10,0,2,1,0,2,0,1,1,361,1,0
전라남도,영광군,묘량면,묘량면제1투,609,401,192,20,160,4,13,0,0,2,0,1,0,1,7,400,1,208
전라남도,영광군,묘량면,묘량면제2투,463,305,149,10,117,7,6,1,1,2,1,0,2,1,6,303,2,158
전라남도,영광군,불갑면,합계,1099,866,427,27,351,10,25,0,1,1,0,5,3,2,5,857,9,233
전라남도,영광군,불갑면,관내사전투표,351,351,175,7,145,5,11,0,1,0,0,2,1,1,2,350,1,0
전라남도,영광군,불갑면,불갑면제1투,514,354,170,13,146,4,11,0,0,1,0,0,1,0,3,349,5,160
전라남도,영광군,불갑면,불갑면제2투,234,161,82,7,60,1,3,0,0,0,0,3,1,1,0,158,3,73
전라남도,영광군,군서면,합계,1977,1464,802,32,511,23,46,0,3,3,1,12,5,2,11,1451,13,513
전라남도,영광군,군서면,관내사전투표,444,444,243,11,146,12,21,0,2,1,0,2,0,0,2,440,4,0
전라남도,영광군,군서면,군서면제1투,762,496,277,10,183,2,10,0,0,0,1,3,3,0,4,493,3,266
전라남도,영광군,군서면,군서면제2투,771,524,282,11,182,9,15,0,1,2,0,7,2,2,5,518,6,247
전라남도,영광군,군남면,합계,2121,1593,900,29,566,20,43,2,2,3,1,2,2,3,11,1584,9,528
전라남도,영광군,군남면,관내사전투표,457,457,250,6,167,11,16,0,1,0,0,0,0,0,3,454,3,0
전라남도,영광군,군남면,군남면제1투,753,480,265,11,176,3,15,1,0,2,0,1,1,0,4,479,1,273
전라남도,영광군,군남면,군남면제2투,356,257,155,4,83,1,4,1,1,1,0,1,1,2,2,256,1,99
전라남도,영광군,군남면,군남면제3투,555,399,230,8,140,5,8,0,0,0,1,0,0,1,2,395,4,156
전라남도,영광군,염산면,합계,3593,2612,1406,66,987,24,49,3,1,5,0,22,6,2,19,2590,22,981
전라남도,영광군,염산면,관내사전투표,850,850,480,9,316,8,20,0,1,2,0,6,1,0,3,846,4,0
전라남도,영광군,염산면,염산면제1투,1097,665,352,30,254,9,9,1,0,1,0,1,0,1,1,659,6,432
전라남도,영광군,염산면,염산면제2투,631,440,231,12,164,2,8,1,0,1,0,10,0,0,7,436,4,191
전라남도,영광군,염산면,염산면제3투,492,317,190,10,97,0,6,0,0,0,0,4,2,1,3,313,4,175
전라남도,영광군,염산면,염산면제4투,523,340,153,5,156,5,6,1,0,1,0,1,3,0,5,336,4,183
전라남도,영광군,법성면,합계,4476,3150,1749,62,1136,43,88,2,0,0,1,14,3,2,22,3122,28,1326
전라남도,영광군,법성면,관내사전투표,799,799,442,11,304,9,20,0,0,0,0,3,1,1,5,796,3,0
전라남도,영광군,법성면,법성면제1투,1576,955,530,11,351,20,29,0,0,0,1,0,0,1,2,945,10,621
전라남도,영광군,법성면,법성면제2투,517,331,189,9,115,4,5,0,0,0,0,1,0,0,5,328,3,186
전라남도,영광군,법성면,법성면제3투,469,326,176,11,120,2,6,0,0,0,0,5,1,0,3,324,2,143
전라남도,영광군,법성면,법성면제4투,696,458,257,8,164,2,14,0,0,0,0,3,0,0,2,450,8,238
전라남도,영광군,법성면,법성면제5투,419,281,155,12,82,6,14,2,0,0,0,2,1,0,5,279,2,138
전라남도,영광군,낙월면,합계,436,222,140,7,57,1,8,1,0,0,0,0,0,2,4,220,2,214
전라남도,영광군,낙월면,관내사전투표,65,65,49,1,9,0,4,1,0,0,0,0,0,0,1,65,0,0
전라남도,영광군,낙월면,낙월면제1투,160,23,12,1,7,0,2,0,0,0,0,0,0,0,0,22,1,137
전라남도,영광군,낙월면,낙월면제2투,76,45,23,1,18,1,1,0,0,0,0,0,0,0,0,44,1,31
전라남도,영광군,낙월면,낙월면제3투,135,89,56,4,23,0,1,0,0,0,0,0,0,2,3,89,0,46
전라남도,영광군,잘못 투입·구분된 투표지,,0,0,0,0,0,0,0,0,0,0,0,0,0,0,0,0,0,0
전라남도,함평군,합계,,30227,23368,13539,471,7831,359,788,11,7,12,10,39,24,22,87,23200,168,6859
전라남도,함평군,거소·선상투표,,188,171,79,7,51,5,4,3,3,1,1,0,1,2,3,160,11,17
전라남도,함평군,관외사전투표,,3787,3787,2326,89,1025,110,203,1,1,0,1,6,0,3,2,3767,20,0
전라남도,함평군,재외투표,,140,102,67,5,20,1,7,0,0,0,1,1,0,0,0,102,0,38
전라남도,함평군,함평읍,합계,6882,5152,2996,112,1716,81,192,0,1,2,2,10,1,3,13,5129,23,1730
전라남도,함평군,함평읍,관내사전투표,2059,2059,1252,40,609,43,99,0,1,1,1,4,0,0,2,2052,7,0
전라남도,함평군,함평읍,함평읍제1투,968,617,331,16,244,4,16,0,0,0,1,2,0,0,1,615,2,351
전라남도,함평군,함평읍,함평읍제2투,974,609,351,21,205,7,14,0,0,0,0,0,0,1,7,606,3,365
전라남도,함평군,함평읍,함평읍제3투,505,332,169,5,137,4,10,0,0,0,0,0,0,1,0,326,6,173
전라남도,함평군,함평읍,함평읍제4투,1569,1016,607,16,329,17,40,0,0,1,0,4,1,0,1,1016,0,553
전라남도,함평군,함평읍,함평읍제5투,807,519,286,14,192,6,13,0,0,0,0,0,0,1,2,514,5,288
전라남도,함평군,손불면,합계,2836,1976,1088,41,730,26,44,2,0,0,1,2,3,2,16,1955,21,860
전라남도,함평군,손불면,관내사전투표,552,552,296,9,210,8,16,0,0,0,0,0,2,2,2,545,7,0
전라남도,함평군,손불면,손불면제1투,1408,869,467,13,340,12,20,1,0,0,1,2,0,0,6,862,7,539
전라남도,함평군,손불면,손불면제2투,876,555,325,19,180,6,8,1,0,0,0,0,1,0,8,548,7,321
전라남도,함평군,신광면,합계,1473,1109,641,18,376,7,35,0,0,0,0,3,4,1,10,1095,14,364
전라남도,함평군,신광면,관내사전투표,301,301,190,6,87,2,9,0,0,0,0,1,0,0,1,296,5,0
전라남도,함평군,신광면,신광면제1투,888,598,322,11,226,5,16,0,0,0,0,2,4,1,5,592,6,290
전라남도,함평군,신광면,신광면제2투,284,210,129,1,63,0,10,0,0,0,0,0,0,0,4,207,3,74
전라남도,함평군,학교면,관내사전투표,535,535,320,7,181,5,9,0,0,1,0,1,1,0,2,527,8,0
전라남도,함평군,학교면,합계,3251,2344,1364,28,847,19,45,2,1,3,3,2,5,0,10,2329,15,907
전라남도,함평군,학교면,학교면제1투,785,514,312,6,176,4,8,1,0,0,1,0,3,0,1,512,2,271
전라남도,함평군,학교면,학교면제2투,442,326,194,5,121,0,1,0,1,0,0,0,0,0,3,325,1,116
전라남도,함평군,학교면,학교면제3투,234,163,83,4,64,1,6,0,0,1,0,0,0,0,3,162,1,71
전라남도,함평군,학교면,학교면제4투,1255,806,455,6,305,9,21,1,0,1,2,1,1,0,1,803,3,449
전라남도,함평군,엄다면,합계,1618,1219,669,23,449,21,33,0,0,3,1,1,2,2,6,1210,9,399
전라남도,함평군,엄다면,관내사전투표,315,315,172,4,120,6,8,0,0,1,0,1,0,1,0,313,2,0
전라남도,함평군,엄다면,엄다면투표소,1303,904,497,19,329,15,25,0,0,2,1,0,2,1,6,897,7,399
전라남도,함평군,대동면,합계,2388,1820,1024,54,644,19,54,3,0,1,0,2,2,2,3,1808,12,568
전라남도,함평군,대동면,관내사전투표,538,538,293,17,189,8,28,1,0,0,0,1,0,0,0,537,1,0
전라남도,함평군,대동면,대동면제1투,1123,771,446,24,261,9,18,2,0,1,0,1,1,0,3,766,5,352
전라남도,함평군,대동면,대동면제2투,727,511,285,13,194,2,8,0,0,0,0,0,1,2,0,505,6,216
전라남도,함평군,나산면,합계,2263,1695,901,40,654,20,44,0,0,2,0,4,4,3,9,1681,14,568
전라남도,함평군,나산면,관내사전투표,645,645,318,17,261,9,24,0,0,2,0,2,3,3,1,640,5,0
전라남도,함평군,나산면,나산면제1투,1228,775,427,21,286,10,16,0,0,0,0,2,1,0,5,768,7,453
전라남도,함평군,나산면,나산면제2투,390,275,156,2,107,1,4,0,0,0,0,0,0,0,3,273,2,115
전라남도,함평군,해보면,합계,2427,1770,1071,24,570,23,61,0,0,0,0,3,0,2,7,1761,9,657
전라남도,함평군,해보면,관내사전투표,618,618,393,6,178,7,26,0,0,0,0,0,0,0,2,612,6,0
전라남도,함평군,해보면,해보면제1투,828,470,260,6,166,9,25,0,0,0,0,1,0,1,0,468,2,358
전라남도,함평군,해보면,해보면제2투,981,682,418,12,226,7,10,0,0,0,0,2,0,1,5,681,1,299
전라남도,함평군,월야면,합계,2974,2223,1313,30,749,27,66,0,1,0,0,5,2,2,8,2203,20,751
전라남도,함평군,월야면,관내사전투표,718,718,426,9,232,12,31,0,0,0,0,1,0,0,1,712,6,0
전라남도,함평군,월야면,월야면제1투,1013,639,395,8,205,8,14,0,1,0,0,1,0,1,4,637,2,374
전라남도,함평군,월야면,월야면제2투,362,258,144,8,96,1,4,0,0,0,0,2,1,0,1,257,1,104
전라남도,함평군,월야면,월야면제3투,881,608,348,5,216,6,17,0,0,0,0,1,1,1,2,597,11,273
전라남도,함평군,잘못 투입·구분된 투표지,,0,0,0,0,0,0,0,0,0,0,0,0,0,0,0,0,0,0
전라남도,신안군,합계,,38305,28950,14370,713,12000,459,890,13,16,34,13,30,44,34,131,28747,203,9355
전라남도,신안군,거소·선상투표,,243,228,105,5,98,2,3,0,0,0,0,1,0,1,0,215,13,15
전라남도,신안군,관외사전투표,,6866,6866,3847,178,2192,196,386,5,1,12,3,7,1,2,10,6840,26,0
전라남도,신안군,재외투표,,139,82,57,1,13,2,9,0,0,0,0,0,0,0,0,82,0,57
전라남도,신안군,지도읍,합계,3756,2641,1260,84,1169,31,50,0,2,2,2,0,4,6,12,2622,19,1115
전라남도,신안군,지도읍,관내사전투표,822,822,406,22,353,9,17,0,1,2,0,0,3,3,1,817,5,0
전라남도,신안군,지도읍,지도읍제1투,1538,934,475,26,390,14,19,0,1,0,0,0,1,0,3,929,5,604
전라남도,신안군,지도읍,지도읍제2투,80,47,19,3,25,0,0,0,0,0,0,0,0,0,0,47,0,33
전라남도,신안군,지도읍,지도읍제3투,572,366,175,14,161,2,4,0,0,0,0,0,0,2,4,362,4,206
전라남도,신안군,지도읍,지도읍제4투,555,340,137,14,168,5,8,0,0,0,2,0,0,1,2,337,3,215
전라남도,신안군,지도읍,지도읍제5투,189,132,48,5,72,1,2,0,0,0,0,0,0,0,2,130,2,57
전라남도,신안군,증도면,합계,1536,1101,532,25,493,11,26,0,0,0,0,0,1,0,4,1092,9,435
전라남도,신안군,증도면,관내사전투표,248,248,133,5,97,3,5,0,0,0,0,0,0,0,1,244,4,0
전라남도,신안군,증도면,증도면제1투,486,296,152,8,122,4,9,0,0,0,0,0,0,0,0,295,1,190
전라남도,신안군,증도면,증도면제2투,554,389,172,9,191,3,10,0,0,0,0,0,1,0,1,387,2,165
전라남도,신안군,증도면,증도면제3투,248,168,75,3,83,1,2,0,0,0,0,0,0,0,2,166,2,80
전라남도,신안군,임자면,관내사전투표,460,460,237,9,193,5,12,0,1,1,0,0,0,0,1,459,1,0
전라남도,신안군,임자면,합계,2477,1694,893,39,682,16,27,1,2,2,0,2,2,4,14,1684,10,783
전라남도,신안군,임자면,임자면제1투,1290,776,404,27,307,10,11,0,1,0,0,2,1,4,4,771,5,514
전라남도,신안군,임자면,임자면제2투,346,234,129,0,97,1,2,0,0,1,0,0,0,0,3,233,1,112
전라남도,신안군,임자면,임자면제3투,79,39,21,1,15,0,0,0,0,0,0,0,1,0,0,38,1,40
전라남도,신안군,임자면,임자면제4투,302,185,102,2,70,0,2,1,0,0,0,0,0,0,6,183,2,117
전라남도,신안군,자은면,합계,1821,1296,635,42,545,14,40,0,1,0,0,0,7,2,5,1291,5,525
전라남도,신안군,자은면,관내사전투표,337,337,165,10,134,3,19,0,1,0,0,0,3,0,1,336,1,0
전라남도,신안군,자은면,자은면제1투,1042,646,274,30,308,11,14,0,0,0,0,0,4,0,2,643,3,396
전라남도,신안군,자은면,자은면제2투,442,313,196,2,103,0,7,0,0,0,0,0,0,2,2,312,1,129
전라남도,신안군,비금면,관내사전투표,507,507,290,1,188,7,17,0,0,1,0,0,1,0,0,505,2,0
전라남도,신안군,비금면,합계,2775,1987,983,33,877,27,36,0,1,1,0,0,5,0,11,1974,13,788
전라남도,신안군,비금면,비금면제1투,984,616,320,13,255,11,8,0,0,0,0,0,0,0,5,612,4,368
전라남도,신안군,비금면,비금면제2투,625,433,165,12,244,1,2,0,1,0,0,0,1,0,2,428,5,192
전라남도,신안군,비금면,비금면제3투,579,374,191,6,158,7,5,0,0,0,0,0,2,0,3,372,2,205
전라남도,신안군,비금면,비금면제4투,80,57,17,1,32,1,4,0,0,0,0,0,1,0,1,57,0,23
전라남도,신안군,도초면,관내사전투표,490,490,234,9,214,11,10,0,0,0,0,2,0,0,2,482,8,0
전라남도,신안군,도초면,합계,2140,1520,721,36,680,20,30,0,0,0,2,3,2,1,13,1508,12,620
전라남도,신안군,도초면,도초면제1투,987,624,284,17,294,5,13,0,0,0,1,1,1,0,6,622,2,363
전라남도,신안군,도초면,도초면제2투,532,341,166,6,153,4,6,0,0,0,1,0,0,1,3,340,1,191
전라남도,신안군,도초면,도초면제3투,131,65,37,4,19,0,1,0,0,0,0,0,1,0,2,64,1,66
전라남도,신안군,흑산면,관내사전투표,498,498,259,17,182,11,15,1,0,2,0,1,2,0,4,494,4,0
전라남도,신안군,흑산면,합계,2815,1739,946,46,621,28,41,3,2,2,2,6,4,1,18,1720,19,1076
전라남도,신안군,흑산면,흑산면제1투,824,363,196,9,139,7,6,1,0,0,0,0,1,0,1,360,3,461
전라남도,신안군,흑산면,흑산면제2투,148,92,51,2,31,1,1,0,0,0,0,0,0,0,4,90,2,56
전라남도,신안군,흑산면,흑산면제3투,224,120,58,1,52,2,3,0,0,0,0,2,0,0,0,118,2,104
전라남도,신안군,흑산면,흑산면제4투,170,116,56,2,54,0,0,1,0,0,0,0,1,0,1,115,1,54
전라남도,신안군,흑산면,흑산면제5투,362,214,145,2,59,0,4,0,1,0,0,0,0,0,2,213,1,148
전라남도,신안군,흑산면,흑산면제6투,134,69,31,0,27,1,3,0,1,0,0,1,0,0,1,65,4,65
전라남도,신안군,흑산면,흑산면제7투,349,194,118,10,46,6,7,0,0,0,1,1,0,0,4,193,1,155
전라남도,신안군,흑산면,흑산면제8투,43,32,17,2,9,0,1,0,0,0,0,1,0,0,1,31,1,11
전라남도,신안군,흑산면,흑산면제9투,63,41,15,1,22,0,1,0,0,0,1,0,0,1,0,41,0,22
전라남도,신안군,하의면,합계,1374,971,401,18,496,10,22,0,2,5,0,1,2,1,7,965,6,403
전라남도,신안군,하의면,관내사전투표,244,244,106,5,115,5,8,0,2,2,0,0,0,0,0,243,1,0
전라남도,신안군,하의면,하의면제1투,541,347,152,3,174,3,7,0,0,0,0,1,0,1,4,345,2,194
전라남도,신안군,하의면,하의면제2투,499,305,121,10,156,2,5,0,0,3,0,0,2,0,3,302,3,194
전라남도,신안군,하의면,하의면제3투,90,75,22,0,51,0,2,0,0,0,0,0,0,0,0,75,0,15
전라남도,신안군,신의면,합계,1189,814,370,22,350,17,33,1,0,2,0,1,2,5,2,805,9,375
전라남도,신안군,신의면,관내사전투표,263,263,128,7,102,7,14,1,0,1,0,0,0,1,0,261,2,0
전라남도,신안군,신의면,신의면투표소,926,551,242,15,248,10,19,0,0,1,0,1,2,4,2,544,7,375
전라남도,신안군,장산면,합계,1269,918,398,29,441,7,27,2,0,0,0,0,1,2,4,911,7,351
전라남도,신안군,장산면,관내사전투표,259,259,120,6,119,1,10,1,0,0,0,0,0,1,1,259,0,0
전라남도,신안군,장산면,장산면제1투,588,406,166,10,207,4,10,1,0,0,0,0,1,0,1,400,6,182
전라남도,신안군,장산면,장산면제2투,422,253,112,13,115,2,7,0,0,0,0,0,0,1,2,252,1,169
전라남도,신안군,안좌면,관내사전투표,364,364,153,6,172,1,24,0,0,1,0,1,2,0,1,361,3,0
전라남도,신안군,안좌면,합계,2416,1727,758,42,835,14,45,0,0,3,0,2,3,1,11,1714,13,689
전라남도,신안군,안좌면,안좌면제1투,917,581,244,17,292,6,13,0,0,1,0,0,1,0,2,576,5,336
전라남도,신안군,안좌면,안좌면제2투,204,139,90,4,42,1,0,0,0,1,0,0,0,0,1,139,0,65
전라남도,신안군,안좌면,안좌면제3투,572,388,184,7,179,4,7,0,0,0,0,0,0,1,3,385,3,184
전라남도,신안군,안좌면,안좌면제4투,359,255,87,8,150,2,1,0,0,0,0,1,0,0,4,253,2,104
전라남도,신안군,팔금면,관내사전투표,175,175,87,2,70,3,8,0,0,0,1,0,1,1,1,174,1,0
전라남도,신안군,팔금면,합계,853,615,289,12,279,7,14,0,0,1,1,1,3,2,3,612,3,238
전라남도,신안군,팔금면,팔금면투표소,678,440,202,10,209,4,6,0,0,1,0,1,2,1,2,438,2,238
전라남도,신안군,암태면,관내사전투표,445,445,200,11,197,6,19,0,1,0,0,0,3,3,3,443,2,0
전라남도,신안군,암태면,합계,1584,1159,533,19,535,13,35,0,1,0,0,0,4,3,6,1149,10,425
전라남도,신안군,암태면,암태면제1투,774,460,214,6,214,6,13,0,0,0,0,0,0,0,3,456,4,314
전라남도,신안군,암태면,암태면제2투,238,162,76,2,77,1,3,0,0,0,0,0,0,0,0,159,3,76
전라남도,신안군,암태면,암태면제3투,127,92,43,0,47,0,0,0,0,0,0,0,1,0,0,91,1,35
전라남도,신안군,압해읍,합계,5052,3592,1642,82,1694,44,66,1,4,4,3,6,3,3,11,3563,29,1460
전라남도,신안군,압해읍,관내사전투표,970,970,475,25,408,19,22,0,0,0,3,3,1,1,3,960,10,0
전라남도,신안군,압해읍,압해읍제1투,1066,641,295,19,291,10,11,0,2,0,0,3,1,0,1,633,8,425
전라남도,신안군,압해읍,압해읍제2투,620,389,177,9,187,1,9,0,0,3,0,0,0,0,1,387,2,231
전라남도,신안군,압해읍,압해읍제3투,945,639,278,9,335,2,5,0,2,1,0,0,0,1,1,634,5,306
전라남도,신안군,압해읍,압해읍제4투,1091,714,298,15,366,12,16,1,0,0,0,0,1,0,2,711,3,377
전라남도,신안군,압해읍,압해읍제5투,173,128,65,4,56,0,2,0,0,0,0,0,0,1,0,128,0,45
전라남도,신안군,압해읍,압해읍제6투,187,111,54,1,51,0,1,0,0,0,0,0,0,0,3,110,1,76
전라남도,신안군,잘못 투입·구분된 투표지,,0,0,0,0,0,0,0,0,0,0,0,0,0,0,0,0,0,0
경상북도,합계,,,2249984,1711627,369726,827237,253905,149017,88080,3053,476,1054,861,1308,1068,2942,2499,1701226,10401,538357
경상북도,포항시북구,합계,,221925,171444,38629,77138,26901,17421,9682,263,33,93,59,89,61,141,162,170672,772,50481
경상북도,포항시북구,거소·선상투표,,623,582,156,166,161,55,24,3,1,0,0,2,0,0,4,572,10,41
경상북도,포항시북구,관외사전투표,,18455,18433,5742,4934,3367,2536,1567,40,4,13,9,21,5,3,25,18266,167,22
경상북도,포항시북구,재외투표,,1099,807,420,53,152,59,117,0,0,0,0,0,0,0,2,803,4,292
경상북도,포항시북구,흥해읍,합계,25624,18647,3365,9856,2646,1656,909,24,4,16,13,12,13,26,25,18565,82,6977
경상북도,포항시북구,흥해읍,관내사전투표,3771,3771,864,1728,539,363,228,4,2,1,4,2,1,3,5,3744,27,0
경상북도,포항시북구,흥해읍,흥해읍제1투,1918,1130,179,694,124,83,43,1,0,0,0,0,1,1,1,1127,3,788
경상북도,포항시북구,흥해읍,흥해읍제2투,1659,1135,189,581,179,108,67,1,1,2,0,1,0,2,1,1132,3,524
경상북도,포항시북구,흥해읍,흥해읍제3투,1262,914,100,639,100,46,19,0,0,0,0,2,0,2,0,908,6,348
경상북도,포항시북구,흥해읍,흥해읍제4투,1551,1040,112,726,121,41,21,2,0,0,1,0,4,7,2,1037,3,511
경상북도,포항시북구,흥해읍,흥해읍제5투,1344,953,169,504,123,89,46,3,0,2,3,3,1,2,0,945,8,391
경상북도,포항시북구,흥해읍,흥해읍제6투,1626,1071,167,594,162,90,45,1,0,3,0,1,0,1,2,1066,5,555
경상북도,포항시북구,흥해읍,흥해읍제7투,1890,1271,154,786,162,110,43,3,1,1,1,0,2,1,2,1266,5,619
경상북도,포항시북구,흥해읍,흥해읍제8투,909,538,47,408,35,32,9,0,0,0,1,0,2,1,1,536,2,371
경상북도,포항시북구,흥해읍,흥해읍제9투,1917,1286,229,655,188,140,67,2,0,2,1,0,0,0,0,1284,2,631
경상북도,포항시북구,흥해읍,흥해읍제10투,3999,2954,693,1184,525,329,195,3,0,2,1,0,2,4,5,2943,11,1045
경상북도,포항시북구,흥해읍,흥해읍제11투,2070,1400,211,790,193,123,68,3,0,3,0,1,0,1,4,1397,3,670
경상북도,포항시북구,흥해읍,흥해읍제12투,1708,1184,251,567,195,102,58,1,0,0,1,2,0,1,2,1180,4,524
경상북도,포항시북구,신광면,합계,2610,1964,254,1313,219,110,33,1,1,0,0,4,2,6,5,1948,16,646
경상북도,포항시북구,신광면,관내사전투표,694,694,111,436,72,50,15,1,1,0,0,2,0,0,0,688,6,0
경상북도,포항시북구,신광면,신광면제1투,863,553,59,379,72,26,6,0,0,0,0,1,0,3,3,549,4,310
경상북도,포항시북구,신광면,신광면제2투,442,296,38,210,23,15,6,0,0,0,0,1,0,1,0,294,2,146
경상북도,포항시북구,신광면,신광면제3투,611,421,46,288,52,19,6,0,0,0,0,0,2,2,2,417,4,190
경상북도,포항시북구,청하면,합계,4536,3324,418,2130,411,213,96,1,2,0,3,2,4,14,4,3298,26,1212
경상북도,포항시북구,청하면,관내사전투표,1055,1054,161,635,121,85,38,0,1,0,0,0,2,4,1,1048,6,1
경상북도,포항시북구,청하면,청하면제1투,1762,1092,134,713,129,70,32,1,0,0,0,1,0,4,1,1085,7,670
경상북도,포항시북구,청하면,청하면제2투,1242,858,88,568,118,42,17,0,1,0,3,1,2,5,2,847,11,384
경상북도,포항시북구,청하면,청하면제3투,477,320,35,214,43,16,9,0,0,0,0,0,0,1,0,318,2,157
경상북도,포항시북구,송라면,합계,2419,1879,214,1277,191,114,44,4,2,2,2,2,3,4,3,1862,17,540
경상북도,포항시북구,송라면,관내사전투표,970,970,117,657,97,54,23,2,2,1,1,1,2,2,2,961,9,0
경상북도,포항시북구,송라면,송라면투표소,1449,909,97,620,94,60,21,2,0,1,1,1,1,2,1,901,8,540
경상북도,포항시북구,기계면,합계,4649,3544,441,2335,383,207,92,7,1,6,2,3,11,12,5,3505,39,1105
경상북도,포항시북구,기계면,관내사전투표,1354,1354,202,820,158,96,46,2,0,3,1,1,3,6,2,1340,14,0
경상북도,포항시북구,기계면,기계면제1투,2055,1354,153,940,134,76,28,3,1,3,0,0,4,1,1,1344,10,701
경상북도,포항시북구,기계면,기계면제2투,679,451,50,301,49,19,11,2,0,0,1,2,1,4,1,441,10,228
경상북도,포항시북구,기계면,기계면제3투,561,385,36,274,42,16,7,0,0,0,0,0,3,1,1,380,5,176
경상북도,포항시북구,죽장면,합계,2447,1875,234,1297,168,104,34,2,0,1,2,0,4,11,7,1864,11,572
경상북도,포항시북구,죽장면,관내사전투표,775,775,97,533,69,42,17,1,0,0,2,0,2,3,4,770,5,0
경상북도,포항시북구,죽장면,죽장면제1투,1181,737,82,521,65,42,10,1,0,1,0,0,2,6,2,732,5,444
경상북도,포항시북구,죽장면,죽장면제2투,491,363,55,243,34,20,7,0,0,0,0,0,0,2,1,362,1,128
경상북도,포항시북구,기북면,합계,1227,1018,134,636,134,49,37,2,4,1,1,0,2,7,2,1009,9,209
경상북도,포항시북구,기북면,관내사전투표,600,600,81,383,70,27,22,0,3,1,1,0,1,5,1,595,5,0
경상북도,포항시북구,기북면,기북면투표소,627,418,53,253,64,22,15,2,1,0,0,0,1,2,1,414,4,209
경상북도,포항시북구,중앙동,합계,14503,10287,1802,5753,1372,819,454,15,2,5,4,2,2,8,7,10245,42,4216
경상북도,포항시북구,중앙동,관내사전투표,3104,3104,699,1527,391,282,179,4,0,3,1,1,0,1,2,3090,14,0
경상북도,포항시북구,중앙동,중앙동제1투,1351,756,102,484,90,52,23,3,0,0,0,0,0,0,1,755,1,595
경상북도,포항시북구,중앙동,중앙동제2투,943,578,77,397,63,32,5,0,0,0,1,0,1,0,1,577,1,365
경상북도,포항시북구,중앙동,중앙동제3투,1357,852,131,477,126,62,47,2,2,0,0,0,0,1,1,849,3,505
경상북도,포항시북구,중앙동,중앙동제4투,2158,1293,203,693,196,123,64,3,0,1,1,1,1,2,0,1288,5,865
경상북도,포항시북구,중앙동,중앙동제5투,2236,1411,184,900,190,78,43,3,0,1,1,0,0,2,0,1402,9,825
경상북도,포항시북구,중앙동,중앙동제6투,1240,734,100,442,97,67,25,0,0,0,0,0,0,1,0,732,2,506
경상북도,포항시북구,중앙동,중앙동제7투,2114,1559,306,833,219,123,68,0,0,0,0,0,0,1,2,1552,7,555
경상북도,포항시북구,양학동,합계,13881,10697,2547,4474,1839,1105,665,13,2,5,3,5,2,4,7,10671,26,3184
경상북도,포항시북구,양학동,관내사전투표,2877,2877,814,1076,446,318,209,1,0,1,1,4,0,2,0,2872,5,0
경상북도,포항시북구,양학동,양학동제1투,2523,1710,355,799,308,160,79,3,0,0,0,0,0,0,2,1706,4,813
경상북도,포항시북구,양학동,양학동제2투,2936,1994,411,962,323,180,108,2,0,0,0,0,2,0,1,1989,5,942
경상북도,포항시북구,양학동,양학동제3투,3090,2216,584,755,448,263,151,3,0,2,0,0,0,1,2,2209,7,874
경상북도,포항시북구,양학동,양학동제4투,2455,1900,383,882,314,184,118,4,2,2,2,1,0,1,2,1895,5,555
경상북도,포항시북구,죽도동,합계,17985,12459,2109,7086,1640,1017,508,17,3,10,3,7,0,7,6,12413,46,5526
경상북도,포항시북구,죽도동,관내사전투표,2966,2966,649,1512,383,238,156,3,2,2,0,1,0,1,2,2949,17,0
경상북도,포항시북구,죽도동,죽도동제1투,2366,1561,188,1040,190,98,31,4,0,1,1,3,0,1,1,1558,3,805
경상북도,포항시북구,죽도동,죽도동제2투,3818,2123,333,1279,265,166,65,2,0,3,1,1,0,2,1,2118,5,1695
경상북도,포항시북구,죽도동,죽도동제3투,3124,2061,320,1195,265,182,86,5,0,0,1,1,0,0,0,2055,6,1063
경상북도,포항시북구,죽도동,죽도동제4투,2436,1627,283,887,231,140,72,2,1,4,0,0,0,2,0,1622,5,809
경상북도,포항시북구,죽도동,죽도동제5투,3275,2121,336,1173,306,193,98,1,0,0,0,1,0,1,2,2111,10,1154
경상북도,포항시북구,용흥동,합계,18437,14092,2878,6873,2204,1352,689,21,0,6,2,4,1,7,11,14048,44,4345
경상북도,포항시북구,용흥동,관내사전투표,3365,3365,788,1624,446,317,162,6,0,0,1,0,0,2,3,3349,16,0
경상북도,포항시북구,용흥동,용흥동제1투,2287,1651,287,950,204,136,65,1,0,1,1,0,0,2,0,1647,4,636
경상북도,포항시북구,용흥동,용흥동제2투,2088,1364,252,686,201,144,72,3,0,1,0,0,0,0,1,1360,4,724
경상북도,포항시북구,용흥동,용흥동제3투,1878,1221,210,655,211,93,48,1,0,0,0,0,1,1,0,1220,1,657
경상북도,포항시북구,용흥동,용흥동제4투,1990,1575,314,759,292,133,69,3,0,1,0,1,0,1,0,1573,2,415
경상북도,포항시북구,용흥동,용흥동제5투,2422,1856,393,787,356,205,105,1,0,0,0,0,0,1,2,1850,6,566
경상북도,포항시북구,용흥동,용흥동제6투,2108,1517,322,670,226,180,103,4,0,3,0,2,0,0,3,1513,4,591
경상북도,포항시북구,용흥동,용흥동제7투,2299,1543,312,742,268,144,65,2,0,0,0,1,0,0,2,1536,7,756
경상북도,포항시북구,우창동,합계,20441,15485,3479,6909,2473,1608,882,21,1,5,4,5,3,15,12,15417,68,4956
경상북도,포항시북구,우창동,관내사전투표,4088,4088,1136,1512,634,471,295,5,0,2,1,1,2,3,5,4067,21,0
경상북도,포항시북구,우창동,우창동제1투,3394,2435,551,1038,413,308,103,3,0,1,1,1,0,4,2,2425,10,959
경상북도,포항시북구,우창동,우창동제2투,2187,1539,270,804,209,164,80,0,0,0,0,0,0,1,0,1528,11,648
경상북도,포항시북구,우창동,우창동제3투,2445,1834,455,730,324,178,135,2,0,0,0,0,0,3,0,1827,7,611
경상북도,포항시북구,우창동,우창동제4투,2008,1320,269,610,236,139,53,2,0,1,0,0,0,2,3,1315,5,688
경상북도,포항시북구,우창동,우창동제5투,1647,1136,204,625,148,86,65,3,0,0,0,0,1,1,0,1133,3,511
경상북도,포항시북구,우창동,우창동제6투,2069,1356,212,815,183,78,57,3,0,1,1,3,0,0,0,1353,3,713
경상북도,포항시북구,우창동,우창동제7투,2603,1777,382,775,326,184,94,3,1,0,1,0,0,1,2,1769,8,826
경상북도,포항시북구,두호동,합계,16601,12846,2716,5912,1984,1403,755,16,2,4,3,3,4,4,11,12817,29,3755
경상북도,포항시북구,두호동,관내사전투표,3170,3170,796,1286,466,379,209,6,0,2,3,1,4,2,3,3157,13,0
경상북도,포항시북구,두호동,두호동제1투,1338,782,112,487,92,59,29,2,0,0,0,0,0,0,1,782,0,556
경상북도,포항시북구,두호동,두호동제2투,2046,1358,263,722,176,128,65,0,1,0,0,1,0,0,0,1356,2,688
경상북도,포항시북구,두호동,두호동제3투,2505,1849,344,879,296,192,127,1,1,1,0,1,0,1,2,1845,4,656
경상북도,포항시북구,두호동,두호동제4투,3047,2359,520,998,417,274,140,2,0,1,0,0,0,0,2,2354,5,688
경상북도,포항시북구,두호동,두호동제5투,1758,1257,215,675,181,120,58,3,0,0,0,0,0,0,2,1254,3,501
경상북도,포항시북구,두호동,두호동제6투,2737,2071,466,865,356,251,127,2,0,0,0,0,0,1,1,2069,2,666
경상북도,포항시북구,장량동,합계,47160,35955,9618,13295,6372,4144,2283,59,4,14,8,12,4,8,22,35843,112,11205
경상북도,포항시북구,장량동,관내사전투표,7703,7702,2293,2665,1240,907,532,17,1,1,1,4,1,1,8,7671,31,1
경상북도,포항시북구,장량동,장량동제1투,1935,1267,246,601,201,134,75,1,0,0,0,1,0,1,3,1263,4,668
경상북도,포항시북구,장량동,장량동제2투,2308,1570,317,749,278,126,84,5,0,0,0,1,1,0,0,1561,9,738
경상북도,포항시북구,장량동,장량동제3투,2279,1621,361,677,301,157,113,1,0,0,1,2,0,0,1,1614,7,658
경상북도,포항시북구,장량동,장량동제4투,2794,2094,513,887,363,207,112,5,0,1,0,1,0,0,1,2090,4,700
경상북도,포항시북구,장량동,장량동제5투,2994,1952,418,813,344,224,139,3,1,2,0,1,0,0,2,1947,5,1042
경상북도,포항시북구,장량동,장량동제6투,2837,2176,528,855,395,271,117,3,1,1,0,0,0,1,0,2172,4,661
경상북도,포항시북구,장량동,장량동제7투,4045,2587,669,982,446,312,168,1,0,2,1,0,0,0,0,2581,6,1458
경상북도,포항시북구,장량동,장량동제8투,3398,2565,782,846,477,291,156,1,0,1,0,0,1,2,3,2560,5,833
경상북도,포항시북구,장량동,장량동제9투,3307,2329,581,856,421,272,179,6,0,1,1,1,0,1,1,2320,9,978
경상북도,포항시북구,장량동,장량동제10투,2908,2357,668,755,473,300,142,7,0,1,2,0,1,0,0,2349,8,551
경상북도,포항시북구,장량동,장량동제11투,2874,1948,589,605,381,229,132,2,0,1,0,1,0,0,1,1941,7,926
경상북도,포항시북구,장량동,장량동제12투,3915,3054,960,915,596,393,177,4,0,1,1,0,0,1,2,3050,4,861
경상북도,포항시북구,장량동,장량동제13투,3863,2733,693,1089,456,321,157,3,1,2,1,0,0,1,0,2724,9,1130
경상북도,포항시북구,환여동,합계,9228,7534,2097,2834,1182,868,492,17,0,5,0,5,1,5,4,7510,24,1694
경상북도,포항시북구,환여동,관내사전투표,2813,2813,957,807,442,376,217,4,0,0,0,1,1,3,2,2810,3,0
경상북도,포항시북구,환여동,환여동제1투,924,610,86,374,87,36,19,0,0,3,0,1,0,0,0,606,4,314
경상북도,포항시북구,환여동,환여동제2투,1210,767,131,411,119,66,30,3,0,0,0,0,0,1,0,761,6,443
경상북도,포항시북구,환여동,환여동제3투,3208,2502,685,945,398,290,167,7,0,2,0,0,0,1,0,2495,7,706
경상북도,포항시북구,환여동,환여동제4투,1073,842,238,297,136,100,59,3,0,0,0,3,0,0,2,838,4,231
경상북도,포항시북구,잘못 투입·구분된 투표지,,0,16,5,5,3,2,1,0,0,0,0,0,0,0,0,16,0,-16
경상북도,포항시남구,합계,,200424,150740,34808,66319,24728,14382,8845,212,29,82,37,120,56,109,189,149916,824,49684
경상북도,포항시남구,거소·선상투표,,417,394,93,111,117,39,10,1,2,0,1,2,1,1,1,379,15,23
경상북도,포항시남구,관외사전투표,,15039,15031,4856,3960,2669,1944,1344,24,4,8,5,19,4,4,28,14869,162,8
경상북도,포항시남구,재외투표,,894,636,355,54,107,40,74,1,0,0,0,0,0,1,1,633,3,258
경상북도,포항시남구,구룡포읍,합계,7557,5022,588,3295,635,286,112,12,1,1,1,5,6,15,8,4965,57,2535
경상북도,포항시남구,구룡포읍,관내사전투표,1253,1253,184,777,128,87,44,2,0,1,0,2,2,5,2,1234,19,0
경상북도,포항시남구,구룡포읍,구룡포읍제1투,2793,1692,195,1120,234,83,36,1,0,0,0,0,1,2,1,1673,19,1101
경상북도,포항시남구,구룡포읍,구룡포읍제2투,1443,912,80,645,113,39,19,5,0,0,0,1,1,1,2,906,6,531
경상북도,포항시남구,구룡포읍,구룡포읍제3투,578,356,29,243,47,19,3,0,0,0,0,2,2,2,3,350,6,222
경상북도,포항시남구,구룡포읍,구룡포읍제4투,1490,809,100,510,113,58,10,4,1,0,1,0,0,5,0,802,7,681
경상북도,포항시남구,연일읍,합계,23752,17957,4151,7732,3009,1748,1174,30,4,15,4,4,5,10,13,17899,58,5795
경상북도,포항시남구,연일읍,관내사전투표,4310,4311,1184,1658,686,426,321,8,1,3,0,2,0,2,5,4296,15,-1
경상북도,포항시남구,연일읍,연일읍제1투,1934,1203,186,651,196,88,68,2,0,2,0,0,0,0,1,1194,9,731
경상북도,포항시남구,연일읍,연일읍제2투,2573,1744,340,854,295,151,98,0,0,0,1,0,2,0,0,1741,3,829
경상북도,포항시남구,연일읍,연일읍제3투,1704,1077,182,558,167,100,58,0,0,3,0,0,1,0,1,1070,7,627
경상북도,포항시남구,연일읍,연일읍제4투,3156,2115,473,930,360,187,143,5,1,3,1,0,0,2,2,2107,8,1041
경상북도,포항시남구,연일읍,연일읍제5투,2535,1815,394,744,323,189,152,3,0,2,0,1,0,2,2,1812,3,720
경상북도,포항시남구,연일읍,연일읍제6투,2873,2249,597,835,404,279,122,4,1,1,1,1,1,0,0,2246,3,624
경상북도,포항시남구,연일읍,연일읍제7투,2919,2248,644,744,412,261,170,7,0,1,1,0,0,0,1,2241,7,671
경상북도,포항시남구,연일읍,연일읍제8투,643,440,54,305,40,18,18,1,1,0,0,0,0,1,1,439,1,203
경상북도,포항시남구,연일읍,연일읍제9투,1105,755,97,453,126,49,24,0,0,0,0,0,1,3,0,753,2,350
경상북도,포항시남구,오천읍,합계,40106,28071,6919,11201,4895,2715,2029,25,2,16,6,27,14,25,52,27926,145,12035
경상북도,포항시남구,오천읍,관내사전투표,7000,7000,2044,2412,1178,724,538,6,1,6,1,12,6,6,14,6948,52,0
경상북도,포항시남구,오천읍,오천읍제1투,2271,1337,279,536,282,138,88,0,1,2,0,0,0,2,2,1330,7,934
경상북도,포항시남구,오천읍,오천읍제2투,1719,1137,165,647,139,104,68,3,0,0,0,0,0,2,3,1131,6,582
경상북도,포항시남구,오천읍,오천읍제3투,1342,924,147,531,133,62,41,3,0,0,1,0,0,0,2,920,4,418
경상북도,포항시남구,오천읍,오천읍제4투,1320,846,163,403,137,69,61,2,0,2,0,1,0,0,3,841,5,474
경상북도,포항시남구,오천읍,오천읍제5투,2210,1451,242,771,240,108,84,0,0,0,0,0,1,2,1,1449,2,759
경상북도,포항시남구,오천읍,오천읍제6투,1277,834,156,422,136,66,43,2,0,0,0,0,0,3,1,829,5,443
경상북도,포항시남구,오천읍,오천읍제7투,2352,1570,301,777,271,119,84,1,0,1,1,3,2,0,5,1565,5,782
경상북도,포항시남구,오천읍,오천읍제8투,1916,1288,255,608,227,110,80,1,0,1,0,0,0,2,0,1284,4,628
경상북도,포항시남구,오천읍,오천읍제9투,4714,2545,727,823,469,282,216,0,0,0,0,4,2,0,5,2528,17,2169
경상북도,포항시남구,오천읍,오천읍제10투,3197,2383,789,625,474,259,218,4,0,0,0,1,0,2,5,2377,6,814
경상북도,포항시남구,오천읍,오천읍제11투,1994,1183,332,415,206,122,91,1,0,2,1,4,0,0,5,1179,4,811
경상북도,포항시남구,오천읍,오천읍제12투,1957,1062,202,499,200,91,57,1,0,2,0,0,0,2,0,1054,8,895
경상북도,포항시남구,오천읍,오천읍제13투,1280,803,133,462,113,48,36,1,0,0,0,1,2,0,1,797,6,477
경상북도,포항시남구,오천읍,오천읍제14투,2547,1512,346,617,287,142,107,0,0,0,2,0,0,1,2,1504,8,1035
경상북도,포항시남구,오천읍,오천읍제15투,3010,2196,638,653,403,271,217,0,0,0,0,1,1,3,3,2190,6,814
경상북도,포항시남구,대송면,합계,3616,2681,374,1658,354,157,95,0,0,3,0,1,3,6,2,2653,28,935
경상북도,포항시남구,대송면,관내사전투표,831,831,150,496,99,46,24,0,0,0,0,0,2,2,0,819,12,0
경상북도,포항시남구,대송면,대송면제1투,1052,721,74,481,84,41,24,0,0,2,0,0,1,4,2,713,8,331
경상북도,포항시남구,대송면,대송면제2투,1012,658,82,397,102,38,32,0,0,0,0,0,0,0,0,651,7,354
경상북도,포항시남구,대송면,대송면제3투,721,471,68,284,69,32,15,0,0,1,0,1,0,0,0,470,1,250
경상북도,포항시남구,동해면,합계,8018,5735,976,3186,806,428,272,4,2,4,2,10,2,6,9,5707,28,2283
경상북도,포항시남구,동해면,관내사전투표,1743,1743,355,875,236,158,89,4,2,0,1,7,0,0,5,1732,11,0
경상북도,포항시남구,동해면,동해면제1투,2094,1353,224,758,194,103,66,0,0,1,1,0,0,1,0,1348,5,741
경상북도,포항시남구,동해면,동해면제2투,476,325,23,249,29,17,3,0,0,0,0,0,0,1,1,323,2,151
경상북도,포항시남구,동해면,동해면제3투,665,448,89,236,68,31,18,0,0,2,0,1,0,1,1,447,1,217
경상북도,포항시남구,동해면,동해면제4투,1933,1187,185,646,192,82,72,0,0,1,0,2,0,1,0,1181,6,746
경상북도,포항시남구,동해면,동해면제5투,1107,679,100,422,87,37,24,0,0,0,0,0,2,2,2,676,3,428
경상북도,포항시남구,장기면,합계,3919,2745,262,1919,322,118,55,4,4,4,1,1,4,14,6,2714,31,1174
경상북도,포항시남구,장기면,관내사전투표,725,725,82,503,78,29,15,0,2,1,1,0,1,3,1,716,9,0
경상북도,포항시남구,장기면,장기면제1투,1035,620,70,409,88,21,14,2,0,1,0,0,1,3,4,613,7,415
경상북도,포항시남구,장기면,장기면제2투,1235,790,54,571,96,44,13,2,0,1,0,0,0,4,0,785,5,445
경상북도,포항시남구,장기면,장기면제3투,924,610,56,436,60,24,13,0,2,1,0,1,2,4,1,600,10,314
경상북도,포항시남구,호미곶면,관내사전투표,526,526,54,365,53,25,13,2,0,0,0,0,2,2,1,517,9,0
경상북도,포항시남구,호미곶면,합계,1858,1311,116,945,143,54,23,3,0,1,0,1,2,4,2,1294,17,547
경상북도,포항시남구,호미곶면,호미곶면투표소,1332,785,62,580,90,29,10,1,0,1,0,1,0,2,1,777,8,547
경상북도,포항시남구,상대동,관내사전투표,3612,3611,885,1602,526,341,219,5,1,3,1,7,1,0,2,3593,18,1
경상북도,포항시남구,상대동,합계,22241,15512,2892,8074,2325,1325,745,23,4,8,6,18,1,7,13,15441,71,6729
경상북도,포항시남구,상대동,상대동제1투,2590,1640,276,872,245,140,88,3,0,1,1,3,0,0,2,1631,9,950
경상북도,포항시남구,상대동,상대동제2투,2570,1611,269,882,225,140,78,1,0,0,0,1,0,3,2,1601,10,959
경상북도,포항시남구,상대동,상대동제3투,2177,1420,254,759,237,90,69,3,1,0,0,3,0,0,0,1416,4,757
경상북도,포항시남구,상대동,상대동제4투,2206,1424,280,669,231,159,67,1,1,1,3,0,0,2,2,1416,8,782
경상북도,포항시남구,상대동,상대동제5투,2103,1208,204,637,180,128,52,1,0,0,1,1,0,0,1,1205,3,895
경상북도,포항시남구,상대동,상대동제6투,2148,1403,234,809,199,99,53,0,0,2,0,1,0,0,1,1398,5,745
경상북도,포항시남구,상대동,상대동제7투,1964,1332,209,790,180,100,42,2,1,1,0,1,0,0,3,1329,3,632
경상북도,포항시남구,상대동,상대동제8투,2871,1863,281,1054,302,128,77,7,0,0,0,1,0,2,0,1852,11,1008
경상북도,포항시남구,해도동,관내사전투표,2730,2730,565,1491,312,212,116,10,1,1,0,3,0,1,1,2713,17,0
경상북도,포항시남구,해도동,합계,16780,11545,1871,6820,1468,820,453,19,2,4,1,15,6,2,9,11490,55,5235
경상북도,포항시남구,해도동,해도동제1투,2377,1385,191,841,188,98,54,1,0,1,0,4,1,0,2,1381,4,992
경상북도,포항시남구,해도동,해도동제2투,1267,798,111,521,92,42,26,0,0,0,1,0,1,0,0,794,4,469
경상북도,포항시남구,해도동,해도동제3투,1948,1284,190,810,161,76,39,1,0,1,0,1,0,0,1,1280,4,664
경상북도,포항시남구,해도동,해도동제4투,1694,1148,138,744,155,76,29,2,0,0,0,0,1,0,1,1146,2,546
경상북도,포항시남구,해도동,해도동제5투,1092,632,84,408,73,44,19,2,0,0,0,0,0,0,0,630,2,460
경상북도,포항시남구,해도동,해도동제6투,2519,1599,244,939,200,114,82,0,1,1,0,3,3,0,1,1588,11,920
경상북도,포항시남구,해도동,해도동제7투,1538,972,188,504,143,80,45,3,0,0,0,2,0,1,0,966,6,566
경상북도,포항시남구,해도동,해도동제8투,1615,997,160,562,144,78,43,0,0,0,0,2,0,0,3,992,5,618
경상북도,포항시남구,송도동,합계,12107,8539,1138,5280,1119,609,324,13,3,3,2,5,2,6,5,8509,30,3568
경상북도,포항시남구,송도동,관내사전투표,2076,2076,341,1181,291,159,90,3,0,1,0,0,1,1,2,2070,6,0
경상북도,포항시남구,송도동,송도동제1투,1766,1047,148,676,121,65,31,1,0,0,0,0,0,0,0,1042,5,719
경상북도,포항시남구,송도동,송도동제2투,1738,1106,133,673,152,91,42,4,1,0,0,1,1,3,1,1102,4,632
경상북도,포항시남구,송도동,송도동제3투,2134,1420,175,912,179,99,48,2,0,0,1,0,0,1,1,1418,2,714
경상북도,포항시남구,송도동,송도동제4투,2697,1811,226,1148,225,129,69,1,1,1,0,3,0,1,0,1804,7,886
경상북도,포항시남구,송도동,송도동제5투,1696,1079,115,690,151,66,44,2,1,1,1,1,0,0,1,1073,6,617
경상북도,포항시남구,청림동,합계,4823,3475,641,1701,595,318,171,4,1,2,1,3,2,1,7,3447,28,1348
경상북도,포항시남구,청림동,관내사전투표,1141,1141,243,473,206,135,61,1,0,1,0,1,0,0,4,1125,16,0
경상북도,포항시남구,청림동,청림동제1투,961,581,131,255,101,64,25,0,0,0,0,0,0,0,0,576,5,380
경상북도,포항시남구,청림동,청림동제2투,1919,1210,221,630,197,91,58,1,0,1,0,2,2,1,0,1204,6,709
경상북도,포항시남구,청림동,청림동제3투,802,543,46,343,91,28,27,2,1,0,1,0,0,0,3,542,1,259
경상북도,포항시남구,제철동,관내사전투표,1091,1091,348,353,182,121,73,2,0,1,0,2,1,0,3,1086,5,0
경상북도,포항시남구,제철동,합계,2865,2309,644,816,400,278,149,3,0,1,1,4,1,0,4,2301,8,556
경상북도,포항시남구,제철동,제철동투표소,1774,1218,296,463,218,157,76,1,0,0,1,2,0,0,1,1215,3,556
경상북도,포항시남구,효곡동,관내사전투표,5064,5064,1935,1169,971,621,350,2,0,2,1,2,0,0,1,5054,10,0
경상북도,포항시남구,효곡동,합계,21465,17957,5729,5346,3598,2121,1065,20,0,6,5,3,1,5,14,17913,44,3508
경상북도,포항시남구,효곡동,효곡동제1투,2116,1569,369,688,287,127,84,2,0,1,3,0,0,1,2,1564,5,547
경상북도,포항시남구,효곡동,효곡동제2투,2032,1591,538,451,308,187,93,5,0,0,0,0,0,1,2,1585,6,441
경상북도,포항시남구,효곡동,효곡동제3투,2379,1893,587,583,410,203,97,3,0,1,0,1,1,0,2,1888,5,486
경상북도,포항시남구,효곡동,효곡동제4투,2566,2032,563,650,459,242,110,2,0,1,0,0,0,0,2,2029,3,534
경상북도,포항시남구,효곡동,효곡동제5투,2186,1751,565,517,375,215,69,0,0,0,0,0,0,1,1,1743,8,435
경상북도,포항시남구,효곡동,효곡동제6투,2020,1665,471,506,351,213,115,2,0,1,0,0,0,2,2,1663,2,355
경상북도,포항시남구,효곡동,효곡동제7투,3102,2392,701,782,437,313,147,4,0,0,1,0,0,0,2,2387,5,710
경상북도,포항시남구,대이동,관내사전투표,3855,3855,1310,1070,663,471,307,7,0,1,0,0,2,1,6,3838,17,0
경상북도,포항시남구,대이동,합계,14967,11820,3203,4221,2166,1382,750,26,0,6,1,2,2,2,15,11776,44,3147
경상북도,포항시남구,대이동,대이동제1투,1240,866,251,328,138,98,49,0,0,0,0,0,0,0,0,864,2,374
경상북도,포항시남구,대이동,대이동제2투,2002,1437,331,577,267,177,70,4,0,3,0,1,0,0,1,1431,6,565
경상북도,포항시남구,대이동,대이동제3투,1448,1099,246,488,191,105,52,5,0,0,0,1,0,1,4,1093,6,349
경상북도,포항시남구,대이동,대이동제4투,1145,688,101,362,109,68,41,2,0,0,0,0,0,0,2,685,3,457
경상북도,포항시남구,대이동,대이동제5투,2608,1943,463,750,390,222,106,3,0,1,0,0,0,0,1,1936,7,665
경상북도,포항시남구,대이동,대이동제6투,2669,1932,501,646,408,241,125,5,0,1,1,0,0,0,1,1929,3,737
경상북도,포항시남구,잘못 투입·구분된 투표지,,0,0,0,0,0,0,0,0,0,0,0,0,0,0,0,0,0,0
경상북도,울릉군,합계,,8968,6810,1443,3520,973,524,261,10,1,3,5,2,4,5,14,6765,45,2158
경상북도,울릉군,거소·선상투표,,37,37,13,10,5,3,2,0,0,0,0,0,0,0,1,34,3,0
경상북도,울릉군,관외사전투표,,1434,1434,436,492,226,168,96,1,0,0,2,1,1,1,1,1425,9,0
경상북도,울릉군,재외투표,,24,15,8,1,3,2,1,0,0,0,0,0,0,0,0,15,0,9
경상북도,울릉군,울릉읍,관내사전투표,979,979,232,473,138,89,35,0,0,0,0,0,0,0,3,970,9,0
경상북도,울릉군,울릉읍,합계,5237,3611,689,1981,514,260,115,7,1,3,1,0,1,2,8,3582,29,1626
경상북도,울릉군,울릉읍,울릉읍제1투,1739,1045,201,562,162,78,28,1,1,0,1,0,0,1,2,1037,8,694
경상북도,울릉군,울릉읍,울릉읍제2투,2068,1282,171,800,177,75,39,6,0,1,0,0,1,1,2,1273,9,786
경상북도,울릉군,울릉읍,울릉읍제3투,451,305,85,146,37,18,13,0,0,2,0,0,0,0,1,302,3,146
경상북도,울릉군,서면,합계,1138,878,145,548,116,35,25,2,0,0,0,0,1,1,3,876,2,260
경상북도,울릉군,서면,관내사전투표,247,247,49,134,38,8,13,1,0,0,0,0,1,1,2,247,0,0
경상북도,울릉군,서면,서면제1투,570,392,64,244,54,19,9,1,0,0,0,0,0,0,0,391,1,178
경상북도,울릉군,서면,서면제2투,321,239,32,170,24,8,3,0,0,0,0,0,0,0,1,238,1,82
경상북도,울릉군,북면,관내사전투표,267,267,59,133,40,27,6,0,0,0,1,0,0,0,0,266,1,0
경상북도,울릉군,북면,합계,1098,835,152,488,109,56,22,0,0,0,2,1,1,1,1,833,2,263
경상북도,울릉군,북면,북면제1투,508,332,57,200,42,19,12,0,0,0,1,0,0,0,0,331,1,176
경상북도,울릉군,북면,북면제2투,323,236,36,155,27,10,4,0,0,0,0,1,1,1,1,236,0,87
경상북도,울릉군,잘못 투입·구분된 투표지,,0,0,0,0,0,0,0,0,0,0,0,0,0,0,0,0,0,0
경상북도,경주시,합계,,218154,167296,38092,80090,23898,13779,9274,331,45,99,76,166,76,206,229,166361,935,50858
경상북도,경주시,거소·선상투표,,752,687,134,255,165,33,22,8,4,9,4,1,3,6,4,648,39,65
경상북도,경주시,관외사전투표,,16241,16241,5402,4160,2930,2044,1456,22,3,15,9,10,6,5,42,16104,137,0
경상북도,경주시,재외투표,,1194,824,417,87,171,43,87,6,0,0,3,0,0,3,1,818,6,370
경상북도,경주시,감포읍,합계,4868,3161,424,2113,326,167,78,3,1,1,0,9,1,12,4,3139,22,1707
경상북도,경주시,감포읍,관내사전투표,864,864,113,553,110,49,23,0,1,0,0,5,1,2,1,858,6,0
경상북도,경주시,감포읍,감포읍제1투,1781,931,149,613,77,53,29,1,0,1,0,0,0,0,1,924,7,850
경상북도,경주시,감포읍,감포읍제2투,735,464,58,310,48,33,9,0,0,0,0,0,0,3,0,461,3,271
경상북도,경주시,감포읍,감포읍제3투,1488,902,104,637,91,32,17,2,0,0,0,4,0,7,2,896,6,586
경상북도,경주시,안강읍,합계,21827,15895,2756,8774,2132,1284,744,32,6,10,8,8,8,27,10,15799,96,5932
경상북도,경주시,안강읍,관내사전투표,5080,5080,963,2788,615,379,263,9,2,2,2,2,2,14,3,5044,36,0
경상북도,경주시,안강읍,안강읍제1투,2276,1301,168,826,163,90,33,5,2,1,1,0,2,5,0,1296,5,975
경상북도,경주시,안강읍,안강읍제2투,1958,1320,151,861,154,99,32,6,0,1,2,0,2,1,0,1309,11,638
경상북도,경주시,안강읍,안강읍제3투,1114,706,93,458,93,31,17,0,0,1,0,0,0,1,1,695,11,408
경상북도,경주시,안강읍,안강읍제4투,2625,1624,260,924,228,115,81,4,0,1,0,0,0,0,2,1615,9,1001
경상북도,경주시,안강읍,안강읍제5투,2174,1448,214,797,232,130,62,1,0,0,0,2,1,2,0,1441,7,726
경상북도,경주시,안강읍,안강읍제6투,2778,1785,343,824,295,185,121,5,0,1,3,2,0,0,1,1780,5,993
경상북도,경주시,안강읍,안강읍제7투,2712,1877,435,830,274,207,112,2,1,1,0,2,1,3,2,1870,7,835
경상북도,경주시,안강읍,안강읍제8투,1110,754,129,466,78,48,23,0,1,2,0,0,0,1,1,749,5,356
경상북도,경주시,건천읍,합계,8646,6211,1047,3849,660,383,185,13,4,4,5,5,2,12,9,6178,33,2435
경상북도,경주시,건천읍,관내사전투표,1885,1885,430,1013,211,137,72,5,1,0,2,1,0,4,2,1878,7,0
경상북도,경주시,건천읍,건천읍제1투,2957,1878,286,1184,209,106,63,3,2,2,2,3,1,2,2,1865,13,1079
경상북도,경주시,건천읍,건천읍제2투,2042,1248,184,801,136,81,27,3,0,0,1,0,1,4,2,1240,8,794
경상북도,경주시,건천읍,건천읍제3투,1762,1200,147,851,104,59,23,2,1,2,0,1,0,2,3,1195,5,562
경상북도,경주시,외동읍,합계,13197,9390,1998,4862,1339,609,459,19,4,1,5,3,3,22,24,9348,42,3807
경상북도,경주시,외동읍,관내사전투표,2205,2205,530,1069,303,153,124,5,0,1,0,1,2,7,4,2199,6,0
경상북도,경주시,외동읍,외동읍제1투,1585,991,190,544,151,60,33,2,0,0,1,0,0,1,5,987,4,594
경상북도,경주시,외동읍,외동읍제2투,2519,1715,426,768,271,117,116,4,1,0,2,2,0,4,2,1713,2,804
경상북도,경주시,외동읍,외동읍제3투,1097,718,120,425,96,41,24,1,1,0,0,0,0,4,2,714,4,379
경상북도,경주시,외동읍,외동읍제4투,1431,949,167,542,131,71,30,2,1,0,0,0,0,1,0,945,4,482
경상북도,경주시,외동읍,외동읍제5투,1839,1221,222,710,146,63,53,2,1,0,1,0,1,4,7,1210,11,618
경상북도,경주시,외동읍,외동읍제6투,2521,1591,343,804,241,104,79,3,0,0,1,0,0,1,4,1580,11,930
경상북도,경주시,양북면,합계,3728,2721,552,1537,331,152,90,4,0,2,2,19,1,8,3,2701,20,1007
경상북도,경주시,양북면,관내사전투표,1144,1144,252,606,140,81,44,1,0,0,0,7,0,3,1,1135,9,0
경상북도,경주시,양북면,양북면투표소,2584,1577,300,931,191,71,46,3,0,2,2,12,1,5,2,1566,11,1007
경상북도,경주시,양남면,합계,5063,3735,994,1773,502,227,169,5,1,4,0,20,4,11,8,3718,17,1328
경상북도,경주시,양남면,관내사전투표,1111,1111,376,446,143,75,59,0,0,0,0,6,0,1,2,1108,3,0
경상북도,경주시,양남면,양남면제1투,2164,1403,252,798,199,71,59,1,0,2,0,4,2,7,2,1397,6,761
경상북도,경주시,양남면,양남면제2투,1788,1221,366,529,160,81,51,4,1,2,0,10,2,3,4,1213,8,567
경상북도,경주시,내남면,합계,4324,3116,533,1830,379,181,126,5,1,0,4,0,5,14,7,3085,31,1208
경상북도,경주시,내남면,관내사전투표,975,975,195,542,102,54,66,2,0,0,3,0,1,2,3,970,5,0
경상북도,경주시,내남면,내남면제1투,1813,1153,203,670,161,51,38,1,1,0,0,0,1,4,3,1133,20,660
경상북도,경주시,내남면,내남면제2투,1536,988,135,618,116,76,22,2,0,0,1,0,3,8,1,982,6,548
경상북도,경주시,산내면,합계,2805,1934,280,1251,223,95,35,3,0,2,1,2,4,13,5,1914,20,871
경상북도,경주시,산내면,관내사전투표,627,627,122,376,62,30,21,0,0,1,0,1,0,5,3,621,6,0
경상북도,경주시,산내면,산내면투표소,2178,1307,158,875,161,65,14,3,0,1,1,1,4,8,2,1293,14,871
경상북도,경주시,서면,합계,3057,2307,351,1500,249,102,61,8,1,1,2,0,2,10,3,2290,17,750
경상북도,경주시,서면,관내사전투표,724,724,144,439,74,22,28,2,0,0,0,0,0,5,1,715,9,0
경상북도,경주시,서면,서면투표소,2333,1583,207,1061,175,80,33,6,1,1,2,0,2,5,2,1575,8,750
경상북도,경주시,현곡면,합계,11302,9012,2300,3843,1369,838,560,25,1,1,2,6,8,7,10,8970,42,2290
경상북도,경주시,현곡면,관내사전투표,2855,2855,895,1000,413,296,216,7,1,1,2,4,4,1,2,2842,13,0
경상북도,경주시,현곡면,현곡면제1투,1946,1337,270,685,213,82,70,3,0,0,0,1,2,2,1,1329,8,609
경상북도,경주시,현곡면,현곡면제2투,2107,1652,468,549,276,210,132,6,0,0,0,0,0,1,2,1644,8,455
경상북도,경주시,현곡면,현곡면제3투,2583,1895,493,764,321,190,111,7,0,0,0,1,1,1,2,1891,4,688
경상북도,경주시,현곡면,현곡면제4투,1811,1273,174,845,146,60,31,2,0,0,0,0,1,2,3,1264,9,538
경상북도,경주시,강동면,합계,5436,3933,649,2222,574,259,150,6,2,5,6,3,6,3,5,3890,43,1503
경상북도,경주시,강동면,관내사전투표,1308,1308,245,718,176,72,48,3,1,1,4,0,3,2,2,1275,33,0
경상북도,경주시,강동면,강동면제1투,2082,1298,146,800,201,80,52,0,0,1,2,2,1,1,2,1288,10,784
경상북도,경주시,강동면,강동면제2투,2046,1327,258,704,197,107,50,3,1,3,0,1,2,0,1,1327,0,719
경상북도,경주시,천북면,합계,4270,3196,486,1951,377,212,125,4,2,2,0,2,1,3,9,3174,22,1074
경상북도,경주시,천북면,관내사전투표,1125,1125,200,629,121,88,68,1,1,0,0,0,0,2,3,1113,12,0
경상북도,경주시,천북면,천북면제1투,2191,1423,192,927,168,83,35,0,1,2,0,2,1,0,4,1415,8,768
경상북도,경주시,천북면,천북면제2투,954,648,94,395,88,41,22,3,0,0,0,0,0,1,2,646,2,306
경상북도,경주시,중부동,관내사전투표,1562,1562,318,852,159,130,80,2,0,1,1,4,1,1,2,1551,11,0
경상북도,경주시,중부동,합계,5649,4139,723,2401,493,306,173,7,1,2,1,5,1,2,6,4121,18,1510
경상북도,경주시,중부동,중부동제1투,2166,1289,222,765,161,86,47,3,1,0,0,1,0,0,2,1288,1,877
경상북도,경주시,중부동,중부동제2투,1921,1288,183,784,173,90,46,2,0,1,0,0,0,1,2,1282,6,633
경상북도,경주시,황오동,관내사전투표,2010,2010,411,1109,235,143,94,5,1,0,0,2,0,0,1,2001,9,0
경상북도,경주시,황오동,합계,6985,5242,871,3139,665,334,191,8,2,0,0,4,0,3,3,5220,22,1743
경상북도,경주시,황오동,황오동제1투,2708,1777,278,1089,232,109,58,0,1,0,0,1,0,3,1,1772,5,931
경상북도,경주시,황오동,황오동제2투,2267,1455,182,941,198,82,39,3,0,0,0,1,0,0,1,1447,8,812
경상북도,경주시,성건동,합계,14080,10366,2097,5525,1354,760,519,25,4,12,3,5,0,7,11,10322,44,3714
경상북도,경주시,성건동,관내사전투표,3385,3385,830,1617,397,298,203,9,1,2,1,2,0,3,3,3366,19,0
경상북도,경주시,성건동,성건동제1투,2502,1637,290,959,221,95,57,1,0,1,0,1,0,1,3,1629,8,865
경상북도,경주시,성건동,성건동제2투,2824,1892,314,1126,245,115,69,5,2,6,0,1,0,2,2,1887,5,932
경상북도,경주시,성건동,성건동제3투,2670,1719,303,955,241,119,82,7,1,1,1,0,0,0,2,1712,7,951
경상북도,경주시,성건동,성건동제4투,2699,1733,360,868,250,133,108,3,0,2,1,1,0,1,1,1728,5,966
경상북도,경주시,황남동,합계,5494,4060,599,2532,500,246,140,5,0,2,2,1,0,6,5,4038,22,1434
경상북도,경주시,황남동,관내사전투표,1366,1366,249,815,149,80,59,2,0,0,1,0,0,2,1,1358,8,0
경상북도,경주시,황남동,황남동제1투,1938,1225,148,791,171,70,34,0,0,2,0,0,0,1,3,1220,5,713
경상북도,경주시,황남동,황남동제2투,2190,1469,202,926,180,96,47,3,0,0,1,1,0,3,1,1460,9,721
경상북도,경주시,월성동,합계,5551,4216,866,2295,550,270,185,12,0,3,4,4,0,4,7,4200,16,1335
경상북도,경주시,월성동,관내사전투표,1218,1218,309,607,143,86,59,4,0,0,0,1,0,3,0,1212,6,0
경상북도,경주시,월성동,월성동제1투,1818,1196,161,749,164,60,43,6,0,0,3,0,0,1,2,1189,7,622
경상북도,경주시,월성동,월성동제2투,2515,1802,396,939,243,124,83,2,0,3,1,3,0,0,5,1799,3,713
경상북도,경주시,선도동,합계,11168,8573,2325,3606,1237,814,513,16,0,3,2,5,0,4,13,8538,35,2595
경상북도,경주시,선도동,관내사전투표,2752,2752,889,1048,342,260,180,8,0,1,1,1,0,1,7,2738,14,0
경상북도,경주시,선도동,선도동제1투,2678,1802,409,834,271,171,105,1,0,1,0,1,0,0,1,1794,8,876
경상북도,경주시,선도동,선도동제2투,3599,2572,648,1147,383,229,145,3,0,1,1,2,0,3,4,2566,6,1027
경상북도,경주시,선도동,선도동제3투,2139,1447,379,577,241,154,83,4,0,0,0,1,0,0,1,1440,7,692
경상북도,경주시,용강동,합계,12512,9641,2519,3825,1539,949,698,25,1,7,6,13,6,3,10,9601,40,2871
경상북도,경주시,용강동,관내사전투표,2468,2468,769,847,360,254,206,6,1,2,1,3,1,1,3,2454,14,0
경상북도,경주시,용강동,용강동제1투,2877,1980,469,849,307,187,148,5,0,1,0,6,0,0,2,1974,6,897
경상북도,경주시,용강동,용강동제2투,1455,992,301,337,163,103,82,0,0,0,1,0,0,2,0,989,3,463
경상북도,경주시,용강동,용강동제3투,2653,1877,362,896,329,160,99,7,0,3,3,3,2,0,4,1868,9,776
경상북도,경주시,용강동,용강동제4투,3059,2324,618,896,380,245,163,7,0,1,1,1,3,0,1,2316,8,735
경상북도,경주시,황성동,관내사전투표,5370,5370,1974,1569,801,517,470,13,0,1,1,3,0,0,4,5353,17,0
경상북도,경주시,황성동,합계,20879,16751,4943,5990,2745,1685,1256,36,4,3,2,18,7,2,7,16698,53,4128
경상북도,경주시,황성동,황성동제1투,2822,2021,547,780,349,195,134,8,1,0,1,0,2,0,0,2017,4,801
경상북도,경주시,황성동,황성동제2투,2439,1813,396,858,278,183,84,1,0,0,0,5,0,0,1,1806,7,626
경상북도,경주시,황성동,황성동제3투,2643,1998,628,646,346,204,151,9,1,1,0,4,1,1,1,1993,5,645
경상북도,경주시,황성동,황성동제4투,2543,1908,512,693,317,215,155,1,0,0,0,4,0,1,0,1898,10,635
경상북도,경주시,황성동,황성동제5투,2875,2122,571,747,403,245,142,3,1,1,0,0,1,0,1,2115,7,753
경상북도,경주시,황성동,황성동제6투,2187,1519,315,697,251,126,120,1,1,0,0,2,3,0,0,1516,3,668
경상북도,경주시,동천동,관내사전투표,4090,4090,1137,1760,528,363,260,8,0,2,2,4,1,2,2,4069,21,0
경상북도,경주시,동천동,합계,19546,14708,3401,6953,2038,1262,916,27,3,8,2,13,4,7,10,14644,64,4838
경상북도,경주시,동천동,동천동제1투,2315,1499,260,864,187,105,64,5,0,2,0,1,1,0,1,1490,9,816
경상북도,경주시,동천동,동천동제2투,2404,1781,400,824,276,168,101,4,0,0,0,1,0,2,1,1777,4,623
경상북도,경주시,동천동,동천동제3투,2876,1866,421,890,252,164,124,4,1,0,0,1,0,1,1,1859,7,1010
경상북도,경주시,동천동,동천동제4투,2471,1635,367,776,237,125,112,2,0,3,0,0,0,0,2,1624,11,836
경상북도,경주시,동천동,동천동제5투,2796,1950,402,938,292,173,127,1,2,1,0,4,1,2,1,1944,6,846
경상북도,경주시,동천동,동천동제6투,2594,1887,414,901,266,164,128,3,0,0,0,2,1,0,2,1881,6,707
경상북도,경주시,불국동,합계,7706,5726,1126,3012,862,404,262,6,0,2,2,6,3,9,9,5703,23,1980
경상북도,경주시,불국동,관내사전투표,2169,2169,493,1071,296,165,115,0,0,1,1,5,2,6,6,2161,8,0
경상북도,경주시,불국동,불국동제1투,2834,1752,336,902,308,108,81,4,0,1,1,1,0,1,1,1744,8,1082
경상북도,경주시,불국동,불국동제2투,2703,1805,297,1039,258,131,66,2,0,0,0,0,1,2,2,1798,7,898
경상북도,경주시,보덕동,합계,1874,1511,299,805,188,120,74,1,0,0,1,4,1,3,4,1500,11,363
경상북도,경주시,보덕동,관내사전투표,715,715,187,326,88,53,53,0,0,0,1,3,0,1,0,712,3,0
경상북도,경주시,보덕동,보덕동투표소,1159,796,112,479,100,67,21,1,0,0,0,1,1,2,4,788,8,363
경상북도,경주시,잘못 투입·구분된 투표지,,0,0,0,0,0,0,0,0,0,0,0,0,0,0,0,0,0,0
경상북도,김천시,합계,,119825,92184,22255,43998,12803,6336,5458,161,26,78,38,48,56,164,151,91572,612,27641
경상북도,김천시,거소·선상투표,,450,405,80,162,87,13,10,4,3,1,3,2,1,3,1,370,35,45
경상북도,김천시,관외사전투표,,9731,9729,3456,2438,1603,1194,875,16,2,5,4,7,4,10,26,9640,89,2
경상북도,김천시,재외투표,,773,454,207,65,108,20,50,3,0,0,1,0,0,0,0,454,0,319
경상북도,김천시,아포읍,합계,6209,4406,657,2692,553,251,185,19,1,0,5,1,3,8,5,4380,26,1803
경상북도,김천시,아포읍,관내사전투표,1409,1408,280,769,169,89,77,8,1,0,2,1,0,2,3,1401,7,1
경상북도,김천시,아포읍,아포읍제1투,1326,865,102,598,100,32,19,3,0,0,2,0,1,2,0,859,6,461
경상북도,김천시,아포읍,아포읍제2투,1124,751,70,520,100,31,20,2,0,0,0,0,1,2,1,747,4,373
경상북도,김천시,아포읍,아포읍제3투,2350,1382,205,805,184,99,69,6,0,0,1,0,1,2,1,1373,9,968
경상북도,김천시,농소면,관내사전투표,627,627,196,280,79,27,37,0,1,1,1,1,0,0,2,625,2,0
경상북도,김천시,농소면,합계,2745,2047,567,974,255,89,135,0,1,1,1,4,0,6,7,2040,7,698
경상북도,김천시,농소면,농소면제1투,899,591,130,329,72,18,36,0,0,0,0,2,0,3,0,590,1,308
경상북도,김천시,농소면,농소면제2투,1219,829,241,365,104,44,62,0,0,0,0,1,0,3,5,825,4,390
경상북도,김천시,남면,합계,2813,2007,356,1158,269,105,71,5,2,3,1,0,1,5,4,1980,27,806
경상북도,김천시,남면,관내사전투표,573,573,134,277,89,42,26,0,0,1,1,0,0,0,0,570,3,0
경상북도,김천시,남면,남면제1투,1200,739,112,449,96,33,19,3,2,2,0,0,0,4,3,723,16,461
경상북도,김천시,남면,남면제2투,1040,695,110,432,84,30,26,2,0,0,0,0,1,1,1,687,8,345
경상북도,김천시,개령면,합계,2281,1716,232,1098,221,86,49,4,2,1,0,1,1,6,1,1702,14,565
경상북도,김천시,개령면,관내사전투표,598,598,117,366,65,25,19,1,0,0,0,0,0,0,0,593,5,0
경상북도,김천시,개령면,개령면투표소,1683,1118,115,732,156,61,30,3,2,1,0,1,1,6,1,1109,9,565
경상북도,김천시,감문면,합계,3053,2309,229,1692,201,89,58,1,0,1,0,0,2,15,6,2294,15,744
경상북도,김천시,감문면,관내사전투표,798,798,88,579,68,33,20,1,0,1,0,0,1,2,5,798,0,0
경상북도,김천시,감문면,감문면제1투,1290,841,80,602,76,37,26,0,0,0,0,0,0,9,1,831,10,449
경상북도,김천시,감문면,감문면제2투,965,670,61,511,57,19,12,0,0,0,0,0,1,4,0,665,5,295
경상북도,김천시,어모면,합계,3842,2774,370,1728,365,130,122,4,1,8,2,2,5,13,1,2751,23,1068
경상북도,김천시,어모면,관내사전투표,999,999,185,532,138,50,71,4,1,4,1,1,1,2,0,990,9,0
경상북도,김천시,어모면,어모면제1투,1634,1045,125,691,121,55,33,0,0,2,0,0,2,7,1,1037,8,589
경상북도,김천시,어모면,어모면제2투,1209,730,60,505,106,25,18,0,0,2,1,1,2,4,0,724,6,479
경상북도,김천시,봉산면,합계,2943,2256,314,1412,308,114,73,5,0,3,0,0,1,3,6,2239,17,687
경상북도,김천시,봉산면,관내사전투표,579,579,115,301,83,41,27,3,0,1,0,0,0,0,0,571,8,0
경상북도,김천시,봉산면,봉산면제1투,1322,912,129,580,125,38,27,1,0,0,0,0,1,3,4,908,4,410
경상북도,김천시,봉산면,봉산면제2투,1042,765,70,531,100,35,19,1,0,2,0,0,0,0,2,760,5,277
경상북도,김천시,대항면,합계,3178,2343,361,1436,317,108,94,2,1,1,0,0,2,3,3,2328,15,835
경상북도,김천시,대항면,관내사전투표,575,575,132,294,75,32,36,0,1,0,0,0,0,1,0,571,4,0
경상북도,김천시,대항면,대항면제1투,1526,1012,125,658,136,44,33,1,0,1,0,0,2,2,2,1004,8,514
경상북도,김천시,대항면,대항면제2투,1077,756,104,484,106,32,25,1,0,0,0,0,0,0,1,753,3,321
경상북도,김천시,감천면,합계,1842,1432,181,923,188,61,55,0,0,2,0,0,1,4,6,1421,11,410
경상북도,김천시,감천면,관내사전투표,411,411,76,221,63,15,26,0,0,1,0,0,0,1,5,408,3,0
경상북도,김천시,감천면,감천면투표소,1431,1021,105,702,125,46,29,0,0,1,0,0,1,3,1,1013,8,410
경상북도,김천시,조마면,합계,1956,1453,198,911,200,56,54,3,1,0,1,0,5,10,1,1440,13,503
경상북도,김천시,조마면,관내사전투표,406,406,67,246,55,10,21,1,0,0,0,0,0,3,0,403,3,0
경상북도,김천시,조마면,조마면투표소,1550,1047,131,665,145,46,33,2,1,0,1,0,5,7,1,1037,10,503
경상북도,김천시,구성면,합계,2525,1752,241,1195,183,59,43,6,1,1,1,1,2,4,3,1740,12,773
경상북도,김천시,구성면,관내사전투표,384,384,66,248,29,13,14,5,0,0,0,0,1,2,1,379,5,0
경상북도,김천시,구성면,구성면제1투,1133,743,92,521,84,27,12,0,1,1,0,0,0,1,1,740,3,390
경상북도,김천시,구성면,구성면제2투,1008,625,83,426,70,19,17,1,0,0,1,1,1,1,1,621,4,383
경상북도,김천시,지례면,합계,1610,1267,211,784,145,68,27,1,0,0,0,0,1,11,5,1253,14,343
경상북도,김천시,지례면,관내사전투표,421,421,96,230,46,28,14,0,0,0,0,0,0,2,0,416,5,0
경상북도,김천시,지례면,지례면제1투,917,639,97,418,68,33,9,1,0,0,0,0,1,4,3,634,5,278
경상북도,김천시,지례면,지례면제2투,272,207,18,136,31,7,4,0,0,0,0,0,0,5,2,203,4,65
경상북도,김천시,부항면,합계,1108,807,114,501,122,28,21,0,1,1,0,1,2,4,9,804,3,301
경상북도,김천시,부항면,관내사전투표,303,303,44,187,43,10,11,0,0,1,0,0,0,1,5,302,1,0
경상북도,김천시,부항면,부항면투표소,805,504,70,314,79,18,10,0,1,0,0,1,2,3,4,502,2,301
경상북도,김천시,대덕면,합계,1896,1350,205,844,170,49,44,3,0,4,1,0,5,9,2,1336,14,546
경상북도,김천시,대덕면,관내사전투표,490,490,103,291,53,14,16,1,0,2,1,0,0,3,1,485,5,0
경상북도,김천시,대덕면,대덕면투표소,1406,860,102,553,117,35,28,2,0,2,0,0,5,6,1,851,9,546
경상북도,김천시,증산면,합계,994,763,110,484,89,21,32,9,0,3,0,1,1,4,3,757,6,231
경상북도,김천시,증산면,관내사전투표,251,251,50,141,25,9,16,2,0,1,0,1,0,1,2,248,3,0
경상북도,김천시,증산면,증산면투표소,743,512,60,343,64,12,16,7,0,2,0,0,1,3,1,509,3,231
경상북도,김천시,자산동,합계,6829,5059,857,3009,612,292,231,8,0,7,2,0,0,2,4,5024,35,1770
경상북도,김천시,자산동,관내사전투표,1456,1456,332,779,146,78,97,2,0,5,1,0,0,0,1,1441,15,0
경상북도,김천시,자산동,자산동제1투,1470,979,117,654,116,53,26,2,0,1,1,0,0,0,1,971,8,491
경상북도,김천시,자산동,자산동제2투,1927,1261,213,735,169,85,47,2,0,1,0,0,0,1,2,1255,6,666
경상북도,김천시,자산동,자산동제3투,1976,1363,195,841,181,76,61,2,0,0,0,0,0,1,0,1357,6,613
경상북도,김천시,평화남산동,관내사전투표,1568,1568,380,748,189,124,101,2,1,4,1,4,0,2,2,1558,10,0
경상북도,김천시,평화남산동,합계,7876,5698,1020,3346,674,326,246,11,4,8,1,8,3,8,6,5661,37,2178
경상북도,김천시,평화남산동,평화남산동제1투,1385,924,117,618,105,42,26,3,1,0,0,0,1,2,0,915,9,461
경상북도,김천시,평화남산동,평화남산동제2투,1792,1137,174,731,130,57,35,0,0,1,0,2,0,1,1,1132,5,655
경상북도,김천시,평화남산동,평화남산동제3투,1540,1018,195,588,122,44,52,1,1,3,0,2,2,2,1,1013,5,522
경상북도,김천시,평화남산동,평화남산동제4투,1591,1051,154,661,128,59,32,5,1,0,0,0,0,1,2,1043,8,540
경상북도,김천시,양금동,합계,3878,3041,475,1905,334,157,122,6,0,4,2,1,1,5,3,3015,26,837
경상북도,김천시,양금동,관내사전투표,902,902,186,494,105,51,53,3,0,1,1,0,0,0,0,894,8,0
경상북도,김천시,양금동,양금동제1투,1285,937,108,661,90,39,28,0,0,1,0,0,0,2,3,932,5,348
경상북도,김천시,양금동,양금동제2투,1691,1202,181,750,139,67,41,3,0,2,1,1,1,3,0,1189,13,489
경상북도,김천시,대신동,관내사전투표,3713,3713,1257,1159,550,357,345,8,3,2,1,1,3,4,8,3698,15,0
경상북도,김천시,대신동,합계,17448,13114,3438,5370,2070,1069,1034,20,3,8,6,5,6,13,16,13058,56,4334
경상북도,김천시,대신동,대신동제1투,2969,1857,437,847,286,139,134,4,0,1,1,2,1,0,1,1853,4,1112
경상북도,김천시,대신동,대신동제2투,1928,1416,378,550,236,117,126,1,0,0,0,1,0,0,0,1409,7,512
경상북도,김천시,대신동,대신동제3투,1940,1357,328,591,220,96,105,0,0,0,2,0,0,3,2,1347,10,583
경상북도,김천시,대신동,대신동제4투,2088,1597,376,694,260,124,130,1,0,1,2,1,0,1,1,1591,6,491
경상북도,김천시,대신동,대신동제5투,1624,1067,183,560,191,72,46,2,0,2,0,0,0,3,2,1061,6,557
경상북도,김천시,대신동,대신동제6투,3186,2107,479,969,327,164,148,4,0,2,0,0,2,2,2,2099,8,1079
경상북도,김천시,대곡동,합계,15214,11307,2468,5605,1614,878,629,16,2,5,3,5,4,4,15,11248,59,3907
경상북도,김천시,대곡동,관내사전투표,3693,3693,932,1644,510,325,249,3,1,2,2,3,2,0,3,3676,17,0
경상북도,김천시,대곡동,대곡동제1투,2208,1506,292,784,220,110,71,7,0,1,0,0,1,1,3,1490,16,702
경상북도,김천시,대곡동,대곡동제2투,1569,994,156,579,150,62,36,0,0,0,0,0,0,1,3,987,7,575
경상북도,김천시,대곡동,대곡동제3투,2425,1778,424,806,285,152,101,1,1,0,1,2,0,0,1,1774,4,647
경상북도,김천시,대곡동,대곡동제4투,1988,1254,200,723,172,83,68,0,0,0,0,0,0,0,2,1248,6,734
경상북도,김천시,대곡동,대곡동제5투,1489,934,230,434,141,62,52,3,0,1,0,0,1,1,2,927,7,555
경상북도,김천시,대곡동,대곡동제6투,1842,1148,234,635,136,84,52,2,0,1,0,0,0,1,1,1146,2,694
경상북도,김천시,지좌동,합계,7295,5234,1154,2647,705,314,341,5,0,9,3,3,3,10,7,5201,33,2061
경상북도,김천시,지좌동,관내사전투표,1872,1872,465,908,238,114,126,0,0,0,0,0,0,4,4,1859,13,0
경상북도,김천시,지좌동,지좌동제1투,3191,1902,423,917,280,123,135,2,0,4,0,3,0,3,2,1892,10,1289
경상북도,김천시,지좌동,지좌동제2투,2232,1460,266,822,187,77,80,3,0,5,3,0,3,3,1,1450,10,772
경상북도,김천시,율곡동,합계,11336,9461,4754,1619,1410,759,857,10,1,2,1,6,2,4,11,9436,25,1875
경상북도,김천시,율곡동,관내사전투표,4066,4066,2128,627,547,335,402,3,0,1,1,4,1,0,6,4055,11,0
경상북도,김천시,율곡동,율곡동제1투,2212,1584,751,307,253,126,139,4,0,0,0,0,0,0,1,1581,3,628
경상북도,김천시,율곡동,율곡동제2투,2509,1996,1058,317,307,149,156,0,0,1,0,2,0,1,1,1992,4,513
경상북도,김천시,율곡동,율곡동제3투,2549,1815,817,368,303,149,160,3,1,0,0,0,1,3,3,1808,7,734
경상북도,김천시,잘못 투입·구분된 투표지,,0,0,0,0,0,0,0,0,0,0,0,0,0,0,0,0,0,0
경상북도,안동시,합계,,139937,107357,23121,52978,15461,9186,5058,170,32,68,70,56,76,221,140,106637,720,32580
경상북도,안동시,거소·선상투표,,637,590,115,243,120,41,18,5,3,3,2,2,3,1,2,558,32,47
경상북도,안동시,관외사전투표,,9794,9794,3377,2462,1708,1307,788,13,2,4,3,6,0,7,29,9706,88,0
경상북도,안동시,재외투표,,630,404,231,37,54,13,62,2,0,0,0,0,0,1,0,400,4,226
경상북도,안동시,풍산읍,합계,6084,4421,692,2679,582,274,108,13,1,0,2,4,5,14,7,4381,40,1663
경상북도,안동시,풍산읍,관내사전투표,1358,1358,272,736,172,102,51,3,0,0,2,1,3,1,2,1345,13,0
경상북도,안동시,풍산읍,풍산읍제1투,1615,993,158,581,146,67,22,3,0,0,0,2,1,2,2,984,9,622
경상북도,안동시,풍산읍,풍산읍제2투,743,545,65,377,67,17,9,2,0,0,0,0,0,3,1,541,4,198
경상북도,안동시,풍산읍,풍산읍제3투,985,636,82,420,79,26,11,2,1,0,0,0,1,2,1,625,11,349
경상북도,안동시,풍산읍,풍산읍제4투,1383,889,115,565,118,62,15,3,0,0,0,1,0,6,1,886,3,494
경상북도,안동시,와룡면,관내사전투표,758,758,169,404,101,48,23,0,0,0,0,0,1,1,2,749,9,0
경상북도,안동시,와룡면,합계,3711,2693,396,1701,339,131,67,3,0,2,1,3,2,12,7,2664,29,1018
경상북도,안동시,와룡면,와룡면제1투,1889,1219,139,847,138,43,28,2,0,1,1,1,0,8,2,1210,9,670
경상북도,안동시,와룡면,와룡면제2투,1064,716,88,450,100,40,16,1,0,1,0,2,1,3,3,705,11,348
경상북도,안동시,북후면,합계,2939,2136,288,1242,272,156,41,3,3,4,4,6,6,19,6,2050,86,803
경상북도,안동시,북후면,관내사전투표,565,565,102,264,87,40,7,3,2,1,0,3,2,5,3,519,46,0
경상북도,안동시,북후면,북후면제1투,1457,992,118,640,121,69,17,0,0,2,0,1,2,10,2,982,10,465
경상북도,안동시,북후면,북후면제2투,917,579,68,338,64,47,17,0,1,1,4,2,2,4,1,549,30,338
경상북도,안동시,서후면,관내사전투표,476,476,100,254,65,28,23,0,1,0,0,0,1,2,0,474,2,0
경상북도,안동시,서후면,합계,3004,2086,318,1295,242,137,58,2,3,1,1,1,6,9,2,2075,11,918
경상북도,안동시,서후면,서후면제1투,1559,934,126,615,97,60,19,1,1,1,1,1,3,4,2,931,3,625
경상북도,안동시,서후면,서후면제2투,969,676,92,426,80,49,16,1,1,0,0,0,2,3,0,670,6,293
경상북도,안동시,풍천면,관내사전투표,764,764,157,409,95,56,36,1,0,0,0,1,0,1,1,757,7,0
경상북도,안동시,풍천면,합계,3732,2708,394,1713,332,152,70,6,0,0,1,1,3,12,6,2690,18,1024
경상북도,안동시,풍천면,풍천면제1투,1625,1040,150,642,147,67,18,2,0,0,1,0,1,3,1,1032,8,585
경상북도,안동시,풍천면,풍천면제2투,930,612,65,437,61,21,13,2,0,0,0,0,2,6,3,610,2,318
경상북도,안동시,풍천면,풍천면제3투,413,292,22,225,29,8,3,1,0,0,0,0,0,2,1,291,1,121
경상북도,안동시,일직면,합계,2674,2008,222,1366,252,84,43,1,1,1,3,0,3,16,2,1994,14,666
경상북도,안동시,일직면,관내사전투표,725,725,83,480,98,35,16,1,1,1,0,0,2,5,0,722,3,0
경상북도,안동시,일직면,일직면제1투,970,663,64,478,71,21,12,0,0,0,1,0,1,7,1,656,7,307
경상북도,안동시,일직면,일직면제2투,979,620,75,408,83,28,15,0,0,0,2,0,0,4,1,616,4,359
경상북도,안동시,남후면,합계,1826,1389,186,902,160,67,38,7,0,2,2,0,1,11,2,1378,11,437
경상북도,안동시,남후면,관내사전투표,465,465,99,253,60,26,17,2,0,0,1,0,0,1,0,459,6,0
경상북도,안동시,남후면,남후면투표소,1361,924,87,649,100,41,21,5,0,2,1,0,1,10,2,919,5,437
경상북도,안동시,남선면,관내사전투표,305,305,74,154,38,26,10,0,0,0,0,0,1,0,1,304,1,0
경상북도,안동시,남선면,합계,1891,1424,228,888,170,81,35,1,0,0,1,2,2,6,2,1416,8,467
경상북도,안동시,남선면,남선면제1투,888,612,78,394,78,40,13,1,0,0,0,1,0,2,1,608,4,276
경상북도,안동시,남선면,남선면제2투,698,507,76,340,54,15,12,0,0,0,1,1,1,4,0,504,3,191
경상북도,안동시,임하면,합계,2771,1992,308,1191,256,102,79,11,2,3,4,3,2,11,8,1980,12,779
경상북도,안동시,임하면,관내사전투표,804,804,181,371,128,51,33,8,2,3,3,3,2,5,5,795,9,0
경상북도,안동시,임하면,임하면제1투,1455,818,84,562,90,38,35,2,0,0,1,0,0,3,2,817,1,637
경상북도,안동시,임하면,임하면제2투,512,370,43,258,38,13,11,1,0,0,0,0,0,3,1,368,2,142
경상북도,안동시,길안면,합계,2706,2001,275,1298,228,108,42,5,2,0,2,0,5,7,6,1978,23,705
경상북도,안동시,길안면,관내사전투표,649,649,119,380,87,34,18,1,0,0,0,0,2,1,3,645,4,0
경상북도,안동시,길안면,길안면제1투,1293,821,105,529,100,47,13,2,2,0,2,0,1,4,3,808,13,472
경상북도,안동시,길안면,길안면제2투,429,288,27,204,23,19,10,0,0,0,0,0,1,0,0,284,4,141
경상북도,안동시,길안면,길안면제3투,335,243,24,185,18,8,1,2,0,0,0,0,1,2,0,241,2,92
경상북도,안동시,임동면,합계,1640,1175,141,791,140,60,25,0,1,1,1,0,4,5,0,1169,6,465
경상북도,안동시,임동면,관내사전투표,541,541,74,366,53,32,9,0,1,1,0,0,1,3,0,540,1,0
경상북도,안동시,임동면,임동면투표소,1099,634,67,425,87,28,16,0,0,0,1,0,3,2,0,629,5,465
경상북도,안동시,예안면,합계,1724,1269,219,748,168,84,27,1,0,1,0,1,2,5,4,1260,9,455
경상북도,안동시,예안면,관내사전투표,342,342,74,196,35,23,12,0,0,0,0,0,0,1,1,342,0,0
경상북도,안동시,예안면,예안면제1투,891,577,86,362,72,33,12,1,0,1,0,1,0,0,1,569,8,314
경상북도,안동시,예안면,예안면제2투,491,350,59,190,61,28,3,0,0,0,0,0,2,4,2,349,1,141
경상북도,안동시,도산면,합계,1574,1152,159,699,157,70,37,2,2,1,1,0,2,9,3,1142,10,422
경상북도,안동시,도산면,관내사전투표,323,323,51,176,46,26,18,1,1,0,0,0,0,2,1,322,1,0
경상북도,안동시,도산면,도산면투표소,1251,829,108,523,111,44,19,1,1,1,1,0,2,7,2,820,9,422
경상북도,안동시,녹전면,합계,1625,1205,145,778,180,53,20,8,0,2,0,1,3,4,2,1196,9,420
경상북도,안동시,녹전면,관내사전투표,192,192,43,101,29,10,6,3,0,0,0,0,0,0,0,192,0,0
경상북도,안동시,녹전면,녹전면제1투,930,653,67,437,96,27,8,2,0,2,0,1,2,2,2,646,7,277
경상북도,안동시,녹전면,녹전면제2투,503,360,35,240,55,16,6,3,0,0,0,0,1,2,0,358,2,143
경상북도,안동시,중구동,합계,4627,3456,595,1994,407,285,136,7,0,1,3,2,0,7,2,3439,17,1171
경상북도,안동시,중구동,관내사전투표,1387,1387,322,666,166,141,79,0,0,0,1,1,0,1,1,1378,9,0
경상북도,안동시,중구동,중구동제1투,1282,825,134,479,105,74,26,3,0,1,1,0,0,2,0,825,0,457
경상북도,안동시,중구동,중구동제2투,862,590,62,420,58,30,11,2,0,0,1,0,0,1,1,586,4,272
경상북도,안동시,중구동,중구동제3투,1096,654,77,429,78,40,20,2,0,0,0,1,0,3,0,650,4,442
경상북도,안동시,명륜동,합계,4724,3676,763,1849,548,312,176,3,1,3,1,1,1,4,2,3664,12,1048
경상북도,안동시,명륜동,관내사전투표,1293,1292,330,581,173,120,71,3,1,1,1,1,1,2,2,1287,5,1
경상북도,안동시,명륜동,명륜동제1투,2005,1424,282,720,225,119,69,0,0,2,0,0,0,2,0,1419,5,581
경상북도,안동시,명륜동,명륜동제2투,1426,960,151,548,150,73,36,0,0,0,0,0,0,0,0,958,2,466
경상북도,안동시,용상동,합계,16642,12491,2841,5846,1853,1126,685,15,2,10,8,3,7,12,11,12419,72,4151
경상북도,안동시,용상동,관내사전투표,3833,3832,1024,1626,521,379,236,9,1,2,1,1,0,5,4,3809,23,1
경상북도,안동시,용상동,용상동제1투,1969,1356,305,602,227,145,64,0,0,2,1,0,2,1,0,1349,7,613
경상북도,안동시,용상동,용상동제2투,1159,668,109,388,84,55,28,1,0,0,0,0,0,0,2,667,1,491
경상북도,안동시,용상동,용상동제3투,1854,1233,228,681,153,103,50,1,0,0,1,0,2,1,1,1221,12,621
경상북도,안동시,용상동,용상동제4투,1119,725,129,405,98,36,46,1,0,1,0,0,0,0,1,717,8,394
경상북도,안동시,용상동,용상동제5투,1431,878,143,489,130,63,42,1,0,2,0,1,0,2,1,874,4,553
경상북도,안동시,용상동,용상동제6투,2253,1711,442,656,335,170,99,0,0,0,2,1,1,1,1,1708,3,542
경상북도,안동시,용상동,용상동제7투,1934,1397,340,610,223,117,88,1,1,2,2,0,1,1,0,1386,11,537
경상북도,안동시,용상동,용상동제8투,1090,691,121,389,82,58,32,1,0,1,1,0,1,1,1,688,3,399
경상북도,안동시,서구동,합계,8064,6164,1245,3259,868,498,250,7,1,3,5,1,0,5,3,6145,19,1900
경상북도,안동시,서구동,관내사전투표,1711,1711,463,732,252,147,105,3,0,1,2,0,0,1,0,1706,5,0
경상북도,안동시,서구동,서구동제1투,2147,1525,369,678,248,165,57,2,1,0,1,0,0,0,1,1522,3,622
경상북도,안동시,서구동,서구동제2투,1885,1274,156,848,161,70,25,0,0,1,2,0,0,2,2,1267,7,611
경상북도,안동시,서구동,서구동제3투,1165,798,125,489,88,58,32,1,0,0,0,0,0,2,0,795,3,367
경상북도,안동시,서구동,서구동제4투,1156,856,132,512,119,58,31,1,0,1,0,1,0,0,0,855,1,300
경상북도,안동시,태화동,합계,10927,7905,1439,4425,1048,644,275,14,1,5,3,4,3,7,5,7873,32,3022
경상북도,안동시,태화동,관내사전투표,1994,1994,413,1086,240,171,68,2,0,2,1,1,0,1,3,1988,6,0
경상북도,안동시,태화동,태화동제1투,1342,885,121,578,100,53,21,4,0,0,0,1,0,1,0,879,6,457
경상북도,안동시,태화동,태화동제2투,1665,1089,175,623,157,86,37,5,0,0,0,1,0,1,1,1086,3,576
경상북도,안동시,태화동,태화동제3투,1822,1168,167,736,142,80,31,2,1,2,0,0,2,1,0,1164,4,654
경상북도,안동시,태화동,태화동제4투,1672,1117,191,601,164,100,46,1,0,0,1,0,0,2,1,1107,10,555
경상북도,안동시,태화동,태화동제5투,2432,1652,372,801,245,154,72,0,0,1,1,1,1,1,0,1649,3,780
경상북도,안동시,평화동,합계,5482,4128,778,2228,580,337,156,9,0,5,2,2,2,3,5,4107,21,1354
경상북도,안동시,평화동,관내사전투표,1182,1182,257,593,181,88,51,2,0,1,0,1,0,0,2,1176,6,0
경상북도,안동시,평화동,평화동제1투,1419,950,155,521,145,78,37,4,0,1,2,0,1,1,2,947,3,469
경상북도,안동시,평화동,평화동제2투,1117,747,138,415,103,61,26,0,0,0,0,0,0,0,0,743,4,370
경상북도,안동시,평화동,평화동제3투,1764,1249,228,699,151,110,42,3,0,3,0,1,1,2,1,1241,8,515
경상북도,안동시,안기동,관내사전투표,1347,1347,362,604,152,119,95,1,0,1,3,1,0,1,2,1341,6,0
경상북도,안동시,안기동,합계,5569,4322,883,2250,576,343,223,3,2,4,5,2,2,7,3,4303,19,1247
경상북도,안동시,안기동,안기동제1투,998,721,147,369,109,55,38,0,0,1,0,1,0,0,0,720,1,277
경상북도,안동시,안기동,안기동제2투,1375,906,138,557,96,77,26,0,0,0,1,0,1,3,1,900,6,469
경상북도,안동시,안기동,안기동제3투,1849,1348,236,720,219,92,64,2,2,2,1,0,1,3,0,1342,6,501
경상북도,안동시,옥동,합계,17010,12907,3284,5310,2010,1343,830,10,3,9,8,3,6,19,10,12845,62,4103
경상북도,안동시,옥동,관내사전투표,3679,3679,1166,1182,551,444,304,6,0,2,5,0,0,1,3,3664,15,0
경상북도,안동시,옥동,옥동제1투,2885,1907,421,848,303,201,119,0,1,0,0,1,0,3,1,1898,9,978
경상북도,안동시,옥동,옥동제2투,2376,1760,560,570,288,210,118,2,0,2,0,0,0,3,1,1754,6,616
경상북도,안동시,옥동,옥동제3투,1953,1486,307,741,206,129,89,0,1,1,0,1,1,0,1,1477,9,467
경상북도,안동시,옥동,옥동제4투,1447,877,136,532,122,38,22,1,1,2,0,0,2,10,1,867,10,570
경상북도,안동시,옥동,옥동제5투,1750,1214,267,539,213,121,61,0,0,0,2,0,1,1,1,1206,8,536
경상북도,안동시,옥동,옥동제6투,1609,1109,228,468,203,123,77,0,0,2,0,1,2,0,1,1105,4,500
경상북도,안동시,옥동,옥동제7투,1311,875,199,430,124,77,40,1,0,0,1,0,0,1,1,874,1,436
경상북도,안동시,송하동,관내사전투표,2677,2677,857,946,380,269,194,0,0,0,3,4,1,1,1,2656,21,0
경상북도,안동시,송하동,합계,11052,8458,2092,3660,1330,838,461,11,1,2,3,6,5,4,6,8419,39,2594
경상북도,안동시,송하동,송하동제1투,1839,1266,268,616,200,111,57,2,0,2,0,1,2,1,2,1262,4,573
경상북도,안동시,송하동,송하동제2투,1499,979,228,452,147,104,43,2,0,0,0,1,0,0,0,977,2,520
경상북도,안동시,송하동,송하동제3투,1488,981,179,501,156,90,46,3,0,0,0,0,0,0,1,976,5,507
경상북도,안동시,송하동,송하동제4투,1626,1197,280,528,205,125,49,4,0,0,0,0,2,2,0,1195,2,429
경상북도,안동시,송하동,송하동제5투,1923,1358,280,617,242,139,72,0,1,0,0,0,0,0,2,1353,5,565
경상북도,안동시,강남동,합계,6878,5402,1507,2123,881,540,308,8,1,1,4,2,1,4,5,5385,17,1476
경상북도,안동시,강남동,관내사전투표,1830,1830,641,572,269,206,124,2,0,0,3,1,0,1,2,1821,9,0
경상북도,안동시,강남동,강남동제1투,998,639,80,401,98,39,14,1,0,1,0,0,1,0,1,636,3,359
경상북도,안동시,강남동,강남동제2투,2299,1632,399,698,280,161,91,0,0,0,1,0,0,1,1,1632,0,667
경상북도,안동시,강남동,강남동제3투,1751,1301,387,452,234,134,79,5,1,0,0,1,0,2,1,1296,5,450
경상북도,안동시,잘못 투입·구분된 투표지,,0,1,0,1,0,0,0,0,0,0,0,0,0,0,0,1,0,-1
경상북도,구미시,합계,,328174,246638,62573,98732,41141,25468,16027,419,57,119,73,105,72,166,350,245302,1336,81536
경상북도,구미시,거소·선상투표,,668,643,160,171,180,59,28,5,2,3,2,0,1,1,5,617,26,25
경상북도,구미시,관외사전투표,,24211,24209,8051,5580,4669,3284,2173,43,8,6,6,17,14,14,72,23937,272,2
경상북도,구미시,재외투표,,1209,834,422,71,175,67,87,4,0,0,0,0,0,1,2,829,5,375
경상북도,구미시,선산읍,합계,12603,9261,1290,5775,1140,597,355,17,2,4,7,3,4,13,14,9221,40,3342
경상북도,구미시,선산읍,관내사전투표,3124,3124,540,1787,356,243,160,7,1,0,1,1,1,3,6,3106,18,0
경상북도,구미시,선산읍,선산읍제1투,1844,1142,116,790,139,50,36,3,1,1,0,0,0,1,1,1138,4,702
경상북도,구미시,선산읍,선산읍제2투,1518,963,142,575,135,62,35,3,0,2,2,0,0,0,1,957,6,555
경상북도,구미시,선산읍,선산읍제3투,2160,1435,118,1013,176,80,35,1,0,1,0,0,2,5,2,1433,2,725
경상북도,구미시,선산읍,선산읍제4투,718,518,39,378,54,29,12,1,0,0,1,1,1,2,0,518,0,200
경상북도,구미시,선산읍,선산읍제5투,3239,2079,335,1232,280,133,77,2,0,0,3,1,0,2,4,2069,10,1160
경상북도,구미시,고아읍,관내사전투표,1889,1889,446,859,290,172,103,6,1,0,1,0,0,1,0,1879,10,0
경상북도,구미시,고아읍,합계,21493,15945,2957,8202,2453,1418,750,30,5,5,5,1,6,20,14,15866,79,5548
경상북도,구미시,고아읍,고아읍제1투,1838,1211,140,801,138,75,33,5,0,0,1,0,1,5,2,1201,10,627
경상북도,구미시,고아읍,고아읍제2투,2235,1454,198,884,208,94,54,3,0,1,0,0,2,1,1,1446,8,781
경상북도,구미시,고아읍,고아읍제3투,3536,2608,541,1191,454,276,123,3,1,1,0,0,0,1,4,2595,13,928
경상북도,구미시,고아읍,고아읍제4투,3182,2353,477,1089,404,223,144,3,0,1,1,1,0,3,1,2347,6,829
경상북도,구미시,고아읍,고아읍제5투,2741,1926,299,1131,234,150,87,6,3,1,0,0,0,4,4,1919,7,815
경상북도,구미시,고아읍,고아읍제6투,2453,1725,217,1062,251,106,66,4,0,0,0,0,1,3,1,1711,14,728
경상북도,구미시,고아읍,고아읍제7투,3619,2779,639,1185,474,322,140,0,0,1,2,0,2,2,1,2768,11,840
경상북도,구미시,무을면,합계,1814,1356,150,942,140,60,33,5,1,1,1,0,3,5,0,1341,15,458
경상북도,구미시,무을면,관내사전투표,488,488,68,310,55,29,13,2,0,1,0,0,1,1,0,480,8,0
경상북도,구미시,무을면,무을면투표소,1326,868,82,632,85,31,20,3,1,0,1,0,2,4,0,861,7,458
경상북도,구미시,옥성면,관내사전투표,355,355,59,213,44,15,11,1,0,0,0,1,1,3,3,351,4,0
경상북도,구미시,옥성면,합계,1622,1225,136,847,124,53,29,3,0,3,0,1,2,7,8,1213,12,397
경상북도,구미시,옥성면,옥성면투표소,1267,870,77,634,80,38,18,2,0,3,0,0,1,4,5,862,8,397
경상북도,구미시,도개면,합계,2064,1546,169,1102,155,59,27,3,2,0,1,3,2,1,2,1526,20,518
경상북도,구미시,도개면,관내사전투표,603,603,84,400,55,33,14,1,2,0,1,1,1,0,1,593,10,0
경상북도,구미시,도개면,도개면투표소,1461,943,85,702,100,26,13,2,0,0,0,2,1,1,1,933,10,518
경상북도,구미시,해평면,관내사전투표,747,747,98,503,74,42,21,2,0,0,1,0,0,3,0,744,3,0
경상북도,구미시,해평면,합계,3952,2836,278,2061,259,126,63,10,2,3,2,2,4,9,0,2819,17,1116
경상북도,구미시,해평면,해평면제1투,1605,1019,86,762,92,39,18,5,2,0,0,1,3,2,0,1010,9,586
경상북도,구미시,해평면,해평면제2투,1600,1070,94,796,93,45,24,3,0,3,1,1,1,4,0,1065,5,530
경상북도,구미시,산동면,관내사전투표,1251,1251,342,514,181,130,74,2,0,0,0,0,1,2,1,1247,4,0
경상북도,구미시,산동면,합계,4759,3454,904,1434,543,354,184,4,1,0,2,3,1,5,4,3439,15,1305
경상북도,구미시,산동면,산동면투표소,3508,2203,562,920,362,224,110,2,1,0,2,3,0,3,3,2192,11,1305
경상북도,구미시,장천면,관내사전투표,829,829,125,519,96,55,27,0,1,0,0,0,1,1,0,825,4,0
경상북도,구미시,장천면,합계,2912,2205,270,1452,260,125,67,6,1,0,2,0,1,4,4,2192,13,707
경상북도,구미시,장천면,장천면투표소,2083,1376,145,933,164,70,40,6,0,0,2,0,0,3,4,1367,9,707
경상북도,구미시,송정동,합계,14501,10962,2403,5080,1697,1030,628,29,4,5,3,4,0,7,14,10904,58,3539
경상북도,구미시,송정동,관내사전투표,3620,3620,1021,1382,537,386,248,14,2,0,0,1,0,1,4,3596,24,0
경상북도,구미시,송정동,송정동제1투,2124,1291,274,587,194,135,87,3,0,0,0,2,0,1,2,1285,6,833
경상북도,구미시,송정동,송정동제2투,2235,1484,227,830,238,110,64,2,1,2,1,0,0,0,2,1477,7,751
경상북도,구미시,송정동,송정동제3투,3138,2329,471,1103,381,226,125,5,1,0,1,0,0,2,4,2319,10,809
경상북도,구미시,송정동,송정동제4투,3384,2238,410,1178,347,173,104,5,0,3,1,1,0,3,2,2227,11,1146
경상북도,구미시,원평1동,관내사전투표,1402,1402,314,676,200,115,77,2,0,0,0,0,1,1,3,1389,13,0
경상북도,구미시,원평1동,합계,4954,3081,583,1665,431,232,128,8,0,0,2,1,1,3,7,3061,20,1873
경상북도,구미시,원평1동,원평1동제1투,2771,1224,221,689,175,89,36,3,0,0,1,0,0,2,4,1220,4,1547
경상북도,구미시,원평1동,원평1동제2투,781,455,48,300,56,28,15,3,0,0,1,1,0,0,0,452,3,326
경상북도,구미시,원평2동,합계,4919,3762,675,1975,479,335,248,9,1,6,2,0,0,4,3,3737,25,1157
경상북도,구미시,원평2동,관내사전투표,1859,1859,431,681,289,238,191,3,0,4,0,0,0,2,3,1842,17,0
경상북도,구미시,원평2동,원평2동제1투,1854,1138,153,794,101,44,33,5,0,0,2,0,0,0,0,1132,6,716
경상북도,구미시,원평2동,원평2동제2투,1206,765,91,500,89,53,24,1,1,2,0,0,0,2,0,763,2,441
경상북도,구미시,지산동,합계,2760,2206,357,1313,268,150,98,1,0,4,0,1,1,2,1,2196,10,554
경상북도,구미시,지산동,관내사전투표,955,955,224,479,126,69,49,1,0,1,0,0,1,1,0,951,4,0
경상북도,구미시,지산동,지산동투표소,1805,1251,133,834,142,81,49,0,0,3,0,1,0,1,1,1245,6,554
경상북도,구미시,도량동,관내사전투표,4080,4080,1074,1568,658,438,294,7,1,3,0,0,0,1,9,4053,27,0
경상북도,구미시,도량동,합계,22193,16833,3791,7448,2867,1588,969,30,3,8,2,8,3,15,25,16757,76,5360
경상북도,구미시,도량동,도량동제1투,1782,1228,181,748,167,77,45,2,0,1,1,0,0,1,0,1223,5,554
경상북도,구미시,도량동,도량동제2투,1576,1061,186,555,179,77,55,1,0,0,1,1,0,2,1,1058,3,515
경상북도,구미시,도량동,도량동제3투,1663,1189,218,630,190,83,50,5,0,1,0,1,1,2,1,1182,7,474
경상북도,구미시,도량동,도량동제4투,3047,2067,408,992,354,183,105,5,0,0,0,1,0,0,8,2056,11,980
경상북도,구미시,도량동,도량동제5투,2955,1942,430,852,353,168,117,2,2,2,0,1,1,6,1,1935,7,1013
경상북도,구미시,도량동,도량동제6투,3342,2394,509,1058,429,259,121,5,0,0,0,0,1,1,4,2387,7,948
경상북도,구미시,도량동,도량동제7투,3748,2872,785,1045,537,303,182,3,0,1,0,4,0,2,1,2863,9,876
경상북도,구미시,선주원남동,합계,33233,25416,6658,9980,4429,2680,1476,29,3,14,8,3,5,7,20,25312,104,7817
경상북도,구미시,선주원남동,관내사전투표,6079,6079,2013,1891,990,721,416,9,0,1,1,0,2,3,4,6051,28,0
경상북도,구미시,선주원남동,선주원남동제1투,2843,2177,656,665,449,252,138,2,1,2,0,1,1,0,6,2173,4,666
경상북도,구미시,선주원남동,선주원남동제2투,2627,1850,426,779,338,190,107,0,0,2,1,0,0,0,2,1845,5,777
경상북도,구미시,선주원남동,선주원남동제3투,3318,1750,332,865,273,169,97,2,0,0,0,0,0,2,0,1740,10,1568
경상북도,구미시,선주원남동,선주원남동제4투,3306,2502,611,1016,473,263,119,1,0,1,1,0,0,0,2,2487,15,804
경상북도,구미시,선주원남동,선주원남동제5투,3565,2539,454,1362,359,214,126,5,0,1,2,0,0,0,1,2524,15,1026
경상북도,구미시,선주원남동,선주원남동제6투,2368,1729,265,995,251,139,63,0,1,3,0,0,1,1,0,1719,10,639
경상북도,구미시,선주원남동,선주원남동제7투,3482,2861,752,1084,546,315,154,2,0,2,2,0,0,1,1,2859,2,621
경상북도,구미시,선주원남동,선주원남동제8투,2405,1823,482,640,359,214,110,4,0,0,0,2,1,0,3,1815,8,582
경상북도,구미시,선주원남동,선주원남동제9투,3240,2106,667,683,391,203,146,4,1,2,1,0,0,0,1,2099,7,1134
경상북도,구미시,형곡1동,관내사전투표,3850,3850,1068,1406,614,461,273,3,0,0,0,0,0,2,1,3828,22,0
경상북도,구미시,형곡1동,합계,11879,9582,2237,4127,1621,957,578,9,0,6,1,2,0,4,5,9547,35,2297
경상북도,구미시,형곡1동,형곡1동제1투,1781,1290,272,573,233,142,63,0,0,1,0,0,0,2,1,1287,3,491
경상북도,구미시,형곡1동,형곡1동제2투,2526,1784,340,878,319,136,102,1,0,2,0,0,0,0,1,1779,5,742
경상북도,구미시,형곡1동,형곡1동제3투,2102,1536,322,718,274,120,91,3,0,3,0,1,0,0,0,1532,4,566
경상북도,구미시,형곡1동,형곡1동제4투,1620,1122,235,552,181,98,49,2,0,0,1,1,0,0,2,1121,1,498
경상북도,구미시,형곡2동,관내사전투표,3167,3167,784,1274,527,312,235,13,0,1,1,1,3,0,3,3154,13,0
경상북도,구미시,형곡2동,합계,14567,11009,2249,5099,1818,1061,681,26,0,6,3,4,5,4,12,10968,41,3558
경상북도,구미시,형곡2동,형곡2동제1투,2345,1619,281,824,239,167,95,2,0,0,1,0,0,1,1,1611,8,726
경상북도,구미시,형곡2동,형곡2동제2투,2448,1748,354,819,310,154,99,3,0,1,0,1,1,0,1,1743,5,700
경상북도,구미시,형곡2동,형곡2동제3투,1957,1359,268,620,248,134,80,2,0,0,0,0,1,1,2,1356,3,598
경상북도,구미시,형곡2동,형곡2동제4투,2309,1525,298,758,236,145,75,2,0,2,0,1,0,0,1,1518,7,784
경상북도,구미시,형곡2동,형곡2동제5투,2341,1591,264,804,258,149,97,4,0,2,1,1,0,2,4,1586,5,750
경상북도,구미시,신평1동,관내사전투표,948,948,256,366,151,87,78,0,0,0,1,0,0,1,3,943,5,0
경상북도,구미시,신평1동,합계,3414,2566,549,1197,408,237,148,1,0,2,2,2,0,3,5,2554,12,848
경상북도,구미시,신평1동,신평1동제1투,1085,790,142,411,112,82,32,0,0,0,1,1,0,1,2,784,6,295
경상북도,구미시,신평1동,신평1동제2투,1381,828,151,420,145,68,38,1,0,2,0,1,0,1,0,827,1,553
경상북도,구미시,신평2동,관내사전투표,555,555,114,288,76,47,26,0,0,0,0,0,0,1,2,554,1,0
경상북도,구미시,신평2동,합계,2027,1444,252,788,194,112,73,2,0,3,0,1,1,2,6,1434,10,583
경상북도,구미시,신평2동,신평2동투표소,1472,889,138,500,118,65,47,2,0,3,0,1,1,1,4,880,9,583
경상북도,구미시,비산동,합계,3702,2744,638,1161,462,290,163,4,0,4,2,2,0,3,5,2734,10,958
경상북도,구미시,비산동,관내사전투표,989,989,272,390,154,103,59,1,0,0,1,0,0,3,3,986,3,0
경상북도,구미시,비산동,비산동투표소,2713,1755,366,771,308,187,104,3,0,4,1,2,0,0,2,1748,7,958
경상북도,구미시,공단1동,합계,3824,2965,698,1160,539,325,212,5,1,1,1,1,0,1,5,2949,16,859
경상북도,구미시,공단1동,관내사전투표,1324,1324,357,491,223,146,96,0,0,0,1,0,0,1,2,1317,7,0
경상북도,구미시,공단1동,공단1동투표소,2500,1641,341,669,316,179,116,5,1,1,0,1,0,0,3,1632,9,859
경상북도,구미시,공단2동,관내사전투표,1502,1502,504,474,241,165,108,1,1,1,0,1,0,0,1,1497,5,0
경상북도,구미시,공단2동,합계,4333,3327,1024,1015,595,423,240,4,1,1,0,4,0,0,4,3311,16,1006
경상북도,구미시,공단2동,공단2동투표소,2831,1825,520,541,354,258,132,3,0,0,0,3,0,0,3,1814,11,1006
경상북도,구미시,광평동,합계,4097,3084,746,1369,507,289,147,7,0,2,1,1,1,0,2,3072,12,1013
경상북도,구미시,광평동,관내사전투표,1269,1269,355,504,209,125,62,3,0,1,0,1,1,0,0,1261,8,0
경상북도,구미시,광평동,광평동투표소,2828,1815,391,865,298,164,85,4,0,1,1,0,0,0,2,1811,4,1013
경상북도,구미시,상모사곡동,합계,21956,15734,3817,6160,2761,1737,1107,35,5,9,1,11,4,3,23,15673,61,6222
경상북도,구미시,상모사곡동,관내사전투표,3179,3179,933,1055,506,385,273,7,1,2,0,2,0,0,3,3167,12,0
경상북도,구미시,상모사곡동,상모사곡동제1투,4099,2380,539,1020,391,250,149,9,0,2,0,4,0,1,2,2367,13,1719
경상북도,구미시,상모사곡동,상모사곡동제2투,1631,1082,240,479,184,98,67,2,1,3,0,0,0,0,1,1075,7,549
경상북도,구미시,상모사곡동,상모사곡동제3투,4740,2847,655,1174,502,291,192,10,0,2,0,2,2,1,6,2837,10,1893
경상북도,구미시,상모사곡동,상모사곡동제4투,3332,2420,591,930,451,270,158,4,2,0,0,2,0,0,6,2414,6,912
경상북도,구미시,상모사곡동,상모사곡동제5투,2622,1896,441,729,346,226,143,1,1,0,1,1,1,0,2,1892,4,726
경상북도,구미시,상모사곡동,상모사곡동제6투,2353,1930,418,773,381,217,125,2,0,0,0,0,1,1,3,1921,9,423
경상북도,구미시,임오동,합계,14093,10300,2729,3678,1855,1219,721,19,3,3,4,3,2,8,7,10251,49,3793
경상북도,구미시,임오동,관내사전투표,2512,2512,825,715,453,314,183,3,2,0,1,0,1,2,2,2501,11,0
경상북도,구미시,임오동,임오동제1투,2206,1237,254,583,192,121,71,3,0,0,0,1,0,1,2,1228,9,969
경상북도,구미시,임오동,임오동제2투,2839,1923,406,799,354,214,134,2,0,1,0,0,0,4,1,1915,8,916
경상북도,구미시,임오동,임오동제3투,2653,1846,420,742,313,216,135,4,1,1,2,0,0,0,2,1836,10,807
경상북도,구미시,임오동,임오동제4투,1272,798,194,321,139,90,45,1,0,0,1,1,1,1,0,794,4,474
경상북도,구미시,임오동,임오동제5투,2611,1984,630,518,404,264,153,6,0,1,0,1,0,0,0,1977,7,627
경상북도,구미시,인동동,합계,37502,25047,7150,8741,4323,2724,1880,41,4,9,3,9,8,13,36,24941,106,12455
경상북도,구미시,인동동,관내사전투표,4978,4978,1722,1373,865,551,420,11,1,2,1,0,0,2,11,4959,19,0
경상북도,구미시,인동동,인동동제1투,2978,1780,327,869,267,176,120,6,0,1,0,0,0,1,1,1768,12,1198
경상북도,구미시,인동동,인동동제2투,2774,1859,577,614,303,213,141,0,0,0,2,0,1,0,1,1852,7,915
경상북도,구미시,인동동,인동동제3투,3657,2035,572,789,294,204,153,3,1,0,0,0,1,3,5,2025,10,1622
경상북도,구미시,인동동,인동동제4투,2241,1364,285,613,236,130,84,1,0,2,0,0,1,1,2,1355,9,877
경상북도,구미시,인동동,인동동제5투,2604,1603,356,704,222,165,130,5,0,0,0,1,2,1,5,1591,12,1001
경상북도,구미시,인동동,인동동제6투,2782,1839,413,806,356,152,97,1,1,1,0,1,1,3,3,1835,4,943
경상북도,구미시,인동동,인동동제7투,3576,1898,533,643,333,235,137,4,1,2,0,1,0,0,3,1892,6,1678
경상북도,구미시,인동동,인동동제8투,1780,939,213,355,194,102,68,3,0,0,0,0,1,0,0,936,3,841
경상북도,구미시,인동동,인동동제9투,2979,2241,712,628,402,299,187,2,0,1,0,0,1,1,1,2234,7,738
경상북도,구미시,인동동,인동동제10투,4375,2847,928,823,534,307,232,4,0,0,0,5,0,1,2,2836,11,1528
경상북도,구미시,인동동,인동동제11투,2778,1664,512,524,317,190,111,1,0,0,0,1,0,0,2,1658,6,1114
경상북도,구미시,진미동,합계,16420,9996,3305,2697,1641,1264,968,8,2,3,5,5,1,4,22,9925,71,6424
경상북도,구미시,진미동,관내사전투표,3971,3971,1486,858,609,510,447,2,2,3,2,2,1,3,10,3935,36,0
경상북도,구미시,진미동,진미동제1투,1441,977,328,193,130,175,130,1,0,0,0,1,0,1,4,963,14,464
경상북도,구미시,진미동,진미동제2투,3227,1430,379,533,232,162,115,1,0,0,0,0,0,0,1,1423,7,1797
경상북도,구미시,진미동,진미동제3투,3808,1616,494,516,283,185,128,0,0,0,0,2,0,0,4,1612,4,2192
경상북도,구미시,진미동,진미동제4투,3973,2002,618,597,387,232,148,4,0,0,3,0,0,0,3,1992,10,1971
경상북도,구미시,양포동,합계,30493,23066,7925,6442,4148,2613,1766,22,6,8,5,13,2,3,23,22976,90,7427
경상북도,구미시,양포동,관내사전투표,5050,5051,2035,1079,844,599,452,3,1,3,1,2,1,0,6,5026,25,-1
경상북도,구미시,양포동,양포동제1투,2794,1632,509,500,318,183,111,2,0,1,0,2,0,0,1,1627,5,1162
경상북도,구미시,양포동,양포동제2투,3681,2826,1097,688,559,319,151,1,1,1,0,2,0,0,1,2820,6,855
경상북도,구미시,양포동,양포동제3투,1619,1163,304,450,196,113,87,2,0,1,1,0,0,0,2,1156,7,456
경상북도,구미시,양포동,양포동제4투,2935,1992,589,664,359,195,169,2,0,1,1,1,1,0,4,1986,6,943
경상북도,구미시,양포동,양포동제5투,3206,2288,596,770,431,273,198,1,1,0,1,1,0,1,3,2276,12,918
경상북도,구미시,양포동,양포동제6투,2534,1701,460,630,282,189,122,2,1,0,0,2,0,2,1,1691,10,833
경상북도,구미시,양포동,양포동제7투,2663,1884,488,667,323,233,155,5,1,1,0,1,0,0,3,1877,7,779
경상북도,구미시,양포동,양포동제8투,1935,1259,398,413,221,131,88,3,0,0,0,0,0,0,1,1255,4,676
경상북도,구미시,양포동,양포동제9투,4076,3270,1449,581,615,378,233,1,1,0,1,2,0,0,1,3262,8,806
경상북도,구미시,잘못 투입·구분된 투표지,,0,0,0,0,0,0,0,0,0,0,0,0,0,0,0,0,0,0
경상북도,영주시,합계,,92117,70861,15280,34504,10444,6451,3182,95,18,41,32,49,52,143,99,70390,471,21256
경상북도,영주시,거소·선상투표,,339,319,64,128,75,25,8,0,3,2,2,1,1,1,4,314,5,20
경상북도,영주시,관외사전투표,,6186,6183,2221,1405,1062,814,564,14,0,4,2,6,2,3,19,6116,67,3
경상북도,영주시,재외투표,,305,231,132,17,34,11,34,1,0,0,0,1,0,0,0,230,1,74
경상북도,영주시,풍기읍,관내사전투표,1805,1805,401,942,232,125,80,3,2,1,0,0,1,1,3,1791,14,0
경상북도,영주시,풍기읍,합계,9387,6761,1148,3925,975,430,201,4,2,2,4,5,4,13,7,6720,41,2626
경상북도,영주시,풍기읍,풍기읍제1투,1728,1158,181,713,157,71,32,0,0,0,0,0,0,2,0,1156,2,570
경상북도,영주시,풍기읍,풍기읍제2투,1690,1068,157,659,159,61,24,0,0,0,2,0,0,2,0,1064,4,622
경상북도,영주시,풍기읍,풍기읍제3투,1612,1052,156,624,172,60,30,0,0,0,1,0,0,3,1,1047,5,560
경상북도,영주시,풍기읍,풍기읍제4투,1521,948,152,521,184,56,24,1,0,1,0,1,1,0,1,942,6,573
경상북도,영주시,풍기읍,풍기읍제5투,1031,730,101,466,71,57,11,0,0,0,1,4,2,5,2,720,10,301
경상북도,영주시,이산면,관내사전투표,343,343,64,154,54,53,12,1,0,0,0,2,0,0,0,340,3,0
경상북도,영주시,이산면,합계,2173,1538,218,805,202,229,48,3,0,0,0,2,2,8,6,1523,15,635
경상북도,영주시,이산면,이산면제1투,994,645,89,373,84,60,24,2,0,0,0,0,0,4,2,638,7,349
경상북도,영주시,이산면,이산면제2투,836,550,65,278,64,116,12,0,0,0,0,0,2,4,4,545,5,286
경상북도,영주시,평은면,합계,1285,957,126,632,88,69,20,6,0,0,1,0,2,5,3,952,5,328
경상북도,영주시,평은면,관내사전투표,266,266,60,148,28,16,7,3,0,0,0,0,1,1,1,265,1,0
경상북도,영주시,평은면,평은면투표소,1019,691,66,484,60,53,13,3,0,0,1,0,1,4,2,687,4,328
경상북도,영주시,문수면,합계,1818,1388,240,797,147,101,45,0,0,0,0,1,6,10,3,1350,38,430
경상북도,영주시,문수면,관내사전투표,440,440,91,221,45,33,16,0,0,0,0,1,4,3,2,416,24,0
경상북도,영주시,문수면,문수면투표소,1378,948,149,576,102,68,29,0,0,0,0,0,2,7,1,934,14,430
경상북도,영주시,장수면,합계,2087,1577,213,986,201,91,47,2,0,2,0,1,6,8,4,1561,16,510
경상북도,영주시,장수면,관내사전투표,555,555,79,345,61,34,22,1,0,1,0,0,2,2,2,549,6,0
경상북도,영주시,장수면,장수면제1투,1103,705,103,427,95,42,19,1,0,0,0,1,2,5,2,697,8,398
경상북도,영주시,장수면,장수면제2투,429,317,31,214,45,15,6,0,0,1,0,0,2,1,0,315,2,112
경상북도,영주시,안정면,합계,2814,2105,283,1226,356,153,53,1,2,2,0,1,0,11,2,2090,15,709
경상북도,영주시,안정면,관내사전투표,528,528,113,263,94,34,19,1,0,0,0,0,0,0,2,526,2,0
경상북도,영주시,안정면,안정면제1투,1588,1076,122,644,189,78,25,0,2,2,0,1,0,5,0,1068,8,512
경상북도,영주시,안정면,안정면제2투,698,501,48,319,73,41,9,0,0,0,0,0,0,6,0,496,5,197
경상북도,영주시,봉현면,합계,2515,1880,247,1202,265,98,42,2,1,1,1,2,2,5,2,1870,10,635
경상북도,영주시,봉현면,관내사전투표,381,381,81,199,55,21,17,0,1,0,0,2,1,2,0,379,2,0
경상북도,영주시,봉현면,봉현면제1투,1399,960,106,638,142,47,15,0,0,1,1,0,1,1,2,954,6,439
경상북도,영주시,봉현면,봉현면제2투,735,539,60,365,68,30,10,2,0,0,0,0,0,2,0,537,2,196
경상북도,영주시,순흥면,합계,1965,1573,228,979,218,88,36,1,1,1,0,0,1,3,4,1560,13,392
경상북도,영주시,순흥면,관내사전투표,467,467,87,254,66,37,19,1,0,1,0,0,1,0,0,466,1,0
경상북도,영주시,순흥면,순흥면투표소,1498,1106,141,725,152,51,17,0,1,0,0,0,0,3,4,1094,12,392
경상북도,영주시,단산면,합계,1800,1369,189,855,190,71,34,2,0,1,4,2,2,8,5,1363,6,431
경상북도,영주시,단산면,관내사전투표,314,314,48,190,43,14,15,0,0,1,0,0,0,1,0,312,2,0
경상북도,영주시,단산면,단산면제1투,830,579,77,345,98,33,10,0,0,0,3,1,0,6,3,576,3,251
경상북도,영주시,단산면,단산면제2투,656,476,64,320,49,24,9,2,0,0,1,1,2,1,2,475,1,180
경상북도,영주시,부석면,합계,2863,2157,308,1271,329,144,55,0,0,5,4,3,3,13,5,2140,17,706
경상북도,영주시,부석면,관내사전투표,582,582,93,321,88,48,20,0,0,3,2,0,1,2,0,578,4,0
경상북도,영주시,부석면,부석면제1투,1704,1169,146,723,163,79,30,0,0,2,1,2,1,7,5,1159,10,535
경상북도,영주시,부석면,부석면제2투,577,406,69,227,78,17,5,0,0,0,1,1,1,4,0,403,3,171
경상북도,영주시,상망동,합계,6137,4610,948,2215,720,432,222,11,2,1,1,4,5,8,6,4575,35,1527
경상북도,영주시,상망동,관내사전투표,1250,1250,337,516,174,130,80,3,1,0,0,0,0,1,0,1242,8,0
경상북도,영주시,상망동,상망동제1투,1012,644,84,403,85,46,18,1,0,0,0,0,1,0,1,639,5,368
경상북도,영주시,상망동,상망동제2투,2330,1666,348,761,285,164,87,5,0,1,0,2,1,2,1,1657,9,664
경상북도,영주시,상망동,상망동제3투,1545,1050,179,535,176,92,37,2,1,0,1,2,3,5,4,1037,13,495
경상북도,영주시,하망동,합계,5150,4002,779,2123,522,378,142,12,1,2,3,2,5,6,1,3976,26,1148
경상북도,영주시,하망동,관내사전투표,1107,1107,283,511,138,112,47,2,0,0,0,0,1,3,0,1097,10,0
경상북도,영주시,하망동,하망동제1투,1590,1082,169,614,154,91,38,3,0,1,2,0,0,2,1,1075,7,508
경상북도,영주시,하망동,하망동제2투,949,724,175,303,124,83,32,0,0,0,0,0,2,1,0,720,4,225
경상북도,영주시,하망동,하망동제3투,1504,1089,152,695,106,92,25,7,1,1,1,2,2,0,0,1084,5,415
경상북도,영주시,영주1동,합계,4082,3066,497,1781,425,232,84,5,0,2,1,1,5,7,2,3042,24,1016
경상북도,영주시,영주1동,관내사전투표,1128,1128,246,598,133,92,45,1,0,1,0,0,1,2,1,1120,8,0
경상북도,영주시,영주1동,영주1동제1투,1466,993,126,616,138,85,17,1,0,0,0,1,0,3,0,987,6,473
경상북도,영주시,영주1동,영주1동제2투,1488,945,125,567,154,55,22,3,0,1,1,0,4,2,1,935,10,543
경상북도,영주시,영주2동,관내사전투표,1491,1491,386,706,198,125,64,3,1,0,1,0,0,0,0,1484,7,0
경상북도,영주시,영주2동,합계,3915,3154,670,1632,448,252,121,6,1,1,2,1,0,4,1,3139,15,761
경상북도,영주시,영주2동,영주2동제1투,1334,908,175,475,137,79,35,1,0,1,1,0,0,0,0,904,4,426
경상북도,영주시,영주2동,영주2동제2투,1090,755,109,451,113,48,22,2,0,0,0,1,0,4,1,751,4,335
경상북도,영주시,휴천1동,관내사전투표,1111,1111,323,435,157,124,61,2,1,1,0,1,1,2,0,1108,3,0
경상북도,영주시,휴천1동,합계,4735,3628,856,1675,525,353,181,6,2,2,0,5,1,4,3,3613,15,1107
경상북도,영주시,휴천1동,휴천1동제1투,1594,1073,173,596,154,100,35,2,1,1,0,2,0,2,1,1067,6,521
경상북도,영주시,휴천1동,휴천1동제2투,2030,1444,360,644,214,129,85,2,0,0,0,2,0,0,2,1438,6,586
경상북도,영주시,휴천2동,합계,7593,5902,1372,2777,814,608,281,2,0,4,3,3,0,7,5,5876,26,1691
경상북도,영주시,휴천2동,관내사전투표,1889,1889,625,651,251,223,121,0,0,2,2,2,0,0,1,1878,11,0
경상북도,영주시,휴천2동,휴천2동제1투,1174,775,129,445,111,58,25,0,0,0,1,0,0,1,2,772,3,399
경상북도,영주시,휴천2동,휴천2동제2투,1426,936,166,515,109,101,36,0,0,1,0,0,0,2,1,931,5,490
경상북도,영주시,휴천2동,휴천2동제3투,1002,696,98,433,88,52,18,2,0,0,0,0,0,3,0,694,2,306
경상북도,영주시,휴천2동,휴천2동제4투,1278,1019,246,444,166,108,50,0,0,1,0,1,0,0,1,1017,2,259
경상북도,영주시,휴천2동,휴천2동제5투,824,587,108,289,89,66,31,0,0,0,0,0,0,1,0,584,3,237
경상북도,영주시,휴천3동,합계,6484,4983,1170,2384,649,521,216,6,3,2,1,4,2,6,2,4966,17,1501
경상북도,영주시,휴천3동,관내사전투표,1325,1325,393,554,174,131,59,2,2,0,0,1,1,1,2,1320,5,0
경상북도,영주시,휴천3동,휴천3동제1투,1689,1182,210,659,151,111,38,0,1,1,0,2,1,3,0,1177,5,507
경상북도,영주시,휴천3동,휴천3동제2투,1770,1234,252,633,162,134,45,1,0,0,0,0,0,2,0,1229,5,536
경상북도,영주시,휴천3동,휴천3동제3투,1700,1242,315,538,162,145,74,3,0,1,1,1,0,0,0,1240,2,458
경상북도,영주시,가흥1동,합계,12623,9265,2469,3728,1520,919,547,8,0,2,1,3,3,10,14,9224,41,3358
경상북도,영주시,가흥1동,관내사전투표,2364,2364,919,639,384,245,154,0,0,0,0,1,1,2,6,2351,13,0
경상북도,영주시,가흥1동,가흥1동제1투,1332,923,127,558,128,65,36,3,0,0,0,0,0,0,0,917,6,409
경상북도,영주시,가흥1동,가흥1동제2투,1462,1004,133,638,130,66,31,2,0,1,0,0,0,2,0,1003,1,458
경상북도,영주시,가흥1동,가흥1동제3투,2787,1721,396,736,299,176,99,1,0,0,0,1,1,2,1,1712,9,1066
경상북도,영주시,가흥1동,가흥1동제4투,2500,1614,381,680,245,175,112,1,0,1,1,1,0,3,7,1607,7,886
경상북도,영주시,가흥1동,가흥1동제5투,2178,1639,513,477,334,192,115,1,0,0,0,0,1,1,0,1634,5,539
경상북도,영주시,가흥2동,합계,5861,4213,902,1961,679,432,201,3,0,5,2,1,0,3,1,4190,23,1648
경상북도,영주시,가흥2동,관내사전투표,1179,1179,320,491,146,151,63,1,0,1,1,0,0,1,0,1175,4,0
경상북도,영주시,가흥2동,가흥2동제1투,2496,1590,289,798,272,141,73,1,0,3,0,0,0,1,0,1578,12,906
경상북도,영주시,가흥2동,가흥2동제2투,2186,1444,293,672,261,140,65,1,0,1,1,1,0,1,1,1437,7,742
경상북도,영주시,잘못 투입·구분된 투표지,,0,0,0,0,0,0,0,0,0,0,0,0,0,0,0,0,0,0
경상북도,영천시,합계,,87459,66091,12250,35328,9175,5553,2606,151,27,56,42,59,86,147,108,65588,503,21368
경상북도,영천시,거소·선상투표,,412,389,105,106,89,20,13,6,3,7,4,3,1,0,3,360,29,23
경상북도,영천시,관외사전투표,,7099,7096,2082,2280,1125,985,522,18,0,2,3,2,4,0,13,7036,60,3
경상북도,영천시,재외투표,,460,234,104,10,79,11,24,1,1,0,0,0,0,0,0,230,4,226
경상북도,영천시,금호읍,합계,9361,6548,952,3958,871,478,192,10,4,6,2,3,9,14,8,6507,41,2813
경상북도,영천시,금호읍,관내사전투표,1163,1163,251,585,159,103,50,3,0,1,0,1,0,0,2,1155,8,0
경상북도,영천시,금호읍,금호읍제1투,1678,1081,129,685,134,92,32,0,0,0,0,0,0,2,0,1074,7,597
경상북도,영천시,금호읍,금호읍제2투,2219,1470,211,846,226,116,56,1,0,1,1,2,2,2,1,1465,5,749
경상북도,영천시,금호읍,금호읍제3투,941,676,79,431,88,48,14,2,1,0,0,0,2,2,1,668,8,265
경상북도,영천시,금호읍,금호읍제4투,1295,907,111,611,94,51,21,2,2,0,0,0,2,3,3,900,7,388
경상북도,영천시,금호읍,금호읍제5투,698,501,54,338,56,29,9,1,0,3,1,0,2,4,0,497,4,197
경상북도,영천시,금호읍,금호읍제6투,1367,750,117,462,114,39,10,1,1,1,0,0,1,1,1,748,2,617
경상북도,영천시,청통면,합계,3450,2575,347,1627,298,182,70,7,1,2,1,2,6,8,5,2556,19,875
경상북도,영천시,청통면,관내사전투표,728,728,136,409,90,53,23,2,0,2,0,1,2,1,2,721,7,0
경상북도,영천시,청통면,청통면제1투,1715,1100,130,706,140,75,30,1,0,0,1,1,3,1,2,1090,10,615
경상북도,영천시,청통면,청통면제2투,1007,747,81,512,68,54,17,4,1,0,0,0,1,6,1,745,2,260
경상북도,영천시,신녕면,합계,3392,2477,279,1654,315,139,48,3,0,1,2,1,5,13,4,2464,13,915
경상북도,영천시,신녕면,관내사전투표,743,743,93,459,105,55,18,1,0,0,1,0,1,5,1,739,4,0
경상북도,영천시,신녕면,신녕면제1투,1376,874,106,590,114,40,16,1,0,1,0,1,0,1,1,871,3,502
경상북도,영천시,신녕면,신녕면제2투,1273,860,80,605,96,44,14,1,0,0,1,0,4,7,2,854,6,413
경상북도,영천시,화산면,합계,2766,2046,290,1256,252,115,42,6,4,3,6,12,7,10,10,2013,33,720
경상북도,영천시,화산면,관내사전투표,683,683,123,355,86,36,24,4,3,3,6,5,6,4,5,660,23,0
경상북도,영천시,화산면,화산면제1투,1347,867,105,561,112,54,10,1,1,0,0,7,1,3,5,860,7,480
경상북도,영천시,화산면,화산면제2투,736,496,62,340,54,25,8,1,0,0,0,0,0,3,0,493,3,240
경상북도,영천시,화북면,합계,1777,1320,176,850,162,67,23,2,1,2,1,2,5,6,2,1299,21,457
경상북도,영천시,화북면,관내사전투표,463,463,60,307,56,19,10,0,1,1,1,0,2,2,0,459,4,0
경상북도,영천시,화북면,화북면투표소,1314,857,116,543,106,48,13,2,0,1,0,2,3,4,2,840,17,457
경상북도,영천시,화남면,관내사전투표,521,521,91,309,63,37,15,0,0,1,0,0,2,1,1,520,1,0
경상북도,영천시,화남면,합계,2747,2052,259,1359,235,119,42,4,1,3,0,1,6,7,5,2041,11,695
경상북도,영천시,화남면,화남면제1투,1423,939,99,645,109,52,12,3,1,1,0,1,3,4,2,932,7,484
경상북도,영천시,화남면,화남면제2투,803,592,69,405,63,30,15,1,0,1,0,0,1,2,2,589,3,211
경상북도,영천시,자양면,합계,893,656,74,452,66,30,18,2,1,0,0,0,4,6,1,654,2,237
경상북도,영천시,자양면,관내사전투표,177,177,29,105,22,12,5,0,0,0,0,0,2,0,0,175,2,0
경상북도,영천시,자양면,자양면투표소,716,479,45,347,44,18,13,2,1,0,0,0,2,6,1,479,0,237
경상북도,영천시,임고면,관내사전투표,561,561,118,284,70,52,29,0,0,2,0,0,1,1,2,559,2,0
경상북도,영천시,임고면,합계,3653,2726,412,1704,334,149,68,5,0,5,1,1,6,11,7,2703,23,927
경상북도,영천시,임고면,임고면제1투,1093,762,107,476,111,37,17,1,0,2,0,0,2,0,3,756,6,331
경상북도,영천시,임고면,임고면제2투,1104,778,108,520,81,37,15,3,0,0,1,1,0,3,0,769,9,326
경상북도,영천시,임고면,임고면제3투,895,625,79,424,72,23,7,1,0,1,0,0,3,7,2,619,6,270
경상북도,영천시,고경면,관내사전투표,721,721,170,329,108,72,36,0,0,2,0,0,0,0,1,718,3,0
경상북도,영천시,고경면,합계,4577,3390,515,2072,433,219,93,7,1,2,2,4,6,9,7,3370,20,1187
경상북도,영천시,고경면,고경면제1투,1145,796,93,531,102,35,20,1,0,0,0,1,2,3,1,789,7,349
경상북도,영천시,고경면,고경면제2투,1628,1120,171,686,138,82,24,2,0,0,0,1,1,4,4,1113,7,508
경상북도,영천시,고경면,고경면제3투,1083,753,81,526,85,30,13,4,1,0,2,2,3,2,1,750,3,330
경상북도,영천시,북안면,합계,3755,2719,456,1669,305,144,67,5,2,3,0,2,5,10,8,2676,43,1036
경상북도,영천시,북안면,관내사전투표,939,939,190,544,107,47,30,1,0,2,0,1,3,4,1,930,9,0
경상북도,영천시,북안면,북안면제1투,1511,944,152,594,92,45,16,3,2,1,0,1,1,3,5,915,29,567
경상북도,영천시,북안면,북안면제2투,1305,836,114,531,106,52,21,1,0,0,0,0,1,3,2,831,5,469
경상북도,영천시,대창면,관내사전투표,509,509,74,314,66,33,15,1,1,0,0,1,0,0,1,506,3,0
경상북도,영천시,대창면,합계,2601,1870,242,1217,226,108,40,5,1,1,3,2,4,5,3,1857,13,731
경상북도,영천시,대창면,대창면투표소,2092,1361,168,903,160,75,25,4,0,1,3,1,4,5,2,1351,10,731
경상북도,영천시,동부동,관내사전투표,2535,2535,781,853,386,308,167,7,0,0,2,2,1,3,2,2512,23,0
경상북도,영천시,동부동,합계,20636,14945,3151,6917,2382,1531,766,34,2,8,8,15,10,23,14,14861,84,5691
경상북도,영천시,동부동,동부동제1투,2439,1653,279,899,245,146,58,10,1,2,0,4,0,1,0,1645,8,786
경상북도,영천시,동부동,동부동제2투,3503,2285,453,1075,389,238,95,7,0,2,2,3,5,3,3,2275,10,1218
경상북도,영천시,동부동,동부동제3투,2517,1706,270,923,243,165,89,5,0,1,2,1,1,2,0,1702,4,811
경상북도,영천시,동부동,동부동제4투,2034,1387,202,830,191,90,46,2,1,2,2,1,3,3,1,1374,13,647
경상북도,영천시,동부동,동부동제5투,2774,2015,390,936,353,223,93,0,0,0,0,1,0,4,4,2004,11,759
경상북도,영천시,동부동,동부동제6투,2557,1716,334,810,272,176,102,3,0,1,0,0,0,5,2,1705,11,841
경상북도,영천시,동부동,동부동제7투,2277,1648,442,591,303,185,116,0,0,0,0,3,0,2,2,1644,4,629
경상북도,영천시,중앙동,합계,7902,6133,1303,2922,881,628,312,13,3,9,3,6,2,9,10,6101,32,1769
경상북도,영천시,중앙동,관내사전투표,2684,2684,752,997,403,323,159,7,3,3,1,5,2,4,6,2665,19,0
경상북도,영천시,중앙동,중앙동제1투,2649,1671,301,868,245,157,80,3,0,5,0,1,0,3,3,1666,5,978
경상북도,영천시,중앙동,중앙동제2투,1631,1139,197,602,168,116,51,1,0,0,1,0,0,0,0,1136,3,492
경상북도,영천시,중앙동,중앙동제3투,938,639,53,455,65,32,22,2,0,1,1,0,0,2,1,634,5,299
경상북도,영천시,서부동,합계,4321,3227,537,1922,383,227,116,11,1,0,2,1,2,4,5,3211,16,1094
경상북도,영천시,서부동,관내사전투표,954,954,223,478,117,75,46,6,0,0,0,1,1,2,1,950,4,0
경상북도,영천시,서부동,서부동제1투,1808,1251,163,794,147,93,42,2,1,0,0,0,1,1,2,1246,5,557
경상북도,영천시,서부동,서부동제2투,1559,1022,151,650,119,59,28,3,0,0,2,0,0,1,2,1015,7,537
경상북도,영천시,완산동,합계,4016,3060,496,1831,413,212,73,6,1,1,2,0,2,4,2,3043,17,956
경상북도,영천시,완산동,관내사전투표,999,999,203,520,142,91,35,1,1,0,0,0,0,0,1,994,5,0
경상북도,영천시,완산동,완산동제1투,1741,1208,181,768,144,74,27,2,0,0,0,0,1,2,1,1200,8,533
경상북도,영천시,완산동,완산동제2투,1276,853,112,543,127,47,11,3,0,1,2,0,1,2,0,849,4,423
경상북도,영천시,남부동,합계,3641,2628,470,1522,326,189,77,6,0,1,2,2,2,8,1,2606,22,1013
경상북도,영천시,남부동,관내사전투표,809,809,174,413,129,55,26,0,0,0,1,0,0,4,1,803,6,0
경상북도,영천시,남부동,남부동제1투,870,548,77,367,55,24,13,2,0,0,0,1,0,2,0,541,7,322
경상북도,영천시,남부동,남부동제2투,1962,1271,219,742,142,110,38,4,0,1,1,1,2,2,0,1262,9,691
경상북도,영천시,잘못 투입·구분된 투표지,,0,0,0,0,0,0,0,0,0,0,0,0,0,0,0,0,0,0
경상북도,상주시,합계,,87859,67717,12356,38171,9392,4021,2589,133,15,50,33,84,63,246,122,67275,442,20142
경상북도,상주시,거소·선상투표,,633,546,115,206,100,30,11,7,3,3,3,4,6,2,7,497,49,87
경상북도,상주시,관외사전투표,,6501,6501,2113,1985,1061,732,520,8,2,2,4,11,2,3,11,6454,47,0
경상북도,상주시,재외투표,,477,275,121,39,69,11,29,4,0,0,0,0,0,0,1,274,1,202
경상북도,상주시,함창읍,합계,5694,4302,613,2743,597,175,113,4,0,3,0,4,5,17,7,4281,21,1392
경상북도,상주시,함창읍,관내사전투표,1571,1571,250,949,242,72,39,1,0,0,0,3,2,2,2,1562,9,0
경상북도,상주시,함창읍,함창읍제1투,1748,1149,169,748,131,49,37,3,0,1,0,0,2,4,1,1145,4,599
경상북도,상주시,함창읍,함창읍제2투,1272,878,119,561,127,34,22,0,0,2,0,0,0,6,2,873,5,394
경상북도,상주시,함창읍,함창읍제3투,1103,704,75,485,97,20,15,0,0,0,0,1,1,5,2,701,3,399
경상북도,상주시,사벌면,관내사전투표,920,920,120,596,139,30,22,1,0,0,0,0,2,6,2,918,2,0
경상북도,상주시,사벌면,합계,3354,2516,317,1629,376,104,52,3,0,0,1,0,2,14,6,2504,12,838
경상북도,상주시,사벌면,사벌면제1투,1478,939,116,604,138,48,19,2,0,0,0,0,0,3,1,931,8,539
경상북도,상주시,사벌면,사벌면제2투,956,657,81,429,99,26,11,0,0,0,1,0,0,5,3,655,2,299
경상북도,상주시,중동면,합계,1279,966,93,711,86,41,19,1,0,1,0,0,2,5,2,961,5,313
경상북도,상주시,중동면,관내사전투표,334,334,29,230,38,18,9,1,0,1,0,0,2,2,1,331,3,0
경상북도,상주시,중동면,중동면투표소,945,632,64,481,48,23,10,0,0,0,0,0,0,3,1,630,2,313
경상북도,상주시,낙동면,합계,3556,2602,270,1841,265,108,61,9,0,3,1,4,2,15,6,2585,17,954
경상북도,상주시,낙동면,관내사전투표,761,761,85,546,73,31,15,2,0,0,0,0,0,5,2,759,2,0
경상북도,상주시,낙동면,낙동면제1투,1164,687,62,483,76,34,19,0,0,3,1,0,1,0,2,681,6,477
경상북도,상주시,낙동면,낙동면제2투,842,594,57,417,65,30,14,6,0,0,0,1,0,1,0,591,3,248
경상북도,상주시,낙동면,낙동면제3투,789,560,66,395,51,13,13,1,0,0,0,3,1,9,2,554,6,229
경상북도,상주시,청리면,합계,2469,1829,182,1320,210,50,26,1,1,0,1,2,2,11,6,1812,17,640
경상북도,상주시,청리면,관내사전투표,776,776,87,552,90,20,13,0,0,0,0,0,1,5,3,771,5,0
경상북도,상주시,청리면,청리면제1투,1066,645,55,474,76,17,8,0,1,0,0,1,1,5,1,639,6,421
경상북도,상주시,청리면,청리면제2투,627,408,40,294,44,13,5,1,0,0,1,1,0,1,2,402,6,219
경상북도,상주시,공성면,관내사전투표,995,995,103,686,126,41,23,2,0,0,1,0,1,6,1,990,5,0
경상북도,상주시,공성면,합계,3661,2768,303,1937,309,104,70,6,1,3,2,2,3,14,5,2759,9,893
경상북도,상주시,공성면,공성면제1투,1077,715,70,517,66,30,18,2,1,0,1,1,1,6,0,713,2,362
경상북도,상주시,공성면,공성면제2투,958,637,88,430,69,23,20,1,0,1,0,0,1,1,2,636,1,321
경상북도,상주시,공성면,공성면제3투,631,421,42,304,48,10,9,1,0,2,0,1,0,1,2,420,1,210
경상북도,상주시,외남면,관내사전투표,372,372,50,241,50,10,12,2,1,0,1,0,0,1,2,370,2,0
경상북도,상주시,외남면,합계,1514,1166,129,772,155,50,31,2,1,2,3,0,3,6,5,1159,7,348
경상북도,상주시,외남면,외남면투표소,1142,794,79,531,105,40,19,0,0,2,2,0,3,5,3,789,5,348
경상북도,상주시,내서면,합계,1661,1257,175,791,177,51,29,2,0,0,2,5,3,10,3,1248,9,404
경상북도,상주시,내서면,관내사전투표,319,319,77,166,40,15,16,2,0,0,2,0,1,0,0,319,0,0
경상북도,상주시,내서면,내서면제1투,576,393,40,261,57,16,6,0,0,0,0,1,0,5,2,388,5,183
경상북도,상주시,내서면,내서면제2투,766,545,58,364,80,20,7,0,0,0,0,4,2,5,1,541,4,221
경상북도,상주시,모동면,관내사전투표,482,482,92,248,79,31,22,4,0,0,1,0,0,0,1,478,4,0
경상북도,상주시,모동면,합계,2243,1766,325,954,299,85,69,5,0,3,3,0,1,6,4,1754,12,477
경상북도,상주시,모동면,모동면제1투,928,665,119,364,121,17,26,0,0,3,2,0,0,4,2,658,7,263
경상북도,상주시,모동면,모동면제2투,833,619,114,342,99,37,21,1,0,0,0,0,1,2,1,618,1,214
경상북도,상주시,모서면,합계,2224,1656,278,944,247,94,56,5,0,4,0,0,1,4,6,1639,17,568
경상북도,상주시,모서면,관내사전투표,461,461,97,242,70,30,14,2,0,3,0,0,0,0,0,458,3,0
경상북도,상주시,모서면,모서면제1투,1191,804,126,467,123,48,25,1,0,1,0,0,0,2,4,797,7,387
경상북도,상주시,모서면,모서면제2투,572,391,55,235,54,16,17,2,0,0,0,0,1,2,2,384,7,181
경상북도,상주시,화동면,합계,1822,1390,214,829,221,69,39,2,0,2,1,1,0,2,2,1382,8,432
경상북도,상주시,화동면,관내사전투표,439,439,90,243,59,26,15,1,0,0,0,1,0,0,1,436,3,0
경상북도,상주시,화동면,화동면투표소,1383,951,124,586,162,43,24,1,0,2,1,0,0,2,1,946,5,432
경상북도,상주시,화서면,합계,2423,1870,262,1230,235,62,41,9,0,3,1,4,2,10,2,1861,9,553
경상북도,상주시,화서면,관내사전투표,579,579,110,338,73,27,18,2,0,0,0,2,1,4,1,576,3,0
경상북도,상주시,화서면,화서면제1투,886,604,62,434,72,15,13,3,0,0,0,0,0,1,0,600,4,282
경상북도,상주시,화서면,화서면제2투,958,687,90,458,90,20,10,4,0,3,1,2,1,5,1,685,2,271
경상북도,상주시,화북면,합계,1436,1130,185,664,183,40,37,1,0,1,2,2,2,6,2,1125,5,306
경상북도,상주시,화북면,관내사전투표,343,342,57,202,49,12,17,1,0,0,0,0,1,2,0,341,1,1
경상북도,상주시,화북면,화북면투표소,1093,788,128,462,134,28,20,0,0,1,2,2,1,4,2,784,4,305
경상북도,상주시,외서면,관내사전투표,355,355,58,217,46,11,16,0,0,0,0,1,0,3,2,354,1,0
경상북도,상주시,외서면,합계,1893,1312,193,835,160,56,39,1,1,1,0,4,2,11,2,1305,7,581
경상북도,상주시,외서면,외서면제1투,1045,649,104,414,70,30,19,1,1,0,0,1,1,3,0,644,5,396
경상북도,상주시,외서면,외서면제2투,493,308,31,204,44,15,4,0,0,1,0,2,1,5,0,307,1,185
경상북도,상주시,은척면,관내사전투표,308,308,50,204,27,13,7,1,0,0,0,1,0,0,0,303,5,0
경상북도,상주시,은척면,합계,1375,1090,123,724,152,38,20,4,0,1,1,1,5,9,4,1082,8,285
경상북도,상주시,은척면,은척면제1투,755,537,53,353,90,17,8,1,0,1,1,0,4,4,3,535,2,218
경상북도,상주시,은척면,은척면제2투,312,245,20,167,35,8,5,2,0,0,0,0,1,5,1,244,1,67
경상북도,상주시,공검면,관내사전투표,595,595,91,355,79,28,20,2,0,1,1,1,1,3,1,583,12,0
경상북도,상주시,공검면,합계,2154,1699,192,1152,206,58,34,2,0,1,3,2,3,13,4,1670,29,455
경상북도,상주시,공검면,공검면제1투,862,607,54,437,73,22,9,0,0,0,2,0,0,3,1,601,6,255
경상북도,상주시,공검면,공검면제2투,697,497,47,360,54,8,5,0,0,0,0,1,2,7,2,486,11,200
경상북도,상주시,이안면,관내사전투표,463,463,69,312,48,18,7,0,1,0,0,1,0,4,1,461,2,0
경상북도,상주시,이안면,합계,1785,1431,186,976,150,49,24,6,1,0,0,5,5,14,4,1420,11,354
경상북도,상주시,이안면,이안면제1투,851,592,67,407,62,18,13,6,0,0,0,2,4,5,3,587,5,259
경상북도,상주시,이안면,이안면제2투,471,376,50,257,40,13,4,0,0,0,0,2,1,5,0,372,4,95
경상북도,상주시,화남면,합계,702,497,71,318,66,18,12,0,0,1,0,0,1,7,1,495,2,205
경상북도,상주시,화남면,관내사전투표,151,151,34,92,9,8,6,0,0,0,0,0,0,0,0,149,2,0
경상북도,상주시,화남면,화남면투표소,551,346,37,226,57,10,6,0,0,1,0,0,1,7,1,346,0,205
경상북도,상주시,남원동,관내사전투표,2460,2459,672,1088,343,188,139,2,0,4,0,1,1,1,5,2444,15,1
경상북도,상주시,남원동,합계,9379,7158,1560,3728,991,490,308,12,0,7,1,10,2,7,9,7125,33,2221
경상북도,상주시,남원동,남원동제1투,1551,988,170,597,138,45,31,1,0,1,1,0,0,2,0,986,2,563
경상북도,상주시,남원동,남원동제2투,990,720,133,422,86,51,26,1,0,0,0,0,0,1,0,720,0,270
경상북도,상주시,남원동,남원동제3투,1122,746,149,380,119,53,30,3,0,0,0,5,1,0,1,741,5,376
경상북도,상주시,남원동,남원동제4투,1069,756,146,421,103,58,25,0,0,1,0,0,0,1,0,755,1,313
경상북도,상주시,남원동,남원동제5투,801,554,91,319,73,32,23,4,0,1,0,3,0,1,2,549,5,247
경상북도,상주시,남원동,남원동제6투,1386,935,199,501,129,63,34,1,0,0,0,1,0,1,1,930,5,451
경상북도,상주시,북문동,합계,7199,5418,1146,2826,745,371,248,18,3,4,0,6,4,13,5,5389,29,1781
경상북도,상주시,북문동,관내사전투표,1879,1879,525,783,280,149,116,5,2,1,0,3,2,3,2,1871,8,0
경상북도,상주시,북문동,북문동제1투,1104,742,90,503,64,49,26,0,0,1,0,1,0,2,2,738,4,362
경상북도,상주시,북문동,북문동제2투,1114,721,170,363,106,48,25,2,0,1,0,0,0,0,1,716,5,393
경상북도,상주시,북문동,북문동제3투,1298,826,144,494,92,48,34,5,1,1,0,1,1,1,0,822,4,472
경상북도,상주시,북문동,북문동제4투,588,424,40,303,40,19,10,1,0,0,0,0,1,5,0,419,5,164
경상북도,상주시,북문동,북문동제5투,1216,826,177,380,163,58,37,5,0,0,0,1,0,2,0,823,3,390
경상북도,상주시,계림동,합계,6210,4571,835,2537,674,271,190,5,1,1,0,8,1,20,5,4548,23,1639
경상북도,상주시,계림동,관내사전투표,1668,1668,338,899,223,96,85,1,1,1,0,6,0,8,1,1659,9,0
경상북도,상주시,계림동,계림동제1투,1789,1136,187,650,172,61,45,2,0,0,0,0,0,10,3,1130,6,653
경상북도,상주시,계림동,계림동제2투,1419,945,186,487,159,69,37,0,0,0,0,1,0,1,1,941,4,474
경상북도,상주시,계림동,계림동제3투,1334,822,124,501,120,45,23,2,0,0,0,1,1,1,0,818,4,512
경상북도,상주시,동문동,관내사전투표,1570,1570,347,791,203,130,80,3,1,2,1,0,0,0,1,1559,11,0
경상북도,상주시,동문동,합계,6431,4686,836,2665,615,332,188,8,1,3,2,2,3,7,4,4666,20,1745
경상북도,상주시,동문동,동문동제1투,1686,1045,207,517,173,88,52,3,0,0,1,1,0,1,0,1043,2,641
경상북도,상주시,동문동,동문동제2투,1156,711,82,506,66,27,20,1,0,0,0,1,1,4,0,708,3,445
경상북도,상주시,동문동,동문동제3투,1210,807,112,517,97,54,18,1,0,0,0,0,1,0,3,803,4,403
경상북도,상주시,동문동,동문동제4투,809,553,88,334,76,33,18,0,0,1,0,0,1,2,0,553,0,256
경상북도,상주시,동성동,관내사전투표,671,671,178,338,72,43,29,0,0,0,0,2,0,2,1,665,6,0
경상북도,상주시,동성동,합계,3300,2466,448,1464,299,139,77,1,0,1,0,5,0,10,5,2449,17,834
경상북도,상주시,동성동,동성동제1투,1087,722,123,418,104,48,18,1,0,1,0,1,0,2,0,716,6,365
경상북도,상주시,동성동,동성동제2투,705,471,60,316,50,20,16,0,0,0,0,1,0,2,3,468,3,234
경상북도,상주시,동성동,동성동제3투,837,602,87,392,73,28,14,0,0,0,0,1,0,4,1,600,2,235
경상북도,상주시,신흥동,합계,6484,4847,1069,2351,744,393,246,7,0,0,2,2,1,10,4,4829,18,1637
경상북도,상주시,신흥동,관내사전투표,1766,1766,451,776,266,148,105,5,0,0,0,0,1,3,3,1758,8,0
경상북도,상주시,신흥동,신흥동제1투,1530,968,200,466,164,84,46,2,0,0,1,2,0,0,0,965,3,562
경상북도,상주시,신흥동,신흥동제2투,1126,730,106,478,81,39,19,0,0,0,0,0,0,3,0,726,4,396
경상북도,상주시,신흥동,신흥동제3투,2062,1383,312,631,233,122,76,0,0,0,1,0,0,4,1,1380,3,679
경상북도,상주시,잘못 투입·구분된 투표지,,0,2,2,0,0,0,0,0,0,0,0,0,0,0,0,2,0,-2
경상북도,문경시,합계,,63553,49113,8616,27832,6905,2981,1973,106,25,40,36,23,37,135,87,48796,317,14440
경상북도,문경시,거소·선상투표,,455,418,70,190,68,21,11,1,7,4,3,5,4,5,4,393,25,37
경상북도,문경시,관외사전투표,,4709,4709,1530,1312,868,531,402,6,2,4,4,0,2,1,10,4672,37,0
경상북도,문경시,재외투표,,273,181,92,15,42,10,18,1,0,0,0,0,0,0,0,178,3,92
경상북도,문경시,문경읍,관내사전투표,1251,1251,204,750,162,61,54,4,0,1,0,0,1,2,2,1241,10,0
경상북도,문경시,문경읍,합계,6120,4379,573,2864,592,172,121,14,2,3,2,1,1,11,7,4363,16,1741
경상북도,문경시,문경읍,문경읍제1투,2169,1299,147,873,185,49,29,4,1,0,2,1,0,3,1,1295,4,870
경상북도,문경시,문경읍,문경읍제2투,1856,1245,140,864,167,30,28,6,1,1,0,0,0,2,4,1243,2,611
경상북도,문경시,문경읍,문경읍제3투,844,584,82,377,78,32,10,0,0,1,0,0,0,4,0,584,0,260
경상북도,문경시,가은읍,관내사전투표,1012,1012,143,669,112,40,31,2,0,1,1,0,1,3,3,1006,6,0
경상북도,문경시,가은읍,합계,3458,2676,383,1732,314,112,74,7,1,1,5,0,5,14,10,2658,18,782
경상북도,문경시,가은읍,가은읍제1투,1899,1293,179,835,156,62,30,4,0,0,1,0,1,10,5,1283,10,606
경상북도,문경시,가은읍,가은읍제2투,547,371,61,228,46,10,13,1,1,0,3,0,3,1,2,369,2,176
경상북도,문경시,영순면,합계,1989,1533,172,1081,168,49,42,0,1,0,2,0,1,4,1,1521,12,456
경상북도,문경시,영순면,관내사전투표,627,627,78,426,78,23,16,0,0,0,1,0,0,2,1,625,2,0
경상북도,문경시,영순면,영순면투표소,1362,906,94,655,90,26,26,0,1,0,1,0,1,2,0,896,10,456
경상북도,문경시,산양면,관내사전투표,603,603,94,385,65,32,11,1,2,2,0,0,1,3,1,597,6,0
경상북도,문경시,산양면,합계,2687,2030,223,1421,211,85,45,2,3,4,1,0,4,11,4,2014,16,657
경상북도,문경시,산양면,산양면제1투,1047,708,64,504,74,36,15,0,0,1,0,0,3,4,2,703,5,339
경상북도,문경시,산양면,산양면제2투,1037,719,65,532,72,17,19,1,1,1,1,0,0,4,1,714,5,318
경상북도,문경시,호계면,관내사전투표,560,560,57,387,77,17,16,0,0,2,0,0,0,1,0,557,3,0
경상북도,문경시,호계면,합계,2026,1509,140,1004,217,73,44,5,1,2,0,1,4,6,1,1498,11,517
경상북도,문경시,호계면,호계면투표소,1466,949,83,617,140,56,28,5,1,0,0,1,4,5,1,941,8,517
경상북도,문경시,산북면,합계,2481,1972,263,1247,249,93,55,4,0,2,2,3,5,22,7,1952,20,509
경상북도,문경시,산북면,관내사전투표,883,883,110,563,101,48,30,1,0,2,0,2,4,6,4,871,12,0
경상북도,문경시,산북면,산북면투표소,1598,1089,153,684,148,45,25,3,0,0,2,1,1,16,3,1081,8,509
경상북도,문경시,동로면,합계,1620,1283,192,819,162,50,27,3,1,2,1,1,3,8,4,1273,10,337
경상북도,문경시,동로면,관내사전투표,473,473,76,285,69,16,10,2,1,2,0,0,2,4,3,470,3,0
경상북도,문경시,동로면,동로면투표소,1147,810,116,534,93,34,17,1,0,0,1,1,1,4,1,803,7,337
경상북도,문경시,마성면,관내사전투표,861,861,130,504,135,36,35,3,2,0,0,0,1,4,2,852,9,0
경상북도,문경시,마성면,합계,3212,2441,319,1581,315,91,75,5,3,1,1,2,3,9,5,2410,31,771
경상북도,문경시,마성면,마성면제1투,1025,647,59,456,79,28,14,0,0,1,0,1,0,1,2,641,6,378
경상북도,문경시,마성면,마성면제2투,1326,933,130,621,101,27,26,2,1,0,1,1,2,4,1,917,16,393
경상북도,문경시,농암면,합계,2228,1700,223,1167,169,62,38,5,0,2,0,0,1,11,5,1683,17,528
경상북도,문경시,농암면,관내사전투표,665,665,101,442,71,19,17,1,0,1,0,0,0,3,3,658,7,0
경상북도,문경시,농암면,농암면제1투,1092,724,84,504,75,30,13,4,0,0,0,0,1,5,2,718,6,368
경상북도,문경시,농암면,농암면제2투,471,311,38,221,23,13,8,0,0,1,0,0,0,3,0,307,4,160
경상북도,문경시,점촌1동,관내사전투표,1858,1857,339,1136,209,83,63,5,0,2,1,1,2,2,3,1846,11,1
경상북도,문경시,점촌1동,합계,5399,4218,657,2685,501,202,119,8,1,6,2,1,3,5,6,4196,22,1181
경상북도,문경시,점촌1동,점촌1동제1투,1380,905,128,595,111,42,20,2,0,4,0,0,1,0,0,903,2,475
경상북도,문경시,점촌1동,점촌1동제2투,1112,754,99,502,93,36,18,1,0,0,0,0,0,1,1,751,3,358
경상북도,문경시,점촌1동,점촌1동제3투,1049,702,91,452,88,41,18,0,1,0,1,0,0,2,2,696,6,347
경상북도,문경시,점촌2동,합계,6193,4527,714,2778,575,263,157,5,0,4,5,0,0,6,3,4510,17,1666
경상북도,문경시,점촌2동,관내사전투표,1617,1617,328,891,210,98,74,3,0,1,1,0,0,3,2,1611,6,0
경상북도,문경시,점촌2동,점촌2동제1투,1724,1115,151,713,142,66,32,1,0,2,2,0,0,2,0,1111,4,609
경상북도,문경시,점촌2동,점촌2동제2투,1076,706,78,498,74,36,14,1,0,1,0,0,0,1,0,703,3,370
경상북도,문경시,점촌2동,점촌2동제3투,1776,1089,157,676,149,63,37,0,0,0,2,0,0,0,1,1085,4,687
경상북도,문경시,점촌3동,합계,7057,5195,850,2950,796,329,199,19,1,2,3,4,1,7,11,5172,23,1862
경상북도,문경시,점촌3동,관내사전투표,1504,1504,330,796,201,100,60,5,0,1,1,1,0,1,3,1499,5,0
경상북도,문경시,점촌3동,점촌3동제1투,2518,1755,234,1034,285,109,62,7,0,0,2,2,0,3,5,1743,12,763
경상북도,문경시,점촌3동,점촌3동제2투,3035,1936,286,1120,310,120,77,7,1,1,0,1,1,3,3,1930,6,1099
경상북도,문경시,점촌4동,합계,2730,1980,256,1251,255,99,84,4,2,1,3,2,0,7,4,1968,12,750
경상북도,문경시,점촌4동,관내사전투표,671,671,105,402,82,41,34,1,1,0,0,0,0,0,1,667,4,0
경상북도,문경시,점촌4동,점촌4동제1투,1260,797,89,512,121,35,27,2,0,1,1,2,0,2,2,794,3,463
경상북도,문경시,점촌4동,점촌4동제2투,799,512,62,337,52,23,23,1,1,0,2,0,0,5,1,507,5,287
경상북도,문경시,점촌5동,관내사전투표,3162,3162,926,1204,480,344,188,6,0,0,0,1,0,3,2,3154,8,0
경상북도,문경시,점촌5동,합계,10916,8362,1959,3735,1403,739,462,17,0,2,2,3,0,8,5,8335,27,2554
경상북도,문경시,점촌5동,점촌5동제1투,2845,1892,318,1000,325,127,100,5,0,1,1,2,0,2,3,1884,8,953
경상북도,문경시,점촌5동,점촌5동제2투,2376,1599,324,822,249,122,71,2,0,1,1,0,0,1,0,1593,6,777
경상북도,문경시,점촌5동,점촌5동제3투,2533,1709,391,709,349,146,103,4,0,0,0,0,0,2,0,1704,5,824
경상북도,문경시,잘못 투입·구분된 투표지,,0,0,0,0,0,0,0,0,0,0,0,0,0,0,0,0,0,0
경상북도,예천군,합계,,40545,32124,5261,18863,4427,1840,1018,52,14,21,23,34,59,155,75,31842,282,8421
경상북도,예천군,거소·선상투표,,186,170,29,79,37,10,3,0,1,1,2,1,0,1,0,164,6,16
경상북도,예천군,관외사전투표,,3509,3509,1130,1132,540,395,265,6,0,3,0,2,1,6,9,3489,20,0
경상북도,예천군,재외투표,,221,133,60,17,37,4,11,2,1,1,0,0,0,0,0,133,0,88
경상북도,예천군,예천읍,합계,13048,9959,1651,5813,1409,622,323,19,3,4,3,6,8,15,15,9891,68,3089
경상북도,예천군,예천읍,관내사전투표,3357,3357,687,1771,461,255,137,8,1,1,2,3,2,3,4,3335,22,0
경상북도,예천군,예천읍,예천읍제1투,1423,900,140,542,140,46,18,5,0,0,0,2,1,0,1,895,5,523
경상북도,예천군,예천읍,예천읍제2투,1883,1345,189,833,189,83,41,0,0,1,0,0,0,0,3,1339,6,538
경상북도,예천군,예천읍,예천읍제3투,1962,1341,233,800,181,71,36,2,0,0,1,0,1,4,2,1331,10,621
경상북도,예천군,예천읍,예천읍제4투,1910,1316,170,859,169,63,32,0,1,1,0,0,1,5,4,1305,11,594
경상북도,예천군,예천읍,예천읍제5투,2513,1700,232,1008,269,104,59,4,1,1,0,1,3,3,1,1686,14,813
경상북도,예천군,용문면,합계,2112,1668,203,1137,189,61,29,4,1,0,0,0,8,16,6,1654,14,444
경상북도,예천군,용문면,관내사전투표,613,613,98,387,73,23,13,1,0,0,0,0,3,5,4,607,6,0
경상북도,예천군,용문면,용문면투표소,1499,1055,105,750,116,38,16,3,1,0,0,0,5,11,2,1047,8,444
경상북도,예천군,감천면,관내사전투표,703,703,103,438,87,31,24,0,1,1,0,3,2,5,3,698,5,0
경상북도,예천군,감천면,합계,2481,1927,258,1235,252,76,54,3,1,1,0,3,8,8,8,1907,20,554
경상북도,예천군,감천면,감천면제1투,1041,697,89,455,95,16,20,2,0,0,0,0,5,3,5,690,7,344
경상북도,예천군,감천면,감천면제2투,737,527,66,342,70,29,10,1,0,0,0,0,1,0,0,519,8,210
경상북도,예천군,보문면,합계,1533,1231,131,778,221,48,18,0,1,1,2,3,5,9,3,1220,11,302
경상북도,예천군,보문면,관내사전투표,547,547,69,328,105,22,9,0,0,0,1,1,3,4,1,543,4,0
경상북도,예천군,보문면,보문면제1투,500,340,31,228,53,15,6,0,0,1,0,0,0,1,0,335,5,160
경상북도,예천군,보문면,보문면제2투,486,344,31,222,63,11,3,0,1,0,1,2,2,4,2,342,2,142
경상북도,예천군,호명면,합계,3399,2543,506,1356,365,181,90,4,1,2,1,2,4,14,3,2529,14,856
경상북도,예천군,호명면,관내사전투표,733,733,180,340,100,68,35,0,0,0,0,0,2,2,2,729,4,0
경상북도,예천군,호명면,호명면제1투,1825,1210,265,595,198,93,42,3,0,0,1,2,0,4,1,1204,6,615
경상북도,예천군,호명면,호명면제2투,841,600,61,421,67,20,13,1,1,2,0,0,2,8,0,596,4,241
경상북도,예천군,유천면,관내사전투표,719,719,112,419,95,45,26,1,0,2,0,3,2,6,2,713,6,0
경상북도,예천군,유천면,합계,2298,1827,268,1127,232,99,46,2,0,2,1,4,4,13,7,1805,22,471
경상북도,예천군,유천면,유천면투표소,1579,1108,156,708,137,54,20,1,0,0,1,1,2,7,5,1092,16,471
경상북도,예천군,용궁면,관내사전투표,758,758,79,497,105,19,18,1,2,0,0,1,2,6,5,735,23,0
경상북도,예천군,용궁면,합계,2403,1875,178,1266,268,53,38,1,2,0,5,2,5,16,7,1841,34,528
경상북도,예천군,용궁면,용궁면제1투,979,643,47,448,107,17,9,0,0,0,3,1,2,3,2,639,4,336
경상북도,예천군,용궁면,용궁면제2투,666,474,52,321,56,17,11,0,0,0,2,0,1,7,0,467,7,192
경상북도,예천군,개포면,합계,1457,1118,121,747,167,37,22,0,1,1,1,0,1,7,1,1106,12,339
경상북도,예천군,개포면,관내사전투표,315,315,38,190,57,11,12,0,0,1,0,0,1,0,0,310,5,0
경상북도,예천군,개포면,개포면투표소,1142,803,83,557,110,26,10,0,1,0,1,0,0,7,1,796,7,339
경상북도,예천군,지보면,합계,2581,1899,227,1321,205,66,35,0,1,2,2,1,5,17,5,1887,12,682
경상북도,예천군,지보면,관내사전투표,460,460,64,316,45,13,11,0,0,0,1,0,0,1,3,454,6,0
경상북도,예천군,지보면,지보면제1투,1443,960,114,666,110,36,16,0,0,1,1,1,2,9,1,957,3,483
경상북도,예천군,지보면,지보면제2투,678,479,49,339,50,17,8,0,1,1,0,0,3,7,1,476,3,199
경상북도,예천군,풍양면,관내사전투표,816,816,90,570,88,33,15,1,0,0,2,2,1,3,2,807,9,0
경상북도,예천군,풍양면,합계,3064,2389,250,1665,246,103,47,5,1,1,5,8,4,14,5,2354,35,675
경상북도,예천군,풍양면,풍양면제1투,1303,907,89,626,95,37,20,2,1,1,3,4,2,6,3,889,18,396
경상북도,예천군,풍양면,풍양면제2투,945,666,71,469,63,33,12,2,0,0,0,2,1,5,0,658,8,279
경상북도,예천군,효자면,합계,973,793,101,506,103,38,12,2,0,1,0,0,4,14,2,783,10,180
경상북도,예천군,효자면,관내사전투표,230,230,34,132,37,16,4,0,0,0,0,0,2,5,0,230,0,0
경상북도,예천군,효자면,효자면제1투,373,269,37,164,32,14,6,2,0,1,0,0,0,6,1,263,6,104
경상북도,예천군,효자면,효자면제2투,370,294,30,210,34,8,2,0,0,0,0,0,2,3,1,290,4,76
경상북도,예천군,은풍면,관내사전투표,414,414,61,240,63,29,13,3,0,0,1,1,0,2,1,414,0,0
경상북도,예천군,은풍면,합계,1280,1083,148,684,156,47,25,4,0,1,1,2,2,5,4,1079,4,197
경상북도,예천군,은풍면,은풍면투표소,866,669,87,444,93,18,12,1,0,1,0,1,2,3,3,665,4,197
경상북도,예천군,잘못 투입·구분된 투표지,,0,0,0,0,0,0,0,0,0,0,0,0,0,0,0,0,0,0
경상북도,경산시,합계,,212825,160794,35602,72129,24606,17962,8551,334,38,82,50,142,61,116,194,159867,927,52031
경상북도,경산시,거소·선상투표,,362,337,88,79,101,44,13,1,0,1,1,0,0,0,1,329,8,25
경상북도,경산시,관외사전투표,,16958,16944,5257,4978,2829,2386,1255,35,4,12,3,10,5,6,31,16811,133,14
경상북도,경산시,재외투표,,1014,729,400,52,120,54,97,4,0,0,0,0,0,0,0,727,2,285
경상북도,경산시,하양읍,합계,19925,14803,2904,7013,2191,1739,802,23,2,4,2,11,6,7,9,14713,90,5122
경상북도,경산시,하양읍,관내사전투표,3590,3590,968,1291,494,518,272,7,1,2,0,4,3,3,4,3567,23,0
경상북도,경산시,하양읍,하양읍제1투,2258,1395,230,720,192,151,91,1,0,0,0,0,0,0,2,1387,8,863
경상북도,경산시,하양읍,하양읍제2투,2058,1385,225,713,229,143,60,1,0,0,1,1,0,1,0,1374,11,673
경상북도,경산시,하양읍,하양읍제3투,3865,2814,626,1159,464,363,185,1,0,1,1,1,0,0,1,2802,12,1051
경상북도,경산시,하양읍,하양읍제4투,779,555,71,344,82,45,9,0,0,0,0,0,1,0,0,552,3,224
경상북도,경산시,하양읍,하양읍제5투,1203,790,103,480,90,87,22,4,1,0,0,1,0,0,0,788,2,413
경상북도,경산시,하양읍,하양읍제6투,2237,1406,180,842,201,117,47,3,0,0,0,2,0,2,0,1394,12,831
경상북도,경산시,하양읍,하양읍제7투,2183,1508,249,779,241,150,68,2,0,1,0,1,2,1,2,1496,12,675
경상북도,경산시,하양읍,하양읍제8투,1752,1360,252,685,198,165,48,4,0,0,0,1,0,0,0,1353,7,392
경상북도,경산시,진량읍,합계,27421,19608,3966,9007,3124,2101,1122,37,5,9,13,14,17,23,39,19477,131,7813
경상북도,경산시,진량읍,관내사전투표,4073,4073,1106,1479,648,491,284,5,2,4,4,3,3,5,8,4042,31,0
경상북도,경산시,진량읍,진량읍제1투,3357,1823,369,812,325,194,108,3,0,0,0,1,1,0,2,1815,8,1534
경상북도,경산시,진량읍,진량읍제2투,2081,1419,295,658,226,145,73,4,1,1,0,1,1,2,1,1408,11,662
경상북도,경산시,진량읍,진량읍제3투,1487,943,95,663,94,65,13,2,0,1,0,0,2,2,3,940,3,544
경상북도,경산시,진량읍,진량읍제4투,2212,1397,206,731,239,122,81,0,0,0,1,1,0,2,3,1386,11,815
경상북도,경산시,진량읍,진량읍제5투,1916,1193,209,600,149,128,58,5,0,0,4,1,4,5,9,1172,21,723
경상북도,경산시,진량읍,진량읍제6투,2419,1826,329,910,279,193,99,1,0,0,2,0,1,0,2,1816,10,593
경상북도,경산시,진량읍,진량읍제7투,2128,1512,299,670,266,172,86,5,0,0,1,0,1,2,2,1504,8,616
경상북도,경산시,진량읍,진량읍제8투,1005,726,109,446,85,52,26,1,0,0,0,0,0,3,1,723,3,279
경상북도,경산시,진량읍,진량읍제9투,2750,1874,398,793,316,208,135,5,1,2,0,3,3,0,1,1865,9,876
경상북도,경산시,진량읍,진량읍제10투,1587,1078,173,552,173,110,54,2,0,0,0,0,1,1,1,1067,11,509
경상북도,경산시,진량읍,진량읍제11투,2406,1744,378,693,324,221,105,4,1,1,1,4,0,1,6,1739,5,662
경상북도,경산시,와촌면,합계,5409,3857,549,2368,468,257,120,9,5,3,1,6,8,8,8,3810,47,1552
경상북도,경산시,와촌면,관내사전투표,892,892,197,420,119,73,30,4,4,2,1,4,2,2,6,864,28,0
경상북도,경산시,와촌면,와촌면제1투,1651,989,125,598,147,66,38,1,1,0,0,1,0,1,1,979,10,662
경상북도,경산시,와촌면,와촌면제2투,1528,1051,114,731,100,64,31,3,0,0,0,0,3,2,0,1048,3,477
경상북도,경산시,와촌면,와촌면제3투,1338,925,113,619,102,54,21,1,0,1,0,1,3,3,1,919,6,413
경상북도,경산시,자인면,합계,5393,3966,546,2422,519,302,122,3,0,0,1,7,3,3,9,3937,29,1427
경상북도,경산시,자인면,관내사전투표,1423,1423,253,781,201,124,40,1,0,0,0,3,1,0,3,1407,16,0
경상북도,경산시,자인면,자인면제1투,1238,818,86,552,79,65,24,2,0,0,0,0,0,1,3,812,6,420
경상북도,경산시,자인면,자인면제2투,1355,893,103,576,121,54,29,0,0,0,0,1,2,0,3,889,4,462
경상북도,경산시,자인면,자인면제3투,1377,832,104,513,118,59,29,0,0,0,1,3,0,2,0,829,3,545
경상북도,경산시,용성면,합계,3001,2238,283,1421,296,129,43,6,0,3,1,12,2,9,7,2212,26,763
경상북도,경산시,용성면,관내사전투표,879,879,126,533,110,59,23,4,0,1,1,5,1,3,4,870,9,0
경상북도,경산시,용성면,용성면제1투,942,553,55,361,83,31,11,0,0,0,0,5,0,1,0,547,6,389
경상북도,경산시,용성면,용성면제2투,885,596,72,391,75,34,6,0,0,1,0,2,1,3,1,586,10,289
경상북도,경산시,용성면,용성면제3투,295,210,30,136,28,5,3,2,0,1,0,0,0,2,2,209,1,85
경상북도,경산시,남산면,합계,3207,2333,292,1496,288,165,49,13,0,1,6,0,1,6,1,2318,15,874
경상북도,경산시,남산면,관내사전투표,608,608,91,354,70,52,20,5,0,1,2,0,0,3,1,599,9,0
경상북도,경산시,남산면,남산면제1투,1679,1125,124,739,160,70,17,5,0,0,3,0,0,2,0,1120,5,554
경상북도,경산시,남산면,남산면제2투,920,600,77,403,58,43,12,3,0,0,1,0,1,1,0,599,1,320
경상북도,경산시,압량면,합계,16157,11550,2788,4741,1851,1422,630,26,0,5,2,5,3,9,14,11496,54,4607
경상북도,경산시,압량면,관내사전투표,3078,3078,946,1023,477,424,181,7,0,2,1,1,1,2,4,3069,9,0
경상북도,경산시,압량면,압량면제1투,3332,1851,383,816,316,196,115,6,0,2,1,0,0,1,3,1839,12,1481
경상북도,경산시,압량면,압량면제2투,1764,1144,168,683,148,96,34,3,0,1,0,0,1,1,2,1137,7,620
경상북도,경산시,압량면,압량면제3투,3653,2208,494,927,372,280,118,3,0,0,0,2,0,3,3,2202,6,1445
경상북도,경산시,압량면,압량면제4투,805,592,70,384,59,41,15,5,0,0,0,1,1,2,2,580,12,213
경상북도,경산시,압량면,압량면제5투,3525,2677,727,908,479,385,167,2,0,0,0,1,0,0,0,2669,8,848
경상북도,경산시,남천면,합계,2847,2203,289,1361,273,177,63,5,1,5,0,7,1,6,6,2194,9,644
경상북도,경산시,남천면,관내사전투표,503,503,85,257,73,56,24,1,0,2,0,1,0,2,1,502,1,0
경상북도,경산시,남천면,남천면제1투,1435,1022,139,628,123,89,25,3,0,1,0,4,0,0,4,1016,6,413
경상북도,경산시,남천면,남천면제2투,909,678,65,476,77,32,14,1,1,2,0,2,1,4,1,676,2,231
경상북도,경산시,중앙동,합계,7467,5669,1199,2768,768,564,305,15,2,4,4,4,0,2,3,5638,31,1798
경상북도,경산시,중앙동,관내사전투표,2449,2449,665,970,325,291,167,8,0,2,2,2,0,1,1,2434,15,0
경상북도,경산시,중앙동,중앙동제1투,3087,2037,343,1142,269,168,93,4,1,2,1,2,0,1,1,2027,10,1050
경상북도,경산시,중앙동,중앙동제2투,1931,1183,191,656,174,105,45,3,1,0,1,0,0,0,1,1177,6,748
경상북도,경산시,동부동,합계,27133,19806,4491,8735,3102,2189,1063,44,6,9,3,22,2,11,21,19698,108,7327
경상북도,경산시,동부동,관내사전투표,3814,3814,1101,1424,565,447,239,10,2,1,0,2,1,2,1,3795,19,0
경상북도,경산시,동부동,동부동제1투,2398,1499,275,699,249,187,71,3,0,0,0,2,0,0,5,1491,8,899
경상북도,경산시,동부동,동부동제2투,1450,919,107,618,84,67,18,3,1,1,0,1,0,3,4,907,12,531
경상북도,경산시,동부동,동부동제3투,2730,1726,295,912,233,171,88,3,0,2,0,2,1,1,2,1710,16,1004
경상북도,경산시,동부동,동부동제4투,1615,1086,177,545,181,114,52,6,1,1,0,0,0,0,0,1077,9,529
경상북도,경산시,동부동,동부동제5투,1519,899,160,459,161,66,37,4,0,0,1,0,0,2,2,892,7,620
경상북도,경산시,동부동,동부동제6투,2592,1880,370,869,325,196,103,6,0,0,1,2,0,0,2,1874,6,712
경상북도,경산시,동부동,동부동제7투,3186,2167,551,881,343,233,145,2,0,1,0,2,0,0,1,2159,8,1019
경상북도,경산시,동부동,동부동제8투,1869,1406,340,579,219,179,79,0,1,0,1,1,0,2,2,1403,3,463
경상북도,경산시,동부동,동부동제9투,2678,1883,457,819,297,185,103,4,1,1,0,4,0,1,0,1872,11,795
경상북도,경산시,동부동,동부동제10투,3282,2527,658,930,445,344,128,3,0,2,0,6,0,0,2,2518,9,755
경상북도,경산시,서부1동,관내사전투표,2903,2903,795,1164,421,335,166,4,0,1,1,0,1,0,2,2890,13,0
경상북도,경산시,서부1동,합계,27118,19828,4362,8843,3125,2243,1070,37,5,9,6,11,8,10,12,19741,87,7290
경상북도,경산시,서부1동,서부1동제1투,3053,2198,430,1057,354,239,95,2,1,2,0,2,1,3,1,2187,11,855
경상북도,경산시,서부1동,서부1동제2투,2193,1376,228,743,205,126,58,3,0,1,1,1,1,1,0,1368,8,817
경상북도,경산시,서부1동,서부1동제3투,2100,1320,263,646,208,125,63,0,1,1,0,2,2,0,1,1312,8,780
경상북도,경산시,서부1동,서부1동제4투,1619,1001,212,452,174,99,50,3,0,1,0,0,0,1,1,993,8,618
경상북도,경산시,서부1동,서부1동제5투,2235,1474,261,734,199,170,92,4,0,0,1,2,0,0,2,1465,9,761
경상북도,경산시,서부1동,서부1동제6투,2341,1747,309,870,278,198,77,4,2,0,1,0,1,0,1,1741,6,594
경상북도,경산시,서부1동,서부1동제7투,2726,1852,371,893,272,207,93,5,0,0,0,1,1,1,0,1844,8,874
경상북도,경산시,서부1동,서부1동제8투,2723,1945,490,756,331,225,125,6,0,0,1,1,0,1,1,1937,8,778
경상북도,경산시,서부1동,서부1동제9투,3020,2284,641,789,387,293,161,3,0,1,0,1,0,3,0,2279,5,736
경상북도,경산시,서부1동,서부1동제10투,2205,1728,362,739,296,226,90,3,1,2,1,1,1,0,3,1725,3,477
경상북도,경산시,서부2동,관내사전투표,3819,3819,1036,1521,536,484,202,10,1,2,0,5,1,5,1,3804,15,0
경상북도,경산시,서부2동,합계,17241,13861,3198,6201,2033,1676,649,26,2,5,1,9,1,6,7,13814,47,3380
경상북도,경산시,서부2동,서부2동제1투,2823,1986,455,852,309,273,84,6,0,0,0,0,0,0,1,1980,6,837
경상북도,경산시,서부2동,서부2동제2투,1783,1319,310,585,208,141,69,1,0,0,0,1,0,0,0,1315,4,464
경상북도,경산시,서부2동,서부2동제3투,2655,2083,405,1105,279,209,78,0,0,0,0,1,0,0,2,2079,4,572
경상북도,경산시,서부2동,서부2동제4투,2181,1787,366,812,281,224,94,2,0,2,1,0,0,1,0,1783,4,394
경상북도,경산시,서부2동,서부2동제5투,2305,1746,363,807,273,208,79,5,0,1,0,1,0,0,1,1738,8,559
경상북도,경산시,서부2동,서부2동제6투,1675,1121,263,519,147,137,43,2,1,0,0,1,0,0,2,1115,6,554
경상북도,경산시,남부동,합계,13144,9844,2032,4693,1559,982,473,22,3,2,3,9,3,6,8,9795,49,3300
경상북도,경산시,남부동,관내사전투표,1976,1976,537,810,303,205,104,8,0,0,1,4,0,0,0,1972,4,0
경상북도,경산시,남부동,남부동제1투,2801,1891,316,987,307,160,99,5,0,2,1,1,0,1,0,1879,12,910
경상북도,경산시,남부동,남부동제2투,735,478,70,290,61,42,10,1,0,0,0,0,0,0,0,474,4,257
경상북도,경산시,남부동,남부동제3투,2116,1513,263,803,241,118,65,3,2,0,1,2,1,3,5,1507,6,603
경상북도,경산시,남부동,남부동제4투,2984,2247,499,968,380,273,111,2,1,0,0,1,0,1,0,2236,11,737
경상북도,경산시,남부동,남부동제5투,2532,1739,347,835,267,184,84,3,0,0,0,1,2,1,3,1727,12,793
경상북도,경산시,북부동,합계,10060,6391,1559,2698,939,808,316,13,0,4,1,11,0,3,7,6359,32,3669
경상북도,경산시,북부동,관내사전투표,1250,1250,405,384,176,193,85,1,0,1,0,0,0,0,0,1245,5,0
경상북도,경산시,북부동,북부동제1투,2835,2228,519,1022,311,271,86,3,0,0,1,2,0,0,3,2218,10,607
경상북도,경산시,북부동,북부동제2투,2476,1009,224,440,160,115,55,1,0,0,0,5,0,0,3,1003,6,1467
경상북도,경산시,북부동,북부동제3투,3499,1904,411,852,292,229,90,8,0,3,0,4,0,3,1,1893,11,1595
경상북도,경산시,중방동,합계,8968,6827,1399,3253,1020,724,359,15,3,6,2,4,1,1,11,6798,29,2141
경상북도,경산시,중방동,관내사전투표,1682,1683,442,694,229,187,109,4,0,1,2,1,0,0,5,1674,9,-1
경상북도,경산시,중방동,중방동제1투,2092,1314,205,705,201,122,65,4,2,1,0,1,0,0,1,1307,7,778
경상북도,경산시,중방동,중방동제2투,1903,1242,218,676,173,104,56,4,1,1,0,0,1,0,2,1236,6,661
경상북도,경산시,중방동,중방동제3투,3291,2588,534,1178,417,311,129,3,0,3,0,2,0,1,3,2581,7,703
경상북도,경산시,잘못 투입·구분된 투표지,,0,0,0,0,0,0,0,0,0,0,0,0,0,0,0,0,0,0
경상북도,청도군,합계,,39505,30398,5323,17678,3654,2145,965,58,9,22,13,32,47,134,77,30157,241,9107
경상북도,청도군,거소·선상투표,,174,164,33,66,33,11,5,1,0,0,0,0,2,1,1,153,11,10
경상북도,청도군,관외사전투표,,3839,3839,1085,1463,578,413,245,7,1,1,1,2,2,5,3,3806,33,0
경상북도,청도군,재외투표,,380,197,82,23,61,10,20,1,0,0,0,0,0,0,0,197,0,183
경상북도,청도군,청도읍,관내사전투표,2219,2219,599,1069,222,192,108,4,0,1,0,4,1,4,8,2212,7,0
경상북도,청도군,청도읍,합계,10702,7864,1429,4506,925,604,259,13,2,7,2,8,10,29,19,7813,51,2838
경상북도,청도군,청도읍,청도읍제1투,2493,1613,253,919,224,141,53,1,1,3,1,1,1,4,2,1604,9,880
경상북도,청도군,청도읍,청도읍제2투,2532,1549,242,908,192,120,60,4,0,0,0,1,1,4,3,1535,14,983
경상북도,청도군,청도읍,청도읍제3투,840,594,100,372,57,38,9,2,0,0,0,0,3,6,0,587,7,246
경상북도,청도군,청도읍,청도읍제4투,1282,926,128,594,104,60,18,1,0,1,0,2,2,7,2,919,7,356
경상북도,청도군,청도읍,청도읍제5투,1336,963,107,644,126,53,11,1,1,2,1,0,2,4,4,956,7,373
경상북도,청도군,화양읍,합계,5595,4094,717,2347,517,314,131,4,1,2,0,7,4,10,10,4064,30,1501
경상북도,청도군,화양읍,관내사전투표,670,670,150,355,75,57,25,0,0,1,0,1,0,1,1,666,4,0
경상북도,청도군,화양읍,화양읍제1투,1122,711,101,421,100,58,13,1,0,0,0,1,2,3,1,701,10,411
경상북도,청도군,화양읍,화양읍제2투,2234,1546,306,813,204,133,67,0,0,1,0,3,1,2,6,1536,10,688
경상북도,청도군,화양읍,화양읍제3투,655,504,66,315,63,34,14,3,0,0,0,0,1,4,2,502,2,151
경상북도,청도군,화양읍,화양읍제4투,914,663,94,443,75,32,12,0,1,0,0,2,0,0,0,659,4,251
경상북도,청도군,각남면,관내사전투표,518,518,85,327,46,23,11,1,0,0,0,1,1,11,2,508,10,0
경상북도,청도군,각남면,합계,1838,1468,225,946,134,73,42,1,0,0,0,1,4,19,8,1453,15,370
경상북도,청도군,각남면,각남면제1투,839,593,106,374,58,32,19,0,0,0,0,0,1,2,0,592,1,246
경상북도,청도군,각남면,각남면제2투,481,357,34,245,30,18,12,0,0,0,0,0,2,6,6,353,4,124
경상북도,청도군,풍각면,관내사전투표,931,931,170,539,105,59,32,1,0,1,0,3,2,4,3,919,12,0
경상북도,청도군,풍각면,합계,3556,2681,371,1718,299,159,66,4,1,6,1,4,9,16,4,2658,23,875
경상북도,청도군,풍각면,풍각면제1투,1521,998,121,655,105,71,26,1,0,3,1,0,5,2,0,990,8,523
경상북도,청도군,풍각면,풍각면제2투,634,420,44,288,56,20,3,1,0,1,0,0,1,5,1,420,0,214
경상북도,청도군,풍각면,풍각면제3투,470,332,36,236,33,9,5,1,1,1,0,1,1,5,0,329,3,138
경상북도,청도군,각북면,관내사전투표,551,551,82,355,56,34,11,0,1,1,0,0,0,3,4,547,4,0
경상북도,청도군,각북면,합계,1776,1360,177,887,146,80,32,3,2,1,4,3,0,7,7,1349,11,416
경상북도,청도군,각북면,각북면투표소,1225,809,95,532,90,46,21,3,1,0,4,3,0,4,3,802,7,416
경상북도,청도군,이서면,합계,3719,2836,377,1903,273,160,73,8,0,1,3,1,4,11,8,2822,14,883
경상북도,청도군,이서면,관내사전투표,637,637,116,395,60,31,21,3,0,0,1,0,0,4,2,633,4,0
경상북도,청도군,이서면,이서면제1투,2004,1423,180,951,142,87,37,3,0,0,0,1,4,5,6,1416,7,581
경상북도,청도군,이서면,이서면제2투,1078,776,81,557,71,42,15,2,0,1,2,0,0,2,0,773,3,302
경상북도,청도군,운문면,관내사전투표,327,327,70,181,36,23,11,1,0,1,0,0,1,0,1,325,2,0
경상북도,청도군,운문면,합계,1823,1364,228,836,166,74,27,4,0,1,1,1,3,7,2,1350,14,459
경상북도,청도군,운문면,운문면제1투,432,310,56,188,31,21,5,2,0,0,0,0,0,3,0,306,4,122
경상북도,청도군,운문면,운문면제2투,574,373,51,240,43,24,10,0,0,0,1,1,1,0,0,371,2,201
경상북도,청도군,운문면,운문면제3투,490,354,51,227,56,6,1,1,0,0,0,0,1,4,1,348,6,136
경상북도,청도군,금천면,관내사전투표,540,540,83,338,66,29,11,4,0,0,0,2,0,4,0,537,3,0
경상북도,청도군,금천면,합계,2848,2134,259,1428,245,116,31,5,0,0,0,4,4,19,8,2119,15,714
경상북도,청도군,금천면,금천면제1투,795,518,55,372,56,17,5,0,0,0,0,0,1,3,0,509,9,277
경상북도,청도군,금천면,금천면제2투,556,388,47,265,33,27,3,1,0,0,0,2,2,4,2,386,2,168
경상북도,청도군,금천면,금천면제3투,957,688,74,453,90,43,12,0,0,0,0,0,1,8,6,687,1,269
경상북도,청도군,매전면,합계,3255,2397,340,1555,277,131,34,7,2,3,1,1,5,10,7,2373,24,858
경상북도,청도군,매전면,관내사전투표,442,442,87,254,51,30,8,3,0,1,0,0,1,1,2,438,4,0
경상북도,청도군,매전면,매전면제1투,743,493,59,330,62,27,5,2,0,1,0,0,1,1,2,490,3,250
경상북도,청도군,매전면,매전면제2투,690,489,69,305,69,26,7,2,1,0,0,1,2,2,1,485,4,201
경상북도,청도군,매전면,매전면제3투,488,358,39,240,41,19,7,0,1,1,0,0,0,3,1,352,6,130
경상북도,청도군,매전면,매전면제4투,892,615,86,426,54,29,7,0,0,0,1,0,1,3,1,608,7,277
경상북도,청도군,잘못 투입·구분된 투표지,,0,0,0,0,0,0,0,0,0,0,0,0,0,0,0,0,0,0
경상북도,고령군,합계,,29964,22396,3754,13248,2600,1523,839,55,13,12,10,30,19,61,45,22209,187,7568
경상북도,고령군,거소·선상투표,,143,138,26,63,22,9,3,1,2,0,1,2,0,1,2,132,6,5
경상북도,고령군,관외사전투표,,2900,2900,732,1189,409,346,181,6,3,0,2,2,1,3,4,2878,22,0
경상북도,고령군,재외투표,,339,130,52,13,46,6,12,0,0,0,0,0,0,0,0,129,1,209
경상북도,고령군,대가야읍,관내사전투표,1627,1627,382,774,205,132,100,5,1,1,0,1,0,6,5,1612,15,0
경상북도,고령군,대가야읍,합계,8203,5836,993,3461,683,367,237,13,1,2,4,5,3,18,10,5797,39,2367
경상북도,고령군,대가야읍,대가야읍제1투,1578,1009,135,670,113,49,27,0,0,0,2,1,0,3,3,1003,6,569
경상북도,고령군,대가야읍,대가야읍제2투,469,332,48,239,27,9,4,1,0,0,0,0,0,1,0,329,3,137
경상북도,고령군,대가야읍,대가야읍제3투,1967,1123,157,732,131,59,31,1,0,0,0,3,1,3,0,1118,5,844
경상북도,고령군,대가야읍,대가야읍제4투,361,253,20,189,22,13,7,0,0,0,0,0,0,1,1,253,0,108
경상북도,고령군,대가야읍,대가야읍제5투,2201,1492,251,857,185,105,68,6,0,1,2,0,2,4,1,1482,10,709
경상북도,고령군,덕곡면,관내사전투표,159,159,25,82,19,13,15,0,0,0,0,1,0,1,0,156,3,0
경상북도,고령군,덕곡면,합계,1291,985,106,664,104,62,23,0,0,0,0,6,1,4,4,974,11,306
경상북도,고령군,덕곡면,덕곡면제1투,696,501,52,350,51,32,4,0,0,0,0,2,0,3,2,496,5,195
경상북도,고령군,덕곡면,덕곡면제2투,436,325,29,232,34,17,4,0,0,0,0,3,1,0,2,322,3,111
경상북도,고령군,운수면,관내사전투표,269,269,57,149,25,24,9,0,1,0,0,1,1,0,2,269,0,0
경상북도,고령군,운수면,합계,1686,1225,182,827,104,59,28,2,2,2,0,2,1,2,6,1217,8,461
경상북도,고령군,운수면,운수면제1투,1063,702,79,515,53,26,10,2,1,1,0,1,0,2,4,694,8,361
경상북도,고령군,운수면,운수면제2투,354,254,46,163,26,9,9,0,0,1,0,0,0,0,0,254,0,100
경상북도,고령군,성산면,합계,2304,1707,227,1139,152,93,37,10,2,0,0,4,1,7,4,1676,31,597
경상북도,고령군,성산면,관내사전투표,329,329,51,208,34,20,9,3,0,0,0,2,0,1,0,328,1,0
경상북도,고령군,성산면,성산면제1투,1349,926,119,609,83,51,21,6,2,0,0,2,1,2,2,898,28,423
경상북도,고령군,성산면,성산면제2투,626,452,57,322,35,22,7,1,0,0,0,0,0,4,2,450,2,174
경상북도,고령군,다산면,관내사전투표,1171,1171,262,599,140,92,63,4,0,1,0,0,0,3,1,1165,6,0
경상북도,고령군,다산면,합계,6982,5007,861,2843,649,375,221,13,1,1,0,2,3,6,5,4980,27,1975
경상북도,고령군,다산면,다산면제1투,1743,1158,173,683,169,75,42,3,0,0,0,2,0,1,2,1150,8,585
경상북도,고령군,다산면,다산면제2투,3116,2026,372,1078,280,176,102,4,0,0,0,0,2,1,2,2017,9,1090
경상북도,고령군,다산면,다산면제3투,952,652,54,483,60,32,14,2,1,0,0,0,1,1,0,648,4,300
경상북도,고령군,개진면,관내사전투표,194,194,25,130,21,8,4,4,0,0,0,0,1,0,0,193,1,0
경상북도,고령군,개진면,합계,1708,1229,142,872,115,55,20,5,1,0,0,2,2,7,1,1222,7,479
경상북도,고령군,개진면,개진면제1투,728,487,54,346,47,19,11,1,1,0,0,1,1,1,1,483,4,241
경상북도,고령군,개진면,개진면제2투,786,548,63,396,47,28,5,0,0,0,0,1,0,6,0,546,2,238
경상북도,고령군,우곡면,관내사전투표,203,203,30,128,13,9,11,0,0,3,1,1,1,4,0,201,2,0
경상북도,고령군,우곡면,합계,1439,1065,142,712,77,53,41,1,0,4,2,2,3,7,5,1049,16,374
경상북도,고령군,우곡면,우곡면제1투,418,282,42,180,22,20,7,0,0,1,1,1,0,1,2,277,5,136
경상북도,고령군,우곡면,우곡면제2투,818,580,70,404,42,24,23,1,0,0,0,0,2,2,3,571,9,238
경상북도,고령군,쌍림면,관내사전투표,397,397,68,220,62,26,7,1,1,1,0,2,0,2,0,390,7,0
경상북도,고령군,쌍림면,합계,2969,2174,291,1465,239,98,36,4,1,3,1,3,4,6,4,2155,19,795
경상북도,고령군,쌍림면,쌍림면제1투,903,604,71,431,60,23,11,0,0,1,0,0,3,2,0,602,2,299
경상북도,고령군,쌍림면,쌍림면제2투,716,519,67,353,57,25,9,1,0,1,1,0,0,0,2,516,3,197
경상북도,고령군,쌍림면,쌍림면제3투,953,654,85,461,60,24,9,2,0,0,0,1,1,2,2,647,7,299
경상북도,고령군,잘못 투입·구분된 투표지,,0,0,0,0,0,0,0,0,0,0,0,0,0,0,0,0,0,0
경상북도,성주군,합계,,40284,30070,5409,16788,3586,2056,1714,60,14,24,15,33,31,83,57,29870,200,10214
경상북도,성주군,거소·선상투표,,100,86,24,29,21,6,0,0,1,1,0,1,0,0,2,85,1,14
경상북도,성주군,관외사전투표,,4074,4073,1086,1571,555,484,312,10,4,1,1,2,1,3,8,4038,35,1
경상북도,성주군,재외투표,,283,134,65,13,32,12,12,0,0,0,0,0,0,0,0,134,0,149
경상북도,성주군,성주읍,합계,10809,7646,1630,3772,901,553,682,9,0,3,4,11,6,11,13,7595,51,3163
경상북도,성주군,성주읍,관내사전투표,2057,2057,573,751,238,196,266,3,0,1,3,5,2,2,5,2045,12,0
경상북도,성주군,성주읍,성주읍제1투,1826,1210,227,694,157,59,61,0,0,0,0,2,0,0,2,1202,8,616
경상북도,성주군,성주읍,성주읍제2투,2519,1526,271,856,160,97,114,1,0,1,0,1,4,3,3,1511,15,993
경상북도,성주군,성주읍,성주읍제3투,2424,1534,308,748,197,118,144,4,0,1,0,2,0,4,2,1528,6,890
경상북도,성주군,성주읍,성주읍제4투,1983,1319,251,723,149,83,97,1,0,0,1,1,0,2,1,1309,10,664
경상북도,성주군,선남면,합계,5233,3773,503,2408,395,284,139,10,0,5,0,1,0,5,5,3755,18,1460
경상북도,성주군,선남면,관내사전투표,698,698,123,401,77,51,39,4,0,0,0,0,0,1,1,697,1,0
경상북도,성주군,선남면,선남면제1투,2183,1446,180,917,155,99,73,5,0,5,0,0,0,1,3,1438,8,737
경상북도,성주군,선남면,선남면제2투,2352,1629,200,1090,163,134,27,1,0,0,0,1,0,3,1,1620,9,723
경상북도,성주군,용암면,합계,3142,2249,307,1421,271,140,74,4,1,0,0,2,3,8,4,2235,14,893
경상북도,성주군,용암면,관내사전투표,573,573,94,341,64,41,19,1,0,0,0,1,2,3,2,568,5,0
경상북도,성주군,용암면,용암면제1투,1277,845,113,526,116,55,27,2,0,0,0,0,1,0,1,841,4,432
경상북도,성주군,용암면,용암면제2투,1292,831,100,554,91,44,28,1,1,0,0,1,0,5,1,826,5,461
경상북도,성주군,수륜면,합계,2451,1738,211,1153,199,84,50,5,0,5,3,2,5,9,3,1729,9,713
경상북도,성주군,수륜면,관내사전투표,487,487,67,314,49,25,18,1,0,1,1,2,1,5,1,485,2,0
경상북도,성주군,수륜면,수륜면제1투,1216,750,91,496,88,41,21,4,0,2,1,0,0,3,1,748,2,466
경상북도,성주군,수륜면,수륜면제2투,748,501,53,343,62,18,11,0,0,2,1,0,4,1,1,496,5,247
경상북도,성주군,가천면,합계,1729,1291,170,835,160,57,35,3,1,1,3,4,5,3,4,1281,10,438
경상북도,성주군,가천면,관내사전투표,365,365,62,219,43,20,11,2,1,0,2,1,2,0,1,364,1,0
경상북도,성주군,가천면,가천면투표소,1364,926,108,616,117,37,24,1,0,1,1,3,3,3,3,917,9,438
경상북도,성주군,금수면,합계,905,702,118,434,77,36,19,3,0,1,0,0,0,6,2,696,6,203
경상북도,성주군,금수면,관내사전투표,182,182,45,88,19,14,9,2,0,0,0,0,0,2,0,179,3,0
경상북도,성주군,금수면,금수면투표소,723,520,73,346,58,22,10,1,0,1,0,0,0,4,2,517,3,203
경상북도,성주군,대가면,합계,2033,1500,255,937,138,73,58,3,2,0,1,2,1,6,4,1480,20,533
경상북도,성주군,대가면,관내사전투표,400,400,72,233,47,20,20,1,0,0,0,1,1,2,0,397,3,0
경상북도,성주군,대가면,대가면투표소,1633,1100,183,704,91,53,38,2,2,0,1,1,0,4,4,1083,17,533
경상북도,성주군,벽진면,합계,2726,1956,310,1167,253,101,90,1,2,1,3,4,2,9,1,1944,12,770
경상북도,성주군,벽진면,관내사전투표,567,567,94,319,84,28,30,0,1,0,2,1,0,3,1,563,4,0
경상북도,성주군,벽진면,벽진면투표소,2159,1389,216,848,169,73,60,1,1,1,1,3,2,6,0,1381,8,770
경상북도,성주군,초전면,합계,4023,2881,489,1658,372,134,169,9,2,4,0,4,3,17,6,2867,14,1142
경상북도,성주군,초전면,관내사전투표,808,808,167,439,95,41,48,4,0,1,0,1,0,4,2,802,6,0
경상북도,성주군,초전면,초전면제1투,1730,1082,172,642,136,53,58,3,1,3,0,1,1,5,2,1077,5,648
경상북도,성주군,초전면,초전면제2투,1485,991,150,577,141,40,63,2,1,0,0,2,2,8,2,988,3,494
경상북도,성주군,월항면,합계,2776,2041,241,1390,212,92,74,3,1,2,0,0,5,6,5,2031,10,735
경상북도,성주군,월항면,관내사전투표,346,346,57,205,42,11,21,1,0,2,0,0,2,0,1,342,4,0
경상북도,성주군,월항면,월항면제1투,1592,1113,118,768,115,61,39,2,0,0,0,0,2,3,2,1110,3,479
경상북도,성주군,월항면,월항면제2투,838,582,66,417,55,20,14,0,1,0,0,0,1,3,2,579,3,256
경상북도,성주군,잘못 투입·구분된 투표지,,0,0,0,0,0,0,0,0,0,0,0,0,0,0,0,0,0,0
경상북도,칠곡군,합계,,98543,72006,16872,31540,11340,7063,4327,137,22,36,20,45,17,71,111,71601,405,26537
경상북도,칠곡군,거소·선상투표,,197,185,41,43,69,17,6,0,1,1,0,0,0,0,0,178,7,12
경상북도,칠곡군,관외사전투표,,8455,8451,2617,2440,1391,1130,724,16,6,4,2,5,3,5,25,8368,83,4
경상북도,칠곡군,재외투표,,392,246,119,25,62,14,23,1,0,0,0,0,0,1,1,246,0,146
경상북도,칠곡군,왜관읍,관내사전투표,4284,4284,1118,1791,597,442,280,8,0,3,1,2,0,2,8,4252,32,0
경상북도,칠곡군,왜관읍,합계,24651,17593,3479,8858,2582,1577,889,40,2,12,2,4,3,16,17,17481,112,7058
경상북도,칠곡군,왜관읍,왜관읍제1투,3186,1893,323,986,282,185,94,5,0,1,1,0,0,1,1,1879,14,1293
경상북도,칠곡군,왜관읍,왜관읍제2투,2179,1439,256,825,176,122,51,1,0,1,0,1,0,0,1,1434,5,740
경상북도,칠곡군,왜관읍,왜관읍제3투,1102,598,91,394,50,41,10,1,0,1,0,0,0,5,1,594,4,504
경상북도,칠곡군,왜관읍,왜관읍제4투,3445,2426,408,1272,376,228,122,5,0,1,0,0,0,1,2,2415,11,1019
경상북도,칠곡군,왜관읍,왜관읍제5투,3676,2452,513,1155,405,227,126,4,2,1,0,0,2,3,0,2438,14,1224
경상북도,칠곡군,왜관읍,왜관읍제6투,1740,1196,195,637,202,97,47,3,0,2,0,0,0,1,0,1184,12,544
경상북도,칠곡군,왜관읍,왜관읍제7투,1798,1159,175,692,141,81,46,5,0,2,0,1,1,1,2,1147,12,639
경상북도,칠곡군,왜관읍,왜관읍제8투,3241,2146,400,1106,353,154,113,8,0,0,0,0,0,2,2,2138,8,1095
경상북도,칠곡군,북삼읍,관내사전투표,3041,3041,887,1104,500,316,195,9,0,2,2,2,0,4,3,3024,17,0
경상북도,칠곡군,북삼읍,합계,17999,12371,2768,5562,2014,1207,662,34,3,5,7,14,3,9,18,12306,65,5628
경상북도,칠곡군,북삼읍,북삼읍제1투,2490,1491,302,686,228,167,94,1,0,0,2,2,0,2,3,1487,4,999
경상북도,칠곡군,북삼읍,북삼읍제2투,1498,969,108,662,121,44,25,0,0,0,0,1,0,0,1,962,7,529
경상북도,칠곡군,북삼읍,북삼읍제3투,2784,1603,348,705,302,152,66,9,0,0,0,2,2,0,4,1590,13,1181
경상북도,칠곡군,북삼읍,북삼읍제4투,2727,1612,362,751,237,165,79,4,1,0,0,1,0,1,1,1602,10,1115
경상북도,칠곡군,북삼읍,북삼읍제5투,2556,1627,244,954,213,135,60,5,1,1,1,2,0,1,2,1619,8,929
경상북도,칠곡군,북삼읍,북삼읍제6투,2903,2028,517,700,413,228,143,6,1,2,2,4,1,1,4,2022,6,875
경상북도,칠곡군,석적읍,관내사전투표,3560,3560,1516,642,571,438,365,4,0,2,1,3,0,3,4,3549,11,0
경상북도,칠곡군,석적읍,합계,23566,16426,5511,4113,3163,2000,1500,19,3,6,3,14,2,9,28,16371,55,7140
경상북도,칠곡군,석적읍,석적읍제1투,2960,2112,638,670,381,254,151,2,1,2,0,3,0,0,3,2105,7,848
경상북도,칠곡군,석적읍,석적읍제2투,3084,1772,569,349,316,275,244,1,0,1,0,2,1,1,3,1762,10,1312
경상북도,칠곡군,석적읍,석적읍제3투,4045,2668,889,634,549,316,253,4,1,1,1,1,0,0,8,2657,11,1377
경상북도,칠곡군,석적읍,석적읍제4투,3673,2867,870,745,659,343,231,4,0,0,0,1,1,1,5,2860,7,806
경상북도,칠곡군,석적읍,석적읍제5투,547,393,32,261,67,21,7,0,0,0,0,1,0,2,1,392,1,154
경상북도,칠곡군,석적읍,석적읍제6투,2676,1149,356,337,239,121,86,3,1,0,0,1,0,2,1,1147,2,1527
경상북도,칠곡군,석적읍,석적읍제7투,3021,1905,641,475,381,232,163,1,0,0,1,2,0,0,3,1899,6,1116
경상북도,칠곡군,지천면,합계,3845,2787,294,1931,290,182,62,4,0,0,0,1,0,2,6,2772,15,1058
경상북도,칠곡군,지천면,관내사전투표,823,823,90,572,75,54,24,1,0,0,0,1,0,2,1,820,3,0
경상북도,칠곡군,지천면,지천면제1투,2075,1306,141,880,145,93,32,3,0,0,0,0,0,0,3,1297,9,769
경상북도,칠곡군,지천면,지천면제2투,947,658,63,479,70,35,6,0,0,0,0,0,0,0,2,655,3,289
경상북도,칠곡군,동명면,합계,4708,3441,430,2259,394,248,69,5,1,3,3,2,1,7,5,3427,14,1267
경상북도,칠곡군,동명면,관내사전투표,867,867,133,550,87,68,15,0,1,3,1,1,1,4,0,864,3,0
경상북도,칠곡군,동명면,동명면제1투,1214,769,95,484,98,54,28,2,0,0,0,0,0,1,1,763,6,445
경상북도,칠곡군,동명면,동명면제2투,1348,877,100,618,83,56,10,3,0,0,0,0,0,2,3,875,2,471
경상북도,칠곡군,동명면,동명면제3투,1279,928,102,607,126,70,16,0,0,0,2,1,0,0,1,925,3,351
경상북도,칠곡군,가산면,합계,2993,2122,244,1414,256,126,49,4,1,1,1,0,1,10,3,2110,12,871
경상북도,칠곡군,가산면,관내사전투표,533,533,84,330,61,22,21,2,0,1,1,0,0,2,2,526,7,0
경상북도,칠곡군,가산면,가산면제1투,1353,822,78,576,95,45,15,2,1,0,0,0,0,6,1,819,3,531
경상북도,칠곡군,가산면,가산면제2투,795,555,63,354,71,51,12,0,0,0,0,0,1,2,0,554,1,240
경상북도,칠곡군,가산면,가산면제3투,312,212,19,154,29,8,1,0,0,0,0,0,0,0,0,211,1,100
경상북도,칠곡군,약목면,합계,8878,6266,984,3676,854,403,273,10,5,4,1,4,4,8,6,6232,34,2612
경상북도,칠곡군,약목면,관내사전투표,1553,1553,274,877,211,92,75,4,3,2,0,0,1,3,3,1545,8,0
경상북도,칠곡군,약목면,약목면제1투,1959,1311,149,894,147,66,43,1,0,1,0,2,1,2,2,1308,3,648
경상북도,칠곡군,약목면,약목면제2투,2348,1472,229,830,224,100,72,4,0,0,1,0,1,1,0,1462,10,876
경상북도,칠곡군,약목면,약목면제3투,1204,795,106,509,99,42,31,0,0,0,0,1,0,1,0,789,6,409
경상북도,칠곡군,약목면,약목면제4투,1814,1135,226,566,173,103,52,1,2,1,0,1,1,1,1,1128,7,679
경상북도,칠곡군,기산면,관내사전투표,549,549,126,276,71,41,30,0,0,0,1,1,0,1,0,547,2,0
경상북도,칠곡군,기산면,합계,2859,2118,385,1219,265,159,70,4,0,0,1,1,0,4,2,2110,8,741
경상북도,칠곡군,기산면,기산면제1투,1855,1263,202,747,165,104,32,4,0,0,0,0,0,3,2,1259,4,592
경상북도,칠곡군,기산면,기산면제2투,455,306,57,196,29,14,8,0,0,0,0,0,0,0,0,304,2,149
경상북도,칠곡군,잘못 투입·구분된 투표지,,0,0,0,0,0,0,0,0,0,0,0,0,0,0,0,0,0,0
경상북도,군위군,합계,,22560,17627,2251,11651,1939,1054,470,42,7,5,7,15,10,57,29,17537,90,4933
경상북도,군위군,거소·선상투표,,64,59,11,28,12,5,0,1,0,0,0,1,0,0,0,58,1,5
경상북도,군위군,관외사전투표,,2616,2616,600,1142,356,330,165,4,0,1,1,3,1,0,3,2606,10,0
경상북도,군위군,재외투표,,287,121,47,21,40,3,7,0,0,1,0,0,0,0,0,119,2,166
경상북도,군위군,군위읍,관내사전투표,2121,2121,326,1388,208,107,71,4,0,0,1,0,1,3,1,2110,11,0
경상북도,군위군,군위읍,합계,6553,4937,635,3291,541,263,144,7,0,0,1,3,3,10,7,4905,32,1616
경상북도,군위군,군위읍,군위읍제1투,1509,934,125,618,121,43,16,0,0,0,0,2,0,1,1,927,7,575
경상북도,군위군,군위읍,군위읍제2투,1516,924,123,565,123,65,39,2,0,0,0,1,0,2,2,922,2,592
경상북도,군위군,군위읍,군위읍제3투,703,476,30,353,40,35,10,1,0,0,0,0,1,3,1,474,2,227
경상북도,군위군,군위읍,군위읍제4투,704,482,31,367,49,13,8,0,0,0,0,0,1,1,2,472,10,222
경상북도,군위군,소보면,관내사전투표,579,579,67,409,45,25,24,0,0,0,0,0,2,3,2,577,2,0
경상북도,군위군,소보면,합계,1996,1469,146,1080,119,66,34,2,0,0,1,2,2,5,5,1462,7,527
경상북도,군위군,소보면,소보면제1투,854,522,47,395,42,24,5,1,0,0,1,1,0,2,2,520,2,332
경상북도,군위군,소보면,소보면제2투,563,368,32,276,32,17,5,1,0,0,0,1,0,0,1,365,3,195
경상북도,군위군,효령면,관내사전투표,889,889,100,627,96,39,8,0,4,1,1,2,1,6,0,885,4,0
경상북도,군위군,효령면,합계,3150,2417,270,1683,252,133,39,3,6,1,4,3,2,9,0,2405,12,733
경상북도,군위군,효령면,효령면제1투,1311,834,107,573,88,44,15,2,0,0,0,0,1,1,0,831,3,477
경상북도,군위군,효령면,효령면제2투,950,694,63,483,68,50,16,1,2,0,3,1,0,2,0,689,5,256
경상북도,군위군,부계면,관내사전투표,438,438,45,303,47,27,4,2,0,0,0,2,0,2,3,435,3,0
경상북도,군위군,부계면,합계,1670,1288,122,921,116,82,18,8,0,0,0,3,1,6,3,1280,8,382
경상북도,군위군,부계면,부계면제1투,554,351,44,242,25,29,5,1,0,0,0,0,1,1,0,348,3,203
경상북도,군위군,부계면,부계면제2투,678,499,33,376,44,26,9,5,0,0,0,1,0,3,0,497,2,179
경상북도,군위군,우보면,관내사전투표,566,566,50,419,62,20,7,1,0,1,0,0,0,2,1,563,3,0
경상북도,군위군,우보면,합계,1795,1383,113,1024,150,51,22,5,0,1,0,0,0,7,4,1377,6,412
경상북도,군위군,우보면,우보면제1투,799,519,48,381,56,18,9,3,0,0,0,0,0,2,0,517,2,280
경상북도,군위군,우보면,우보면제2투,430,298,15,224,32,13,6,1,0,0,0,0,0,3,3,297,1,132
경상북도,군위군,의흥면,합계,2230,1654,147,1218,182,67,22,2,1,0,0,0,0,8,2,1649,5,576
경상북도,군위군,의흥면,관내사전투표,682,682,66,491,82,24,9,2,1,0,0,0,0,2,1,678,4,0
경상북도,군위군,의흥면,의흥면제1투,1160,708,59,519,78,38,10,0,0,0,0,0,0,3,0,707,1,452
경상북도,군위군,의흥면,의흥면제2투,388,264,22,208,22,5,3,0,0,0,0,0,0,3,1,264,0,124
경상북도,군위군,산성면,합계,1083,841,64,625,97,26,12,6,0,0,0,0,1,6,2,839,2,242
경상북도,군위군,산성면,관내사전투표,194,194,14,149,17,9,3,1,0,0,0,0,0,1,0,194,0,0
경상북도,군위군,산성면,산성면제1투,421,305,22,228,36,9,3,0,0,0,0,0,0,3,2,303,2,116
경상북도,군위군,산성면,산성면제2투,468,342,28,248,44,8,6,5,0,0,0,0,1,2,0,342,0,126
경상북도,군위군,고로면,합계,1116,842,96,618,74,28,7,4,0,1,0,0,0,6,3,837,5,274
경상북도,군위군,고로면,관내사전투표,235,235,28,170,20,12,2,1,0,1,0,0,0,1,0,235,0,0
경상북도,군위군,고로면,고로면제1투,379,232,29,159,29,7,2,0,0,0,0,0,0,2,1,229,3,147
경상북도,군위군,고로면,고로면제2투,502,375,39,289,25,9,3,3,0,0,0,0,0,3,2,373,2,127
경상북도,군위군,잘못 투입·구분된 투표지,,0,0,0,0,0,0,0,0,0,0,0,0,0,0,0,0,0,0
경상북도,의성군,합계,,49768,37855,5365,23790,4767,2184,1023,78,13,21,20,72,49,139,61,37582,273,11913
경상북도,의성군,거소·선상투표,,161,150,36,57,30,8,3,0,0,0,0,1,0,1,1,137,13,11
경상북도,의성군,관외사전투표,,3889,3889,1128,1374,540,503,298,8,0,2,2,2,0,1,3,3861,28,0
경상북도,의성군,재외투표,,637,243,73,40,96,10,17,3,0,1,0,0,0,0,0,240,3,394
경상북도,의성군,의성읍,관내사전투표,2820,2820,594,1480,389,216,104,7,1,0,0,1,2,1,5,2800,20,0
경상북도,의성군,의성읍,합계,11137,8045,1322,4765,1102,525,224,16,1,2,2,7,6,10,11,7993,52,3092
경상북도,의성군,의성읍,의성읍제1투,1389,782,99,520,93,48,15,2,0,1,0,0,0,0,0,778,4,607
경상북도,의성군,의성읍,의성읍제2투,2434,1520,262,890,211,99,38,3,0,1,1,2,2,1,1,1511,9,914
경상북도,의성군,의성읍,의성읍제3투,2338,1486,222,907,224,69,41,3,0,0,1,1,1,1,2,1472,14,852
경상북도,의성군,의성읍,의성읍제4투,2156,1437,145,968,185,93,26,1,0,0,0,3,1,7,3,1432,5,719
경상북도,의성군,단촌면,합계,1828,1388,161,948,145,73,21,4,2,4,0,5,4,4,3,1374,14,440
경상북도,의성군,단촌면,관내사전투표,430,430,55,282,43,28,8,2,1,2,0,2,1,1,0,425,5,0
경상북도,의성군,단촌면,단촌면투표소,1398,958,106,666,102,45,13,2,1,2,0,3,3,3,3,949,9,440
경상북도,의성군,점곡면,합계,1508,1121,161,716,140,49,26,1,1,1,0,10,1,8,3,1117,4,387
경상북도,의성군,점곡면,관내사전투표,452,452,89,268,60,16,12,0,0,0,0,3,0,2,0,450,2,0
경상북도,의성군,점곡면,점곡면투표소,1056,669,72,448,80,33,14,1,1,1,0,7,1,6,3,667,2,387
경상북도,의성군,옥산면,관내사전투표,512,512,83,287,79,36,14,1,0,0,1,0,1,4,0,506,6,0
경상북도,의성군,옥산면,합계,1655,1264,171,801,170,70,28,2,0,0,2,1,3,6,2,1256,8,391
경상북도,의성군,옥산면,옥산면투표소,1143,752,88,514,91,34,14,1,0,0,1,1,2,2,2,750,2,391
경상북도,의성군,사곡면,합계,1437,1096,102,748,149,54,23,4,2,0,1,3,0,4,2,1092,4,341
경상북도,의성군,사곡면,관내사전투표,432,432,38,287,66,22,11,2,1,0,1,1,0,1,1,431,1,0
경상북도,의성군,사곡면,사곡면투표소,1005,664,64,461,83,32,12,2,1,0,0,2,0,3,1,661,3,341
경상북도,의성군,춘산면,관내사전투표,269,269,38,181,28,12,6,1,0,0,1,0,0,1,0,268,1,0
경상북도,의성군,춘산면,합계,1298,984,102,686,113,52,10,1,1,0,2,3,1,5,0,976,8,314
경상북도,의성군,춘산면,춘산면투표소,1029,715,64,505,85,40,4,0,1,0,1,3,1,4,0,708,7,314
경상북도,의성군,가음면,합계,1327,1008,115,663,139,54,22,0,1,2,0,2,1,2,3,1004,4,319
경상북도,의성군,가음면,관내사전투표,423,423,39,281,58,26,12,0,0,1,0,2,1,0,1,421,2,0
경상북도,의성군,가음면,가음면투표소,904,585,76,382,81,28,10,0,1,1,0,0,0,2,2,583,2,319
경상북도,의성군,금성면,관내사전투표,1194,1194,147,805,131,62,23,1,0,3,1,8,3,2,0,1186,8,0
경상북도,의성군,금성면,합계,3907,2940,338,2000,332,159,56,3,1,3,1,14,6,12,1,2926,14,967
경상북도,의성군,금성면,금성면제1투,1575,995,106,684,114,54,21,1,1,0,0,4,2,4,1,992,3,580
경상북도,의성군,금성면,금성면제2투,1138,751,85,511,87,43,12,1,0,0,0,2,1,6,0,748,3,387
경상북도,의성군,봉양면,합계,3361,2554,274,1781,303,98,66,1,0,0,2,3,3,6,3,2540,14,807
경상북도,의성군,봉양면,관내사전투표,909,909,104,620,120,30,23,0,0,0,0,1,0,3,2,903,6,0
경상북도,의성군,봉양면,봉양면제1투,638,475,45,350,49,16,7,0,0,0,1,0,2,2,0,472,3,163
경상북도,의성군,봉양면,봉양면제2투,1814,1170,125,811,134,52,36,1,0,0,1,2,1,1,1,1165,5,644
경상북도,의성군,비안면,합계,2048,1491,145,1055,184,48,25,2,1,4,1,3,2,7,3,1480,11,557
경상북도,의성군,비안면,관내사전투표,496,496,53,341,56,21,13,0,0,1,0,0,2,3,1,491,5,0
경상북도,의성군,비안면,비안면투표소,1552,995,92,714,128,27,12,2,1,3,1,3,0,4,2,989,6,557
경상북도,의성군,구천면,관내사전투표,496,496,58,345,56,20,6,0,0,0,1,0,0,3,0,489,7,0
경상북도,의성군,구천면,합계,1645,1193,127,819,157,42,19,4,0,0,1,4,2,4,2,1181,12,452
경상북도,의성군,구천면,구천면투표소,1149,697,69,474,101,22,13,4,0,0,0,4,2,1,2,692,5,452
경상북도,의성군,단밀면,관내사전투표,506,506,55,348,57,18,11,0,1,0,1,1,1,5,2,500,6,0
경상북도,의성군,단밀면,합계,1606,1186,123,833,131,44,23,0,1,0,2,5,2,10,2,1176,10,420
경상북도,의성군,단밀면,단밀면투표소,1100,680,68,485,74,26,12,0,0,0,1,4,1,5,0,676,4,420
경상북도,의성군,단북면,관내사전투표,584,584,39,420,69,28,9,3,0,1,0,1,0,7,3,580,4,0
경상북도,의성군,단북면,합계,1625,1278,92,913,158,60,22,4,0,1,0,1,2,9,4,1266,12,347
경상북도,의성군,단북면,단북면투표소,1041,694,53,493,89,32,13,1,0,0,0,0,2,2,1,686,8,347
경상북도,의성군,안계면,관내사전투표,1288,1288,146,870,149,66,35,6,0,0,0,0,3,2,4,1281,7,0
경상북도,의성군,안계면,합계,3826,2917,329,1997,333,143,72,9,0,0,0,1,3,7,5,2899,18,909
경상북도,의성군,안계면,안계면제1투,1349,859,101,597,91,40,20,2,0,0,0,0,0,1,1,853,6,490
경상북도,의성군,안계면,안계면제2투,1189,770,82,530,93,37,17,1,0,0,0,1,0,4,0,765,5,419
경상북도,의성군,다인면,합계,3470,2555,277,1786,281,112,35,9,1,1,2,1,5,19,6,2535,20,915
경상북도,의성군,다인면,관내사전투표,986,986,106,699,105,34,15,1,0,1,1,0,3,8,4,977,9,0
경상북도,의성군,다인면,다인면제1투,1306,822,87,575,94,42,8,5,0,0,0,1,0,3,0,815,7,484
경상북도,의성군,다인면,다인면제2투,1178,747,84,512,82,36,12,3,1,0,1,0,2,8,2,743,4,431
경상북도,의성군,신평면,합계,741,611,65,412,78,26,9,1,0,0,0,2,2,7,3,605,6,130
경상북도,의성군,신평면,관내사전투표,292,292,26,198,39,17,4,1,0,0,0,0,0,2,2,289,3,0
경상북도,의성군,신평면,신평면투표소,449,319,39,214,39,9,5,0,0,0,0,2,2,5,1,316,3,130
경상북도,의성군,안평면,합계,1888,1354,144,989,137,37,18,3,0,0,2,3,4,7,2,1346,8,534
경상북도,의성군,안평면,관내사전투표,555,555,60,416,48,10,8,0,0,0,2,0,1,3,1,549,6,0
경상북도,의성군,안평면,안평면투표소,1333,799,84,573,89,27,10,3,0,0,0,3,3,4,1,797,2,534
경상북도,의성군,안사면,합계,774,588,80,407,49,17,6,3,1,0,0,1,2,10,2,578,10,186
경상북도,의성군,안사면,관내사전투표,235,235,40,154,14,8,5,2,1,0,0,0,1,2,1,228,7,0
경상북도,의성군,안사면,안사면투표소,539,353,40,253,35,9,1,1,0,0,0,1,1,8,1,350,3,186
경상북도,의성군,잘못 투입·구분된 투표지,,0,0,0,0,0,0,0,0,0,0,0,0,0,0,0,0,0,0
경상북도,청송군,합계,,23810,18418,3218,10669,2387,1180,605,37,5,14,29,20,23,90,25,18302,116,5392
경상북도,청송군,거소·선상투표,,106,96,21,31,23,5,1,0,2,1,0,1,1,5,0,91,5,10
경상북도,청송군,관외사전투표,,2178,2178,659,714,340,277,161,2,0,0,0,3,1,1,3,2161,17,0
경상북도,청송군,재외투표,,188,86,29,14,28,4,9,2,0,0,0,0,0,0,0,86,0,102
경상북도,청송군,청송읍,합계,4382,3308,601,1846,436,247,111,12,1,3,7,2,4,10,4,3284,24,1074
경상북도,청송군,청송읍,관내사전투표,1289,1289,302,620,165,113,67,6,0,1,2,1,1,2,0,1280,9,0
경상북도,청송군,청송읍,청송읍제1투,1009,630,99,368,94,39,12,1,0,2,3,1,2,1,1,623,7,379
경상북도,청송군,청송읍,청송읍제2투,546,348,43,212,50,22,8,4,0,0,0,0,0,2,2,343,5,198
경상북도,청송군,청송읍,청송읍제3투,933,614,94,383,78,38,11,1,0,0,2,0,1,3,0,611,3,319
경상북도,청송군,청송읍,청송읍제4투,605,427,63,263,49,35,13,0,1,0,0,0,0,2,1,427,0,178
경상북도,청송군,부동면,합계,1600,1168,177,732,149,57,23,0,1,1,4,2,4,6,2,1158,10,432
경상북도,청송군,부동면,관내사전투표,300,300,38,194,42,14,9,0,0,0,0,0,2,0,0,299,1,0
경상북도,청송군,부동면,부동면제1투,679,415,58,273,49,19,6,0,1,1,0,0,2,0,0,409,6,264
경상북도,청송군,부동면,부동면제2투,621,453,81,265,58,24,8,0,0,0,4,2,0,6,2,450,3,168
경상북도,청송군,부남면,합계,2238,1731,252,1087,226,89,45,2,1,3,1,0,3,10,3,1722,9,507
경상북도,청송군,부남면,관내사전투표,662,662,98,411,90,33,19,0,0,2,1,0,1,4,0,659,3,0
경상북도,청송군,부남면,부남면제1투,729,470,72,303,50,30,11,0,0,0,0,0,0,2,1,469,1,259
경상북도,청송군,부남면,부남면제2투,847,599,82,373,86,26,15,2,1,1,0,0,2,4,2,594,5,248
경상북도,청송군,현동면,관내사전투표,569,569,74,374,70,26,12,1,0,1,0,1,1,4,2,566,3,0
경상북도,청송군,현동면,합계,1843,1402,177,946,164,57,30,1,0,2,0,4,2,7,3,1393,9,441
경상북도,청송군,현동면,현동면투표소,1274,833,103,572,94,31,18,0,0,1,0,3,1,3,1,827,6,441
경상북도,청송군,현서면,합계,2175,1678,263,1057,225,70,32,5,0,2,1,4,1,10,0,1670,8,497
경상북도,청송군,현서면,관내사전투표,510,510,112,290,69,20,10,2,0,0,0,0,0,4,0,507,3,0
경상북도,청송군,현서면,현서면제1투,1146,774,111,514,94,28,14,2,0,2,1,1,1,3,0,771,3,372
경상북도,청송군,현서면,현서면제2투,519,394,40,253,62,22,8,1,0,0,0,3,0,3,0,392,2,125
경상북도,청송군,안덕면,합계,2224,1699,205,1154,193,77,28,6,0,1,1,4,2,15,4,1690,9,525
경상북도,청송군,안덕면,관내사전투표,637,637,89,430,72,24,11,1,0,1,0,1,1,4,1,635,2,0
경상북도,청송군,안덕면,안덕면제1투,1190,785,83,529,93,45,15,2,0,0,1,3,1,6,1,779,6,405
경상북도,청송군,안덕면,안덕면제2투,397,277,33,195,28,8,2,3,0,0,0,0,0,5,2,276,1,120
경상북도,청송군,파천면,합계,1554,1171,154,782,129,53,33,2,0,0,2,0,1,7,1,1164,7,383
경상북도,청송군,파천면,관내사전투표,257,257,51,152,30,14,7,0,0,0,0,0,1,1,0,256,1,0
경상북도,청송군,파천면,파천면제1투,704,478,54,326,52,18,20,2,0,0,1,0,0,4,0,477,1,226
경상북도,청송군,파천면,파천면제2투,593,436,49,304,47,21,6,0,0,0,1,0,0,2,1,431,5,157
경상북도,청송군,진보면,관내사전투표,1027,1027,231,517,146,75,45,1,0,1,4,0,2,1,1,1024,3,0
경상북도,청송군,진보면,합계,5322,3901,680,2306,474,244,132,5,0,1,13,0,4,19,5,3883,18,1421
경상북도,청송군,진보면,진보면제1투,1319,842,101,575,87,51,16,2,0,0,1,0,0,5,3,841,1,477
경상북도,청송군,진보면,진보면제2투,1406,911,150,545,114,49,37,0,0,0,3,0,2,6,1,907,4,495
경상북도,청송군,진보면,진보면제3투,759,519,112,288,52,46,16,0,0,0,0,0,0,3,0,517,2,240
경상북도,청송군,진보면,진보면제4투,811,602,86,381,75,23,18,2,0,0,5,0,0,4,0,594,8,209
경상북도,청송군,잘못 투입·구분된 투표지,,0,0,0,0,0,0,0,0,0,0,0,0,0,0,0,0,0,0
경상북도,영양군,합계,,15705,12048,2281,6554,1701,697,438,20,6,14,145,3,12,57,21,11949,99,3657
경상북도,영양군,거소·선상투표,,77,74,10,34,11,1,1,2,2,0,1,0,1,2,1,66,8,3
경상북도,영양군,관외사전투표,,1326,1326,459,372,205,165,101,3,0,2,9,0,1,0,2,1319,7,0
경상북도,영양군,재외투표,,67,46,22,2,15,2,3,2,0,0,0,0,0,0,0,46,0,21
경상북도,영양군,영양읍,관내사전투표,1574,1574,386,754,199,121,79,0,1,1,12,1,1,6,3,1564,10,0
경상북도,영양군,영양읍,합계,5847,4380,816,2440,576,280,164,5,2,3,39,2,3,17,9,4356,24,1467
경상북도,영양군,영양읍,영양읍제1투,1702,1115,172,656,161,63,35,1,0,0,9,0,1,6,2,1106,9,587
경상북도,영양군,영양읍,영양읍제2투,1351,920,141,554,128,50,24,3,0,2,9,0,0,2,3,916,4,431
경상북도,영양군,영양읍,영양읍제3투,1220,771,117,476,88,46,26,1,1,0,9,1,1,3,1,770,1,449
경상북도,영양군,입암면,관내사전투표,717,717,98,469,85,33,15,0,0,0,6,0,0,5,2,713,4,0
경상북도,영양군,입암면,합계,1929,1417,196,906,186,69,31,1,0,1,12,0,0,8,2,1412,5,512
경상북도,영양군,입암면,입암면투표소,1212,700,98,437,101,36,16,1,0,1,6,0,0,3,0,699,1,512
경상북도,영양군,청기면,합계,1556,1149,168,735,151,46,16,5,0,2,7,1,2,6,3,1142,7,407
경상북도,영양군,청기면,관내사전투표,224,224,48,123,32,10,6,0,0,0,3,0,0,1,1,224,0,0
경상북도,영양군,청기면,청기면제1투,831,550,73,362,71,23,8,3,0,2,1,0,2,0,1,546,4,281
경상북도,영양군,청기면,청기면제2투,501,375,47,250,48,13,2,2,0,0,3,1,0,5,1,372,3,126
경상북도,영양군,일월면,합계,1555,1188,202,691,175,44,46,1,0,2,4,0,1,8,1,1175,13,367
경상북도,영양군,일월면,관내사전투표,380,380,76,197,69,11,16,1,0,0,1,0,0,6,0,377,3,0
경상북도,영양군,일월면,일월면투표소,1175,808,126,494,106,33,30,0,0,2,3,0,1,2,1,798,10,367
경상북도,영양군,수비면,합계,1468,1061,188,576,177,35,50,0,2,2,5,0,3,8,1,1047,14,407
경상북도,영양군,수비면,관내사전투표,281,281,79,120,47,7,16,0,1,0,3,0,1,3,0,277,4,0
경상북도,영양군,수비면,수비면투표소,1187,780,109,456,130,28,34,0,1,2,2,0,2,5,1,770,10,407
경상북도,영양군,석보면,관내사전투표,316,316,64,168,43,14,7,0,0,1,14,0,0,2,2,315,1,0
경상북도,영양군,석보면,합계,1880,1407,220,798,205,55,26,1,0,2,68,0,1,8,2,1386,21,473
경상북도,영양군,석보면,석보면제1투,1153,798,120,465,117,26,16,0,0,1,41,0,0,5,0,791,7,355
경상북도,영양군,석보면,석보면제2투,411,293,36,165,45,15,3,1,0,0,13,0,1,1,0,280,13,118
경상북도,영양군,잘못 투입·구분된 투표지,,0,0,0,0,0,0,0,0,0,0,0,0,0,0,0,0,0,0
경상북도,영덕군,합계,,34714,26125,3786,16314,3231,1513,807,46,8,14,11,18,33,82,45,25908,217,8589
경상북도,영덕군,거소·선상투표,,167,148,25,64,31,6,2,1,1,0,2,1,0,2,0,135,13,19
경상북도,영덕군,관외사전투표,,2774,2774,753,963,474,314,229,3,0,2,0,1,3,2,7,2751,23,0
경상북도,영덕군,재외투표,,156,84,44,10,20,5,4,1,0,0,0,0,0,0,0,84,0,72
경상북도,영덕군,영덕읍,합계,8858,6544,1041,3998,766,433,215,17,4,2,2,6,2,9,10,6505,39,2314
경상북도,영덕군,영덕읍,관내사전투표,2195,2195,459,1148,271,180,105,7,0,1,0,4,1,2,4,2182,13,0
경상북도,영덕군,영덕읍,영덕읍제1투,2085,1366,250,728,198,112,55,8,1,0,1,1,0,1,2,1357,9,719
경상북도,영덕군,영덕읍,영덕읍제2투,1862,1237,142,867,130,64,21,2,1,1,0,0,1,1,1,1231,6,625
경상북도,영덕군,영덕읍,영덕읍제3투,1648,1093,137,753,103,57,30,0,1,0,1,1,0,2,2,1087,6,555
경상북도,영덕군,영덕읍,영덕읍제4투,1068,653,53,502,64,20,4,0,1,0,0,0,0,3,1,648,5,415
경상북도,영덕군,강구면,합계,5509,3777,419,2609,434,182,74,5,0,3,0,4,3,8,6,3747,30,1732
경상북도,영덕군,강구면,관내사전투표,762,762,112,467,106,45,19,0,0,1,0,1,0,3,0,754,8,0
경상북도,영덕군,강구면,강구면제1투,1711,1056,113,753,94,55,27,1,0,2,0,0,1,1,2,1049,7,655
경상북도,영덕군,강구면,강구면제2투,1809,1240,111,893,141,53,19,0,0,0,0,3,1,3,3,1227,13,569
경상북도,영덕군,강구면,강구면제3투,1227,719,83,496,93,29,9,4,0,0,0,0,1,1,1,717,2,508
경상북도,영덕군,남정면,합계,2186,1593,143,1112,188,78,43,3,0,2,1,1,1,11,1,1584,9,593
경상북도,영덕군,남정면,관내사전투표,454,454,40,314,51,27,16,0,0,1,0,0,0,1,0,450,4,0
경상북도,영덕군,남정면,남정면제1투,1176,758,74,512,98,41,21,1,0,0,0,1,1,7,0,756,2,418
경상북도,영덕군,남정면,남정면제2투,556,381,29,286,39,10,6,2,0,1,1,0,0,3,1,378,3,175
경상북도,영덕군,달산면,합계,1034,764,86,514,96,31,10,4,0,0,0,1,2,10,2,756,8,270
경상북도,영덕군,달산면,관내사전투표,173,173,34,89,27,11,6,2,0,0,0,0,0,2,0,171,2,0
경상북도,영덕군,달산면,달산면제1투,633,417,37,306,49,7,3,1,0,0,0,0,2,6,1,412,5,216
경상북도,영덕군,달산면,달산면제2투,228,174,15,119,20,13,1,1,0,0,0,1,0,2,1,173,1,54
경상북도,영덕군,지품면,관내사전투표,314,314,50,188,33,25,8,0,0,0,0,0,3,3,1,311,3,0
경상북도,영덕군,지품면,합계,1847,1416,175,944,174,68,20,1,1,0,2,0,5,6,4,1400,16,431
경상북도,영덕군,지품면,지품면제1투,1028,717,65,520,86,29,6,0,0,0,2,0,0,0,3,711,6,311
경상북도,영덕군,지품면,지품면제2투,505,385,60,236,55,14,6,1,1,0,0,0,2,3,0,378,7,120
경상북도,영덕군,축산면,합계,2481,1852,197,1323,206,69,29,1,1,1,0,0,5,4,1,1837,15,629
경상북도,영덕군,축산면,관내사전투표,611,611,76,439,49,24,13,0,0,0,0,0,3,0,0,604,7,0
경상북도,영덕군,축산면,축산면제1투,632,451,47,332,39,18,6,1,1,1,0,0,2,1,1,449,2,181
경상북도,영덕군,축산면,축산면제2투,1238,790,74,552,118,27,10,0,0,0,0,0,0,3,0,784,6,448
경상북도,영덕군,영해면,합계,5550,4047,575,2586,507,213,100,5,1,2,1,1,4,15,6,4016,31,1503
경상북도,영덕군,영해면,관내사전투표,1263,1263,208,749,163,76,45,2,0,0,1,1,0,5,2,1252,11,0
경상북도,영덕군,영해면,영해면제1투,1302,794,122,503,100,42,16,0,0,0,0,0,1,2,2,788,6,508
경상북도,영덕군,영해면,영해면제2투,1559,1037,154,661,127,59,21,3,0,2,0,0,0,2,1,1030,7,522
경상북도,영덕군,영해면,영해면제3투,1426,953,91,673,117,36,18,0,1,0,0,0,3,6,1,946,7,473
경상북도,영덕군,병곡면,합계,2550,1903,182,1356,202,68,47,4,0,1,0,2,5,5,6,1878,25,647
경상북도,영덕군,병곡면,관내사전투표,658,658,71,471,65,22,19,0,0,0,0,1,1,2,2,654,4,0
경상북도,영덕군,병곡면,병곡면제1투,816,493,53,345,48,18,14,2,0,0,0,1,2,1,2,486,7,323
경상북도,영덕군,병곡면,병곡면제2투,1076,752,58,540,89,28,14,2,0,1,0,0,2,2,2,738,14,324
경상북도,영덕군,창수면,관내사전투표,338,338,51,219,38,22,5,0,0,1,1,0,0,0,0,337,1,0
경상북도,영덕군,창수면,합계,1602,1223,146,835,133,46,34,1,0,1,3,1,3,10,2,1215,8,379
경상북도,영덕군,창수면,창수면제1투,755,519,57,365,51,19,16,0,0,0,2,0,0,6,0,516,3,236
경상북도,영덕군,창수면,창수면제2투,509,366,38,251,44,5,13,1,0,0,0,1,3,4,2,362,4,143
경상북도,영덕군,잘못 투입·구분된 투표지,,0,0,0,0,0,0,0,0,0,0,0,0,0,0,0,0,0,0
경상북도,봉화군,합계,,29612,22947,4209,12536,3370,1423,934,45,9,29,9,29,31,108,51,22783,164,6665
경상북도,봉화군,거소·선상투표,,155,139,19,64,33,2,6,1,1,1,0,0,1,3,0,131,8,16
경상북도,봉화군,관외사전투표,,2515,2515,844,737,421,277,198,10,1,3,0,1,1,2,5,2500,15,0
경상북도,봉화군,재외투표,,96,73,41,9,11,5,7,0,0,0,0,0,0,0,0,73,0,23
경상북도,봉화군,봉화읍,합계,8172,6196,1128,3407,859,437,268,12,0,5,2,8,3,11,12,6152,44,1976
경상북도,봉화군,봉화읍,관내사전투표,2286,2286,546,1078,303,195,134,5,0,3,0,1,0,4,2,2271,15,0
경상북도,봉화군,봉화읍,봉화읍제1투,1818,1155,196,630,175,87,53,1,0,2,1,1,1,1,1,1149,6,663
경상북도,봉화군,봉화읍,봉화읍제2투,1522,1004,147,606,137,55,37,1,0,0,1,5,0,3,0,992,12,518
경상북도,봉화군,봉화읍,봉화읍제3투,1403,922,130,582,127,44,28,0,0,0,0,1,0,1,4,917,5,481
경상북도,봉화군,봉화읍,봉화읍제4투,1143,829,109,511,117,56,16,5,0,0,0,0,2,2,5,823,6,314
경상북도,봉화군,물야면,합계,2673,2002,283,1200,312,107,64,2,0,1,2,4,2,10,4,1991,11,671
경상북도,봉화군,물야면,관내사전투표,406,406,76,202,66,33,23,0,0,0,0,0,1,2,1,404,2,0
경상북도,봉화군,물야면,물야면제1투,1099,765,92,456,129,46,24,1,0,0,2,2,1,4,2,759,6,334
경상북도,봉화군,물야면,물야면제2투,1168,831,115,542,117,28,17,1,0,1,0,2,0,4,1,828,3,337
경상북도,봉화군,봉성면,합계,1813,1357,173,842,189,79,42,2,2,0,0,3,3,8,3,1346,11,456
경상북도,봉화군,봉성면,관내사전투표,236,236,42,121,39,20,9,0,0,0,0,0,1,2,1,235,1,0
경상북도,봉화군,봉성면,봉성면제1투,692,486,48,310,77,27,11,1,1,0,0,1,2,3,1,482,4,206
경상북도,봉화군,봉성면,봉성면제2투,885,635,83,411,73,32,22,1,1,0,0,2,0,3,1,629,6,250
경상북도,봉화군,법전면,관내사전투표,304,304,51,178,46,7,13,1,0,0,0,2,0,3,0,301,3,0
경상북도,봉화군,법전면,합계,1749,1285,161,804,200,45,42,3,0,1,0,2,5,9,1,1273,12,464
경상북도,봉화군,법전면,법전면투표소,1445,981,110,626,154,38,29,2,0,1,0,0,5,6,1,972,9,464
경상북도,봉화군,춘양면,합계,3950,3094,471,1860,460,141,101,4,1,3,3,3,5,20,5,3077,17,856
경상북도,봉화군,춘양면,관내사전투표,992,992,175,573,131,56,40,1,0,2,1,1,0,6,1,987,5,0
경상북도,봉화군,춘양면,춘양면제1투,920,623,74,401,95,26,15,1,1,0,0,0,0,4,0,617,6,297
경상북도,봉화군,춘양면,춘양면제2투,1043,776,100,494,120,32,22,2,0,0,0,1,0,3,1,775,1,267
경상북도,봉화군,춘양면,춘양면제3투,995,703,122,392,114,27,24,0,0,1,2,1,5,7,3,698,5,292
경상북도,봉화군,소천면,합계,1949,1478,263,837,196,94,42,3,3,4,1,1,5,12,4,1465,13,471
경상북도,봉화군,소천면,관내사전투표,336,336,81,161,49,25,12,0,1,2,0,1,0,2,0,334,2,0
경상북도,봉화군,소천면,소천면제1투,609,385,43,249,48,27,7,1,1,0,0,0,3,4,1,384,1,224
경상북도,봉화군,소천면,소천면제2투,486,368,56,212,52,24,8,2,1,2,0,0,1,1,2,361,7,118
경상북도,봉화군,소천면,소천면제3투,518,389,83,215,47,18,15,0,0,0,1,0,1,5,1,386,3,129
경상북도,봉화군,석포면,합계,1702,1232,308,591,185,66,65,1,0,3,0,0,2,5,1,1227,5,470
경상북도,봉화군,석포면,관내사전투표,408,408,109,175,63,35,20,1,0,1,0,0,1,2,0,407,1,0
경상북도,봉화군,석포면,석포면투표소,1294,824,199,416,122,31,45,0,0,2,0,0,1,3,1,820,4,470
경상북도,봉화군,재산면,관내사전투표,292,292,65,149,49,14,7,1,0,0,0,0,0,4,1,290,2,0
경상북도,봉화군,재산면,합계,1384,992,190,518,168,53,32,1,0,4,1,3,1,11,5,987,5,392
경상북도,봉화군,재산면,재산면투표소,1092,700,125,369,119,39,25,0,0,4,1,3,1,7,4,697,3,392
경상북도,봉화군,명호면,합계,1878,1392,207,861,185,57,43,3,0,4,0,4,1,10,3,1378,14,486
경상북도,봉화군,명호면,관내사전투표,375,375,86,201,51,21,11,0,0,2,0,2,0,1,0,375,0,0
경상북도,봉화군,명호면,명호면투표소,1503,1017,121,660,134,36,32,3,0,2,0,2,1,9,3,1003,14,486
경상북도,봉화군,상운면,합계,1576,1192,121,806,151,60,24,3,1,0,0,0,2,7,8,1183,9,384
경상북도,봉화군,상운면,관내사전투표,307,307,40,192,44,19,6,0,0,0,0,0,0,2,1,304,3,0
경상북도,봉화군,상운면,상운면투표소,1269,885,81,614,107,41,18,3,1,0,0,0,2,5,7,879,6,384
경상북도,봉화군,잘못 투입·구분된 투표지,,0,0,0,0,0,0,0,0,0,0,0,0,0,0,0,0,0,0
경상북도,울진군,합계,,43754,32568,6972,16867,4476,2275,1434,38,10,31,8,34,37,106,57,32345,223,11186
경상북도,울진군,거소·선상투표,,180,170,41,65,39,2,4,1,0,0,1,1,1,1,1,157,13,10
경상북도,울진군,관외사전투표,,3424,3424,1182,836,565,479,304,4,1,0,0,8,0,3,6,3388,36,0
경상북도,울진군,재외투표,,170,117,65,7,28,4,13,0,0,0,0,0,0,0,0,117,0,53
경상북도,울진군,울진읍,합계,10369,7818,1918,3706,1056,643,408,9,1,9,1,7,3,12,9,7782,36,2551
경상북도,울진군,울진읍,관내사전투표,2594,2594,810,1008,306,268,178,4,1,1,1,5,2,0,2,2586,8,0
경상북도,울진군,울진읍,울진읍제1투,1833,1172,240,653,153,69,47,1,0,0,0,0,0,4,0,1167,5,661
경상북도,울진군,울진읍,울진읍제2투,1879,1244,297,576,200,101,58,2,0,2,0,1,1,1,2,1241,3,635
경상북도,울진군,울진읍,울진읍제3투,2275,1567,313,807,242,119,68,0,0,4,0,0,0,3,3,1559,8,708
경상북도,울진군,울진읍,울진읍제4투,1788,1241,258,662,155,86,57,2,0,2,0,1,0,4,2,1229,12,547
경상북도,울진군,평해읍,합계,2557,1829,236,1251,197,82,33,1,0,2,0,0,5,7,4,1818,11,728
경상북도,울진군,평해읍,관내사전투표,699,699,107,466,68,33,15,1,0,1,0,0,3,2,1,697,2,0
경상북도,울진군,평해읍,평해읍제1투,883,523,56,364,58,27,13,0,0,1,0,0,0,0,1,520,3,360
경상북도,울진군,평해읍,평해읍제2투,975,607,73,421,71,22,5,0,0,0,0,0,2,5,2,601,6,368
경상북도,울진군,북면,관내사전투표,1572,1572,504,612,228,108,90,2,2,1,0,5,1,9,3,1565,7,0
경상북도,울진군,북면,합계,5384,4108,1173,1689,640,309,230,6,2,6,0,9,2,15,8,4089,19,1276
경상북도,울진군,북면,북면제1투,1939,1120,220,546,191,83,57,4,0,4,0,4,0,5,2,1116,4,819
경상북도,울진군,북면,북면제2투,509,367,50,224,57,15,14,0,0,1,0,0,0,1,0,362,5,142
경상북도,울진군,북면,북면제3투,1364,1049,399,307,164,103,69,0,0,0,0,0,1,0,3,1046,3,315
경상북도,울진군,금강송면,합계,1204,917,150,602,91,39,17,1,1,0,0,0,3,8,1,913,4,287
경상북도,울진군,금강송면,관내사전투표,364,364,62,230,40,14,12,0,0,0,0,0,1,4,0,363,1,0
경상북도,울진군,금강송면,금강송면제1투,621,377,50,274,29,11,4,1,1,0,0,0,1,3,1,375,2,244
경상북도,울진군,금강송면,금강송면제2투,219,176,38,98,22,14,1,0,0,0,0,0,1,1,0,175,1,43
경상북도,울진군,근남면,관내사전투표,608,608,119,342,75,40,16,1,0,1,0,1,0,7,0,602,6,0
경상북도,울진군,근남면,합계,2383,1756,307,1017,230,112,46,6,0,3,1,1,2,13,4,1742,14,627
경상북도,울진군,근남면,근남면투표소,1775,1148,188,675,155,72,30,5,0,2,1,0,2,6,4,1140,8,627
경상북도,울진군,매화면,합계,1933,1419,206,899,182,47,45,1,1,1,3,1,4,16,5,1411,8,514
경상북도,울진군,매화면,관내사전투표,674,674,111,421,74,21,24,1,1,1,1,0,2,10,3,670,4,0
경상북도,울진군,매화면,매화면투표소,1259,745,95,478,108,26,21,0,0,0,2,1,2,6,2,741,4,514
경상북도,울진군,기성면,합계,2325,1608,211,1043,231,59,28,1,0,3,0,0,6,12,0,1594,14,717
경상북도,울진군,기성면,관내사전투표,679,679,102,412,107,25,17,0,0,2,0,0,3,6,0,674,5,0
경상북도,울진군,기성면,기성면투표소,1646,929,109,631,124,34,11,1,0,1,0,0,3,6,0,920,9,717
경상북도,울진군,온정면,합계,1631,1214,127,881,118,38,22,1,0,2,1,1,5,6,5,1207,7,417
경상북도,울진군,온정면,관내사전투표,413,413,54,291,37,16,8,0,0,1,0,1,0,1,3,412,1,0
경상북도,울진군,온정면,온정면투표소,1218,801,73,590,81,22,14,1,0,1,1,0,5,5,2,795,6,417
경상북도,울진군,죽변면,합계,5734,3810,746,2048,556,224,172,4,2,2,0,5,4,5,8,3776,34,1924
경상북도,울진군,죽변면,관내사전투표,1602,1602,318,886,219,76,72,2,0,0,0,4,1,3,5,1586,16,0
경상북도,울진군,죽변면,죽변면제1투,1628,794,108,483,110,50,28,0,0,1,0,1,2,0,2,785,9,834
경상북도,울진군,죽변면,죽변면제2투,2504,1414,320,679,227,98,72,2,2,1,0,0,1,2,1,1405,9,1090
경상북도,울진군,후포면,합계,6460,4378,610,2823,543,237,112,3,2,3,1,1,2,8,6,4351,27,2082
경상북도,울진군,후포면,관내사전투표,1263,1263,208,779,139,79,46,0,1,1,0,0,0,0,0,1253,10,0
경상북도,울진군,후포면,후포면제1투,1341,840,73,611,100,34,8,1,1,1,0,1,2,2,1,835,5,501
경상북도,울진군,후포면,후포면제2투,1849,1074,140,697,154,51,18,2,0,0,0,0,0,2,3,1067,7,775
경상북도,울진군,후포면,후포면제3투,2007,1201,189,736,150,73,40,0,0,1,1,0,0,4,2,1196,5,806
경상북도,울진군,잘못 투입·구분된 투표지,,0,0,0,0,0,0,0,0,0,0,0,0,0,0,0,0,0,0
경상남도,합계,,,2744633,2135055,779731,790491,284272,142479,113051,2290,458,1240,721,1394,1011,2234,3267,2122639,12416,609578
경상남도,창원시의창구,합계,,207375,164047,60757,56887,22830,12134,9772,196,31,102,44,118,51,77,224,163223,824,43328
경상남도,창원시의창구,거소·선상투표,,710,673,190,177,177,58,27,6,2,2,1,3,1,2,5,651,22,37
경상남도,창원시의창구,관외사전투표,,19542,19535,8205,4520,3044,1915,1548,25,4,11,7,18,6,6,43,19352,183,7
경상남도,창원시의창구,재외투표,,1006,721,396,52,121,46,93,9,0,0,0,0,0,1,1,719,2,285
경상남도,창원시의창구,동읍,관내사전투표,2843,2843,1261,874,351,189,142,3,0,3,1,2,1,1,6,2834,9,0
경상남도,창원시의창구,동읍,합계,16643,12675,4706,4776,1680,773,609,15,2,10,5,11,5,5,21,12618,57,3968
경상남도,창원시의창구,동읍,동읍제1투,1389,1081,423,267,229,101,50,1,0,1,0,1,0,1,2,1076,5,308
경상남도,창원시의창구,동읍,동읍제2투,2697,1790,614,763,213,83,101,2,0,3,1,1,0,0,3,1784,6,907
경상남도,창원시의창구,동읍,동읍제3투,1862,1358,487,563,164,72,61,1,0,0,0,0,1,1,0,1350,8,504
경상남도,창원시의창구,동읍,동읍제4투,2539,1927,796,604,268,129,102,3,0,3,0,5,0,1,5,1916,11,612
경상남도,창원시의창구,동읍,동읍제5투,2650,1819,639,738,226,110,93,2,1,0,1,0,0,1,2,1813,6,831
경상남도,창원시의창구,동읍,동읍제6투,1467,1035,271,512,136,61,38,2,1,0,1,1,3,0,1,1027,8,432
경상남도,창원시의창구,동읍,동읍제7투,1196,822,215,455,93,28,22,1,0,0,1,1,0,0,2,818,4,374
경상남도,창원시의창구,북면,관내사전투표,2975,2975,1201,1004,343,219,165,11,1,3,3,6,0,1,1,2958,17,0
경상남도,창원시의창구,북면,합계,20643,16230,6022,5887,2224,1105,824,34,3,6,5,15,5,13,19,16162,68,4413
경상남도,창원시의창구,북면,북면제1투,3806,3037,1246,966,461,215,126,2,0,1,0,1,1,4,4,3027,10,769
경상남도,창원시의창구,북면,북면제2투,4550,3567,1406,1153,518,260,201,6,0,1,0,1,1,2,4,3553,14,983
경상남도,창원시의창구,북면,북면제3투,5138,3921,1502,1297,576,282,230,6,0,0,1,3,2,4,6,3909,12,1217
경상남도,창원시의창구,북면,북면제4투,3275,2094,550,1056,270,99,91,8,2,1,0,3,0,1,4,2085,9,1181
경상남도,창원시의창구,북면,북면제5투,899,636,117,411,56,30,11,1,0,0,1,1,1,1,0,630,6,263
경상남도,창원시의창구,대산면,관내사전투표,759,759,347,251,83,30,39,2,0,0,0,3,1,0,2,758,1,0
경상남도,창원시의창구,대산면,합계,5850,4163,1433,1913,439,174,134,5,2,0,1,5,5,8,12,4131,32,1687
경상남도,창원시의창구,대산면,대산면제1투,1526,1073,337,542,90,53,24,2,1,0,0,1,3,2,6,1061,12,453
경상남도,창원시의창구,대산면,대산면제2투,2451,1570,456,790,186,61,50,1,1,0,0,1,0,4,4,1554,16,881
경상남도,창원시의창구,대산면,대산면제3투,1114,761,293,330,80,30,21,0,0,0,1,0,1,2,0,758,3,353
경상남도,창원시의창구,의창동,합계,28099,21314,7153,8667,2741,1444,1109,19,4,15,4,10,10,6,26,21208,106,6785
경상남도,창원시의창구,의창동,관내사전투표,4168,4168,1588,1544,489,266,245,4,0,3,1,4,3,1,4,4152,16,0
경상남도,창원시의창구,의창동,의창동제1투,2208,1513,391,800,177,68,64,0,0,0,0,0,1,1,0,1502,11,695
경상남도,창원시의창구,의창동,의창동제2투,3076,2268,655,1047,296,155,103,1,0,2,0,0,0,1,2,2262,6,808
경상남도,창원시의창구,의창동,의창동제3투,2951,2173,780,786,292,166,124,4,0,2,0,1,2,0,5,2162,11,778
경상남도,창원시의창구,의창동,의창동제4투,3218,2229,713,963,279,131,116,4,0,1,0,2,0,1,4,2214,15,989
경상남도,창원시의창구,의창동,의창동제5투,2837,2041,673,877,242,135,92,1,3,1,2,1,2,0,2,2031,10,796
경상남도,창원시의창구,의창동,의창동제6투,2923,2061,680,774,298,170,117,2,0,1,1,1,0,1,2,2047,14,862
경상남도,창원시의창구,의창동,의창동제7투,2062,1528,465,667,212,97,69,1,0,2,0,1,1,0,4,1519,9,534
경상남도,창원시의창구,의창동,의창동제8투,1896,1448,429,683,166,98,59,1,1,2,0,0,1,1,1,1442,6,448
경상남도,창원시의창구,의창동,의창동제9투,2760,1885,779,526,290,158,120,1,0,1,0,0,0,0,2,1877,8,875
경상남도,창원시의창구,팔룡동,합계,27858,22425,8722,7197,3158,1767,1400,23,5,15,4,7,3,4,26,22331,94,5433
경상남도,창원시의창구,팔룡동,관내사전투표,5735,5735,2589,1495,721,481,408,2,1,4,1,3,0,0,5,5710,25,0
경상남도,창원시의창구,팔룡동,팔룡동제1투,2748,1985,695,733,288,156,100,3,0,0,1,1,0,0,2,1979,6,763
경상남도,창원시의창구,팔룡동,팔룡동제2투,2565,1654,551,649,227,108,102,1,1,3,0,1,0,1,3,1647,7,911
경상남도,창원시의창구,팔룡동,팔룡동제3투,2950,1995,656,768,310,147,99,3,2,0,1,0,1,0,2,1989,6,955
경상남도,창원시의창구,팔룡동,팔룡동제4투,2998,2314,963,620,334,196,181,3,0,3,0,0,0,0,4,2304,10,684
경상남도,창원시의창구,팔룡동,팔룡동제5투,3277,2722,1138,798,407,195,167,1,0,0,0,0,1,0,3,2710,12,555
경상남도,창원시의창구,팔룡동,팔룡동제6투,3149,2369,886,810,314,182,145,6,0,5,1,1,1,2,4,2357,12,780
경상남도,창원시의창구,팔룡동,팔룡동제7투,2536,2061,788,645,292,164,153,4,1,0,0,1,0,0,3,2051,10,475
경상남도,창원시의창구,팔룡동,팔룡동제8투,1900,1590,456,679,265,138,45,0,0,0,0,0,0,1,0,1584,6,310
경상남도,창원시의창구,명곡동,합계,37884,29017,10188,10760,3949,2080,1800,23,3,20,5,16,8,10,26,28888,129,8867
경상남도,창원시의창구,명곡동,관내사전투표,6827,6826,2833,2073,880,515,469,8,0,2,2,5,2,4,4,6797,29,1
경상남도,창원시의창구,명곡동,명곡동제1투,3334,2451,798,996,304,170,163,0,0,2,0,0,0,1,3,2437,14,883
경상남도,창원시의창구,명곡동,명곡동제2투,3413,2581,893,864,399,189,216,0,0,1,0,0,2,0,3,2567,14,832
경상남도,창원시의창구,명곡동,명곡동제3투,2911,2228,817,769,294,181,148,2,1,0,1,1,0,0,4,2218,10,683
경상남도,창원시의창구,명곡동,명곡동제4투,2587,1672,617,568,244,134,94,0,0,0,1,1,1,1,4,1665,7,915
경상남도,창원시의창구,명곡동,명곡동제5투,2696,2173,768,779,333,199,81,0,1,1,0,1,1,1,1,2166,7,523
경상남도,창원시의창구,명곡동,명곡동제6투,2674,1797,596,749,235,110,91,1,1,1,0,1,0,0,1,1786,11,877
경상남도,창원시의창구,명곡동,명곡동제7투,2977,2094,621,918,269,142,125,1,0,3,0,2,0,1,3,2085,9,883
경상남도,창원시의창구,명곡동,명곡동제8투,2968,2029,607,848,287,144,124,3,0,3,0,3,0,2,2,2023,6,939
경상남도,창원시의창구,명곡동,명곡동제9투,2817,1950,601,843,251,134,105,1,0,5,0,1,1,0,0,1942,8,867
경상남도,창원시의창구,명곡동,명곡동제10투,2266,1588,527,645,225,79,99,1,0,1,1,0,1,0,0,1579,9,678
경상남도,창원시의창구,명곡동,명곡동제11투,2414,1628,510,708,228,83,85,6,0,1,0,1,0,0,1,1623,5,786
경상남도,창원시의창구,봉림동,합계,27120,20029,7252,7245,2779,1432,1110,26,4,18,9,22,8,14,28,19947,82,7091
경상남도,창원시의창구,봉림동,관내사전투표,4415,4415,1882,1327,564,329,277,8,0,1,1,5,2,3,3,4402,13,0
경상남도,창원시의창구,봉림동,봉림동제1투,3412,2275,748,928,309,154,112,4,0,5,2,1,1,1,1,2266,9,1137
경상남도,창원시의창구,봉림동,봉림동제2투,3006,2067,683,821,312,145,89,2,0,2,1,1,1,1,1,2059,8,939
경상남도,창원시의창구,봉림동,봉림동제3투,2931,1965,664,768,269,113,136,2,1,2,0,1,0,2,2,1960,5,966
경상남도,창원시의창구,봉림동,봉림동제4투,2797,1938,675,706,293,129,111,0,2,2,1,1,0,5,3,1928,10,859
경상남도,창원시의창구,봉림동,봉림동제5투,3719,2547,935,916,357,167,136,4,0,2,3,2,2,1,6,2531,16,1172
경상남도,창원시의창구,봉림동,봉림동제6투,3606,2546,872,958,359,191,133,4,1,3,0,9,0,0,6,2536,10,1060
경상남도,창원시의창구,봉림동,봉림동제7투,3234,2276,793,821,316,204,116,2,0,1,1,2,2,1,6,2265,11,958
경상남도,창원시의창구,용지동,합계,22020,17264,6489,5693,2518,1340,1118,11,2,5,3,11,0,8,17,17215,49,4756
경상남도,창원시의창구,용지동,관내사전투표,4064,4064,1811,1096,526,319,291,6,1,0,1,1,0,1,2,4055,9,0
경상남도,창원시의창구,용지동,용지동제1투,1653,1212,483,393,154,96,74,1,0,1,0,1,0,1,4,1208,4,441
경상남도,창원시의창구,용지동,용지동제2투,2369,1776,602,648,288,127,103,0,1,0,0,2,0,2,0,1773,3,593
경상남도,창원시의창구,용지동,용지동제3투,2577,1905,725,578,306,158,126,0,0,2,0,1,0,0,4,1900,5,672
경상남도,창원시의창구,용지동,용지동제4투,2795,1962,647,768,257,162,111,1,0,1,0,2,0,1,5,1955,7,833
경상남도,창원시의창구,용지동,용지동제5투,3669,2471,814,952,378,163,150,3,0,0,0,0,0,3,2,2465,6,1198
경상남도,창원시의창구,용지동,용지동제6투,2812,2274,782,776,369,193,144,0,0,1,1,2,0,0,0,2268,6,538
경상남도,창원시의창구,용지동,용지동제7투,2081,1600,625,482,240,122,119,0,0,0,1,2,0,0,0,1591,9,481
경상남도,창원시의창구,잘못 투입·구분된 투표지,,0,1,1,0,0,0,0,0,0,0,0,0,0,0,0,1,0,-1
경상남도,창원시성산구,합계,,183547,153327,63717,42052,22923,12512,10826,152,17,55,31,116,41,49,156,152647,680,30220
경상남도,창원시성산구,거소·선상투표,,533,512,161,121,137,44,19,2,0,3,0,0,0,3,2,492,20,21
경상남도,창원시성산구,관외사전투표,,18125,18125,7863,3500,3098,1920,1498,16,7,4,6,27,8,9,35,17991,134,0
경상남도,창원시성산구,재외투표,,981,740,414,58,117,57,88,0,0,0,0,0,1,0,0,735,5,241
경상남도,창원시성산구,반송동,관내사전투표,6164,6164,2952,1441,811,497,431,3,0,3,2,4,0,0,4,6148,16,0
경상남도,창원시성산구,반송동,합계,32323,27172,10873,8370,3978,2098,1660,34,2,11,8,14,7,6,19,27080,92,5151
경상남도,창원시성산구,반송동,반송동제1투,2071,1727,612,595,252,153,98,5,0,1,0,1,0,1,1,1719,8,344
경상남도,창원시성산구,반송동,반송동제2투,2294,1919,736,621,272,159,115,2,0,1,0,0,1,1,2,1910,9,375
경상남도,창원시성산구,반송동,반송동제3투,2040,1713,687,522,269,126,99,5,0,0,1,0,0,1,1,1711,2,327
경상남도,창원시성산구,반송동,반송동제4투,2114,1778,744,503,288,140,97,0,1,1,0,0,0,0,1,1775,3,336
경상남도,창원시성산구,반송동,반송동제5투,2082,1765,725,491,304,147,88,3,0,0,0,1,0,1,1,1761,4,317
경상남도,창원시성산구,반송동,반송동제6투,2229,1839,727,521,323,161,92,6,1,0,3,0,0,0,1,1835,4,390
경상남도,창원시성산구,반송동,반송동제7투,2605,2147,791,682,326,177,157,2,0,1,0,2,0,0,2,2140,7,458
경상남도,창원시성산구,반송동,반송동제8투,2799,2024,689,810,283,115,112,2,0,1,1,0,2,0,2,2017,7,775
경상남도,창원시성산구,반송동,반송동제9투,2634,1909,632,747,258,142,106,1,0,1,0,0,1,1,3,1892,17,725
경상남도,창원시성산구,반송동,반송동제10투,2603,1893,721,690,254,115,96,0,0,0,0,3,2,1,0,1882,11,710
경상남도,창원시성산구,반송동,반송동제11투,2688,2294,857,747,338,166,169,5,0,2,1,3,1,0,1,2290,4,394
경상남도,창원시성산구,중앙동,합계,18858,13618,5398,4086,2009,1054,980,14,0,4,2,8,1,3,11,13570,48,5240
경상남도,창원시성산구,중앙동,관내사전투표,3412,3412,1575,842,444,252,273,2,0,0,0,4,1,0,4,3397,15,0
경상남도,창원시성산구,중앙동,중앙동제1투,2437,1433,499,513,202,103,108,2,0,0,0,0,0,0,2,1429,4,1004
경상남도,창원시성산구,중앙동,중앙동제2투,2735,1487,510,533,223,117,98,1,0,0,0,0,0,1,1,1484,3,1248
경상남도,창원시성산구,중앙동,중앙동제3투,2306,1504,469,623,212,109,81,0,0,0,1,0,0,0,0,1495,9,802
경상남도,창원시성산구,중앙동,중앙동제4투,2580,1684,674,488,268,135,102,6,0,0,0,3,0,1,4,1681,3,896
경상남도,창원시성산구,중앙동,중앙동제5투,2250,1605,648,460,230,124,135,2,0,0,0,1,0,0,0,1600,5,645
경상남도,창원시성산구,중앙동,중앙동제6투,3138,2493,1023,627,430,214,183,1,0,4,1,0,0,1,0,2484,9,645
경상남도,창원시성산구,상남동,합계,23124,19307,8053,5297,2983,1584,1244,24,5,5,6,15,5,5,13,19239,68,3817
경상남도,창원시성산구,상남동,관내사전투표,6618,6618,3139,1479,912,550,481,7,3,3,3,7,1,2,4,6591,27,0
경상남도,창원시성산구,상남동,상남동제1투,2675,2118,863,570,322,178,171,1,0,0,0,3,0,0,2,2110,8,557
경상남도,창원시성산구,상남동,상남동제2투,2160,1578,624,497,211,130,106,2,0,0,0,0,0,1,0,1571,7,582
경상남도,창원시성산구,상남동,상남동제3투,2708,2204,817,664,396,191,124,2,0,1,1,0,0,1,1,2198,6,504
경상남도,창원시성산구,상남동,상남동제4투,2851,2261,807,741,405,181,111,3,1,0,1,2,1,0,2,2255,6,590
경상남도,창원시성산구,상남동,상남동제5투,3119,2478,1031,677,412,190,149,4,1,0,1,2,2,0,4,2473,5,641
경상남도,창원시성산구,상남동,상남동제6투,2993,2050,772,669,325,164,102,5,0,1,0,1,1,1,0,2041,9,943
경상남도,창원시성산구,사파동,합계,37394,30567,12968,8406,4358,2419,2179,22,1,9,3,26,6,14,26,30437,130,6827
경상남도,창원시성산구,사파동,관내사전투표,7024,7023,3482,1572,862,552,511,9,1,1,1,4,0,2,4,7001,22,1
경상남도,창원시성산구,사파동,사파동제1투,3909,2796,1073,878,425,228,175,3,0,2,0,2,0,0,2,2788,8,1113
경상남도,창원시성산구,사파동,사파동제2투,2746,2009,689,778,279,126,116,2,0,1,0,1,2,3,3,2000,9,737
경상남도,창원시성산구,사파동,사파동제3투,1670,1301,531,370,175,113,100,2,0,0,0,0,0,1,3,1295,6,369
경상남도,창원시성산구,사파동,사파동제4투,3009,2352,960,653,362,177,177,0,0,3,1,4,0,0,0,2337,15,657
경상남도,창원시성산구,사파동,사파동제5투,3196,2498,1014,755,348,208,148,1,0,1,0,6,0,1,3,2485,13,698
경상남도,창원시성산구,사파동,사파동제6투,2583,2142,859,607,317,179,163,1,0,0,0,4,1,1,2,2134,8,441
경상남도,창원시성산구,사파동,사파동제7투,2015,1294,412,514,216,74,65,0,0,0,0,2,1,1,1,1286,8,721
경상남도,창원시성산구,사파동,사파동제8투,2843,2224,938,607,330,162,170,1,0,1,0,0,1,4,3,2217,7,619
경상남도,창원시성산구,사파동,사파동제9투,2961,2408,1045,617,343,217,169,0,0,0,1,2,0,0,2,2396,12,553
경상남도,창원시성산구,사파동,사파동제10투,2407,2024,865,496,304,180,165,0,0,0,0,0,0,0,2,2012,12,383
경상남도,창원시성산구,사파동,사파동제11투,3031,2496,1100,559,397,203,220,3,0,0,0,1,1,1,1,2486,10,535
경상남도,창원시성산구,가음정동,합계,27032,22378,9470,6144,3167,1767,1649,27,1,11,3,15,5,4,29,22292,86,4654
경상남도,창원시성산구,가음정동,관내사전투표,5706,5706,2807,1268,693,449,439,10,0,3,2,3,0,0,7,5681,25,0
경상남도,창원시성산구,가음정동,가음정동제1투,2129,1630,678,432,238,152,119,1,1,1,0,1,0,0,2,1625,5,499
경상남도,창원시성산구,가음정동,가음정동제2투,657,461,184,124,77,34,37,1,0,1,0,1,0,0,0,459,2,196
경상남도,창원시성산구,가음정동,가음정동제3투,2060,1567,571,510,234,120,119,3,0,0,0,2,2,0,0,1561,6,493
경상남도,창원시성산구,가음정동,가음정동제4투,3070,2461,1009,696,380,200,162,3,0,3,0,0,0,0,3,2456,5,609
경상남도,창원시성산구,가음정동,가음정동제5투,2810,2336,935,679,353,171,181,1,0,0,0,3,1,1,2,2327,9,474
경상남도,창원시성산구,가음정동,가음정동제6투,2472,2036,806,625,281,183,132,1,0,1,0,1,0,0,1,2031,5,436
경상남도,창원시성산구,가음정동,가음정동제7투,2450,1785,631,671,219,142,104,2,0,1,1,1,1,1,5,1779,6,665
경상남도,창원시성산구,가음정동,가음정동제8투,2310,1828,826,421,288,126,146,3,0,0,0,3,0,1,4,1818,10,482
경상남도,창원시성산구,가음정동,가음정동제9투,3368,2568,1023,718,404,190,210,2,0,1,0,0,1,1,5,2555,13,800
경상남도,창원시성산구,성주동,합계,18327,15410,6531,4083,2329,1202,1155,7,1,5,2,7,6,4,13,15345,65,2917
경상남도,창원시성산구,성주동,관내사전투표,3356,3356,1641,770,405,240,274,1,0,2,1,2,2,0,1,3339,17,0
경상남도,창원시성산구,성주동,성주동제1투,3063,2467,937,786,402,188,141,1,1,1,0,1,1,0,2,2461,6,596
경상남도,창원시성산구,성주동,성주동제2투,1628,1176,512,242,170,88,153,0,0,0,1,0,1,0,0,1167,9,452
경상남도,창원시성산구,성주동,성주동제3투,2984,2288,985,585,338,146,211,1,0,1,0,3,1,3,3,2277,11,696
경상남도,창원시성산구,성주동,성주동제4투,2073,1747,771,400,263,144,154,1,0,1,0,1,0,0,4,1739,8,326
경상남도,창원시성산구,성주동,성주동제5투,2832,2377,906,722,420,204,114,1,0,0,0,0,1,1,2,2371,6,455
경상남도,창원시성산구,성주동,성주동제6투,2391,1999,779,578,331,192,108,2,0,0,0,0,0,0,1,1991,8,392
경상남도,창원시성산구,웅남동,합계,6850,5498,1986,1987,747,367,354,6,0,3,1,4,2,1,8,5466,32,1352
경상남도,창원시성산구,웅남동,관내사전투표,1389,1389,579,424,188,91,93,1,0,0,1,1,0,0,2,1380,9,0
경상남도,창원시성산구,웅남동,웅남동제1투,1316,931,282,415,116,57,54,0,0,1,0,0,0,0,0,925,6,385
경상남도,창원시성산구,웅남동,웅남동제2투,1912,1451,546,492,203,98,104,0,0,0,0,1,0,1,1,1446,5,461
경상남도,창원시성산구,웅남동,웅남동제3투,1662,1276,441,488,176,82,70,4,0,1,0,2,0,0,3,1267,9,386
경상남도,창원시성산구,웅남동,웅남동제4투,571,451,138,168,64,39,33,1,0,1,0,0,2,0,2,448,3,120
경상남도,창원시성산구,잘못 투입·구분된 투표지,,0,0,0,0,0,0,0,0,0,0,0,0,0,0,0,0,0,0
경상남도,창원시마산합포구,합계,,153651,119281,35592,54488,14686,7491,5887,112,18,58,46,50,28,63,160,118679,602,34370
경상남도,창원시마산합포구,거소·선상투표,,472,433,103,142,108,27,18,4,0,1,1,1,0,2,8,415,18,39
경상남도,창원시마산합포구,관외사전투표,,11805,11805,4626,3237,1744,1089,945,12,1,5,3,15,1,6,26,11710,95,0
경상남도,창원시마산합포구,재외투표,,1086,657,350,60,137,28,78,1,0,0,0,0,0,0,1,655,2,429
경상남도,창원시마산합포구,구산면,합계,3931,2795,573,1723,252,122,78,2,1,3,2,1,0,7,8,2772,23,1136
경상남도,창원시마산합포구,구산면,관내사전투표,501,501,133,264,50,27,22,0,1,0,0,0,0,1,0,498,3,0
경상남도,창원시마산합포구,구산면,구산면제1투,1251,843,183,494,79,39,30,2,0,0,0,0,0,3,3,833,10,408
경상남도,창원시마산합포구,구산면,구산면제2투,2179,1451,257,965,123,56,26,0,0,3,2,1,0,3,5,1441,10,728
경상남도,창원시마산합포구,진동면,합계,10166,7679,2371,3516,938,417,365,13,2,4,1,5,2,6,8,7648,31,2487
경상남도,창원시마산합포구,진동면,관내사전투표,2135,2135,790,834,262,113,117,3,0,2,1,2,1,1,5,2131,4,0
경상남도,창원시마산합포구,진동면,진동면제1투,936,662,133,428,55,29,9,0,1,0,0,1,0,1,0,657,5,274
경상남도,창원시마산합포구,진동면,진동면제2투,2841,1916,507,954,238,96,101,2,1,0,0,1,1,4,1,1906,10,925
경상남도,창원시마산합포구,진동면,진동면제3투,1830,1206,273,685,131,57,44,4,0,1,0,1,0,0,2,1198,8,624
경상남도,창원시마산합포구,진동면,진동면제4투,2424,1760,668,615,252,122,94,4,0,1,0,0,0,0,0,1756,4,664
경상남도,창원시마산합포구,진북면,합계,3295,2271,488,1339,235,107,71,0,1,1,3,1,2,3,4,2255,16,1024
경상남도,창원시마산합포구,진북면,관내사전투표,623,623,158,330,71,36,21,0,0,1,0,0,0,0,2,619,4,0
경상남도,창원시마산합포구,진북면,진북면제1투,1891,1186,251,702,129,50,40,0,0,0,2,1,2,0,2,1179,7,705
경상남도,창원시마산합포구,진북면,진북면제2투,781,462,79,307,35,21,10,0,1,0,1,0,0,3,0,457,5,319
경상남도,창원시마산합포구,진전면,합계,3478,2563,500,1629,221,92,64,2,2,3,1,2,2,11,6,2535,28,915
경상남도,창원시마산합포구,진전면,관내사전투표,638,638,115,419,46,22,20,0,2,1,0,1,0,3,1,630,8,0
경상남도,창원시마산합포구,진전면,진전면제1투,1595,1019,212,636,87,43,23,1,0,2,1,0,2,2,2,1011,8,576
경상남도,창원시마산합포구,진전면,진전면제2투,1245,906,173,574,88,27,21,1,0,0,0,1,0,6,3,894,12,339
경상남도,창원시마산합포구,현동,합계,6853,5414,1928,2143,669,387,241,4,0,1,1,0,2,6,4,5386,28,1439
경상남도,창원시마산합포구,현동,관내사전투표,1436,1436,623,462,169,103,67,0,0,0,0,0,0,4,1,1429,7,0
경상남도,창원시마산합포구,현동,현동제1투,1763,1279,403,569,148,96,52,0,0,0,0,0,0,1,0,1269,10,484
경상남도,창원시마산합포구,현동,현동제2투,427,312,68,196,25,17,3,0,0,0,0,0,1,0,0,310,2,115
경상남도,창원시마산합포구,현동,현동제3투,3227,2387,834,916,327,171,119,4,0,1,1,0,1,1,3,2378,9,840
경상남도,창원시마산합포구,가포동,합계,922,709,215,328,90,44,27,0,0,1,0,0,0,0,0,705,4,213
경상남도,창원시마산합포구,가포동,관내사전투표,336,336,124,131,42,24,13,0,0,1,0,0,0,0,0,335,1,0
경상남도,창원시마산합포구,가포동,가포동투표소,586,373,91,197,48,20,14,0,0,0,0,0,0,0,0,370,3,213
경상남도,창원시마산합포구,월영동,합계,21962,17310,5599,7023,2309,1281,970,14,1,6,7,6,4,2,18,17240,70,4652
경상남도,창원시마산합포구,월영동,관내사전투표,4013,4013,1511,1320,482,352,322,1,1,0,1,0,0,0,2,3992,21,0
경상남도,창원시마산합포구,월영동,월영동제1투,1785,1155,306,551,168,79,42,1,0,0,1,2,0,0,1,1151,4,630
경상남도,창원시마산합포구,월영동,월영동제2투,2113,1360,322,713,165,77,66,2,0,0,2,1,0,0,6,1354,6,753
경상남도,창원시마산합포구,월영동,월영동제3투,1645,1204,359,541,148,90,56,1,0,1,0,0,1,0,3,1200,4,441
경상남도,창원시마산합포구,월영동,월영동제4투,2725,1983,616,864,262,122,102,4,0,3,1,1,0,0,0,1975,8,742
경상남도,창원시마산합포구,월영동,월영동제5투,2075,1628,476,741,222,118,66,0,0,0,1,1,0,0,1,1626,2,447
경상남도,창원시마산합포구,월영동,월영동제6투,2570,2016,689,796,280,150,84,1,0,1,0,1,0,0,1,2003,13,554
경상남도,창원시마산합포구,월영동,월영동제7투,2536,1987,647,808,261,143,111,3,0,1,0,0,3,1,1,1979,8,549
경상남도,창원시마산합포구,월영동,월영동제8투,2500,1964,673,689,321,150,121,1,0,0,1,0,0,1,3,1960,4,536
경상남도,창원시마산합포구,문화동,합계,10277,7900,2200,3826,966,472,364,11,1,4,7,4,2,3,7,7867,33,2377
경상남도,창원시마산합포구,문화동,관내사전투표,2471,2471,824,1066,282,135,140,5,0,3,1,0,1,1,1,2459,12,0
경상남도,창원시마산합포구,문화동,문화동제1투,2736,1854,471,949,220,109,91,2,1,0,2,2,1,0,2,1850,4,882
경상남도,창원시마산합포구,문화동,문화동제2투,2264,1511,357,777,215,89,58,3,0,1,0,2,0,0,0,1502,9,753
경상남도,창원시마산합포구,문화동,문화동제3투,2806,2064,548,1034,249,139,75,1,0,0,4,0,0,2,4,2056,8,742
경상남도,창원시마산합포구,완월동,합계,8593,6561,1770,3204,753,405,344,13,2,9,2,4,4,1,14,6525,36,2032
경상남도,창원시마산합포구,완월동,관내사전투표,1734,1734,593,706,174,127,114,0,1,2,2,0,1,0,5,1725,9,0
경상남도,창원시마산합포구,완월동,완월동제1투,1742,1098,252,604,129,53,38,7,0,1,0,1,2,0,3,1090,8,644
경상남도,창원시마산합포구,완월동,완월동제2투,2293,1646,386,894,185,84,78,3,1,2,0,3,0,0,3,1639,7,647
경상남도,창원시마산합포구,완월동,완월동제3투,2824,2083,539,1000,265,141,114,3,0,4,0,0,1,1,3,2071,12,741
경상남도,창원시마산합포구,자산동,관내사전투표,2099,2099,680,945,239,110,106,2,0,2,1,1,0,1,6,2093,6,0
경상남도,창원시마산합포구,자산동,합계,9981,7695,2091,3858,936,416,326,7,2,5,6,2,1,2,10,7662,33,2286
경상남도,창원시마산합포구,자산동,자산동제1투,2702,2018,480,1016,283,135,89,2,1,2,1,0,1,0,2,2012,6,684
경상남도,창원시마산합포구,자산동,자산동제2투,1496,974,220,580,104,32,28,0,0,0,0,0,0,1,1,966,8,522
경상남도,창원시마산합포구,자산동,자산동제3투,1552,1088,274,571,139,55,44,0,1,0,1,0,0,0,0,1085,3,464
경상남도,창원시마산합포구,자산동,자산동제4투,2132,1516,437,746,171,84,59,3,0,1,3,1,0,0,1,1506,10,616
경상남도,창원시마산합포구,교방동,합계,7491,5703,1709,2721,652,335,247,3,0,3,4,0,1,1,7,5683,20,1788
경상남도,창원시마산합포구,교방동,관내사전투표,1480,1480,534,593,176,97,74,1,0,0,1,0,1,0,2,1479,1,0
경상남도,창원시마산합포구,교방동,교방동제1투,2218,1467,337,806,181,71,61,2,0,1,2,0,0,1,0,1462,5,751
경상남도,창원시마산합포구,교방동,교방동제2투,2598,1945,653,841,226,130,82,0,0,2,0,0,0,0,3,1937,8,653
경상남도,창원시마산합포구,교방동,교방동제3투,1195,811,185,481,69,37,30,0,0,0,1,0,0,0,2,805,6,384
경상남도,창원시마산합포구,노산동,합계,5618,4182,1112,2195,444,213,182,7,1,0,0,0,1,5,1,4161,21,1436
경상남도,창원시마산합포구,노산동,관내사전투표,823,823,256,403,78,41,34,1,0,0,0,0,0,4,0,817,6,0
경상남도,창원시마산합포구,노산동,노산동제1투,2460,1891,539,930,212,114,80,4,0,0,0,0,0,1,1,1881,10,569
경상남도,창원시마산합포구,노산동,노산동제2투,2335,1468,317,862,154,58,68,2,1,0,0,0,1,0,0,1463,5,867
경상남도,창원시마산합포구,합포동,합계,7151,5329,1532,2648,593,285,227,0,1,1,3,0,0,3,8,5301,28,1822
경상남도,창원시마산합포구,합포동,관내사전투표,1948,1948,632,911,185,107,98,0,0,0,2,0,0,2,0,1937,11,0
경상남도,창원시마산합포구,합포동,합포동제1투,3093,2158,627,1017,265,144,90,0,0,0,0,0,0,1,5,2149,9,935
경상남도,창원시마산합포구,합포동,합포동제2투,2110,1223,273,720,143,34,39,0,1,1,1,0,0,0,3,1215,8,887
경상남도,창원시마산합포구,산호동,합계,10695,7848,2252,3744,950,420,421,3,1,3,1,2,1,3,8,7809,39,2847
경상남도,창원시마산합포구,산호동,관내사전투표,1850,1850,644,769,206,111,102,0,0,1,0,0,1,1,4,1839,11,0
경상남도,창원시마산합포구,산호동,산호동제1투,2542,1853,492,958,202,85,108,0,0,0,1,0,0,0,1,1847,6,689
경상남도,창원시마산합포구,산호동,산호동제2투,1453,864,207,454,113,48,37,0,0,1,0,0,0,2,0,862,2,589
경상남도,창원시마산합포구,산호동,산호동제3투,2678,1898,537,887,245,112,94,3,0,0,0,1,0,0,3,1882,16,780
경상남도,창원시마산합포구,산호동,산호동제4투,2172,1383,372,676,184,64,80,0,1,1,0,1,0,0,0,1379,4,789
경상남도,창원시마산합포구,반월중앙동,합계,13232,10373,3114,4817,1221,682,468,8,1,5,0,5,2,1,9,10333,40,2859
경상남도,창원시마산합포구,반월중앙동,관내사전투표,3032,3032,1045,1310,338,185,133,0,0,2,0,2,0,0,3,3018,14,0
경상남도,창원시마산합포구,반월중앙동,반월중앙동제1투,3174,2298,688,1031,298,162,107,0,0,0,0,0,0,0,2,2288,10,876
경상남도,창원시마산합포구,반월중앙동,반월중앙동제2투,1532,971,203,535,117,50,55,2,0,2,0,0,1,1,2,968,3,561
경상남도,창원시마산합포구,반월중앙동,반월중앙동제3투,2590,1818,508,899,184,142,70,4,0,1,0,2,1,0,0,1811,7,772
경상남도,창원시마산합포구,반월중앙동,반월중앙동제4투,2904,2254,670,1042,284,143,103,2,1,0,0,1,0,0,2,2248,6,650
경상남도,창원시마산합포구,오동동,합계,16643,12054,3059,6335,1468,669,451,8,1,3,4,2,3,1,13,12017,37,4589
경상남도,창원시마산합포구,오동동,관내사전투표,2099,2099,557,1126,214,108,79,4,1,0,1,0,1,1,2,2094,5,0
경상남도,창원시마산합포구,오동동,오동동제1투,2911,1832,385,1071,210,95,65,0,0,1,0,0,0,0,1,1828,4,1079
경상남도,창원시마산합포구,오동동,오동동제2투,2594,1896,510,969,246,92,66,1,0,1,1,1,1,0,0,1888,8,698
경상남도,창원시마산합포구,오동동,오동동제3투,1905,1568,450,695,250,117,51,1,0,0,0,0,0,0,1,1565,3,337
경상남도,창원시마산합포구,오동동,오동동제4투,2855,1879,400,1069,211,104,75,2,0,1,2,1,0,0,7,1872,7,976
경상남도,창원시마산합포구,오동동,오동동제5투,2451,1657,531,740,202,105,71,0,0,0,0,0,0,0,2,1651,6,794
경상남도,창원시마산합포구,오동동,오동동제6투,1828,1123,226,665,135,48,44,0,0,0,0,0,1,0,0,1119,4,705
경상남도,창원시마산합포구,잘못 투입·구분된 투표지,,0,0,0,0,0,0,0,0,0,0,0,0,0,0,0,0,0,0
경상남도,창원시마산회원구,합계,,172306,136757,45014,56340,17744,9228,7132,127,23,73,45,67,42,67,190,136092,665,35549
경상남도,창원시마산회원구,거소·선상투표,,529,495,125,178,109,47,13,0,0,0,0,2,1,0,5,480,15,34
경상남도,창원시마산회원구,관외사전투표,,13904,13902,5461,3580,2184,1362,1103,20,5,6,6,5,2,7,42,13783,119,2
경상남도,창원시마산회원구,재외투표,,688,511,273,41,98,32,60,2,0,0,0,0,0,0,0,506,5,177
경상남도,창원시마산회원구,내서읍,합계,49195,39337,14346,14409,5254,2818,2188,27,4,19,7,21,12,10,57,39172,165,9858
경상남도,창원시마산회원구,내서읍,관내사전투표,7478,7478,3303,2152,854,619,476,6,1,6,1,3,1,1,14,7437,41,0
경상남도,창원시마산회원구,내서읍,내서읍제1투,416,324,65,198,37,8,12,1,0,0,0,0,0,1,1,323,1,92
경상남도,창원시마산회원구,내서읍,내서읍제2투,3505,2833,1008,1031,460,169,147,0,1,0,0,2,1,1,4,2824,9,672
경상남도,창원시마산회원구,내서읍,내서읍제3투,2281,1723,636,680,214,107,69,4,0,1,0,2,1,1,1,1716,7,558
경상남도,창원시마산회원구,내서읍,내서읍제4투,3046,2570,947,942,351,171,148,5,0,0,0,1,0,1,1,2567,3,476
경상남도,창원시마산회원구,내서읍,내서읍제5투,2938,2186,684,957,290,124,111,1,0,1,0,1,2,1,4,2176,10,752
경상남도,창원시마산회원구,내서읍,내서읍제6투,2450,1821,513,884,209,113,82,1,0,0,2,0,1,1,4,1810,11,629
경상남도,창원시마산회원구,내서읍,내서읍제7투,2883,1948,556,900,221,168,83,0,0,2,0,0,1,0,3,1934,14,935
경상남도,창원시마산회원구,내서읍,내서읍제8투,3120,2246,729,903,312,139,139,1,0,5,0,2,0,0,2,2232,14,874
경상남도,창원시마산회원구,내서읍,내서읍제9투,2642,1800,492,886,234,92,70,1,1,0,1,0,1,1,6,1785,15,842
경상남도,창원시마산회원구,내서읍,내서읍제10투,4151,3168,1112,1144,445,258,190,2,0,2,1,0,0,0,5,3159,9,983
경상남도,창원시마산회원구,내서읍,내서읍제11투,2800,2119,803,691,318,167,131,1,0,0,0,0,0,0,1,2112,7,681
경상남도,창원시마산회원구,내서읍,내서읍제12투,3902,3014,1098,1017,449,245,175,1,1,1,1,2,3,1,6,3000,14,888
경상남도,창원시마산회원구,내서읍,내서읍제13투,3629,2901,1137,959,406,211,169,2,0,1,1,6,0,0,5,2897,4,728
경상남도,창원시마산회원구,내서읍,내서읍제14투,3321,2709,1163,762,399,210,169,1,0,0,0,1,0,0,0,2705,4,612
경상남도,창원시마산회원구,내서읍,내서읍제15투,633,497,100,303,55,17,17,0,0,0,0,1,1,1,0,495,2,136
경상남도,창원시마산회원구,회원1동,합계,9935,7477,1845,4016,883,388,276,10,2,2,0,3,5,7,7,7444,33,2458
경상남도,창원시마산회원구,회원1동,관내사전투표,1871,1871,573,913,196,92,79,3,1,0,0,0,1,4,1,1863,8,0
경상남도,창원시마산회원구,회원1동,회원1동제1투,2918,2116,426,1216,246,127,85,2,1,0,0,0,1,3,0,2107,9,802
경상남도,창원시마산회원구,회원1동,회원1동제2투,2861,1929,462,1090,222,84,56,3,0,0,0,1,1,0,3,1922,7,932
경상남도,창원시마산회원구,회원1동,회원1동제3투,2285,1561,384,797,219,85,56,2,0,2,0,2,2,0,3,1552,9,724
경상남도,창원시마산회원구,회원2동,합계,9369,6839,1797,3644,696,364,281,8,2,2,1,1,3,1,11,6811,28,2530
경상남도,창원시마산회원구,회원2동,관내사전투표,1589,1589,541,734,137,98,66,3,1,0,0,0,1,0,2,1583,6,0
경상남도,창원시마산회원구,회원2동,회원2동제1투,1547,963,205,572,105,50,24,0,1,0,0,0,2,0,3,962,1,584
경상남도,창원시마산회원구,회원2동,회원2동제2투,1807,1262,336,656,143,62,53,1,0,2,1,0,0,0,2,1256,6,545
경상남도,창원시마산회원구,회원2동,회원2동제3투,2398,1632,356,950,163,79,71,2,0,0,0,0,0,1,0,1622,10,766
경상남도,창원시마산회원구,회원2동,회원2동제4투,2028,1393,359,732,148,75,67,2,0,0,0,1,0,0,4,1388,5,635
경상남도,창원시마산회원구,회성동,합계,6356,4725,1228,2540,494,235,176,6,1,4,5,0,3,3,9,4704,21,1631
경상남도,창원시마산회원구,회성동,관내사전투표,1281,1281,394,646,110,61,50,2,1,3,1,0,1,1,3,1273,8,0
경상남도,창원시마산회원구,회성동,회성동제1투,2355,1580,385,850,186,88,57,2,0,0,1,0,2,0,4,1575,5,775
경상남도,창원시마산회원구,회성동,회성동제2투,2012,1384,330,778,150,59,52,2,0,1,3,0,0,2,2,1379,5,628
경상남도,창원시마산회원구,회성동,회성동제3투,708,480,119,266,48,27,17,0,0,0,0,0,0,0,0,477,3,228
경상남도,창원시마산회원구,양덕1동,합계,9864,7273,2227,3350,854,466,320,4,1,3,4,6,2,2,11,7250,23,2591
경상남도,창원시마산회원구,양덕1동,관내사전투표,1996,1996,663,860,222,146,89,2,0,1,0,3,0,0,4,1990,6,0
경상남도,창원시마산회원구,양덕1동,양덕1동제1투,2661,1656,486,805,200,93,60,0,0,0,2,0,0,1,4,1651,5,1005
경상남도,창원시마산회원구,양덕1동,양덕1동제2투,2548,1815,523,879,198,103,95,1,0,1,2,3,1,1,0,1807,8,733
경상남도,창원시마산회원구,양덕1동,양덕1동제3투,2659,1806,555,806,234,124,76,1,1,1,0,0,1,0,3,1802,4,853
경상남도,창원시마산회원구,양덕2동,관내사전투표,4637,4637,1872,1533,565,348,286,1,0,5,1,3,0,3,7,4624,13,0
경상남도,창원시마산회원구,양덕2동,합계,24995,20566,7051,8081,2845,1455,1001,16,2,12,5,9,2,8,15,20502,64,4429
경상남도,창원시마산회원구,양덕2동,양덕2동제1투,3540,2775,1012,998,414,194,149,0,0,0,0,0,1,1,1,2770,5,765
경상남도,창원시마산회원구,양덕2동,양덕2동제2투,2689,2139,625,960,302,160,72,6,0,1,2,2,0,0,1,2131,8,550
경상남도,창원시마산회원구,양덕2동,양덕2동제3투,2492,1733,495,793,222,125,83,0,0,1,0,1,0,1,1,1722,11,759
경상남도,창원시마산회원구,양덕2동,양덕2동제4투,2165,1642,499,719,225,99,85,3,0,1,0,1,1,1,0,1634,8,523
경상남도,창원시마산회원구,양덕2동,양덕2동제5투,2512,1781,547,783,227,119,90,2,1,2,1,1,0,2,1,1776,5,731
경상남도,창원시마산회원구,양덕2동,양덕2동제6투,3757,3159,965,1389,472,209,105,4,1,1,1,0,0,0,2,3149,10,598
경상남도,창원시마산회원구,양덕2동,양덕2동제7투,3203,2700,1036,906,418,201,131,0,0,1,0,1,0,0,2,2696,4,503
경상남도,창원시마산회원구,합성1동,관내사전투표,1423,1423,499,578,150,95,88,0,0,1,3,0,1,2,1,1418,5,0
경상남도,창원시마산회원구,합성1동,합계,6309,4640,1371,2160,582,269,210,2,0,5,3,0,2,8,5,4617,23,1669
경상남도,창원시마산회원구,합성1동,합성1동제1투,2328,1491,425,726,185,75,65,0,0,1,0,0,1,2,2,1482,9,837
경상남도,창원시마산회원구,합성1동,합성1동제2투,2558,1726,447,856,247,99,57,2,0,3,0,0,0,4,2,1717,9,832
경상남도,창원시마산회원구,합성2동,합계,8431,6180,1752,2922,771,354,320,7,2,2,3,3,2,0,7,6145,35,2251
경상남도,창원시마산회원구,합성2동,관내사전투표,1912,1912,627,814,215,106,132,2,0,1,0,0,1,0,3,1901,11,0
경상남도,창원시마산회원구,합성2동,합성2동제1투,2089,1377,384,655,178,87,62,3,0,0,2,1,1,0,1,1374,3,712
경상남도,창원시마산회원구,합성2동,합성2동제2투,2363,1524,377,798,191,79,65,0,1,1,1,1,0,0,2,1516,8,839
경상남도,창원시마산회원구,합성2동,합성2동제3투,2067,1367,364,655,187,82,61,2,1,0,0,1,0,0,1,1354,13,700
경상남도,창원시마산회원구,구암1동,합계,8703,6672,2082,3005,811,358,346,9,1,7,3,4,3,5,4,6638,34,2031
경상남도,창원시마산회원구,구암1동,관내사전투표,1492,1492,556,582,174,83,81,3,0,1,2,1,0,2,2,1487,5,0
경상남도,창원시마산회원구,구암1동,구암1동제1투,2440,1690,468,809,217,87,88,3,1,0,0,2,0,2,1,1678,12,750
경상남도,창원시마산회원구,구암1동,구암1동제2투,1792,1262,328,647,141,74,58,3,0,4,1,1,0,1,0,1258,4,530
경상남도,창원시마산회원구,구암1동,구암1동제3투,2979,2228,730,967,279,114,119,0,0,2,0,0,3,0,1,2215,13,751
경상남도,창원시마산회원구,구암2동,합계,8273,6423,2124,2690,781,436,319,7,2,5,2,3,2,3,6,6380,43,1850
경상남도,창원시마산회원구,구암2동,관내사전투표,1282,1282,556,421,132,91,72,1,1,1,0,2,0,1,0,1278,4,0
경상남도,창원시마산회원구,구암2동,구암2동제1투,2353,1749,501,793,229,125,86,2,0,1,1,1,0,0,0,1739,10,604
경상남도,창원시마산회원구,구암2동,구암2동제2투,3041,2267,740,947,282,158,108,2,0,3,1,0,2,0,4,2247,20,774
경상남도,창원시마산회원구,구암2동,구암2동제3투,1597,1125,327,529,138,62,53,2,1,0,0,0,0,2,2,1116,9,472
경상남도,창원시마산회원구,봉암동,합계,3396,2398,780,1068,302,117,106,3,0,1,1,2,1,4,2,2387,11,998
경상남도,창원시마산회원구,봉암동,관내사전투표,634,634,248,243,74,31,31,0,0,0,0,1,0,1,0,629,5,0
경상남도,창원시마산회원구,봉암동,봉암동제1투,1146,738,247,313,101,36,36,1,0,0,1,0,1,0,0,736,2,408
경상남도,창원시마산회원구,봉암동,봉암동제2투,1616,1026,285,512,127,50,39,2,0,1,0,1,0,3,2,1022,4,590
경상남도,창원시마산회원구,석전동,합계,12359,9319,2552,4656,1080,527,413,6,1,5,5,8,2,9,9,9273,46,3040
경상남도,창원시마산회원구,석전동,관내사전투표,2187,2187,690,1006,240,121,106,3,0,1,3,1,0,0,1,2172,15,0
경상남도,창원시마산회원구,석전동,석전동제1투,1381,992,275,497,98,66,48,0,0,0,0,1,1,0,2,988,4,389
경상남도,창원시마산회원구,석전동,석전동제2투,824,529,128,282,69,29,15,1,0,1,1,0,0,0,1,527,2,295
경상남도,창원시마산회원구,석전동,석전동제3투,1779,1302,345,686,139,58,64,0,0,0,0,0,1,4,0,1297,5,477
경상남도,창원시마산회원구,석전동,석전동제4투,1546,1122,271,578,125,78,57,1,1,1,0,1,0,2,0,1115,7,424
경상남도,창원시마산회원구,석전동,석전동제5투,1747,1187,314,599,152,58,51,0,0,1,1,1,0,2,3,1182,5,560
경상남도,창원시마산회원구,석전동,석전동제6투,2895,2000,529,1008,257,117,72,1,0,1,0,4,0,1,2,1992,8,895
경상남도,창원시마산회원구,잘못 투입·구분된 투표지,,0,0,0,0,0,0,0,0,0,0,0,0,0,0,0,0,0,0
경상남도,창원시진해구,합계,,146938,114779,41249,40049,17435,8732,6186,108,17,73,38,53,31,63,181,114215,564,32159
경상남도,창원시진해구,거소·선상투표,,1832,1793,464,458,491,209,61,2,3,2,3,6,0,3,31,1733,60,39
경상남도,창원시진해구,관외사전투표,,10633,10633,4450,2469,1665,1133,788,12,1,3,5,1,4,5,22,10558,75,0
경상남도,창원시진해구,재외투표,,765,556,278,55,120,44,54,0,0,0,0,0,0,3,1,555,1,209
경상남도,창원시진해구,중앙동,합계,5389,4312,1383,1354,773,520,223,4,0,3,4,2,3,0,14,4283,29,1077
경상남도,창원시진해구,중앙동,관내사전투표,1809,1809,618,481,335,248,96,2,0,1,0,1,3,0,7,1792,17,0
경상남도,창원시진해구,중앙동,중앙동투표소,3580,2503,765,873,438,272,127,2,0,2,4,1,0,0,7,2491,12,1077
경상남도,창원시진해구,태평동,합계,5411,4218,1144,1928,589,321,173,8,1,9,0,2,3,1,10,4189,29,1193
경상남도,창원시진해구,태평동,관내사전투표,1433,1433,452,547,205,145,59,1,0,2,0,2,1,0,9,1423,10,0
경상남도,창원시진해구,태평동,태평동제1투,2006,1359,318,693,173,101,50,4,1,2,0,0,2,0,1,1345,14,647
경상남도,창원시진해구,태평동,태평동제2투,1972,1426,374,688,211,75,64,3,0,5,0,0,0,1,0,1421,5,546
경상남도,창원시진해구,충무동,합계,3730,2730,708,1402,360,136,95,7,0,3,1,3,0,1,3,2719,11,1000
경상남도,창원시진해구,충무동,관내사전투표,1085,1085,328,499,142,61,42,0,0,1,1,0,0,1,3,1078,7,0
경상남도,창원시진해구,충무동,충무동투표소,2645,1645,380,903,218,75,53,7,0,2,0,3,0,0,0,1641,4,1000
경상남도,창원시진해구,여좌동,관내사전투표,1819,1819,558,790,252,109,91,0,0,1,0,0,0,0,11,1812,7,0
경상남도,창원시진해구,여좌동,합계,8268,6168,1623,3014,872,342,263,3,1,4,1,1,2,2,16,6144,24,2100
경상남도,창원시진해구,여좌동,여좌동제1투,1373,948,219,532,114,45,30,1,0,1,0,0,0,2,0,944,4,425
경상남도,창원시진해구,여좌동,여좌동제2투,2513,1623,414,778,248,98,72,1,0,0,0,0,2,0,1,1614,9,890
경상남도,창원시진해구,여좌동,여좌동제3투,2563,1778,432,914,258,90,70,1,1,2,1,1,0,0,4,1774,4,785
경상남도,창원시진해구,태백동,합계,5167,3707,935,1932,456,203,133,6,0,2,3,2,3,5,6,3686,21,1460
경상남도,창원시진해구,태백동,관내사전투표,987,987,330,426,127,62,31,0,0,0,1,1,1,1,2,982,5,0
경상남도,창원시진해구,태백동,태백동제1투,2203,1420,317,780,175,68,60,2,0,1,1,0,1,2,2,1409,11,783
경상남도,창원시진해구,태백동,태백동제2투,1977,1300,288,726,154,73,42,4,0,1,1,1,1,2,2,1295,5,677
경상남도,창원시진해구,경화동,관내사전투표,1771,1771,677,600,222,143,113,3,1,1,0,0,1,1,3,1765,6,0
경상남도,창원시진해구,경화동,합계,8349,6431,2112,2557,923,430,356,5,1,4,2,2,1,2,8,6403,28,1918
경상남도,창원시진해구,경화동,경화동제1투,2919,1889,457,975,254,102,81,0,0,2,1,0,0,0,4,1876,13,1030
경상남도,창원시진해구,경화동,경화동제2투,3659,2771,978,982,447,185,162,2,0,1,1,2,0,1,1,2762,9,888
경상남도,창원시진해구,병암동,합계,6309,4727,1570,1901,677,302,228,7,0,4,2,2,0,2,7,4702,25,1582
경상남도,창원시진해구,병암동,관내사전투표,1503,1503,545,600,189,83,69,3,0,2,0,0,0,1,6,1498,5,0
경상남도,창원시진해구,병암동,병암동제1투,2323,1603,513,684,233,78,79,2,0,1,1,2,0,0,0,1593,10,720
경상남도,창원시진해구,병암동,병암동제2투,2483,1621,512,617,255,141,80,2,0,1,1,0,0,1,1,1611,10,862
경상남도,창원시진해구,석동,합계,12961,10404,4119,3156,1633,840,598,8,1,4,3,1,0,3,7,10373,31,2557
경상남도,창원시진해구,석동,관내사전투표,2903,2902,1315,735,381,237,218,2,1,1,1,0,0,0,3,2894,8,1
경상남도,창원시진해구,석동,석동제1투,3756,2516,886,881,400,201,127,4,0,1,0,0,0,1,2,2503,13,1240
경상남도,창원시진해구,석동,석동제2투,3199,2473,963,731,432,184,149,1,0,2,0,0,0,2,2,2466,7,726
경상남도,창원시진해구,석동,석동제3투,3103,2513,955,809,420,218,104,1,0,0,2,1,0,0,0,2510,3,590
경상남도,창원시진해구,이동,합계,8334,5991,1793,2655,851,337,299,8,1,4,1,5,0,2,7,5963,28,2343
경상남도,창원시진해구,이동,관내사전투표,1525,1525,553,590,190,97,84,3,0,0,1,3,0,0,2,1523,2,0
경상남도,창원시진해구,이동,이동제1투,2284,1392,439,595,201,68,74,1,0,2,0,1,0,0,0,1381,11,892
경상남도,창원시진해구,이동,이동제2투,2109,1417,366,655,234,75,68,1,1,1,0,1,0,2,3,1407,10,692
경상남도,창원시진해구,이동,이동제3투,2416,1657,435,815,226,97,73,3,0,1,0,0,0,0,2,1652,5,759
경상남도,창원시진해구,자은동,관내사전투표,2129,2129,876,621,314,184,122,2,1,0,0,1,0,0,1,2122,7,0
경상남도,창원시진해구,자은동,합계,11627,9281,3535,3015,1387,748,529,7,1,2,4,6,2,2,5,9243,38,2346
경상남도,창원시진해구,자은동,자은동제1투,2886,2093,695,804,291,161,124,3,0,0,1,0,1,0,1,2081,12,793
경상남도,창원시진해구,자은동,자은동제2투,3778,2681,879,1071,374,190,137,2,0,1,3,5,1,2,2,2667,14,1097
경상남도,창원시진해구,자은동,자은동제3투,2834,2378,1085,519,408,213,146,0,0,1,0,0,0,0,1,2373,5,456
경상남도,창원시진해구,덕산동,관내사전투표,1883,1883,710,638,255,133,122,3,0,3,0,2,2,1,3,1872,11,0
경상남도,창원시진해구,덕산동,합계,7815,5966,2024,2258,867,408,341,4,3,8,0,6,4,3,7,5933,33,1849
경상남도,창원시진해구,덕산동,덕산동제1투,3386,2335,717,945,365,152,136,0,0,2,0,2,0,2,1,2322,13,1051
경상남도,창원시진해구,덕산동,덕산동제2투,2546,1748,597,675,247,123,83,1,3,3,0,2,2,0,3,1739,9,798
경상남도,창원시진해구,풍호동,관내사전투표,3650,3650,1576,1065,494,297,196,1,0,1,1,0,0,4,3,3638,12,0
경상남도,창원시진해구,풍호동,합계,17817,14682,5716,4620,2290,1186,773,10,0,7,2,4,1,6,13,14628,54,3135
경상남도,창원시진해구,풍호동,풍호동제1투,3307,2380,825,926,338,165,107,3,0,2,0,0,0,1,3,2370,10,927
경상남도,창원시진해구,풍호동,풍호동제2투,2888,2302,730,884,372,170,120,4,0,3,0,2,0,1,2,2288,14,586
경상남도,창원시진해구,풍호동,풍호동제3투,4064,3183,1239,997,517,262,151,2,0,1,1,1,1,0,2,3174,9,881
경상남도,창원시진해구,풍호동,풍호동제4투,3908,3167,1346,748,569,292,199,0,0,0,0,1,0,0,3,3158,9,741
경상남도,창원시진해구,웅천동,관내사전투표,760,760,193,417,72,38,32,1,0,0,1,0,1,3,0,758,2,0
경상남도,창원시진해구,웅천동,합계,3320,2379,555,1374,244,109,74,3,0,0,1,0,2,6,3,2371,8,941
경상남도,창원시진해구,웅천동,웅천동제1투,1775,1122,260,639,134,48,30,1,0,0,0,0,1,2,3,1118,4,653
경상남도,창원시진해구,웅천동,웅천동제2투,785,497,102,318,38,23,12,1,0,0,0,0,0,1,0,495,2,288
경상남도,창원시진해구,웅동1동,관내사전투표,1331,1331,544,445,185,86,57,1,0,1,0,1,0,2,3,1325,6,0
경상남도,창원시진해구,웅동1동,합계,5275,3873,1415,1451,554,231,181,4,0,4,0,2,0,6,8,3856,17,1402
경상남도,창원시진해구,웅동1동,웅동1동제1투,2305,1544,562,560,245,86,74,2,0,1,0,1,0,2,5,1538,6,761
경상남도,창원시진해구,웅동1동,웅동1동제2투,1639,998,309,446,124,59,50,1,0,2,0,0,0,2,0,993,5,641
경상남도,창원시진해구,웅동2동,관내사전투표,4248,4248,2181,940,546,285,276,1,0,0,2,1,2,1,3,4238,10,0
경상남도,창원시진해구,웅동2동,합계,23936,16927,7425,4449,2683,1233,1017,10,4,10,6,8,6,11,13,16875,52,7009
경상남도,창원시진해구,웅동2동,웅동2동제1투,3075,1699,612,589,287,114,81,3,2,2,1,0,1,1,0,1693,6,1376
경상남도,창원시진해구,웅동2동,웅동2동제2투,4215,2884,1009,973,502,201,169,3,2,2,0,1,1,3,3,2869,15,1331
경상남도,창원시진해구,웅동2동,웅동2동제3투,3427,2600,1189,618,418,204,159,1,0,2,0,1,2,1,1,2596,4,827
경상남도,창원시진해구,웅동2동,웅동2동제4투,3043,2093,1023,434,338,164,115,2,0,2,2,2,0,3,1,2086,7,950
경상남도,창원시진해구,웅동2동,웅동2동제5투,2341,1644,731,421,272,118,96,0,0,2,0,0,0,1,1,1642,2,697
경상남도,창원시진해구,웅동2동,웅동2동제6투,3587,1759,680,474,320,147,121,0,0,0,1,3,0,1,4,1751,8,1828
경상남도,창원시진해구,잘못 투입·구분된 투표지,,0,1,0,1,0,0,0,0,0,0,0,0,0,0,0,1,0,-1
경상남도,진주시,합계,,281105,222813,73929,93751,26687,14735,11243,212,44,111,92,182,83,240,308,221617,1196,58292
경상남도,진주시,거소·선상투표,,713,662,213,210,139,34,14,3,3,2,0,3,0,3,3,627,35,51
경상남도,진주시,관외사전투표,,19274,19274,8191,4473,2950,1896,1484,16,6,8,6,16,5,9,47,19107,167,0
경상남도,진주시,재외투표,,1547,1069,592,97,217,34,122,3,0,0,0,1,1,0,0,1067,2,478
경상남도,진주시,문산읍,관내사전투표,1641,1641,626,594,197,111,92,4,0,2,0,1,1,2,2,1632,9,0
경상남도,진주시,문산읍,합계,7149,5407,1729,2421,610,312,256,12,1,5,2,4,4,14,8,5378,29,1742
경상남도,진주시,문산읍,문산읍제1투,3261,2119,582,1054,238,113,90,6,1,2,1,1,3,10,5,2106,13,1142
경상남도,진주시,문산읍,문산읍제2투,2247,1647,521,773,175,88,74,2,0,1,1,2,0,2,1,1640,7,600
경상남도,진주시,내동면,합계,3331,2750,894,1224,329,164,103,4,1,1,2,0,1,1,7,2731,19,581
경상남도,진주시,내동면,관내사전투표,1115,1115,434,458,117,60,37,0,0,0,2,0,0,0,3,1111,4,0
경상남도,진주시,내동면,내동면투표소,2216,1635,460,766,212,104,66,4,1,1,0,0,1,1,4,1620,15,581
경상남도,진주시,정촌면,관내사전투표,1174,1174,385,563,93,66,54,1,0,0,0,1,0,1,7,1171,3,0
경상남도,진주시,정촌면,합계,3037,2433,653,1316,231,106,84,1,1,3,1,2,0,5,9,2412,21,604
경상남도,진주시,정촌면,정촌면투표소,1863,1259,268,753,138,40,30,0,1,3,1,1,0,4,2,1241,18,604
경상남도,진주시,금곡면,합계,2110,1624,390,942,153,68,44,1,1,0,0,4,1,9,2,1615,9,486
경상남도,진주시,금곡면,관내사전투표,409,409,120,206,40,19,13,0,1,0,0,2,0,3,1,405,4,0
경상남도,진주시,금곡면,금곡면투표소,1701,1215,270,736,113,49,31,1,0,0,0,2,1,6,1,1210,5,486
경상남도,진주시,진성면,합계,1980,1517,382,862,134,56,50,1,0,0,2,8,2,3,5,1505,12,463
경상남도,진주시,진성면,관내사전투표,552,552,174,274,50,22,22,0,0,0,0,3,1,2,1,549,3,0
경상남도,진주시,진성면,진성면투표소,1428,965,208,588,84,34,28,1,0,0,2,5,1,1,4,956,9,463
경상남도,진주시,일반성면,관내사전투표,880,880,282,443,78,35,26,2,0,1,2,0,2,2,3,876,4,0
경상남도,진주시,일반성면,합계,2664,2095,571,1141,208,76,58,2,1,2,3,1,4,4,6,2077,18,569
경상남도,진주시,일반성면,일반성면투표소,1784,1215,289,698,130,41,32,0,1,1,1,1,2,2,3,1201,14,569
경상남도,진주시,이반성면,합계,1470,1102,306,573,108,55,31,0,0,2,0,0,1,8,3,1087,15,368
경상남도,진주시,이반성면,관내사전투표,273,273,91,131,24,17,9,0,0,1,0,0,0,0,0,273,0,0
경상남도,진주시,이반성면,이반성면투표소,1197,829,215,442,84,38,22,0,0,1,0,0,1,8,3,814,15,368
경상남도,진주시,사봉면,합계,1437,1102,280,599,125,52,21,3,1,1,6,2,0,6,3,1099,3,335
경상남도,진주시,사봉면,관내사전투표,356,356,113,186,29,13,10,2,0,0,1,1,0,1,0,356,0,0
경상남도,진주시,사봉면,사봉면투표소,1081,746,167,413,96,39,11,1,1,1,5,1,0,5,3,743,3,335
경상남도,진주시,지수면,관내사전투표,313,313,96,155,34,17,4,1,0,0,0,4,0,0,1,312,1,0
경상남도,진주시,지수면,합계,1394,1033,278,550,107,46,26,3,0,2,1,5,1,2,4,1025,8,361
경상남도,진주시,지수면,지수면투표소,1081,720,182,395,73,29,22,2,0,2,1,1,1,2,3,713,7,361
경상남도,진주시,대곡면,합계,3174,2302,555,1285,252,89,71,3,1,0,1,0,2,11,9,2279,23,872
경상남도,진주시,대곡면,관내사전투표,602,602,170,306,67,32,21,0,0,0,0,0,0,1,1,598,4,0
경상남도,진주시,대곡면,대곡면투표소,2572,1700,385,979,185,57,50,3,1,0,1,0,2,10,8,1681,19,872
경상남도,진주시,금산면,합계,15160,11997,4437,4585,1511,769,580,7,3,4,6,25,3,7,12,11949,48,3163
경상남도,진주시,금산면,관내사전투표,3451,3451,1501,1115,388,239,177,3,1,0,2,8,0,1,3,3438,13,0
경상남도,진주시,금산면,금산면제1투,2687,1812,496,933,176,109,71,0,1,1,0,5,1,3,3,1799,13,875
경상남도,진주시,금산면,금산면제2투,3442,2457,782,1037,345,155,114,0,0,2,2,5,1,2,3,2448,9,985
경상남도,진주시,금산면,금산면제3투,2404,1791,613,703,240,122,89,2,1,1,2,6,0,0,2,1781,10,613
경상남도,진주시,금산면,금산면제4투,3176,2486,1045,797,362,144,129,2,0,0,0,1,1,1,1,2483,3,690
경상남도,진주시,집현면,합계,3857,2801,759,1469,288,125,114,1,1,1,1,4,1,20,5,2789,12,1056
경상남도,진주시,집현면,관내사전투표,739,739,234,356,75,35,30,0,1,0,0,1,1,4,1,738,1,0
경상남도,진주시,집현면,집현면투표소,3118,2062,525,1113,213,90,84,1,0,1,1,3,0,16,4,2051,11,1056
경상남도,진주시,미천면,합계,1422,991,189,595,105,47,22,0,1,3,0,3,2,11,4,982,9,431
경상남도,진주시,미천면,관내사전투표,173,173,58,74,22,11,6,0,0,0,0,0,0,0,0,171,2,0
경상남도,진주시,미천면,미천면투표소,1249,818,131,521,83,36,16,0,1,3,0,3,2,11,4,811,7,431
경상남도,진주시,명석면,합계,3707,2748,613,1627,263,102,98,2,0,3,1,3,7,12,5,2736,12,959
경상남도,진주시,명석면,관내사전투표,776,776,237,383,80,32,28,0,0,2,1,1,3,4,0,771,5,0
경상남도,진주시,명석면,명석면투표소,2931,1972,376,1244,183,70,70,2,0,1,0,2,4,8,5,1965,7,959
경상남도,진주시,대평면,관내사전투표,325,325,81,171,33,13,16,1,0,0,0,0,1,0,3,319,6,0
경상남도,진주시,대평면,합계,1054,834,186,488,79,31,28,2,0,0,0,0,1,2,6,823,11,220
경상남도,진주시,대평면,대평면투표소,729,509,105,317,46,18,12,1,0,0,0,0,0,2,3,504,5,220
경상남도,진주시,수곡면,합계,2066,1545,400,876,133,50,51,0,0,1,4,1,2,8,7,1533,12,521
경상남도,진주시,수곡면,관내사전투표,414,414,129,228,33,8,8,0,0,1,2,0,0,2,1,412,2,0
경상남도,진주시,수곡면,수곡면투표소,1652,1131,271,648,100,42,43,0,0,0,2,1,2,6,6,1121,10,521
경상남도,진주시,중앙동,합계,11461,8313,1790,5001,793,349,277,5,4,6,6,3,4,16,11,8265,48,3148
경상남도,진주시,중앙동,관내사전투표,2286,2286,626,1251,173,101,103,1,3,2,3,3,0,4,5,2275,11,0
경상남도,진주시,중앙동,중앙동제1투,2442,1566,288,998,177,51,39,2,0,1,1,0,1,0,1,1559,7,876
경상남도,진주시,중앙동,중앙동제2투,2845,1946,380,1222,177,78,65,1,1,0,0,0,1,5,1,1931,15,899
경상남도,진주시,중앙동,중앙동제3투,1966,1249,231,772,135,64,31,0,0,1,2,0,1,3,2,1242,7,717
경상남도,진주시,중앙동,중앙동제4투,1922,1266,265,758,131,55,39,1,0,2,0,0,1,4,2,1258,8,656
경상남도,진주시,상평동,관내사전투표,2033,2033,710,873,220,127,95,0,0,0,2,0,1,0,2,2030,3,0
경상남도,진주시,상평동,합계,9976,7572,2143,3772,835,445,327,3,0,1,4,2,4,1,8,7545,27,2404
경상남도,진주시,상평동,상평동제1투,2153,1388,328,761,149,71,65,0,0,0,1,1,1,1,2,1380,8,765
경상남도,진주시,상평동,상평동제2투,2590,1783,389,1039,173,110,55,1,0,0,1,0,1,0,2,1771,12,807
경상남도,진주시,상평동,상평동제3투,3200,2368,716,1099,293,137,112,2,0,1,0,1,1,0,2,2364,4,832
경상남도,진주시,초장동,관내사전투표,4095,4095,1780,1243,456,342,242,4,0,0,2,3,0,2,1,4075,20,0
경상남도,진주시,초장동,합계,15430,12883,4904,4592,1634,1014,640,11,1,1,6,5,1,12,7,12828,55,2547
경상남도,진주시,초장동,초장동제1투,2980,2116,654,947,268,134,84,2,0,1,2,0,1,7,2,2102,14,864
경상남도,진주시,초장동,초장동제2투,2415,1859,570,790,224,165,90,1,0,0,1,1,0,2,2,1846,13,556
경상남도,진주시,초장동,초장동제3투,2526,2038,761,716,314,163,75,1,0,0,0,0,0,1,1,2032,6,488
경상남도,진주시,초장동,초장동제4투,3414,2775,1139,896,372,210,149,3,1,0,1,1,0,0,1,2773,2,639
경상남도,진주시,평거동,합계,19607,15637,5833,5685,2046,1142,803,10,3,4,3,12,4,4,12,15561,76,3970
경상남도,진주시,평거동,관내사전투표,4521,4521,2073,1332,474,341,268,3,0,0,2,4,0,0,2,4499,22,0
경상남도,진주시,평거동,평거동제1투,2695,1819,488,890,227,114,77,1,0,0,1,2,1,1,3,1805,14,876
경상남도,진주시,평거동,평거동제2투,3384,2584,962,936,392,167,111,0,0,0,0,0,2,1,3,2574,10,800
경상남도,진주시,평거동,평거동제3투,2755,2126,730,808,319,156,93,2,0,1,0,2,1,0,1,2113,13,629
경상남도,진주시,평거동,평거동제4투,3129,2236,762,837,308,184,123,1,2,2,0,2,0,0,3,2224,12,893
경상남도,진주시,평거동,평거동제5투,3123,2351,818,882,326,180,131,3,1,1,0,2,0,2,0,2346,5,772
경상남도,진주시,신안동,관내사전투표,2946,2946,1075,1189,265,213,175,3,0,3,0,4,1,3,3,2934,12,0
경상남도,진주시,신안동,합계,10728,8698,2650,3961,994,598,417,13,1,6,2,7,1,6,8,8664,34,2030
경상남도,진주시,신안동,신안동제1투,3209,2443,718,1096,316,174,116,6,0,1,1,0,0,2,1,2431,12,766
경상남도,진주시,신안동,신안동제2투,2427,1827,454,935,229,117,82,1,1,1,0,0,0,0,3,1823,4,600
경상남도,진주시,신안동,신안동제3투,2146,1482,403,741,184,94,44,3,0,1,1,3,0,1,1,1476,6,664
경상남도,진주시,이현동,합계,9994,7703,2267,3639,911,463,358,16,0,2,1,6,1,7,5,7676,27,2291
경상남도,진주시,이현동,관내사전투표,2359,2359,757,1086,239,146,110,5,0,0,1,1,0,5,0,2350,9,0
경상남도,진주시,이현동,이현동제1투,2852,2181,701,939,299,141,85,4,0,1,0,2,1,0,3,2176,5,671
경상남도,진주시,이현동,이현동제2투,2267,1471,361,790,164,75,70,2,0,0,0,2,0,1,2,1467,4,796
경상남도,진주시,이현동,이현동제3투,2516,1692,448,824,209,101,93,5,0,1,0,1,0,1,0,1683,9,824
경상남도,진주시,판문동,합계,15278,12397,4812,4363,1610,870,647,6,5,3,4,8,5,9,4,12346,51,2881
경상남도,진주시,판문동,관내사전투표,3879,3879,1823,1117,407,273,233,2,0,0,1,0,1,1,0,3858,21,0
경상남도,진주시,판문동,판문동제1투,2612,1790,471,863,239,111,83,1,1,0,2,3,1,4,2,1781,9,822
경상남도,진주시,판문동,판문동제2투,2456,1754,487,832,218,110,85,0,2,1,0,4,2,3,1,1745,9,702
경상남도,진주시,판문동,판문동제3투,2226,1623,642,543,216,117,93,1,2,2,0,0,1,1,0,1618,5,603
경상남도,진주시,판문동,판문동제4투,2449,2026,822,631,319,163,84,1,0,0,0,1,0,0,1,2022,4,423
경상남도,진주시,판문동,판문동제5투,1656,1325,567,377,211,96,69,1,0,0,1,0,0,0,0,1322,3,331
경상남도,진주시,가호동,관내사전투표,3458,3458,1651,634,425,365,342,2,0,0,2,8,0,0,5,3434,24,0
경상남도,진주시,가호동,합계,16080,12714,4826,4347,1567,1002,835,14,3,6,4,16,2,4,17,12643,71,3366
경상남도,진주시,가호동,가호동제1투,2220,1558,448,745,153,117,78,2,1,2,0,0,0,0,2,1548,10,662
경상남도,진주시,가호동,가호동제2투,2576,1756,638,681,209,132,86,0,0,2,1,1,0,0,0,1750,6,820
경상남도,진주시,가호동,가호동제3투,2858,2102,639,963,245,124,96,6,2,1,1,0,2,4,6,2089,13,756
경상남도,진주시,가호동,가호동제4투,2716,2122,808,703,292,158,140,2,0,1,0,2,0,0,1,2107,15,594
경상남도,진주시,가호동,가호동제5투,2252,1718,642,621,243,106,93,2,0,0,0,5,0,0,3,1715,3,534
경상남도,진주시,천전동,관내사전투표,4345,4345,1706,1426,495,358,322,0,0,3,0,0,2,1,9,4322,23,0
경상남도,진주시,천전동,합계,23847,18801,5663,8575,2259,1213,911,18,1,9,4,6,5,13,30,18707,94,5046
경상남도,진주시,천전동,천전동제1투,1756,1267,318,714,119,62,42,3,0,2,0,0,0,3,0,1263,4,489
경상남도,진주시,천전동,천전동제2투,1602,1148,230,704,102,55,43,2,0,0,0,1,0,1,2,1140,8,454
경상남도,진주시,천전동,천전동제3투,1985,1358,468,527,172,102,76,0,0,2,1,1,0,0,2,1351,7,627
경상남도,진주시,천전동,천전동제4투,2095,1519,367,794,198,85,58,1,0,0,1,2,0,0,2,1508,11,576
경상남도,진주시,천전동,천전동제5투,1845,1436,487,570,208,109,51,0,0,0,0,0,0,1,2,1428,8,409
경상남도,진주시,천전동,천전동제6투,2800,1877,396,1122,193,86,52,4,1,0,0,1,1,3,6,1865,12,923
경상남도,진주시,천전동,천전동제7투,2754,2022,486,1058,243,111,100,5,0,0,0,1,2,0,4,2010,12,732
경상남도,진주시,천전동,천전동제8투,2289,1866,540,890,253,104,72,2,0,0,0,0,0,0,0,1861,5,423
경상남도,진주시,천전동,천전동제9투,2376,1963,665,770,276,141,95,1,0,2,2,0,0,4,3,1959,4,413
경상남도,진주시,성북동,합계,10021,7149,1798,3829,757,414,284,3,2,4,4,5,1,8,6,7115,34,2872
경상남도,진주시,성북동,관내사전투표,2023,2023,633,975,170,121,99,2,2,2,0,3,0,3,2,2012,11,0
경상남도,진주시,성북동,성북동제1투,3088,2033,451,1138,238,112,78,0,0,2,0,1,1,2,4,2027,6,1055
경상남도,진주시,성북동,성북동제2투,2293,1386,316,783,141,78,57,0,0,0,2,0,0,2,0,1379,7,907
경상남도,진주시,성북동,성북동제3투,2617,1707,398,933,208,103,50,1,0,0,2,1,0,1,0,1697,10,910
경상남도,진주시,상봉동,합계,12923,9344,2379,4940,901,551,481,7,0,9,4,5,4,9,13,9303,41,3579
경상남도,진주시,상봉동,관내사전투표,2459,2459,794,1123,217,160,146,3,0,1,0,2,2,1,3,2452,7,0
경상남도,진주시,상봉동,상봉동제1투,2195,1374,322,781,115,75,65,0,0,2,1,1,0,3,4,1369,5,821
경상남도,진주시,상봉동,상봉동제2투,2132,1393,312,773,149,77,68,1,0,1,0,1,0,1,4,1387,6,739
경상남도,진주시,상봉동,상봉동제3투,2986,1960,418,1147,190,98,92,3,0,2,1,0,0,1,0,1952,8,1026
경상남도,진주시,상봉동,상봉동제4투,3151,2158,533,1116,230,141,110,0,0,3,2,1,2,3,2,2143,15,993
경상남도,진주시,충무공동,합계,8923,7755,3998,1804,932,587,393,4,0,2,0,6,1,1,9,7737,18,1168
경상남도,진주시,충무공동,관내사전투표,3214,3214,1793,666,323,237,174,3,0,0,0,5,0,0,6,3207,7,0
경상남도,진주시,충무공동,충무공동제1투,2930,2334,1143,572,307,185,114,1,0,2,0,1,0,1,1,2327,7,596
경상남도,진주시,충무공동,충무공동제2투,2779,2207,1062,566,302,165,105,0,0,0,0,0,1,0,2,2203,4,572
경상남도,진주시,상대동,합계,18983,14480,4341,6748,1622,900,714,20,2,10,6,11,8,10,17,14409,71,4503
경상남도,진주시,상대동,관내사전투표,4725,4725,1716,1921,484,320,239,6,1,3,1,1,3,5,3,4703,22,0
경상남도,진주시,상대동,상대동제1투,2679,1869,522,870,236,108,110,1,0,0,0,3,0,1,1,1852,17,810
경상남도,진주시,상대동,상대동제2투,2745,1795,478,879,226,101,89,2,0,1,2,3,2,2,4,1789,6,950
경상남도,진주시,상대동,상대동제3투,2789,1841,480,934,209,118,80,2,0,2,1,1,0,0,4,1831,10,948
경상남도,진주시,상대동,상대동제4투,2751,1875,495,964,193,114,89,8,1,2,0,1,1,0,1,1869,6,876
경상남도,진주시,상대동,상대동제5투,3294,2375,650,1180,274,139,107,1,0,2,2,2,2,2,4,2365,10,919
경상남도,진주시,하대동,합계,21308,16081,4907,7162,1884,1075,899,18,1,10,8,8,4,5,16,15997,84,5227
경상남도,진주시,하대동,관내사전투표,4279,4279,1528,1719,450,284,264,5,0,3,0,1,1,1,3,4259,20,0
경상남도,진주시,하대동,하대동제1투,2285,1716,534,731,226,131,82,0,0,0,0,0,1,0,1,1706,10,569
경상남도,진주시,하대동,하대동제2투,2855,1891,494,961,198,116,103,2,0,1,2,1,0,1,1,1880,11,964
경상남도,진주시,하대동,하대동제3투,3030,2014,604,890,242,131,123,5,0,0,1,3,1,0,3,2003,11,1016
경상남도,진주시,하대동,하대동제4투,2771,1858,526,860,235,121,96,1,1,1,3,0,1,1,1,1847,11,913
경상남도,진주시,하대동,하대동제5투,3028,2185,604,979,294,155,129,2,0,3,1,3,0,0,5,2175,10,843
경상남도,진주시,하대동,하대동제6투,3060,2138,617,1022,239,137,102,3,0,2,1,0,0,2,2,2127,11,922
경상남도,진주시,잘못 투입·구분된 투표지,,0,0,0,0,0,0,0,0,0,0,0,0,0,0,0,0,0,0
경상남도,통영시,합계,,111279,82855,25477,36128,10738,5332,4075,104,25,59,26,42,55,134,142,82337,518,28424
경상남도,통영시,거소·선상투표,,579,539,163,141,137,38,18,5,9,4,1,3,0,1,2,522,17,40
경상남도,통영시,관외사전투표,,7369,7369,3188,1561,1090,779,631,12,2,3,4,5,2,7,19,7303,66,0
경상남도,통영시,재외투표,,391,266,151,20,34,18,40,1,0,1,0,0,0,0,0,265,1,125
경상남도,통영시,산양읍,합계,4216,2850,646,1638,310,124,73,3,2,2,0,0,8,18,2,2826,24,1366
경상남도,통영시,산양읍,관내사전투표,594,594,173,268,87,34,19,3,0,1,0,0,1,4,0,590,4,0
경상남도,통영시,산양읍,산양읍제1투,2638,1630,366,966,160,71,44,0,0,1,0,0,4,5,0,1617,13,1008
경상남도,통영시,산양읍,산양읍제2투,647,400,69,248,49,10,9,0,2,0,0,0,1,7,2,397,3,247
경상남도,통영시,산양읍,산양읍제3투,224,153,26,112,3,6,1,0,0,0,0,0,0,1,0,149,4,71
경상남도,통영시,산양읍,산양읍제4투,113,73,12,44,11,3,0,0,0,0,0,0,2,1,0,73,0,40
경상남도,통영시,용남면,합계,9411,6996,2186,2993,957,439,339,7,2,4,2,2,5,13,14,6963,33,2415
경상남도,통영시,용남면,관내사전투표,1931,1931,804,644,227,126,106,2,0,0,0,0,2,4,8,1923,8,0
경상남도,통영시,용남면,용남면제1투,2602,1746,553,689,269,113,101,1,2,3,0,2,1,1,1,1736,10,856
경상남도,통영시,용남면,용남면제2투,2685,1825,425,958,242,102,76,2,0,1,1,0,0,3,2,1812,13,860
경상남도,통영시,용남면,용남면제3투,216,148,21,113,6,1,1,0,0,0,0,0,1,4,0,147,1,68
경상남도,통영시,용남면,용남면제4투,1977,1346,383,589,213,97,55,2,0,0,1,0,1,1,3,1345,1,631
경상남도,통영시,도산면,합계,2737,2007,451,1134,217,113,47,1,0,3,0,1,2,13,15,1997,10,730
경상남도,통영시,도산면,관내사전투표,443,443,130,224,48,23,13,0,0,1,0,0,0,0,2,441,2,0
경상남도,통영시,도산면,도산면제1투,1425,932,189,545,104,50,29,0,0,0,0,0,2,6,4,929,3,493
경상남도,통영시,도산면,도산면제2투,476,344,56,222,27,23,4,0,0,1,0,0,0,5,4,342,2,132
경상남도,통영시,도산면,도산면제3투,393,288,76,143,38,17,1,1,0,1,0,1,0,2,5,285,3,105
경상남도,통영시,광도면,합계,19384,14570,5755,4788,2015,1043,826,9,0,4,5,10,4,16,25,14500,70,4814
경상남도,통영시,광도면,관내사전투표,4403,4403,2050,1134,534,351,290,3,0,1,1,7,1,1,3,4376,27,0
경상남도,통영시,광도면,광도면제1투,1481,1002,252,530,127,45,33,0,0,0,2,0,0,2,5,996,6,479
경상남도,통영시,광도면,광도면제2투,2629,1699,700,575,214,107,87,0,0,1,0,0,1,5,0,1690,9,930
경상남도,통영시,광도면,광도면제3투,1515,990,249,498,120,59,49,0,0,0,0,2,0,5,2,984,6,525
경상남도,통영시,광도면,광도면제4투,3166,1897,669,666,283,149,113,0,0,1,1,0,0,1,4,1887,10,1269
경상남도,통영시,광도면,광도면제5투,2701,2126,874,639,356,141,101,1,0,1,1,1,1,2,4,2122,4,575
경상남도,통영시,광도면,광도면제6투,3489,2453,961,746,381,191,153,5,0,0,0,0,1,0,7,2445,8,1036
경상남도,통영시,욕지면,합계,1638,1131,192,739,112,45,24,3,0,1,0,0,3,2,4,1125,6,507
경상남도,통영시,욕지면,관내사전투표,352,352,66,223,35,17,8,1,0,0,0,0,0,0,0,350,2,0
경상남도,통영시,욕지면,욕지면제1투,905,520,88,327,57,24,13,1,0,1,0,0,2,2,3,518,2,385
경상남도,통영시,욕지면,욕지면제2투,159,114,27,74,7,3,1,0,0,0,0,0,0,0,1,113,1,45
경상남도,통영시,욕지면,욕지면제3투,222,145,11,115,13,1,2,1,0,0,0,0,1,0,0,144,1,77
경상남도,통영시,한산면,합계,1690,1190,159,835,109,41,15,2,1,1,0,1,2,14,2,1182,8,500
경상남도,통영시,한산면,관내사전투표,368,368,57,248,34,17,3,0,0,1,0,1,0,5,0,366,2,0
경상남도,통영시,한산면,한산면제1투,1048,648,77,473,53,19,5,2,1,0,0,0,2,8,2,642,6,400
경상남도,통영시,한산면,한산면제2투,148,111,11,83,12,1,4,0,0,0,0,0,0,0,0,111,0,37
경상남도,통영시,한산면,한산면제3투,126,63,14,31,10,4,3,0,0,0,0,0,0,1,0,63,0,63
경상남도,통영시,사량면,합계,1338,935,176,567,101,36,23,0,1,0,0,0,6,7,1,918,17,403
경상남도,통영시,사량면,관내사전투표,426,426,85,259,45,11,11,0,1,0,0,0,4,1,1,418,8,0
경상남도,통영시,사량면,사량면투표소,912,509,91,308,56,25,12,0,0,0,0,0,2,6,0,500,9,403
경상남도,통영시,도천동,합계,7854,5375,1309,2755,704,311,226,7,3,2,1,2,3,1,11,5335,40,2479
경상남도,통영시,도천동,관내사전투표,892,892,326,316,126,65,48,0,1,0,0,0,2,0,3,887,5,0
경상남도,통영시,도천동,도천동제1투,2200,1399,278,797,176,80,52,1,1,1,0,0,1,0,3,1390,9,801
경상남도,통영시,도천동,도천동제2투,1844,1158,252,668,126,57,35,2,0,0,0,2,0,0,2,1144,14,686
경상남도,통영시,도천동,도천동제3투,1691,1096,269,522,158,72,60,4,1,1,0,0,0,0,1,1088,8,595
경상남도,통영시,도천동,도천동제4투,1227,830,184,452,118,37,31,0,0,0,1,0,0,1,2,826,4,397
경상남도,통영시,명정동,합계,3925,2991,623,1748,327,142,104,2,1,2,4,1,4,8,1,2967,24,934
경상남도,통영시,명정동,관내사전투표,1442,1442,323,827,148,71,52,1,1,0,2,0,1,4,0,1430,12,0
경상남도,통영시,명정동,명정동제1투,1240,767,151,461,83,33,30,1,0,0,1,0,1,1,0,762,5,473
경상남도,통영시,명정동,명정동제2투,1243,782,149,460,96,38,22,0,0,2,1,1,2,3,1,775,7,461
경상남도,통영시,중앙동,합계,4279,2904,589,1747,313,126,86,5,0,2,0,0,2,2,5,2877,27,1375
경상남도,통영시,중앙동,관내사전투표,664,664,150,373,66,40,25,3,0,0,0,0,0,0,1,658,6,0
경상남도,통영시,중앙동,중앙동제1투,2165,1306,253,793,152,52,36,2,0,0,0,0,1,0,3,1292,14,859
경상남도,통영시,중앙동,중앙동제2투,1450,934,186,581,95,34,25,0,0,2,0,0,1,2,1,927,7,516
경상남도,통영시,정량동,합계,8405,5846,1505,3074,661,292,249,11,1,4,2,4,3,7,6,5819,27,2559
경상남도,통영시,정량동,관내사전투표,1277,1277,434,560,142,72,59,1,0,0,0,1,0,1,0,1270,7,0
경상남도,통영시,정량동,정량동제1투,2235,1369,300,786,150,53,62,0,0,2,1,0,2,2,4,1362,7,866
경상남도,통영시,정량동,정량동제2투,2387,1534,344,849,194,76,51,8,0,0,0,1,1,0,1,1525,9,853
경상남도,통영시,정량동,정량동제3투,2506,1666,427,879,175,91,77,2,1,2,1,2,0,4,1,1662,4,840
경상남도,통영시,북신동,합계,8512,6564,1799,3257,777,360,302,8,1,5,2,2,0,5,9,6527,37,1948
경상남도,통영시,북신동,관내사전투표,2488,2488,843,1024,274,162,157,7,0,2,0,1,0,0,4,2474,14,0
경상남도,통영시,북신동,북신동제1투,2564,1875,448,985,246,98,76,0,1,1,0,1,0,2,3,1861,14,689
경상남도,통영시,북신동,북신동제2투,2258,1463,328,845,165,64,50,1,0,1,1,0,0,2,1,1458,5,795
경상남도,통영시,북신동,북신동제3투,1202,738,180,403,92,36,19,0,0,1,1,0,0,1,1,734,4,464
경상남도,통영시,무전동,합계,10550,7885,2554,3279,1041,541,397,12,1,2,1,3,4,3,11,7849,36,2665
경상남도,통영시,무전동,관내사전투표,1866,1866,774,598,211,139,117,5,1,1,0,2,1,1,4,1854,12,0
경상남도,통영시,무전동,무전동제1투,3255,2011,552,995,240,112,88,2,0,1,1,0,2,2,6,2001,10,1244
경상남도,통영시,무전동,무전동제2투,2776,1972,549,874,272,154,111,2,0,0,0,0,1,0,1,1964,8,804
경상남도,통영시,무전동,무전동제3투,2653,2036,679,812,318,136,81,3,0,0,0,1,0,0,0,2030,6,617
경상남도,통영시,미수동,합계,9237,6848,2127,2823,953,485,386,11,1,5,1,6,3,9,9,6819,29,2389
경상남도,통영시,미수동,관내사전투표,1800,1800,702,608,223,133,117,0,0,0,1,3,1,3,1,1792,8,0
경상남도,통영시,미수동,미수동제1투,2042,1317,317,643,187,82,69,4,0,1,0,0,0,2,3,1308,9,725
경상남도,통영시,미수동,미수동제2투,2260,1554,439,666,223,120,86,4,1,1,0,1,0,1,3,1545,9,706
경상남도,통영시,미수동,미수동제3투,1436,939,271,411,130,68,49,3,0,0,0,0,2,2,2,938,1,497
경상남도,통영시,미수동,미수동제4투,1699,1238,398,495,190,82,65,0,0,3,0,2,0,1,0,1236,2,461
경상남도,통영시,봉평동,합계,9764,6589,1904,3029,880,399,289,5,0,14,3,2,4,8,6,6543,46,3175
경상남도,통영시,봉평동,관내사전투표,1547,1547,559,599,185,110,78,2,0,5,0,0,0,1,1,1540,7,0
경상남도,통영시,봉평동,봉평동제1투,2113,1341,380,597,198,83,65,1,0,0,1,0,0,1,0,1326,15,772
경상남도,통영시,봉평동,봉평동제2투,2482,1504,398,742,193,71,72,2,0,4,1,1,3,4,3,1494,10,978
경상남도,통영시,봉평동,봉평동제3투,1882,1110,270,547,165,74,41,0,0,4,1,0,0,2,0,1104,6,772
경상남도,통영시,봉평동,봉평동제4투,1740,1087,297,544,139,61,33,0,0,1,0,1,1,0,2,1079,8,653
경상남도,통영시,잘못 투입·구분된 투표지,,0,0,0,0,0,0,0,0,0,0,0,0,0,0,0,0,0,0
경상남도,고성군,합계,,47369,34603,9848,16797,4104,1828,1459,51,13,19,13,21,39,75,71,34338,265,12766
경상남도,고성군,거소·선상투표,,299,283,79,91,61,19,8,3,1,1,2,2,1,1,0,269,14,16
경상남도,고성군,관외사전투표,,3944,3944,1582,1095,541,379,289,8,3,1,0,0,1,4,9,3912,32,0
경상남도,고성군,재외투표,,512,227,85,30,83,8,18,2,0,0,0,0,0,0,0,226,1,285
경상남도,고성군,고성읍,합계,19417,13844,4348,6176,1680,801,658,18,3,10,2,9,10,14,25,13754,90,5573
경상남도,고성군,고성읍,관내사전투표,4133,4133,1577,1532,479,254,232,11,2,2,2,4,3,0,9,4107,26,0
경상남도,고성군,고성읍,고성읍제1투,2748,1735,522,830,188,102,75,2,0,1,0,0,0,2,1,1723,12,1013
경상남도,고성군,고성읍,고성읍제2투,4236,2782,818,1241,376,180,141,2,0,2,0,2,2,2,3,2769,13,1454
경상남도,고성군,고성읍,고성읍제3투,2059,1331,409,572,177,80,74,1,0,1,0,1,0,2,3,1320,11,728
경상남도,고성군,고성읍,고성읍제4투,1773,1128,270,622,126,54,42,0,0,1,0,1,1,2,2,1121,7,645
경상남도,고성군,고성읍,고성읍제5투,2622,1553,469,710,198,83,66,1,0,2,0,0,0,3,5,1537,16,1069
경상남도,고성군,고성읍,고성읍제6투,738,489,129,259,62,20,10,0,0,0,0,1,3,1,1,486,3,249
경상남도,고성군,고성읍,고성읍제7투,1108,693,154,410,74,28,18,1,1,1,0,0,1,2,1,691,2,415
경상남도,고성군,삼산면,합계,1465,1036,271,556,127,46,21,0,0,0,0,1,2,2,1,1027,9,429
경상남도,고성군,삼산면,관내사전투표,350,350,99,178,38,23,9,0,0,0,0,0,0,0,0,347,3,0
경상남도,고성군,삼산면,삼산면투표소,1115,686,172,378,89,23,12,0,0,0,0,1,2,2,1,680,6,429
경상남도,고성군,하일면,관내사전투표,342,342,80,187,41,16,10,0,1,0,0,0,1,0,1,337,5,0
경상남도,고성군,하일면,합계,1612,1105,192,700,121,36,28,0,1,0,0,1,3,9,2,1093,12,507
경상남도,고성군,하일면,하일면투표소,1270,763,112,513,80,20,18,0,0,0,0,1,2,9,1,756,7,507
경상남도,고성군,하이면,합계,2210,1582,334,914,183,68,50,4,2,1,1,2,0,2,8,1569,13,628
경상남도,고성군,하이면,관내사전투표,421,421,107,214,57,17,17,0,1,1,0,0,0,0,4,418,3,0
경상남도,고성군,하이면,하이면투표소,1789,1161,227,700,126,51,33,4,1,0,1,2,0,2,4,1151,10,628
경상남도,고성군,상리면,관내사전투표,377,377,102,197,39,20,14,0,0,0,0,0,1,0,0,373,4,0
경상남도,고성군,상리면,합계,1421,1037,248,618,95,34,27,2,0,0,0,0,1,2,0,1027,10,384
경상남도,고성군,상리면,상리면투표소,1044,660,146,421,56,14,13,2,0,0,0,0,0,2,0,654,6,384
경상남도,고성군,대가면,관내사전투표,276,276,80,146,28,8,10,0,0,0,0,1,0,2,0,275,1,0
경상남도,고성군,대가면,합계,1363,990,220,597,102,30,25,0,0,0,1,1,1,5,2,984,6,373
경상남도,고성군,대가면,대가면투표소,1087,714,140,451,74,22,15,0,0,0,1,0,1,3,2,709,5,373
경상남도,고성군,영현면,관내사전투표,240,240,49,135,25,21,7,0,0,0,0,0,1,0,0,238,2,0
경상남도,고성군,영현면,합계,763,594,121,340,70,35,18,0,0,0,0,0,3,1,1,589,5,169
경상남도,고성군,영현면,영현면투표소,523,354,72,205,45,14,11,0,0,0,0,0,2,1,1,351,3,169
경상남도,고성군,영오면,합계,1230,885,215,503,91,39,20,2,0,2,0,0,2,4,3,881,4,345
경상남도,고성군,영오면,관내사전투표,312,312,88,168,35,11,3,1,0,1,0,0,2,1,0,310,2,0
경상남도,고성군,영오면,영오면투표소,918,573,127,335,56,28,17,1,0,1,0,0,0,3,3,571,2,345
경상남도,고성군,개천면,관내사전투표,197,197,49,107,20,10,7,1,0,0,1,0,0,0,0,195,2,0
경상남도,고성군,개천면,합계,966,749,179,426,74,32,18,2,1,2,1,0,2,6,1,744,5,217
경상남도,고성군,개천면,개천면제1투,470,327,88,183,36,11,4,1,1,1,0,0,0,2,0,327,0,143
경상남도,고성군,개천면,개천면제2투,299,225,42,136,18,11,7,0,0,1,0,0,2,4,1,222,3,74
경상남도,고성군,구만면,합계,917,674,230,320,83,21,13,1,0,0,0,0,0,1,2,671,3,243
경상남도,고성군,구만면,관내사전투표,252,252,108,102,27,7,5,0,0,0,0,0,0,1,0,250,2,0
경상남도,고성군,구만면,구만면투표소,665,422,122,218,56,14,8,1,0,0,0,0,0,0,2,421,1,243
경상남도,고성군,회화면,합계,3161,2263,475,1349,226,89,90,0,0,0,2,2,1,6,4,2244,19,898
경상남도,고성군,회화면,관내사전투표,798,798,201,431,87,30,35,0,0,0,1,0,0,2,1,788,10,0
경상남도,고성군,회화면,회화면투표소,2363,1465,274,918,139,59,55,0,0,0,1,2,1,4,3,1456,9,898
경상남도,고성군,마암면,관내사전투표,361,361,75,222,38,7,9,0,0,1,0,1,2,1,0,356,5,0
경상남도,고성군,마암면,합계,1508,1075,257,593,131,24,40,1,0,2,1,1,2,7,5,1064,11,433
경상남도,고성군,마암면,마암면투표소,1147,714,182,371,93,17,31,1,0,1,1,0,0,6,5,708,6,433
경상남도,고성군,동해면,관내사전투표,321,321,79,170,35,22,10,1,0,0,0,0,0,1,1,319,2,0
경상남도,고성군,동해면,합계,2696,1775,374,1090,176,63,40,2,1,0,1,0,7,4,4,1762,13,921
경상남도,고성군,동해면,동해면제1투,1266,728,146,465,61,25,16,1,0,0,0,0,4,2,0,720,8,538
경상남도,고성군,동해면,동해면제2투,1109,726,149,455,80,16,14,0,1,0,1,0,3,1,3,723,3,383
경상남도,고성군,거류면,관내사전투표,599,599,198,268,59,30,33,1,0,0,0,1,1,2,0,593,6,0
경상남도,고성군,거류면,합계,3885,2540,638,1399,260,104,96,6,1,0,2,2,3,7,4,2522,18,1345
경상남도,고성군,거류면,거류면제1투,2157,1205,283,683,129,47,44,4,0,0,0,1,1,4,3,1199,6,952
경상남도,고성군,거류면,거류면제2투,1129,736,157,448,72,27,19,1,1,0,2,0,1,1,1,730,6,393
경상남도,고성군,잘못 투입·구분된 투표지,,0,0,0,0,0,0,0,0,0,0,0,0,0,0,0,0,0,0
경상남도,사천시,합계,,94377,71555,22370,32475,8350,4135,3267,62,15,34,21,56,48,110,123,71066,489,22822
경상남도,사천시,거소·선상투표,,324,304,90,98,68,23,5,1,0,2,1,0,2,0,3,293,11,20
경상남도,사천시,관외사전투표,,7789,7788,3275,1932,1118,745,603,9,4,3,3,3,2,4,14,7715,73,1
경상남도,사천시,재외투표,,510,310,164,28,76,10,30,1,0,0,0,0,0,0,0,309,1,200
경상남도,사천시,사천읍,합계,13986,10203,3429,4232,1236,675,540,7,0,6,3,6,4,7,16,10161,42,3783
경상남도,사천시,사천읍,관내사전투표,3309,3309,1409,1069,389,222,201,1,0,0,0,3,0,3,3,3300,9,0
경상남도,사천시,사천읍,사천읍제1투,3391,2173,776,856,278,144,100,2,0,1,0,1,0,0,7,2165,8,1218
경상남도,사천시,사천읍,사천읍제2투,1692,1036,270,519,114,71,48,1,0,2,1,0,0,1,2,1029,7,656
경상남도,사천시,사천읍,사천읍제3투,1922,1210,292,593,175,87,51,3,0,0,0,1,2,1,1,1206,4,712
경상남도,사천시,사천읍,사천읍제4투,3672,2475,682,1195,280,151,140,0,0,3,2,1,2,2,3,2461,14,1197
경상남도,사천시,정동면,합계,7032,5294,1896,2149,617,277,293,1,0,2,0,7,6,6,9,5263,31,1738
경상남도,사천시,정동면,관내사전투표,853,853,356,307,89,46,46,0,0,0,0,2,2,0,3,851,2,0
경상남도,사천시,정동면,정동면제1투,1641,1194,356,567,127,71,63,0,0,0,0,0,1,2,0,1187,7,447
경상남도,사천시,정동면,정동면제2투,2002,1565,607,564,213,78,90,0,0,1,0,2,1,1,1,1558,7,437
경상남도,사천시,정동면,정동면제3투,2536,1682,577,711,188,82,94,1,0,1,0,3,2,3,5,1667,15,854
경상남도,사천시,사남면,합계,9896,7762,3115,2739,954,522,374,3,0,4,2,6,1,9,8,7737,25,2134
경상남도,사천시,사남면,관내사전투표,2494,2494,1088,783,306,176,125,0,0,1,0,3,0,3,0,2485,9,0
경상남도,사천시,사남면,사남면제1투,1990,1243,320,702,113,53,33,3,0,1,1,1,1,4,3,1235,8,747
경상남도,사천시,사남면,사남면제2투,2297,1746,678,601,231,139,87,0,0,2,1,1,0,0,4,1744,2,551
경상남도,사천시,사남면,사남면제3투,3115,2279,1029,653,304,154,129,0,0,0,0,1,0,2,1,2273,6,836
경상남도,사천시,용현면,합계,6063,4350,1342,1989,530,245,177,8,1,4,1,3,3,10,5,4318,32,1713
경상남도,사천시,용현면,관내사전투표,1409,1409,493,588,168,77,66,4,0,1,0,1,0,0,0,1398,11,0
경상남도,사천시,용현면,용현면제1투,1923,1210,380,534,145,72,58,1,0,0,0,1,3,5,2,1201,9,713
경상남도,사천시,용현면,용현면제2투,2731,1731,469,867,217,96,53,3,1,3,1,1,0,5,3,1719,12,1000
경상남도,사천시,축동면,합계,1638,1260,298,775,102,38,29,0,0,1,1,0,0,5,2,1251,9,378
경상남도,사천시,축동면,관내사전투표,376,376,111,180,49,18,10,0,0,0,1,0,0,3,1,373,3,0
경상남도,사천시,축동면,축동면투표소,1262,884,187,595,53,20,19,0,0,1,0,0,0,2,1,878,6,378
경상남도,사천시,곤양면,합계,3158,2331,513,1329,257,97,58,3,0,2,1,2,5,6,11,2284,47,827
경상남도,사천시,곤양면,관내사전투표,589,589,163,278,72,23,21,2,0,1,0,2,0,0,10,572,17,0
경상남도,사천시,곤양면,곤양면제1투,1867,1250,259,719,152,56,28,1,0,1,0,0,3,4,1,1224,26,617
경상남도,사천시,곤양면,곤양면제2투,702,492,91,332,33,18,9,0,0,0,1,0,2,2,0,488,4,210
경상남도,사천시,곤명면,합계,2509,1869,417,1156,161,58,43,4,0,1,0,4,6,2,6,1858,11,640
경상남도,사천시,곤명면,관내사전투표,413,413,115,227,42,12,9,3,0,0,0,0,1,0,2,411,2,0
경상남도,사천시,곤명면,곤명면제1투,945,630,123,417,47,13,21,0,0,0,0,2,1,1,1,626,4,315
경상남도,사천시,곤명면,곤명면제2투,1151,826,179,512,72,33,13,1,0,1,0,2,4,1,3,821,5,325
경상남도,사천시,서포면,합계,3142,2164,467,1313,216,72,44,1,0,0,1,1,4,11,9,2139,25,978
경상남도,사천시,서포면,관내사전투표,706,706,167,422,69,21,10,1,0,0,1,1,2,4,3,701,5,0
경상남도,사천시,서포면,서포면투표소,2436,1458,300,891,147,51,34,0,0,0,0,0,2,7,6,1438,20,978
경상남도,사천시,동서동,합계,6319,4426,826,2844,436,157,119,1,0,0,2,0,4,8,6,4403,23,1893
경상남도,사천시,동서동,관내사전투표,729,729,182,408,69,35,33,0,0,0,0,0,0,0,0,727,2,0
경상남도,사천시,동서동,동서동제1투,2117,1367,221,920,138,39,33,0,0,0,2,0,3,3,1,1360,7,750
경상남도,사천시,동서동,동서동제2투,1709,1145,208,756,102,46,23,1,0,0,0,0,0,3,4,1143,2,564
경상남도,사천시,동서동,동서동제3투,1517,1022,197,635,114,34,28,0,0,0,0,0,0,2,0,1010,12,495
경상남도,사천시,동서동,동서동제4투,247,163,18,125,13,3,2,0,0,0,0,0,1,0,1,163,0,84
경상남도,사천시,선구동,합계,4561,3198,793,1804,301,149,110,6,2,0,1,4,2,5,1,3178,20,1363
경상남도,사천시,선구동,관내사전투표,568,568,202,229,55,38,38,1,0,0,0,1,0,0,0,564,4,0
경상남도,사천시,선구동,선구동제1투,1420,872,123,601,84,40,15,1,1,0,0,0,1,2,1,869,3,548
경상남도,사천시,선구동,선구동제2투,1122,752,203,419,56,37,20,3,1,0,0,1,1,1,0,742,10,370
경상남도,사천시,선구동,선구동제3투,1451,1006,265,555,106,34,37,1,0,0,1,2,0,2,0,1003,3,445
경상남도,사천시,동서금동,관내사전투표,1376,1376,391,734,140,67,33,0,0,0,0,0,0,2,0,1367,9,0
경상남도,사천시,동서금동,합계,4628,3282,768,1866,373,142,98,3,0,0,0,1,0,6,3,3260,22,1346
경상남도,사천시,동서금동,동서금동제1투,1926,1090,230,629,129,51,42,1,0,0,0,1,0,2,1,1086,4,836
경상남도,사천시,동서금동,동서금동제2투,1326,816,147,503,104,24,23,2,0,0,0,0,0,2,2,807,9,510
경상남도,사천시,벌용동,합계,12541,9320,2860,4324,1047,528,448,7,1,3,3,14,2,9,12,9258,62,3221
경상남도,사천시,벌용동,관내사전투표,2566,2566,978,975,261,148,170,5,0,1,2,4,0,1,5,2550,16,0
경상남도,사천시,벌용동,벌용동제1투,3080,2037,553,1009,238,123,85,2,1,2,0,2,1,0,1,2017,20,1043
경상남도,사천시,벌용동,벌용동제2투,1949,1301,307,754,131,64,31,0,0,0,0,1,0,4,3,1295,6,648
경상남도,사천시,벌용동,벌용동제3투,2298,1586,426,803,183,83,83,0,0,0,0,1,0,0,1,1580,6,712
경상남도,사천시,벌용동,벌용동제4투,2648,1830,596,783,234,110,79,0,0,0,1,6,1,4,2,1816,14,818
경상남도,사천시,향촌동,합계,5727,4237,1135,2139,481,230,174,5,7,3,0,2,4,14,12,4206,31,1490
경상남도,사천시,향촌동,관내사전투표,1456,1456,482,593,168,85,87,2,6,3,0,0,1,7,6,1440,16,0
경상남도,사천시,향촌동,향촌동제1투,3129,2008,503,1070,226,113,74,2,0,0,0,2,2,2,3,1997,11,1121
경상남도,사천시,향촌동,향촌동제2투,1142,773,150,476,87,32,13,1,1,0,0,0,1,5,3,769,4,369
경상남도,사천시,남양동,합계,4554,3457,982,1758,377,167,122,2,0,3,2,3,3,8,6,3433,24,1097
경상남도,사천시,남양동,관내사전투표,999,999,366,421,102,59,41,0,0,1,1,2,0,2,2,997,2,0
경상남도,사천시,남양동,남양동제1투,3007,2064,545,1078,238,94,75,2,0,2,1,0,3,4,4,2046,18,943
경상남도,사천시,남양동,남양동제2투,548,394,71,259,37,14,6,0,0,0,0,1,0,2,0,390,4,154
경상남도,사천시,잘못 투입·구분된 투표지,,0,0,0,0,0,0,0,0,0,0,0,0,0,0,0,0,0,0
경상남도,김해시,합계,,414018,318253,147972,82880,45126,21936,17441,291,52,158,79,157,83,123,387,316685,1568,95765
경상남도,김해시,거소·선상투표,,1153,1075,416,226,254,81,29,1,1,5,0,1,1,2,16,1033,42,78
경상남도,김해시,관외사전투표,,29679,29677,14045,5552,4699,2691,2232,25,14,8,9,24,12,7,83,29401,276,2
경상남도,김해시,재외투표,,1803,1320,798,92,195,51,166,5,0,0,0,1,0,1,1,1310,10,483
경상남도,김해시,진영읍,합계,33649,24833,12759,6164,3001,1523,1177,28,2,12,6,10,8,6,27,24723,110,8816
경상남도,김해시,진영읍,관내사전투표,6097,6098,3511,1249,585,400,307,7,2,3,1,1,2,1,3,6072,26,-1
경상남도,김해시,진영읍,진영읍제1투,1779,1238,533,437,142,61,51,4,0,1,0,2,0,0,1,1232,6,541
경상남도,김해시,진영읍,진영읍제2투,4449,2993,1488,788,385,170,132,8,0,2,0,0,2,1,5,2981,12,1456
경상남도,김해시,진영읍,진영읍제3투,4736,3679,1933,766,488,259,210,6,0,0,0,4,0,0,3,3669,10,1057
경상남도,김해시,진영읍,진영읍제4투,2873,2309,1216,513,307,157,109,0,0,2,0,1,0,0,1,2306,3,564
경상남도,김해시,진영읍,진영읍제5투,4622,2818,1413,707,377,153,142,1,0,1,2,1,1,2,5,2805,13,1804
경상남도,김해시,진영읍,진영읍제6투,3503,2009,952,579,267,107,78,2,0,0,0,0,0,2,6,1993,16,1494
경상남도,김해시,진영읍,진영읍제7투,3656,2475,1149,701,324,153,121,0,0,3,2,1,2,0,2,2458,17,1181
경상남도,김해시,진영읍,진영읍제8투,1934,1214,564,424,126,63,27,0,0,0,1,0,1,0,1,1207,7,720
경상남도,김해시,주촌면,합계,3220,2293,861,980,261,104,54,6,2,4,2,0,0,2,0,2276,17,927
경상남도,김해시,주촌면,관내사전투표,1010,1010,449,349,118,48,33,2,2,3,1,0,0,0,0,1005,5,0
경상남도,김해시,주촌면,주촌면투표소,2210,1283,412,631,143,56,21,4,0,1,1,0,0,2,0,1271,12,927
경상남도,김해시,진례면,관내사전투표,1385,1385,628,465,143,70,59,1,0,1,0,2,2,1,0,1372,13,0
경상남도,김해시,진례면,합계,6243,4442,1700,1735,536,232,178,3,1,2,2,3,2,3,4,4401,41,1801
경상남도,김해시,진례면,진례면제1투,2462,1595,579,633,204,83,73,1,0,1,1,1,0,0,4,1580,15,867
경상남도,김해시,진례면,진례면제2투,2396,1462,493,637,189,79,46,1,1,0,1,0,0,2,0,1449,13,934
경상남도,김해시,한림면,합계,7073,4850,2145,1756,534,194,133,7,0,9,1,5,7,10,11,4812,38,2223
경상남도,김해시,한림면,관내사전투표,860,860,445,235,90,48,25,0,0,4,1,3,1,1,1,854,6,0
경상남도,김해시,한림면,한림면제1투,1306,812,320,334,96,36,15,1,0,1,0,0,0,2,2,807,5,494
경상남도,김해시,한림면,한림면제2투,1621,1067,392,490,96,33,38,4,0,1,0,1,1,3,1,1060,7,554
경상남도,김해시,한림면,한림면제3투,1954,1265,621,375,161,51,35,1,0,2,0,1,3,2,4,1256,9,689
경상남도,김해시,한림면,한림면제4투,1332,846,367,322,91,26,20,1,0,1,0,0,2,2,3,835,11,486
경상남도,김해시,생림면,합계,3719,2676,952,1206,293,119,65,3,0,4,1,0,1,4,3,2651,25,1043
경상남도,김해시,생림면,관내사전투표,923,923,427,311,82,51,40,0,0,0,1,0,1,1,1,915,8,0
경상남도,김해시,생림면,생림면제1투,1424,864,258,463,90,29,10,2,0,2,0,0,0,2,0,856,8,560
경상남도,김해시,생림면,생림면제2투,1372,889,267,432,121,39,15,1,0,2,0,0,0,1,2,880,9,483
경상남도,김해시,상동면,합계,2992,2177,759,929,273,84,66,7,1,2,3,2,2,3,4,2135,42,815
경상남도,김해시,상동면,관내사전투표,869,869,332,329,107,33,28,4,0,1,2,2,2,2,0,842,27,0
경상남도,김해시,상동면,상동면제1투,1606,959,331,433,119,30,30,2,1,1,0,0,0,1,3,951,8,647
경상남도,김해시,상동면,상동면제2투,517,349,96,167,47,21,8,1,0,0,1,0,0,0,1,342,7,168
경상남도,김해시,대동면,합계,5838,4251,1489,1861,525,201,137,3,0,6,1,3,0,1,4,4231,20,1587
경상남도,김해시,대동면,관내사전투표,895,895,374,312,115,57,30,0,0,1,1,2,0,0,1,893,2,0
경상남도,김해시,대동면,대동면제1투,1623,1088,373,496,135,45,29,1,0,3,0,1,0,0,0,1083,5,535
경상남도,김해시,대동면,대동면제2투,1778,1191,415,505,162,62,37,1,0,1,0,0,0,0,0,1183,8,587
경상남도,김해시,대동면,대동면제3투,1542,1077,327,548,113,37,41,1,0,1,0,0,0,1,3,1072,5,465
경상남도,김해시,동상동,합계,8634,6137,2387,2226,834,363,260,6,2,3,1,2,3,3,4,6094,43,2497
경상남도,김해시,동상동,관내사전투표,2245,2245,1020,729,244,130,104,2,2,1,1,1,1,0,0,2235,10,0
경상남도,김해시,동상동,동상동제1투,3849,2448,868,898,382,167,112,0,0,1,0,1,0,2,2,2433,15,1401
경상남도,김해시,동상동,동상동제2투,2540,1444,499,599,208,66,44,4,0,1,0,0,2,1,2,1426,18,1096
경상남도,김해시,회현동,합계,7732,5664,2263,2130,708,289,226,7,0,0,2,2,1,1,7,5636,28,2068
경상남도,김해시,회현동,관내사전투표,2451,2451,1076,858,268,122,108,2,0,0,0,1,0,1,4,2440,11,0
경상남도,김해시,회현동,회현동제1투,2227,1379,504,569,179,77,43,2,0,0,0,0,0,0,0,1374,5,848
경상남도,김해시,회현동,회현동제2투,3054,1834,683,703,261,90,75,3,0,0,2,1,1,0,3,1822,12,1220
경상남도,김해시,부원동,합계,8903,6510,2805,2086,852,384,331,4,1,3,2,2,1,3,5,6479,31,2393
경상남도,김해시,부원동,관내사전투표,2488,2488,1256,640,270,159,143,2,0,1,1,0,0,3,0,2475,13,0
경상남도,김해시,부원동,부원동제1투,2961,1811,737,591,257,120,92,1,1,2,0,1,0,0,3,1805,6,1150
경상남도,김해시,부원동,부원동제2투,3454,2211,812,855,325,105,96,1,0,0,1,1,1,0,2,2199,12,1243
경상남도,김해시,내외동,합계,60598,44624,20739,11431,6398,3102,2580,34,5,19,9,33,10,15,44,44419,205,15974
경상남도,김해시,내외동,관내사전투표,10812,10812,5746,2219,1369,700,689,5,1,3,0,6,1,3,13,10755,57,0
경상남도,김해시,내외동,내외동제1투,2797,1853,867,439,280,118,136,1,0,0,1,4,0,1,4,1851,2,944
경상남도,김해시,내외동,내외동제2투,2685,1657,680,481,270,111,96,5,0,3,1,2,0,1,0,1650,7,1028
경상남도,김해시,내외동,내외동제3투,2411,1490,610,460,236,91,71,2,0,0,0,1,2,1,4,1478,12,921
경상남도,김해시,내외동,내외동제4투,3191,2073,904,597,302,157,101,1,0,1,0,4,0,0,0,2067,6,1118
경상남도,김해시,내외동,내외동제5투,3947,2807,1229,762,449,231,118,1,0,1,1,0,0,2,2,2796,11,1140
경상남도,김해시,내외동,내외동제6투,3745,2858,1332,698,441,200,163,9,0,1,4,1,1,2,2,2854,4,887
경상남도,김해시,내외동,내외동제7투,3163,1698,726,482,262,101,113,0,0,2,1,2,0,0,0,1689,9,1465
경상남도,김해시,내외동,내외동제8투,2943,1995,897,519,301,146,117,3,1,0,0,1,1,0,2,1988,7,948
경상남도,김해시,내외동,내외동제9투,3283,2476,1114,673,376,169,122,1,0,1,1,1,1,0,6,2465,11,807
경상남도,김해시,내외동,내외동제10투,2972,2177,1005,542,297,194,126,1,0,1,0,0,1,0,0,2167,10,795
경상남도,김해시,내외동,내외동제11투,2803,1662,719,535,195,91,94,0,0,2,0,4,2,2,2,1646,16,1141
경상남도,김해시,내외동,내외동제12투,4015,3184,1399,895,438,249,181,3,0,0,0,1,1,1,2,3170,14,831
경상남도,김해시,내외동,내외동제13투,3891,2349,1004,678,362,170,123,1,2,1,0,2,0,1,1,2345,4,1542
경상남도,김해시,내외동,내외동제14투,3975,2753,1269,663,443,187,173,0,1,0,0,2,0,1,3,2742,11,1222
경상남도,김해시,내외동,내외동제15투,3965,2780,1238,788,377,187,157,1,0,3,0,2,0,0,3,2756,24,1185
경상남도,김해시,북부동,합계,57272,43700,21343,10522,6229,3025,2309,34,5,14,13,16,11,18,41,43580,120,13572
경상남도,김해시,북부동,관내사전투표,10635,10635,5900,2018,1314,727,614,7,0,3,4,4,4,3,10,10608,27,0
경상남도,김해시,북부동,북부동제1투,3478,2028,819,716,255,120,99,2,0,2,0,1,1,2,3,2020,8,1450
경상남도,김해시,북부동,북부동제2투,3177,2119,801,736,341,126,87,5,2,4,0,2,4,1,0,2109,10,1058
경상남도,김해시,북부동,북부동제3투,3572,2410,1033,759,342,144,118,2,0,2,1,0,0,1,1,2403,7,1162
경상남도,김해시,북부동,북부동제4투,3023,2381,1247,444,365,191,127,1,0,0,0,1,0,0,3,2379,2,642
경상남도,김해시,북부동,북부동제5투,3519,2661,1322,555,389,217,160,2,0,0,3,2,0,1,5,2656,5,858
경상남도,김해시,북부동,북부동제6투,3907,2760,1180,827,406,185,143,2,0,1,0,0,0,1,4,2749,11,1147
경상남도,김해시,북부동,북부동제7투,3017,2271,988,686,331,166,87,0,0,1,2,0,0,2,3,2266,5,746
경상남도,김해시,북부동,북부동제8투,2857,1979,924,503,294,136,110,4,0,0,0,0,0,0,1,1972,7,878
경상남도,김해시,북부동,북부동제9투,2782,1877,916,433,295,114,105,1,2,0,0,1,0,3,1,1871,6,905
경상남도,김해시,북부동,북부동제10투,2238,1539,755,320,238,135,84,0,0,0,0,0,0,0,1,1533,6,699
경상남도,김해시,북부동,북부동제11투,3008,2268,1169,461,352,172,105,1,1,0,1,0,1,0,1,2264,4,740
경상남도,김해시,북부동,북부동제12투,2365,1519,708,384,216,101,99,1,0,0,1,1,0,1,2,1514,5,846
경상남도,김해시,북부동,북부동제13투,3489,2531,1211,641,364,165,134,4,0,0,0,2,0,0,2,2523,8,958
경상남도,김해시,북부동,북부동제14투,2882,2166,1075,472,327,148,135,1,0,0,1,0,0,2,3,2164,2,716
경상남도,김해시,북부동,북부동제15투,3323,2556,1295,567,400,178,102,1,0,1,0,2,1,1,1,2549,7,767
경상남도,김해시,칠산서부동,합계,8290,6094,2590,2010,783,366,291,4,2,2,2,4,1,1,8,6064,30,2196
경상남도,김해시,칠산서부동,관내사전투표,1894,1894,950,486,229,101,111,2,0,1,0,2,0,0,3,1885,9,0
경상남도,김해시,칠산서부동,칠산서부동제1투,2277,1521,559,610,196,85,58,1,0,1,1,1,0,0,1,1513,8,756
경상남도,김해시,칠산서부동,칠산서부동제2투,4119,2679,1081,914,358,180,122,1,2,0,1,1,1,1,4,2666,13,1440
경상남도,김해시,활천동,합계,33276,23512,10266,6887,3306,1642,1206,23,3,15,5,8,7,8,26,23402,110,9764
경상남도,김해시,활천동,관내사전투표,5069,5069,2469,1333,575,367,288,5,0,2,0,1,1,1,6,5048,21,0
경상남도,김해시,활천동,활천동제1투,3957,2411,944,797,368,169,109,1,0,0,1,1,3,1,1,2395,16,1546
경상남도,김해시,활천동,활천동제2투,3614,2457,1073,686,357,200,117,2,1,2,2,2,0,1,2,2445,12,1157
경상남도,김해시,활천동,활천동제3투,3569,2333,963,756,342,148,105,1,1,2,0,0,2,2,1,2323,10,1236
경상남도,김해시,활천동,활천동제4투,4869,3149,1273,1020,461,213,149,7,0,3,0,1,0,2,7,3136,13,1720
경상남도,김해시,활천동,활천동제5투,4460,2918,1296,833,412,189,165,3,0,2,2,0,0,0,2,2904,14,1542
경상남도,김해시,활천동,활천동제6투,3708,2772,1215,771,438,192,134,2,1,1,0,1,0,1,4,2760,12,936
경상남도,김해시,활천동,활천동제7투,4030,2403,1033,691,353,164,139,2,0,3,0,2,1,0,3,2391,12,1627
경상남도,김해시,삼안동,합계,31481,22804,9786,6547,3291,1651,1306,20,3,17,9,21,4,9,40,22704,100,8677
경상남도,김해시,삼안동,관내사전투표,6284,6284,3142,1479,764,454,397,7,0,1,4,7,0,1,5,6261,23,0
경상남도,김해시,삼안동,삼안동제1투,3737,2307,916,729,334,169,132,2,1,3,2,1,1,1,5,2296,11,1430
경상남도,김해시,삼안동,삼안동제2투,2144,1481,593,508,190,100,76,0,0,0,0,1,0,0,7,1475,6,663
경상남도,김해시,삼안동,삼안동제3투,4038,2935,1205,872,438,224,172,2,1,3,0,1,0,1,2,2921,14,1103
경상남도,김해시,삼안동,삼안동제4투,3101,1815,708,567,301,120,97,4,1,2,2,1,0,2,3,1808,7,1286
경상남도,김해시,삼안동,삼안동제5투,3383,2501,1049,695,405,198,129,0,0,2,0,1,1,2,6,2488,13,882
경상남도,김해시,삼안동,삼안동제6투,2666,1892,816,534,314,120,93,0,0,2,0,2,0,0,4,1885,7,774
경상남도,김해시,삼안동,삼안동제7투,2972,1886,721,597,287,133,117,4,0,3,1,3,1,1,7,1875,11,1086
경상남도,김해시,삼안동,삼안동제8투,3156,1703,636,566,258,133,93,1,0,1,0,4,1,1,1,1695,8,1453
경상남도,김해시,불암동,합계,6451,4884,2073,1496,736,302,232,3,1,3,0,2,1,4,5,4858,26,1567
경상남도,김해시,불암동,관내사전투표,1263,1263,634,316,181,66,56,0,0,0,0,0,0,2,2,1257,6,0
경상남도,김해시,불암동,불암동제1투,4139,2970,1205,910,466,207,154,3,0,3,0,2,1,1,3,2955,15,1169
경상남도,김해시,불암동,불암동제2투,1049,651,234,270,89,29,22,0,1,0,0,0,0,1,0,646,5,398
경상남도,김해시,장유1동,합계,37020,28961,13811,6942,4354,1988,1660,26,3,18,5,2,5,11,24,28849,112,8059
경상남도,김해시,장유1동,관내사전투표,6635,6635,3587,1360,810,446,392,4,2,7,2,0,3,1,3,6617,18,0
경상남도,김해시,장유1동,장유1동제1투,3934,3058,1450,665,496,235,189,3,0,3,0,1,1,0,2,3045,13,876
경상남도,김해시,장유1동,장유1동제2투,3817,2850,1359,618,452,210,191,2,0,2,2,0,1,2,1,2840,10,967
경상남도,김해시,장유1동,장유1동제3투,3433,2550,1205,626,385,167,142,2,1,0,0,1,0,2,3,2534,16,883
경상남도,김해시,장유1동,장유1동제4투,3438,2739,1362,590,395,206,168,2,0,1,1,0,0,1,4,2730,9,699
경상남도,김해시,장유1동,장유1동제5투,3740,2877,1305,765,452,195,142,6,0,2,0,0,0,1,3,2871,6,863
경상남도,김해시,장유1동,장유1동제6투,4606,3226,1508,720,551,214,212,1,0,2,0,0,0,1,6,3215,11,1380
경상남도,김해시,장유1동,장유1동제7투,3802,2365,890,861,349,136,108,1,0,0,0,0,0,2,1,2348,17,1437
경상남도,김해시,장유1동,장유1동제8투,3615,2661,1145,737,464,179,116,5,0,1,0,0,0,1,1,2649,12,954
경상남도,김해시,장유2동,관내사전투표,6051,6051,3353,1138,738,405,378,5,1,2,1,5,1,2,2,6031,20,0
경상남도,김해시,장유2동,합계,24108,19098,9270,4366,2821,1382,1140,16,3,3,2,8,4,6,8,19029,69,5010
경상남도,김해시,장유2동,장유2동제1투,2534,1611,751,347,269,133,98,2,0,0,0,1,0,0,1,1602,9,923
경상남도,김해시,장유2동,장유2동제2투,2786,2016,893,558,304,144,102,1,0,0,0,0,2,0,0,2004,12,770
경상남도,김해시,장유2동,장유2동제3투,3033,2332,1070,537,378,181,152,3,0,0,0,1,0,1,2,2325,7,701
경상남도,김해시,장유2동,장유2동제4투,3337,2340,1038,622,392,159,118,1,2,0,0,0,0,1,2,2335,5,997
경상남도,김해시,장유2동,장유2동제5투,3167,2293,1022,607,356,158,137,2,0,0,1,1,0,1,0,2285,8,874
경상남도,김해시,장유2동,장유2동제6투,3200,2455,1143,557,384,202,155,2,0,1,0,0,1,1,1,2447,8,745
경상남도,김해시,장유3동,관내사전투표,7683,7683,4399,1263,928,597,459,8,1,1,0,4,1,0,8,7669,14,0
경상남도,김해시,장유3동,합계,34884,28671,14715,5736,4243,2162,1663,26,3,9,4,8,2,5,22,28598,73,6213
경상남도,김해시,장유3동,장유3동제1투,3823,3045,1472,686,462,244,171,1,0,3,1,0,0,0,1,3041,4,778
경상남도,김해시,장유3동,장유3동제2투,2945,2335,1117,528,370,161,149,2,0,1,0,0,0,1,1,2330,5,610
경상남도,김해시,장유3동,장유3동제3투,3787,2891,1511,496,483,213,169,6,0,0,0,1,0,0,2,2881,10,896
경상남도,김해시,장유3동,장유3동제4투,3345,2415,1202,537,340,168,158,1,0,2,0,0,0,0,1,2409,6,930
경상남도,김해시,장유3동,장유3동제5투,2700,2159,1127,400,336,167,117,2,0,0,0,0,0,0,1,2150,9,541
경상남도,김해시,장유3동,장유3동제6투,3410,2626,1126,702,434,207,145,1,1,0,1,0,1,1,4,2623,3,784
경상남도,김해시,장유3동,장유3동제7투,3950,3253,1737,537,498,273,188,3,0,0,1,3,0,2,2,3244,9,697
경상남도,김해시,장유3동,장유3동제8투,3241,2264,1024,587,392,132,107,2,1,2,1,0,0,1,2,2251,13,977
경상남도,김해시,잘못 투입·구분된 투표지,,0,0,0,0,0,0,0,0,0,0,0,0,0,0,0,0,0,0
경상남도,밀양시,합계,,93568,70687,20842,32394,9073,4441,2940,116,16,41,26,47,53,111,102,70202,485,22881
경상남도,밀양시,거소·선상투표,,405,369,114,119,73,14,8,5,5,2,1,1,1,3,4,350,19,36
경상남도,밀양시,관외사전투표,,7377,7375,2926,1992,1092,675,557,10,1,6,3,8,5,2,18,7295,80,2
경상남도,밀양시,재외투표,,677,363,181,41,88,12,40,0,0,0,0,1,0,0,0,363,0,314
경상남도,밀양시,삼랑진읍,합계,5836,4078,1045,2200,474,182,97,10,1,4,1,8,5,7,8,4042,36,1758
경상남도,밀양시,삼랑진읍,관내사전투표,807,807,285,345,97,40,31,2,0,1,0,1,2,0,1,805,2,0
경상남도,밀양시,삼랑진읍,삼랑진읍제1투,2093,1395,290,818,176,60,28,6,0,1,1,3,1,1,2,1387,8,698
경상남도,밀양시,삼랑진읍,삼랑진읍제2투,1882,1149,285,623,131,55,21,1,0,2,0,3,2,3,4,1130,19,733
경상남도,밀양시,삼랑진읍,삼랑진읍제3투,1054,727,185,414,70,27,17,1,1,0,0,1,0,3,1,720,7,327
경상남도,밀양시,하남읍,합계,6570,4621,1327,2321,518,259,122,6,1,3,3,2,8,9,8,4587,34,1949
경상남도,밀양시,하남읍,관내사전투표,1172,1172,443,454,120,84,54,2,0,2,0,1,1,3,2,1166,6,0
경상남도,밀양시,하남읍,하남읍제1투,995,678,150,411,75,21,7,1,0,1,1,1,4,2,2,676,2,317
경상남도,밀양시,하남읍,하남읍제2투,1332,811,209,414,102,43,30,1,0,0,1,0,1,1,1,803,8,521
경상남도,밀양시,하남읍,하남읍제3투,1304,875,246,477,97,24,11,0,0,0,1,0,1,3,2,862,13,429
경상남도,밀양시,하남읍,하남읍제4투,1767,1085,279,565,124,87,20,2,1,0,0,0,1,0,1,1080,5,682
경상남도,밀양시,부북면,합계,4769,3554,873,1971,401,149,111,5,0,0,1,2,3,6,7,3529,25,1215
경상남도,밀양시,부북면,관내사전투표,1008,1008,273,552,92,43,34,2,0,0,1,0,0,0,2,999,9,0
경상남도,밀양시,부북면,부북면제1투,1251,858,189,490,112,37,21,0,0,0,0,1,1,3,1,855,3,393
경상남도,밀양시,부북면,부북면제2투,1236,842,221,462,91,34,24,1,0,0,0,0,2,2,1,838,4,394
경상남도,밀양시,부북면,부북면제3투,1274,846,190,467,106,35,32,2,0,0,0,1,0,1,3,837,9,428
경상남도,밀양시,상동면,합계,2666,2038,514,1122,247,65,64,2,0,1,0,0,3,7,0,2025,13,628
경상남도,밀양시,상동면,관내사전투표,524,524,172,239,61,22,26,1,0,1,0,0,0,2,0,524,0,0
경상남도,밀양시,상동면,상동면제1투,1492,1050,250,611,123,27,28,0,0,0,0,0,2,3,0,1044,6,442
경상남도,밀양시,상동면,상동면제2투,650,464,92,272,63,16,10,1,0,0,0,0,1,2,0,457,7,186
경상남도,밀양시,산외면,합계,2468,1830,433,1003,236,90,44,2,0,1,0,2,1,1,5,1818,12,638
경상남도,밀양시,산외면,관내사전투표,552,552,159,267,70,34,15,1,0,0,0,0,0,0,2,548,4,0
경상남도,밀양시,산외면,산외면제1투,1096,732,166,415,93,34,15,0,0,1,0,1,1,1,1,728,4,364
경상남도,밀양시,산외면,산외면제2투,820,546,108,321,73,22,14,1,0,0,0,1,0,0,2,542,4,274
경상남도,밀양시,산내면,관내사전투표,575,575,171,288,59,22,25,1,0,0,0,0,2,1,1,570,5,0
경상남도,밀양시,산내면,합계,3270,2447,610,1350,284,92,68,3,1,1,2,1,4,7,4,2427,20,823
경상남도,밀양시,산내면,산내면제1투,1660,1122,242,657,143,46,20,0,0,0,0,0,1,5,2,1116,6,538
경상남도,밀양시,산내면,산내면제2투,1035,750,197,405,82,24,23,2,1,1,2,1,1,1,1,741,9,285
경상남도,밀양시,단장면,합계,3603,2633,648,1462,294,112,67,7,0,3,1,0,2,12,8,2616,17,970
경상남도,밀양시,단장면,관내사전투표,598,598,191,293,56,29,21,2,0,2,1,0,0,0,0,595,3,0
경상남도,밀양시,단장면,단장면제1투,797,549,130,303,65,22,17,3,0,0,0,0,1,4,3,548,1,248
경상남도,밀양시,단장면,단장면제2투,1128,763,157,451,91,34,16,0,0,1,0,0,1,4,2,757,6,365
경상남도,밀양시,단장면,단장면제3투,1080,723,170,415,82,27,13,2,0,0,0,0,0,4,3,716,7,357
경상남도,밀양시,상남면,관내사전투표,1168,1168,404,451,142,88,64,5,1,0,0,2,3,2,0,1162,6,0
경상남도,밀양시,상남면,합계,7444,5324,1466,2563,688,319,207,9,2,2,3,2,7,10,6,5284,40,2120
경상남도,밀양시,상남면,상남면제1투,2094,1373,333,701,191,74,47,4,0,1,1,0,1,1,2,1356,17,721
경상남도,밀양시,상남면,상남면제2투,1866,1249,401,513,166,96,57,0,0,0,0,0,0,5,1,1239,10,617
경상남도,밀양시,상남면,상남면제3투,2316,1534,328,898,189,61,39,0,1,1,2,0,3,2,3,1527,7,782
경상남도,밀양시,초동면,관내사전투표,526,526,150,257,55,32,23,0,0,0,2,0,0,1,3,523,3,0
경상남도,밀양시,초동면,합계,2871,2064,503,1144,238,98,51,1,1,0,3,0,0,3,5,2047,17,807
경상남도,밀양시,초동면,초동면투표소,2345,1538,353,887,183,66,28,1,1,0,1,0,0,2,2,1524,14,807
경상남도,밀양시,무안면,관내사전투표,1114,1114,289,583,104,97,28,0,0,3,0,0,0,3,2,1109,5,0
경상남도,밀양시,무안면,합계,4517,3234,714,1758,371,262,77,1,1,3,1,0,5,16,5,3214,20,1283
경상남도,밀양시,무안면,무안면제1투,1844,1131,221,617,149,100,27,0,0,0,0,0,1,7,1,1123,8,713
경상남도,밀양시,무안면,무안면제2투,1559,989,204,558,118,65,22,1,1,0,1,0,4,6,2,982,7,570
경상남도,밀양시,청도면,합계,1591,1201,307,646,133,57,32,3,0,2,0,0,2,7,2,1191,10,390
경상남도,밀양시,청도면,관내사전투표,330,330,101,157,37,17,12,2,0,0,0,0,0,2,1,329,1,0
경상남도,밀양시,청도면,청도면투표소,1261,871,206,489,96,40,20,1,0,2,0,0,2,5,1,862,9,390
경상남도,밀양시,내일동,합계,3194,2361,550,1268,311,125,89,3,0,2,1,2,0,2,0,2353,8,833
경상남도,밀양시,내일동,관내사전투표,886,886,242,404,120,62,50,2,0,1,0,2,0,1,0,884,2,0
경상남도,밀양시,내일동,내일동제1투,1781,1114,241,626,160,48,31,1,0,1,1,0,0,1,0,1110,4,667
경상남도,밀양시,내일동,내일동제2투,527,361,67,238,31,15,8,0,0,0,0,0,0,0,0,359,2,166
경상남도,밀양시,내이동,합계,9664,6671,1948,3076,837,466,293,12,1,1,2,4,2,3,3,6648,23,2993
경상남도,밀양시,내이동,관내사전투표,1641,1641,520,712,169,129,101,3,0,0,0,1,0,2,1,1638,3,0
경상남도,밀양시,내이동,내이동제1투,2456,1749,502,824,229,127,54,3,0,1,1,1,0,0,1,1743,6,707
경상남도,밀양시,내이동,내이동제2투,1623,1002,240,530,128,66,27,4,1,0,1,1,1,1,0,1000,2,621
경상남도,밀양시,내이동,내이동제3투,3944,2279,686,1010,311,144,111,2,0,0,0,1,1,0,1,2267,12,1665
경상남도,밀양시,교동,합계,5524,4323,1415,1732,581,304,251,6,0,4,1,0,2,0,4,4300,23,1201
경상남도,밀양시,교동,관내사전투표,1770,1770,684,556,228,148,132,5,0,4,1,0,0,0,1,1759,11,0
경상남도,밀양시,교동,교동제1투,1340,957,278,422,139,70,41,0,0,0,0,0,0,0,2,952,5,383
경상남도,밀양시,교동,교동제2투,2414,1596,453,754,214,86,78,1,0,0,0,0,2,0,1,1589,7,818
경상남도,밀양시,삼문동,합계,15199,11997,4133,4581,1628,931,623,20,1,5,2,11,0,8,8,11951,46,3202
경상남도,밀양시,삼문동,관내사전투표,4443,4443,1752,1440,548,390,278,9,1,2,0,5,0,0,2,4427,16,0
경상남도,밀양시,삼문동,삼문동제1투,1762,1270,396,553,178,89,44,1,0,0,0,0,0,1,1,1263,7,492
경상남도,밀양시,삼문동,삼문동제2투,1685,1130,261,607,150,65,34,4,0,0,0,0,0,2,2,1125,5,555
경상남도,밀양시,삼문동,삼문동제3투,2189,1471,478,578,211,103,88,2,0,1,2,1,0,0,1,1465,6,718
경상남도,밀양시,삼문동,삼문동제4투,2182,1514,424,679,228,96,75,2,0,1,0,1,0,0,0,1506,8,668
경상남도,밀양시,삼문동,삼문동제5투,2938,2169,822,724,313,188,104,2,0,1,0,4,0,5,2,2165,4,769
경상남도,밀양시,가곡동,합계,5923,4204,1135,2045,579,229,139,11,1,1,1,3,3,8,7,4162,42,1719
경상남도,밀양시,가곡동,관내사전투표,1122,1122,348,482,134,74,59,4,0,0,0,1,1,2,3,1108,14,0
경상남도,밀양시,가곡동,가곡동제1투,2626,1653,409,840,253,86,42,4,0,0,0,1,1,2,2,1640,13,973
경상남도,밀양시,가곡동,가곡동제2투,2175,1429,378,723,192,69,38,3,1,1,1,1,1,4,2,1414,15,746
경상남도,밀양시,잘못 투입·구분된 투표지,,0,0,0,0,0,0,0,0,0,0,0,0,0,0,0,0,0,0
경상남도,거제시,합계,,196936,150230,68291,38775,20359,10941,10256,167,28,85,46,83,49,102,212,149394,836,46706
경상남도,거제시,거소·선상투표,,666,615,182,142,120,47,22,3,2,7,5,3,4,3,5,545,70,51
경상남도,거제시,관외사전투표,,15732,15729,7595,2618,2425,1523,1356,13,7,2,6,11,5,8,42,15611,118,3
경상남도,거제시,재외투표,,762,563,355,37,71,36,58,5,0,0,0,0,0,0,0,562,1,199
경상남도,거제시,일운면,합계,5517,3833,1443,1501,408,241,192,2,0,2,0,0,3,6,2,3800,33,1684
경상남도,거제시,일운면,관내사전투표,1177,1177,507,414,111,70,65,1,0,0,0,0,0,0,1,1169,8,0
경상남도,거제시,일운면,일운면제1투,3288,1995,730,766,236,133,104,1,0,2,0,0,3,3,1,1979,16,1293
경상남도,거제시,일운면,일운면제2투,1052,661,206,321,61,38,23,0,0,0,0,0,0,3,0,652,9,391
경상남도,거제시,동부면,합계,2977,2178,695,1067,237,75,56,10,0,2,1,4,1,3,6,2157,21,799
경상남도,거제시,동부면,관내사전투표,637,637,247,255,60,25,30,2,0,1,0,3,1,2,2,628,9,0
경상남도,거제시,동부면,동부면투표소,2340,1541,448,812,177,50,26,8,0,1,1,1,0,1,4,1529,12,799
경상남도,거제시,남부면,합계,1421,994,226,564,136,40,14,0,0,1,0,2,0,4,2,989,5,427
경상남도,거제시,남부면,관내사전투표,227,227,67,103,41,10,4,0,0,0,0,1,0,0,0,226,1,0
경상남도,거제시,남부면,남부면투표소,1194,767,159,461,95,30,10,0,0,1,0,1,0,4,2,763,4,427
경상남도,거제시,거제면,합계,5852,4296,1471,1985,421,204,143,3,0,3,2,3,3,7,14,4259,37,1556
경상남도,거제시,거제면,관내사전투표,1715,1715,610,749,172,86,64,1,0,2,0,3,3,4,6,1700,15,0
경상남도,거제시,거제면,거제면제1투,2538,1557,567,699,150,62,54,2,0,0,1,0,0,1,5,1541,16,981
경상남도,거제시,거제면,거제면제2투,1599,1024,294,537,99,56,25,0,0,1,1,0,0,2,3,1018,6,575
경상남도,거제시,둔덕면,합계,2771,2053,543,1143,182,94,61,2,1,1,1,2,0,6,2,2038,15,718
경상남도,거제시,둔덕면,관내사전투표,730,730,240,367,59,29,25,2,0,1,0,0,0,3,0,726,4,0
경상남도,거제시,둔덕면,둔덕면투표소,2041,1323,303,776,123,65,36,0,1,0,1,2,0,3,2,1312,11,718
경상남도,거제시,사등면,합계,10079,7369,2591,2853,937,471,406,9,2,4,2,4,1,11,10,7301,68,2710
경상남도,거제시,사등면,관내사전투표,1682,1682,723,518,197,107,113,1,1,1,1,1,0,0,3,1666,16,0
경상남도,거제시,사등면,사등면제1투,1797,1048,293,516,125,59,35,1,0,0,0,0,1,0,1,1031,17,749
경상남도,거제시,사등면,사등면제2투,1954,1281,311,661,153,70,60,1,1,1,0,2,0,6,2,1268,13,673
경상남도,거제시,사등면,사등면제3투,898,665,141,400,72,25,14,1,0,0,0,0,0,4,2,659,6,233
경상남도,거제시,사등면,사등면제4투,3748,2693,1123,758,390,210,184,5,0,2,1,1,0,1,2,2677,16,1055
경상남도,거제시,연초면,합계,7788,5207,2049,1793,710,320,277,4,0,2,1,2,1,6,10,5175,32,2581
경상남도,거제시,연초면,관내사전투표,1515,1515,679,418,193,112,91,2,0,0,0,1,0,2,5,1503,12,0
경상남도,거제시,연초면,연초면제1투,3203,1925,705,729,257,112,104,0,0,2,1,1,1,3,3,1918,7,1278
경상남도,거제시,연초면,연초면제2투,2334,1333,506,478,194,77,64,2,0,0,0,0,0,1,1,1323,10,1001
경상남도,거제시,연초면,연초면제3투,736,434,159,168,66,19,18,0,0,0,0,0,0,0,1,431,3,302
경상남도,거제시,하청면,합계,4479,3122,947,1443,403,163,132,0,0,4,2,2,2,4,6,3108,14,1357
경상남도,거제시,하청면,관내사전투표,979,979,365,410,107,56,35,0,0,0,0,0,0,0,1,974,5,0
경상남도,거제시,하청면,하청면제1투,2607,1578,485,667,240,77,87,0,0,2,0,2,1,3,5,1569,9,1029
경상남도,거제시,하청면,하청면제2투,893,565,97,366,56,30,10,0,0,2,2,0,1,1,0,565,0,328
경상남도,거제시,장목면,합계,4131,2820,662,1618,288,128,84,2,1,3,0,5,2,4,6,2803,17,1311
경상남도,거제시,장목면,관내사전투표,969,969,261,528,97,36,32,0,0,0,0,4,0,1,3,962,7,0
경상남도,거제시,장목면,장목면제1투,2082,1149,249,679,106,66,29,2,1,2,0,1,1,3,3,1142,7,933
경상남도,거제시,장목면,장목면제2투,1080,702,152,411,85,26,23,0,0,1,0,0,1,0,0,699,3,378
경상남도,거제시,장승포동,합계,6357,4415,2046,1152,539,262,332,11,1,3,1,4,2,3,9,4365,50,1942
경상남도,거제시,장승포동,관내사전투표,1514,1514,810,305,164,87,110,6,0,2,1,2,1,0,4,1492,22,0
경상남도,거제시,장승포동,장승포동제1투,2232,1259,464,453,159,83,67,5,0,0,0,0,1,3,4,1239,20,973
경상남도,거제시,장승포동,장승포동제2투,2611,1642,772,394,216,92,155,0,1,1,0,2,0,0,1,1634,8,969
경상남도,거제시,능포동,합계,8659,6294,3079,1601,741,374,452,7,0,5,3,3,0,1,2,6268,26,2365
경상남도,거제시,능포동,관내사전투표,1964,1964,1129,388,174,121,142,4,0,2,0,1,0,0,0,1961,3,0
경상남도,거제시,능포동,능포동제1투,2129,1139,429,408,149,60,80,1,0,1,1,0,0,1,2,1132,7,990
경상남도,거제시,능포동,능포동제2투,2175,1779,911,357,226,117,154,2,0,1,2,2,0,0,0,1772,7,396
경상남도,거제시,능포동,능포동제3투,2391,1412,610,448,192,76,76,0,0,1,0,0,0,0,0,1403,9,979
경상남도,거제시,아주동,합계,17341,13332,7949,1648,1679,969,1032,9,1,2,1,5,3,3,7,13308,24,4009
경상남도,거제시,아주동,관내사전투표,4167,4167,2685,413,407,292,353,2,1,0,0,2,1,1,2,4159,8,0
경상남도,거제시,아주동,아주동제1투,3569,2050,1085,332,328,136,158,3,0,1,0,0,0,2,1,2046,4,1519
경상남도,거제시,아주동,아주동제2투,3687,2479,1396,395,323,186,166,2,0,1,0,0,1,0,3,2473,6,1208
경상남도,거제시,아주동,아주동제3투,2429,1777,1037,246,245,133,113,0,0,0,1,1,0,0,0,1776,1,652
경상남도,거제시,아주동,아주동제4투,1735,1373,860,130,162,100,114,2,0,0,0,2,0,0,0,1370,3,362
경상남도,거제시,아주동,아주동제5투,1754,1486,886,132,214,122,128,0,0,0,0,0,1,0,1,1484,2,268
경상남도,거제시,옥포1동,합계,6981,5177,2561,1215,642,344,365,6,0,3,1,5,1,1,7,5151,26,1804
경상남도,거제시,옥포1동,관내사전투표,2297,2297,1314,392,248,152,173,2,0,1,1,4,0,1,1,2289,8,0
경상남도,거제시,옥포1동,옥포1동제1투,2767,1681,752,442,238,115,115,1,0,2,0,1,1,0,2,1669,12,1086
경상남도,거제시,옥포1동,옥포1동제2투,1917,1199,495,381,156,77,77,3,0,0,0,0,0,0,4,1193,6,718
경상남도,거제시,옥포2동,합계,20101,14644,7131,3110,2111,971,1164,25,3,10,8,6,8,13,22,14582,62,5457
경상남도,거제시,옥포2동,관내사전투표,3661,3661,1985,576,478,259,317,4,0,3,4,2,1,3,8,3640,21,0
경상남도,거제시,옥포2동,옥포2동제1투,2567,1597,734,437,205,84,116,5,1,1,0,0,1,1,3,1588,9,970
경상남도,거제시,옥포2동,옥포2동제2투,2863,1819,806,456,266,139,137,2,0,2,0,1,0,3,1,1813,6,1044
경상남도,거제시,옥포2동,옥포2동제3투,2598,1952,969,362,292,140,168,2,1,3,1,1,1,1,4,1945,7,646
경상남도,거제시,옥포2동,옥포2동제4투,2727,1712,728,474,275,104,112,5,1,1,2,1,0,2,2,1707,5,1015
경상남도,거제시,옥포2동,옥포2동제5투,2393,1606,782,322,249,108,126,5,0,0,1,0,4,1,2,1600,6,787
경상남도,거제시,옥포2동,옥포2동제6투,2703,1908,999,327,277,122,171,1,0,0,0,1,1,2,1,1902,6,795
경상남도,거제시,옥포2동,옥포2동제7투,589,389,128,156,69,15,17,1,0,0,0,0,0,0,1,387,2,200
경상남도,거제시,장평동,합계,17749,12696,5801,2916,1877,1016,976,14,0,8,5,3,4,1,14,12635,61,5053
경상남도,거제시,장평동,관내사전투표,4528,4528,2362,824,607,337,362,6,0,0,1,2,1,1,4,4507,21,0
경상남도,거제시,장평동,장평동제1투,1055,604,302,95,85,70,46,0,0,2,0,0,0,0,1,601,3,451
경상남도,거제시,장평동,장평동제2투,2500,1694,734,419,278,112,139,2,0,2,0,0,0,0,1,1687,7,806
경상남도,거제시,장평동,장평동제3투,1758,968,386,270,157,79,62,1,0,1,1,0,1,0,4,962,6,790
경상남도,거제시,장평동,장평동제4투,2225,1244,487,357,206,84,95,1,0,1,1,0,1,0,1,1234,10,981
경상남도,거제시,장평동,장평동제5투,2665,1636,668,444,242,142,126,1,0,0,1,0,1,0,2,1627,9,1029
경상남도,거제시,장평동,장평동제6투,3018,2022,862,507,302,192,146,3,0,2,1,1,0,0,1,2017,5,996
경상남도,거제시,고현동,관내사전투표,5065,5065,2410,1233,601,407,373,5,2,4,0,3,1,4,3,5046,19,0
경상남도,거제시,고현동,합계,28829,21530,9241,5844,3011,1771,1474,28,7,12,4,7,5,11,26,21441,89,7299
경상남도,거제시,고현동,고현동제1투,1736,1054,353,393,144,81,65,1,1,1,0,0,0,2,3,1044,10,682
경상남도,거제시,고현동,고현동제2투,3004,1950,628,789,275,128,108,7,0,1,0,1,1,1,0,1939,11,1054
경상남도,거제시,고현동,고현동제3투,1903,1250,449,439,208,85,61,1,0,1,0,0,0,1,0,1245,5,653
경상남도,거제시,고현동,고현동제4투,1112,671,243,241,92,45,43,0,0,1,1,0,0,1,0,667,4,441
경상남도,거제시,고현동,고현동제5투,2134,1270,490,413,174,107,73,4,0,0,1,0,0,0,2,1264,6,864
경상남도,거제시,고현동,고현동제6투,2795,1859,757,547,257,144,135,5,2,0,0,0,1,0,6,1854,5,936
경상남도,거제시,고현동,고현동제7투,2882,2076,884,568,285,182,145,2,0,2,0,0,0,1,3,2072,4,806
경상남도,거제시,고현동,고현동제8투,2470,1893,842,432,291,174,141,1,0,1,1,1,0,1,4,1889,4,577
경상남도,거제시,고현동,고현동제9투,2578,2054,1010,393,304,186,149,0,0,0,0,1,0,0,3,2046,8,524
경상남도,거제시,고현동,고현동제10투,3150,2388,1175,396,380,232,181,2,2,1,1,1,2,0,2,2375,13,762
경상남도,거제시,상문동,관내사전투표,3374,3374,1909,488,423,257,272,5,0,1,0,3,0,2,5,3365,9,0
경상남도,거제시,상문동,합계,16374,13055,6518,2419,1978,1070,979,13,3,9,1,6,2,4,13,13015,40,3319
경상남도,거제시,상문동,상문동제1투,2400,1584,649,440,258,129,98,0,1,1,0,0,0,0,1,1577,7,816
경상남도,거제시,상문동,상문동제2투,2863,2411,1220,403,379,209,184,4,0,4,0,0,0,0,1,2404,7,452
경상남도,거제시,상문동,상문동제3투,3233,2255,1059,481,338,177,185,3,0,0,1,0,1,1,3,2249,6,978
경상남도,거제시,상문동,상문동제4투,2336,1691,757,388,277,137,117,1,1,1,0,2,0,1,1,1683,8,645
경상남도,거제시,상문동,상문동제5투,2168,1740,924,219,303,161,123,0,1,2,0,1,1,0,2,1737,3,428
경상남도,거제시,수양동,합계,12370,10308,5206,2106,1443,822,681,1,0,2,2,6,2,3,7,10281,27,2062
경상남도,거제시,수양동,관내사전투표,3975,3975,2180,630,554,311,288,0,0,0,0,2,1,1,2,3969,6,0
경상남도,거제시,수양동,수양동제1투,1360,1045,501,221,151,82,83,0,0,0,1,1,0,2,1,1043,2,315
경상남도,거제시,수양동,수양동제2투,2523,1723,785,484,215,108,115,1,0,0,1,2,1,0,3,1715,8,800
경상남도,거제시,수양동,수양동제3투,2487,2004,967,464,284,182,98,0,0,0,0,1,0,0,1,1997,7,483
경상남도,거제시,수양동,수양동제4투,2025,1561,773,307,239,139,97,0,0,2,0,0,0,0,0,1557,4,464
경상남도,거제시,잘못 투입·구분된 투표지,,0,0,0,0,0,0,0,0,0,0,0,0,0,0,0,0,0,0
경상남도,의령군,합계,,25302,19258,5115,10134,1984,820,690,29,5,24,8,21,42,97,75,19044,214,6044
경상남도,의령군,거소·선상투표,,110,97,30,42,15,4,3,0,0,0,0,0,1,0,1,96,1,13
경상남도,의령군,관외사전투표,,2585,2585,1011,859,318,198,164,5,0,2,1,2,1,2,7,2570,15,0
경상남도,의령군,재외투표,,459,154,55,11,69,6,10,2,0,0,0,0,0,0,1,154,0,305
경상남도,의령군,의령읍,합계,6916,5151,1604,2453,539,253,221,5,0,4,0,2,10,9,14,5114,37,1765
경상남도,의령군,의령읍,관내사전투표,1774,1774,682,710,176,87,98,2,0,1,0,1,5,0,2,1764,10,0
경상남도,의령군,의령읍,의령읍제1투,2254,1503,424,745,174,81,49,1,0,2,0,0,4,5,6,1491,12,751
경상남도,의령군,의령읍,의령읍제2투,2888,1874,498,998,189,85,74,2,0,1,0,1,1,4,6,1859,15,1014
경상남도,의령군,가례면,합계,1508,1048,227,594,104,32,36,1,0,1,1,2,2,9,5,1014,34,460
경상남도,의령군,가례면,관내사전투표,350,350,103,181,35,7,12,0,0,0,1,1,0,1,2,343,7,0
경상남도,의령군,가례면,가례면투표소,1158,698,124,413,69,25,24,1,0,1,0,1,2,8,3,671,27,460
경상남도,의령군,칠곡면,합계,987,765,190,429,80,24,22,0,0,2,0,2,0,3,4,756,9,222
경상남도,의령군,칠곡면,관내사전투표,268,268,75,136,26,12,10,0,0,1,0,1,0,1,2,264,4,0
경상남도,의령군,칠곡면,칠곡면투표소,719,497,115,293,54,12,12,0,0,1,0,1,0,2,2,492,5,222
경상남도,의령군,대의면,관내사전투표,215,215,77,108,12,11,5,0,0,0,0,0,0,0,1,214,1,0
경상남도,의령군,대의면,합계,918,715,186,403,60,23,13,1,1,0,2,1,4,6,2,702,13,203
경상남도,의령군,대의면,대의면투표소,703,500,109,295,48,12,8,1,1,0,2,1,4,6,1,488,12,203
경상남도,의령군,화정면,합계,1330,991,230,582,94,44,23,3,0,2,0,2,1,2,3,986,5,339
경상남도,의령군,화정면,관내사전투표,278,278,75,155,19,13,7,2,0,1,0,2,0,0,1,275,3,0
경상남도,의령군,화정면,화정면투표소,1052,713,155,427,75,31,16,1,0,1,0,0,1,2,2,711,2,339
경상남도,의령군,용덕면,합계,1347,989,198,601,106,35,26,1,1,2,0,1,0,6,5,982,7,358
경상남도,의령군,용덕면,관내사전투표,194,194,56,99,17,8,10,1,0,0,0,0,0,0,1,192,2,0
경상남도,의령군,용덕면,용덕면제1투,586,418,52,295,45,13,3,0,1,0,0,0,0,3,2,414,4,168
경상남도,의령군,용덕면,용덕면제2투,567,377,90,207,44,14,13,0,0,2,0,1,0,3,2,376,1,190
경상남도,의령군,정곡면,관내사전투표,191,191,72,88,14,7,5,0,0,0,0,0,0,1,1,188,3,0
경상남도,의령군,정곡면,합계,1227,885,221,506,66,37,14,3,0,0,1,0,5,13,9,875,10,342
경상남도,의령군,정곡면,정곡면투표소,1036,694,149,418,52,30,9,3,0,0,1,0,5,12,8,687,7,342
경상남도,의령군,지정면,합계,1592,1183,263,696,113,37,35,3,1,2,0,4,1,8,2,1165,18,409
경상남도,의령군,지정면,관내사전투표,317,317,80,176,22,14,11,1,1,0,0,1,0,2,1,309,8,0
경상남도,의령군,지정면,지정면투표소,1275,866,183,520,91,23,24,2,0,2,0,3,1,6,1,856,10,409
경상남도,의령군,낙서면,합계,685,511,68,358,39,15,11,1,0,1,0,2,1,2,4,502,9,174
경상남도,의령군,낙서면,관내사전투표,131,131,21,83,16,5,4,0,0,0,0,0,0,0,0,129,2,0
경상남도,의령군,낙서면,낙서면투표소,554,380,47,275,23,10,7,1,0,1,0,2,1,2,4,373,7,174
경상남도,의령군,부림면,관내사전투표,635,635,150,370,47,24,26,0,0,2,0,1,3,1,2,626,9,0
경상남도,의령군,부림면,합계,2678,1947,416,1152,186,64,71,1,0,5,0,1,9,13,9,1927,20,731
경상남도,의령군,부림면,부림면투표소,2043,1312,266,782,139,40,45,1,0,3,0,0,6,12,7,1301,11,731
경상남도,의령군,봉수면,합계,827,607,94,432,41,6,12,1,0,0,1,1,3,6,4,601,6,220
경상남도,의령군,봉수면,관내사전투표,186,186,33,128,10,2,4,0,0,0,1,0,0,3,3,184,2,0
경상남도,의령군,봉수면,봉수면투표소,641,421,61,304,31,4,8,1,0,0,0,1,3,3,1,417,4,220
경상남도,의령군,궁류면,관내사전투표,218,218,44,123,26,11,5,0,0,1,0,1,1,1,0,213,5,0
경상남도,의령군,궁류면,합계,1044,772,147,458,90,21,15,0,1,3,0,1,4,11,3,754,18,272
경상남도,의령군,궁류면,궁류면투표소,826,554,103,335,64,10,10,0,1,2,0,0,3,10,3,541,13,272
경상남도,의령군,유곡면,합계,1089,858,175,558,64,21,14,2,1,0,2,0,0,7,2,846,12,231
경상남도,의령군,유곡면,관내사전투표,174,174,47,97,15,6,5,1,0,0,0,0,0,0,0,171,3,0
경상남도,의령군,유곡면,유곡면제1투,487,384,60,273,24,7,5,1,1,0,1,0,0,3,2,377,7,103
경상남도,의령군,유곡면,유곡면제2투,428,300,68,188,25,8,4,0,0,0,1,0,0,4,0,298,2,128
경상남도,의령군,잘못 투입·구분된 투표지,,0,0,0,0,0,0,0,0,0,0,0,0,0,0,0,0,0,0
경상남도,함안군,합계,,57493,43866,13597,19809,5399,2452,1986,43,17,18,18,34,31,65,86,43555,311,13627
경상남도,함안군,거소·선상투표,,216,195,59,78,34,13,4,0,1,0,0,0,0,1,0,190,5,21
경상남도,함안군,관외사전투표,,5713,5713,2240,1679,800,515,403,4,2,3,1,8,1,2,8,5666,47,0
경상남도,함안군,재외투표,,609,289,108,34,109,9,27,0,0,0,0,0,0,1,0,288,1,320
경상남도,함안군,가야읍,합계,13716,9943,3218,4355,1162,569,517,9,2,4,2,5,6,7,22,9878,65,3773
경상남도,함안군,가야읍,관내사전투표,2399,2399,1016,799,237,153,163,3,0,1,0,2,2,0,6,2382,17,0
경상남도,함안군,가야읍,가야읍제1투,2364,1579,435,788,190,87,61,1,0,1,0,0,1,1,2,1567,12,785
경상남도,함안군,가야읍,가야읍제2투,3328,2164,663,996,257,111,108,3,0,0,0,1,1,2,5,2147,17,1164
경상남도,함안군,가야읍,가야읍제3투,2936,2031,626,913,266,118,90,1,1,1,1,1,1,2,3,2024,7,905
경상남도,함안군,가야읍,가야읍제4투,2689,1770,478,859,212,100,95,1,1,1,1,1,1,2,6,1758,12,919
경상남도,함안군,함안면,관내사전투표,429,429,131,221,41,18,12,0,0,1,0,0,0,1,1,426,3,0
경상남도,함안군,함안면,합계,2119,1526,324,885,187,62,40,1,2,2,1,1,1,5,7,1518,8,593
경상남도,함안군,함안면,함안면투표소,1690,1097,193,664,146,44,28,1,2,1,1,1,1,4,6,1092,5,593
경상남도,함안군,군북면,합계,5451,3866,958,2093,429,186,120,4,0,0,2,6,6,11,7,3822,44,1585
경상남도,함안군,군북면,관내사전투표,1148,1148,347,547,115,76,37,2,0,0,0,3,2,1,4,1134,14,0
경상남도,함안군,군북면,군북면제1투,2155,1282,307,684,163,59,48,2,0,0,0,2,0,3,1,1269,13,873
경상남도,함안군,군북면,군북면제2투,685,487,114,276,54,20,7,0,0,0,1,0,3,5,0,480,7,198
경상남도,함안군,군북면,군북면제3투,889,564,111,348,53,22,20,0,0,0,1,0,0,1,0,556,8,325
경상남도,함안군,군북면,군북면제4투,574,385,79,238,44,9,8,0,0,0,0,1,1,1,2,383,2,189
경상남도,함안군,법수면,관내사전투표,549,549,160,293,51,20,18,0,0,0,0,1,1,1,1,546,3,0
경상남도,함안군,법수면,합계,2613,1803,459,963,201,73,75,2,1,0,1,2,4,6,2,1789,14,810
경상남도,함안군,법수면,법수면투표소,2064,1254,299,670,150,53,57,2,1,0,1,1,3,5,1,1243,11,810
경상남도,함안군,대산면,합계,3198,2216,558,1247,234,68,62,4,1,2,3,1,3,6,10,2199,17,982
경상남도,함안군,대산면,관내사전투표,585,585,180,295,64,15,22,3,0,0,1,0,0,1,2,583,2,0
경상남도,함안군,대산면,대산면투표소,2613,1631,378,952,170,53,40,1,1,2,2,1,3,5,8,1616,15,982
경상남도,함안군,칠서면,합계,4285,3083,827,1655,321,137,105,1,1,0,1,2,3,3,9,3065,18,1202
경상남도,함안군,칠서면,관내사전투표,471,471,137,257,41,19,14,0,0,0,0,1,1,0,0,470,1,0
경상남도,함안군,칠서면,칠서면제1투,2077,1421,441,642,180,77,65,0,1,0,0,1,0,0,8,1415,6,656
경상남도,함안군,칠서면,칠서면제2투,674,439,78,281,43,19,10,1,0,0,1,0,1,0,0,434,5,235
경상남도,함안군,칠서면,칠서면제3투,1063,752,171,475,57,22,16,0,0,0,0,0,1,3,1,746,6,311
경상남도,함안군,칠북면,합계,1787,1351,245,858,140,48,35,1,2,4,1,1,1,4,5,1345,6,436
경상남도,함안군,칠북면,관내사전투표,325,325,90,162,37,17,10,0,2,4,0,1,0,0,0,323,2,0
경상남도,함안군,칠북면,칠북면투표소,1462,1026,155,696,103,31,25,1,0,0,1,0,1,4,5,1022,4,436
경상남도,함안군,칠원읍,합계,14097,10931,3718,4534,1432,623,514,14,1,2,4,5,4,9,12,10872,59,3166
경상남도,함안군,칠원읍,관내사전투표,2186,2186,777,879,268,105,132,1,0,2,0,0,0,3,3,2170,16,0
경상남도,함안군,칠원읍,칠원읍제1투,3451,2256,564,1169,295,119,81,3,0,0,2,0,1,2,4,2240,16,1195
경상남도,함안군,칠원읍,칠원읍제2투,938,684,129,410,86,32,11,2,1,0,0,1,1,2,3,678,6,254
경상남도,함안군,칠원읍,칠원읍제3투,2940,2484,1089,697,367,175,142,2,0,0,1,2,1,0,0,2476,8,456
경상남도,함안군,칠원읍,칠원읍제4투,2174,1451,387,744,172,76,54,4,0,0,0,2,0,1,2,1442,9,723
경상남도,함안군,칠원읍,칠원읍제5투,2408,1870,772,635,244,116,94,2,0,0,1,0,1,1,0,1866,4,538
경상남도,함안군,산인면,합계,2884,2309,733,1079,257,126,70,3,4,1,2,2,1,9,3,2290,19,575
경상남도,함안군,산인면,관내사전투표,1206,1206,435,493,135,71,41,3,1,1,1,1,1,8,2,1193,13,0
경상남도,함안군,산인면,산인면투표소,1678,1103,298,586,122,55,29,0,3,0,1,1,0,1,1,1097,6,575
경상남도,함안군,여항면,관내사전투표,294,294,86,137,42,13,10,0,0,0,0,1,0,0,1,290,4,0
경상남도,함안군,여항면,합계,805,641,150,349,93,23,14,0,0,0,0,1,1,1,1,633,8,164
경상남도,함안군,여항면,여항면투표소,511,347,64,212,51,10,4,0,0,0,0,0,1,1,0,343,4,164
경상남도,함안군,잘못 투입·구분된 투표지,,0,0,0,0,0,0,0,0,0,0,0,0,0,0,0,0,0,0
경상남도,창녕군,합계,,55896,42878,10310,24464,3877,2013,1408,47,11,17,22,31,38,113,99,42450,428,13018
경상남도,창녕군,거소·선상투표,,241,214,46,100,23,9,3,2,0,4,3,0,1,0,1,192,22,27
경상남도,창녕군,관외사전투표,,5261,5259,1955,1816,635,467,325,5,1,2,2,4,3,0,13,5228,31,2
경상남도,창녕군,재외투표,,459,210,103,20,59,10,16,0,0,0,0,0,0,0,1,209,1,249
경상남도,창녕군,창녕읍,합계,12848,9669,2396,5439,805,498,350,15,2,3,2,5,3,16,18,9552,117,3179
경상남도,창녕군,창녕읍,관내사전투표,3212,3212,984,1588,245,184,144,2,1,2,1,3,2,6,10,3172,40,0
경상남도,창녕군,창녕읍,창녕읍제1투,1976,1390,252,897,126,55,39,3,1,0,0,0,0,1,2,1376,14,586
경상남도,창녕군,창녕읍,창녕읍제2투,2450,1557,340,938,120,85,57,3,0,0,1,0,0,2,1,1547,10,893
경상남도,창녕군,창녕읍,창녕읍제3투,2235,1484,325,865,133,80,47,3,0,1,0,1,0,5,4,1464,20,751
경상남도,창녕군,창녕읍,창녕읍제4투,2975,2026,495,1151,181,94,63,4,0,0,0,1,1,2,1,1993,33,949
경상남도,창녕군,남지읍,합계,9632,7113,1650,4219,633,291,230,1,1,4,5,2,4,16,8,7064,49,2519
경상남도,창녕군,남지읍,관내사전투표,2083,2083,596,1115,168,96,85,0,1,0,1,0,1,5,1,2069,14,0
경상남도,창녕군,남지읍,남지읍제1투,3117,2028,452,1253,157,74,67,1,0,2,0,1,1,3,2,2013,15,1089
경상남도,창녕군,남지읍,남지읍제2투,3517,2334,523,1351,263,109,65,0,0,2,4,0,0,2,3,2322,12,1183
경상남도,창녕군,남지읍,남지읍제3투,915,668,79,500,45,12,13,0,0,0,0,1,2,6,2,660,8,247
경상남도,창녕군,고암면,합계,1869,1420,257,895,142,51,35,2,0,0,1,1,1,8,4,1397,23,449
경상남도,창녕군,고암면,관내사전투표,550,550,106,321,68,24,19,0,0,0,1,0,0,2,0,541,9,0
경상남도,창녕군,고암면,고암면투표소,1319,870,151,574,74,27,16,2,0,0,0,1,1,6,4,856,14,449
경상남도,창녕군,성산면,합계,1326,992,154,679,90,33,20,0,0,0,4,0,1,5,0,986,6,334
경상남도,창녕군,성산면,관내사전투표,395,395,55,280,28,14,8,0,0,0,4,0,0,4,0,393,2,0
경상남도,창녕군,성산면,성산면투표소,931,597,99,399,62,19,12,0,0,0,0,0,1,1,0,593,4,334
경상남도,창녕군,대합면,합계,3284,2314,392,1556,187,82,50,1,1,1,1,0,5,15,6,2297,17,970
경상남도,창녕군,대합면,관내사전투표,879,879,153,584,73,32,19,0,0,1,0,0,1,6,5,874,5,0
경상남도,창녕군,대합면,대합면투표소,2405,1435,239,972,114,50,31,1,1,0,1,0,4,9,1,1423,12,970
경상남도,창녕군,이방면,합계,2123,1590,246,1121,104,58,30,5,1,0,1,2,1,10,5,1584,6,533
경상남도,창녕군,이방면,관내사전투표,495,495,87,327,35,26,14,0,0,0,0,1,0,1,2,493,2,0
경상남도,창녕군,이방면,이방면투표소,1628,1095,159,794,69,32,16,5,1,0,1,1,1,9,3,1091,4,533
경상남도,창녕군,유어면,관내사전투표,351,351,85,207,22,15,10,0,0,0,0,1,0,1,0,341,10,0
경상남도,창녕군,유어면,합계,1595,1240,239,814,83,38,22,1,3,1,0,1,2,3,12,1219,21,355
경상남도,창녕군,유어면,유어면투표소,1244,889,154,607,61,23,12,1,3,1,0,0,2,2,12,878,11,355
경상남도,창녕군,대지면,관내사전투표,571,571,161,311,36,23,25,1,0,0,0,1,0,3,4,565,6,0
경상남도,창녕군,대지면,합계,2162,1680,340,1060,115,68,52,1,0,1,1,3,1,4,4,1650,30,482
경상남도,창녕군,대지면,대지면투표소,1591,1109,179,749,79,45,27,0,0,1,1,2,1,1,0,1085,24,482
경상남도,창녕군,계성면,합계,2121,1527,318,974,126,45,29,2,0,0,0,0,3,9,2,1508,19,594
경상남도,창녕군,계성면,관내사전투표,439,439,103,254,41,23,13,0,0,0,0,0,0,0,0,434,5,0
경상남도,창녕군,계성면,계성면투표소,1682,1088,215,720,85,22,16,2,0,0,0,0,3,9,2,1074,14,594
경상남도,창녕군,영산면,합계,4647,3407,829,1959,319,153,103,4,0,0,0,0,2,3,6,3378,29,1240
경상남도,창녕군,영산면,관내사전투표,965,965,289,476,86,55,45,2,0,0,0,0,0,0,3,956,9,0
경상남도,창녕군,영산면,영산면제1투,2899,1905,413,1152,187,87,45,1,0,0,0,0,2,0,1,1888,17,994
경상남도,창녕군,영산면,영산면제2투,783,537,127,331,46,11,13,1,0,0,0,0,0,3,2,534,3,246
경상남도,창녕군,장마면,합계,1595,1185,266,751,91,30,19,0,1,0,0,2,2,5,6,1173,12,410
경상남도,창녕군,장마면,관내사전투표,409,409,87,267,33,13,3,0,0,0,0,0,0,0,2,405,4,0
경상남도,창녕군,장마면,장마면투표소,1186,776,179,484,58,17,16,0,1,0,0,2,2,5,4,768,8,410
경상남도,창녕군,도천면,관내사전투표,541,541,156,307,40,15,15,2,0,0,0,0,0,1,2,538,3,0
경상남도,창녕군,도천면,합계,2262,1650,387,996,142,54,41,2,0,0,0,6,1,4,2,1635,15,612
경상남도,창녕군,도천면,도천면투표소,1721,1109,231,689,102,39,26,0,0,0,0,6,1,3,0,1097,12,612
경상남도,창녕군,길곡면,관내사전투표,376,376,80,231,34,14,10,1,0,0,0,0,0,3,0,373,3,0
경상남도,창녕군,길곡면,합계,1297,1055,215,659,90,38,26,5,0,0,0,2,2,6,6,1049,6,242
경상남도,창녕군,길곡면,길곡면투표소,921,679,135,428,56,24,16,4,0,0,0,2,2,3,6,676,3,242
경상남도,창녕군,부곡면,합계,3174,2353,517,1406,233,88,57,1,1,1,2,3,6,9,5,2329,24,821
경상남도,창녕군,부곡면,관내사전투표,768,768,209,411,75,32,21,0,1,0,0,2,3,2,2,758,10,0
경상남도,창녕군,부곡면,부곡면투표소,2406,1585,308,995,158,56,36,1,0,1,2,1,3,7,3,1571,14,821
경상남도,창녕군,잘못 투입·구분된 투표지,,0,0,0,0,0,0,0,0,0,0,0,0,0,0,0,0,0,0
경상남도,양산시,합계,,256724,199835,83412,58811,30945,14055,10705,212,41,132,46,130,48,104,240,198881,954,56889
경상남도,양산시,거소·선상투표,,737,683,246,137,186,47,27,0,3,1,2,2,1,0,10,662,21,54
경상남도,양산시,관외사전투표,,18615,18614,8503,3783,2956,1731,1385,24,5,8,5,12,9,14,40,18475,139,1
경상남도,양산시,재외투표,,1166,887,541,53,147,42,97,0,0,0,0,1,0,0,3,884,3,279
경상남도,양산시,물금읍,합계,62107,49038,22360,12285,7722,3681,2568,40,11,23,13,33,5,14,53,48808,230,13069
경상남도,양산시,물금읍,관내사전투표,9972,9972,5329,2034,1261,719,528,6,2,7,2,4,1,4,13,9910,62,0
경상남도,양산시,물금읍,물금읍제1투,1262,831,224,380,139,45,31,1,0,1,0,1,0,0,0,822,9,431
경상남도,양산시,물금읍,물금읍제2투,3439,2527,1202,544,439,199,132,2,0,1,0,0,0,0,1,2520,7,912
경상남도,양산시,물금읍,물금읍제3투,3596,2541,919,906,358,165,135,2,2,3,5,7,1,0,6,2509,32,1055
경상남도,양산시,물금읍,물금읍제4투,2849,1893,727,621,295,133,101,0,3,0,0,3,0,0,1,1884,9,956
경상남도,양산시,물금읍,물금읍제5투,4114,3327,1650,691,564,252,152,2,0,1,0,3,1,1,1,3318,9,787
경상남도,양산시,물금읍,물금읍제6투,2334,1542,528,537,264,121,76,2,0,1,1,1,0,0,3,1534,8,792
경상남도,양산시,물금읍,물금읍제7투,1902,1384,515,448,211,112,87,0,0,1,0,2,0,0,3,1379,5,518
경상남도,양산시,물금읍,물금읍제8투,2137,1657,689,444,248,141,118,1,0,0,1,6,0,0,3,1651,6,480
경상남도,양산시,물금읍,물금읍제9투,2428,1545,671,348,273,139,98,4,0,1,0,2,0,1,1,1538,7,883
경상남도,양산시,물금읍,물금읍제10투,2862,2385,1167,584,338,167,120,1,0,0,0,0,0,2,1,2380,5,477
경상남도,양산시,물금읍,물금읍제11투,3069,2366,1033,664,378,156,107,2,1,0,2,2,0,1,7,2353,13,703
경상남도,양산시,물금읍,물금읍제12투,2156,1704,743,417,306,142,79,4,1,0,0,0,0,0,2,1694,10,452
경상남도,양산시,물금읍,물금읍제13투,2371,1989,998,403,306,167,97,6,0,2,0,0,0,0,1,1980,9,382
경상남도,양산시,물금읍,물금읍제14투,2863,2313,1128,458,380,199,134,1,0,2,0,1,0,1,3,2307,6,550
경상남도,양산시,물금읍,물금읍제15투,2942,1849,760,535,323,141,81,0,0,0,0,0,0,2,0,1842,7,1093
경상남도,양산시,물금읍,물금읍제16투,3247,2543,1136,605,460,206,124,1,0,2,0,0,0,2,0,2536,7,704
경상남도,양산시,물금읍,물금읍제17투,1763,1341,549,328,250,108,96,0,1,0,0,1,1,0,2,1336,5,422
경상남도,양산시,물금읍,물금읍제18투,4062,3141,1407,798,549,216,158,4,0,0,0,0,1,0,1,3134,7,921
경상남도,양산시,물금읍,물금읍제19투,659,442,139,200,68,15,14,0,0,0,1,0,0,0,3,440,2,217
경상남도,양산시,물금읍,물금읍제20투,2080,1746,846,340,312,138,100,1,1,1,1,0,0,0,1,1741,5,334
경상남도,양산시,동면,합계,18388,14026,6038,4155,2169,950,629,16,1,6,1,5,2,5,8,13985,41,4362
경상남도,양산시,동면,관내사전투표,1652,1652,817,455,200,94,78,1,0,0,1,1,0,1,2,1650,2,0
경상남도,양산시,동면,동면제1투,4396,2988,1106,1036,496,196,128,5,1,2,0,2,1,1,1,2975,13,1408
경상남도,양산시,동면,동면제2투,2596,1871,703,648,277,142,88,6,0,2,0,0,0,0,1,1867,4,725
경상남도,양산시,동면,동면제3투,2216,1611,624,541,258,95,78,3,0,1,0,1,0,0,1,1602,9,605
경상남도,양산시,동면,동면제4투,858,627,140,370,75,26,11,0,0,1,0,0,0,2,1,626,1,231
경상남도,양산시,동면,동면제5투,4288,3430,1698,747,569,240,167,1,0,0,0,1,1,0,2,3426,4,858
경상남도,양산시,동면,동면제6투,2382,1847,950,358,294,157,79,0,0,0,0,0,0,1,0,1839,8,535
경상남도,양산시,원동면,관내사전투표,368,368,111,190,39,13,9,0,0,1,0,0,0,1,0,364,4,0
경상남도,양산시,원동면,합계,2741,1964,449,1133,232,79,47,2,0,2,0,1,2,5,3,1955,9,777
경상남도,양산시,원동면,원동면제1투,950,593,117,373,58,23,16,0,0,1,0,0,0,0,3,591,2,357
경상남도,양산시,원동면,원동면제2투,929,661,146,377,81,35,15,2,0,0,0,1,0,3,0,660,1,268
경상남도,양산시,원동면,원동면제3투,494,342,75,193,54,8,7,0,0,0,0,0,2,1,0,340,2,152
경상남도,양산시,상북면,합계,11759,8625,2792,3610,1287,478,346,9,3,6,3,6,7,12,15,8574,51,3134
경상남도,양산시,상북면,관내사전투표,2616,2616,950,1033,342,142,110,0,0,1,0,2,5,5,5,2595,21,0
경상남도,양산시,상북면,상북면제1투,1296,844,229,367,141,43,48,3,0,2,0,0,1,1,4,839,5,452
경상남도,양산시,상북면,상북면제2투,1322,872,221,418,139,43,35,2,0,1,0,0,1,2,0,862,10,450
경상남도,양산시,상북면,상북면제3투,1431,945,282,394,167,62,32,2,2,0,1,0,0,0,1,943,2,486
경상남도,양산시,상북면,상북면제4투,2429,1643,558,663,262,78,60,1,1,2,1,3,0,3,5,1637,6,786
경상남도,양산시,상북면,상북면제5투,1645,1113,402,422,170,73,39,0,0,0,1,1,0,1,0,1109,4,532
경상남도,양산시,상북면,상북면제6투,1020,592,150,313,66,37,22,1,0,0,0,0,0,0,0,589,3,428
경상남도,양산시,하북면,합계,7581,5460,1591,2562,732,315,187,6,1,3,0,6,3,10,10,5426,34,2121
경상남도,양산시,하북면,관내사전투표,1719,1719,613,703,219,87,73,0,1,0,0,4,1,6,2,1709,10,0
경상남도,양산시,하북면,하북면제1투,2361,1484,428,667,223,96,50,1,0,1,0,1,1,1,5,1474,10,877
경상남도,양산시,하북면,하북면제2투,769,500,129,270,58,22,13,3,0,0,0,0,0,1,2,498,2,269
경상남도,양산시,하북면,하북면제3투,958,661,138,380,72,40,22,1,0,2,0,0,0,1,0,656,5,297
경상남도,양산시,하북면,하북면제4투,1774,1096,283,542,160,70,29,1,0,0,0,1,1,1,1,1089,7,678
경상남도,양산시,중앙동,합계,9850,6751,2148,2888,965,407,273,5,1,5,2,3,2,4,9,6712,39,3099
경상남도,양산시,중앙동,관내사전투표,1963,1963,804,682,244,127,88,3,0,2,2,2,0,1,1,1956,7,0
경상남도,양산시,중앙동,중앙동제1투,1831,1053,308,474,151,64,44,0,0,1,0,0,0,0,3,1045,8,778
경상남도,양산시,중앙동,중앙동제2투,2363,1457,417,666,230,81,49,0,1,1,0,0,1,2,1,1449,8,906
경상남도,양산시,중앙동,중앙동제3투,1818,1088,329,482,155,60,45,1,0,1,0,1,1,1,3,1079,9,730
경상남도,양산시,중앙동,중앙동제4투,1875,1190,290,584,185,75,47,1,0,0,0,0,0,0,1,1183,7,685
경상남도,양산시,양주동,합계,26824,22180,9760,5783,3456,1663,1340,20,4,17,3,18,4,11,14,22093,87,4644
경상남도,양산시,양주동,관내사전투표,6463,6463,3280,1410,845,491,395,2,3,3,1,2,2,4,2,6440,23,0
경상남도,양산시,양주동,양주동제1투,1679,1062,377,373,180,60,61,0,0,2,0,0,0,1,0,1054,8,617
경상남도,양산시,양주동,양주동제2투,2064,1578,620,474,255,112,111,0,0,0,0,2,0,0,1,1575,3,486
경상남도,양산시,양주동,양주동제3투,1903,1509,589,393,273,122,113,3,0,2,1,0,0,0,3,1499,10,394
경상남도,양산시,양주동,양주동제4투,1568,1159,391,403,204,80,62,2,1,0,0,2,1,1,1,1148,11,409
경상남도,양산시,양주동,양주동제5투,1725,1344,557,379,214,89,94,1,0,0,0,4,0,1,1,1340,4,381
경상남도,양산시,양주동,양주동제6투,2508,1930,823,510,318,141,124,0,0,2,1,3,0,0,2,1924,6,578
경상남도,양산시,양주동,양주동제7투,2771,2296,1053,516,370,204,135,4,0,3,0,1,0,0,1,2287,9,475
경상남도,양산시,양주동,양주동제8투,2410,1895,871,460,306,144,99,6,0,2,0,2,0,1,2,1893,2,515
경상남도,양산시,양주동,양주동제9투,1882,1596,742,381,261,118,86,0,0,0,0,1,0,0,1,1590,6,286
경상남도,양산시,양주동,양주동제10투,1851,1348,457,484,230,102,60,2,0,3,0,1,1,3,0,1343,5,503
경상남도,양산시,삼성동,합계,18758,13710,5509,4073,2172,1031,792,11,2,12,1,12,3,1,17,13636,74,5048
경상남도,양산시,삼성동,관내사전투표,3766,3766,1795,889,523,284,242,1,0,4,0,6,1,0,3,3748,18,0
경상남도,양산시,삼성동,삼성동제1투,2034,1276,462,407,214,87,87,1,0,1,0,3,0,1,0,1263,13,758
경상남도,양산시,삼성동,삼성동제2투,2939,2125,772,727,330,174,108,2,0,2,0,0,0,0,1,2116,9,814
경상남도,양산시,삼성동,삼성동제3투,2284,1401,485,495,244,103,62,2,1,0,0,1,0,0,3,1396,5,883
경상남도,양산시,삼성동,삼성동제4투,2708,1807,718,538,290,135,108,2,0,2,0,0,0,0,4,1797,10,901
경상남도,양산시,삼성동,삼성동제5투,2372,1663,654,460,306,127,101,0,0,2,1,1,2,0,1,1655,8,709
경상남도,양산시,삼성동,삼성동제6투,2655,1672,623,557,265,121,84,3,1,1,0,1,0,0,5,1661,11,983
경상남도,양산시,강서동,합계,7262,5467,2263,1571,876,381,314,6,0,15,1,7,1,4,6,5445,22,1795
경상남도,양산시,강서동,관내사전투표,1899,1899,933,431,258,136,123,1,0,4,0,1,1,0,4,1892,7,0
경상남도,양산시,강서동,강서동제1투,2889,1986,767,630,312,149,104,2,0,8,1,1,0,2,1,1977,9,903
경상남도,양산시,강서동,강서동제2투,2474,1582,563,510,306,96,87,3,0,3,0,5,0,2,1,1576,6,892
경상남도,양산시,서창동,합계,22785,16698,6843,5035,2699,1087,917,18,3,9,0,6,2,8,13,16640,58,6087
경상남도,양산시,서창동,관내사전투표,4760,4760,2176,1364,683,256,259,6,1,2,0,1,1,1,1,4751,9,0
경상남도,양산시,서창동,서창동제1투,1813,1135,338,506,182,62,42,1,0,0,0,0,0,0,0,1131,4,678
경상남도,양산시,서창동,서창동제2투,2723,1886,721,526,366,146,115,2,0,1,0,3,0,0,2,1882,4,837
경상남도,양산시,서창동,서창동제3투,2130,1227,428,461,208,64,52,2,0,1,0,1,0,0,2,1219,8,903
경상남도,양산시,서창동,서창동제4투,3805,2921,1337,697,468,211,193,0,0,1,0,0,1,2,2,2912,9,884
경상남도,양산시,서창동,서창동제5투,2050,1283,434,511,196,71,59,3,0,0,0,0,0,1,0,1275,8,767
경상남도,양산시,서창동,서창동제6투,2530,1201,393,389,243,95,63,2,1,0,0,1,0,2,4,1193,8,1329
경상남도,양산시,서창동,서창동제7투,2974,2285,1016,581,353,182,134,2,1,4,0,0,0,2,2,2277,8,689
경상남도,양산시,소주동,합계,15450,11089,4353,3607,1754,660,610,18,1,13,6,4,3,7,13,11049,40,4361
경상남도,양산시,소주동,관내사전투표,2908,2908,1300,843,390,178,168,4,0,7,3,3,0,1,2,2899,9,0
경상남도,양산시,소주동,소주동제1투,2281,1586,570,568,242,88,106,3,0,1,0,1,1,1,1,1582,4,695
경상남도,양산시,소주동,소주동제2투,2067,1381,534,445,245,76,71,1,0,0,1,0,1,1,2,1377,4,686
경상남도,양산시,소주동,소주동제3투,2253,1498,519,540,267,85,68,4,0,2,0,0,0,0,2,1487,11,755
경상남도,양산시,소주동,소주동제4투,1608,1144,449,352,179,73,76,2,1,1,1,0,0,2,2,1138,6,464
경상남도,양산시,소주동,소주동제5투,2275,1267,436,481,212,71,55,3,0,2,0,0,1,0,3,1264,3,1008
경상남도,양산시,소주동,소주동제6투,2058,1305,545,378,219,89,66,1,0,0,1,0,0,2,1,1302,3,753
경상남도,양산시,평산동,합계,22485,16742,6886,5376,2476,1032,816,27,3,7,7,7,4,6,20,16667,75,5743
경상남도,양산시,평산동,관내사전투표,3907,3907,1819,1120,499,224,213,4,0,1,2,2,1,1,4,3890,17,0
경상남도,양산시,평산동,평산동제1투,2042,1453,619,379,265,92,82,4,0,1,0,1,0,1,1,1445,8,589
경상남도,양산시,평산동,평산동제2투,2548,1779,739,545,267,123,77,1,0,0,1,1,0,1,6,1761,18,769
경상남도,양산시,평산동,평산동제3투,2534,1894,751,671,270,93,93,4,0,1,0,0,0,1,2,1886,8,640
경상남도,양산시,평산동,평산동제4투,1751,1308,528,453,188,78,48,0,1,2,0,0,0,0,2,1300,8,443
경상남도,양산시,평산동,평산동제5투,3454,2006,729,722,320,124,92,4,1,2,2,0,1,0,1,1998,8,1448
경상남도,양산시,평산동,평산동제6투,1653,1046,399,357,157,74,51,0,0,0,0,2,0,0,2,1042,4,607
경상남도,양산시,평산동,평산동제7투,1989,1382,424,594,226,74,56,2,1,0,1,0,1,1,1,1381,1,607
경상남도,양산시,평산동,평산동제8투,2607,1967,878,535,284,150,104,8,0,0,1,1,1,1,1,1964,3,640
경상남도,양산시,덕계동,관내사전투표,3077,3077,1338,953,410,184,157,5,3,3,1,6,0,1,2,3063,14,0
경상남도,양산시,덕계동,합계,10216,7900,3130,2760,1116,470,357,10,3,5,2,7,0,3,6,7869,31,2316
경상남도,양산시,덕계동,덕계동제1투,2346,1566,576,618,214,93,59,1,0,0,0,0,0,1,0,1562,4,780
경상남도,양산시,덕계동,덕계동제2투,2560,1799,709,605,267,117,85,3,0,2,0,1,0,0,3,1792,7,761
경상남도,양산시,덕계동,덕계동제3투,2233,1458,507,584,225,76,56,1,0,0,1,0,0,1,1,1452,6,775
경상남도,양산시,잘못 투입·구분된 투표지,,0,1,0,0,0,1,0,0,0,0,0,0,0,0,0,1,0,-1
경상남도,하동군,합계,,43206,34324,11211,14864,4150,1792,1489,57,17,38,32,42,48,113,114,33967,357,8882
경상남도,하동군,거소·선상투표,,496,423,119,129,66,25,7,4,2,7,0,3,6,4,9,381,42,73
경상남도,하동군,관외사전투표,,5120,5120,2157,1408,673,418,395,5,1,4,4,2,5,3,5,5080,40,0
경상남도,하동군,재외투표,,307,178,94,21,39,6,17,0,0,0,0,1,0,0,0,178,0,129
경상남도,하동군,하동읍,관내사전투표,2348,2348,922,910,239,123,129,4,0,3,1,1,2,0,3,2337,11,0
경상남도,하동군,하동읍,합계,8090,6223,2143,2629,729,375,250,8,0,8,8,4,6,10,12,6182,41,1867
경상남도,하동군,하동읍,하동읍제1투,1662,1139,354,504,139,74,42,2,0,2,2,1,2,4,5,1131,8,523
경상남도,하동군,하동읍,하동읍제2투,1614,1103,395,449,138,73,36,1,0,1,2,1,1,0,0,1097,6,511
경상남도,하동군,하동읍,하동읍제3투,874,626,168,311,80,36,16,1,0,0,1,0,1,3,2,619,7,248
경상남도,하동군,하동읍,하동읍제4투,1592,1007,304,455,133,69,27,0,0,2,2,1,0,3,2,998,9,585
경상남도,하동군,화개면,관내사전투표,742,742,306,279,82,33,32,2,0,0,0,2,0,0,1,737,5,0
경상남도,하동군,화개면,합계,2670,2032,783,770,265,86,82,5,0,2,3,4,0,9,4,2013,19,638
경상남도,하동군,화개면,화개면제1투,1280,824,318,296,118,40,28,3,0,1,2,1,0,6,2,815,9,456
경상남도,하동군,화개면,화개면제2투,648,466,159,195,65,13,22,0,0,1,1,1,0,3,1,461,5,182
경상남도,하동군,악양면,관내사전투표,913,913,281,428,106,28,47,0,0,0,0,4,3,4,2,903,10,0
경상남도,하동군,악양면,합계,2993,2250,662,1040,278,84,115,3,2,1,3,8,8,9,8,2221,29,743
경상남도,하동군,악양면,악양면투표소,2080,1337,381,612,172,56,68,3,2,1,3,4,5,5,6,1318,19,743
경상남도,하동군,적량면,합계,1673,1286,393,582,175,49,52,2,1,1,0,0,2,9,6,1272,14,387
경상남도,하동군,적량면,관내사전투표,417,417,159,165,47,13,23,1,0,1,0,0,1,1,1,412,5,0
경상남도,하동군,적량면,적량면투표소,1256,869,234,417,128,36,29,1,1,0,0,0,1,8,5,860,9,387
경상남도,하동군,횡천면,관내사전투표,550,550,173,264,72,15,14,0,1,1,0,1,0,2,2,545,5,0
경상남도,하동군,횡천면,합계,1669,1336,373,678,161,59,40,0,1,1,0,1,3,4,5,1326,10,333
경상남도,하동군,횡천면,횡천면투표소,1119,786,200,414,89,44,26,0,0,0,0,0,3,2,3,781,5,333
경상남도,하동군,고전면,합계,1918,1483,449,689,171,77,45,5,0,3,4,4,3,7,5,1462,21,435
경상남도,하동군,고전면,관내사전투표,484,484,159,206,54,29,18,1,0,3,1,2,1,1,1,476,8,0
경상남도,하동군,고전면,고전면제1투,798,543,150,269,67,32,9,1,0,0,3,1,0,2,0,534,9,255
경상남도,하동군,고전면,고전면제2투,636,456,140,214,50,16,18,3,0,0,0,1,2,4,4,452,4,180
경상남도,하동군,금남면,합계,2947,2251,650,1097,259,100,76,2,3,3,4,0,2,9,10,2215,36,696
경상남도,하동군,금남면,관내사전투표,752,752,258,312,89,39,32,1,2,0,1,0,0,3,1,738,14,0
경상남도,하동군,금남면,금남면제1투,1294,863,225,458,98,34,20,1,1,2,2,0,0,4,4,849,14,431
경상남도,하동군,금남면,금남면제2투,901,636,167,327,72,27,24,0,0,1,1,0,2,2,5,628,8,265
경상남도,하동군,금성면,관내사전투표,809,809,295,347,76,35,37,1,1,1,0,0,1,5,2,801,8,0
경상남도,하동군,금성면,합계,2558,1891,637,846,196,87,76,1,4,2,1,3,3,7,8,1871,20,667
경상남도,하동군,금성면,금성면제1투,998,618,211,276,69,28,21,0,0,0,0,2,1,2,4,614,4,380
경상남도,하동군,금성면,금성면제2투,751,464,131,223,51,24,18,0,3,1,1,1,1,0,2,456,8,287
경상남도,하동군,진교면,합계,5059,3892,1237,1785,452,191,148,6,0,2,1,6,2,11,13,3854,38,1167
경상남도,하동군,진교면,관내사전투표,1729,1729,558,809,183,88,63,2,0,1,0,1,0,6,5,1716,13,0
경상남도,하동군,진교면,진교면제1투,1858,1159,364,511,144,63,46,2,0,0,0,4,1,1,6,1142,17,699
경상남도,하동군,진교면,진교면제2투,1472,1004,315,465,125,40,39,2,0,1,1,1,1,4,2,996,8,468
경상남도,하동군,양보면,합계,1521,1177,296,644,133,43,38,2,0,2,1,1,1,4,4,1169,8,344
경상남도,하동군,양보면,관내사전투표,516,516,135,278,54,19,20,1,0,0,0,0,1,1,1,510,6,0
경상남도,하동군,양보면,양보면투표소,1005,661,161,366,79,24,18,1,0,2,1,1,0,3,3,659,2,344
경상남도,하동군,북천면,합계,1461,1092,220,658,120,39,24,5,2,0,0,0,2,4,4,1078,14,369
경상남도,하동군,북천면,관내사전투표,476,476,103,266,58,18,14,2,2,0,0,0,0,1,4,468,8,0
경상남도,하동군,북천면,북천면투표소,985,616,117,392,62,21,10,3,0,0,0,0,2,3,0,610,6,369
경상남도,하동군,청암면,합계,1133,890,227,456,121,27,34,0,0,1,0,1,1,8,8,884,6,243
경상남도,하동군,청암면,관내사전투표,304,304,84,157,33,11,12,0,0,0,0,1,0,1,2,301,3,0
경상남도,하동군,청암면,청암면제1투,464,329,54,193,49,13,10,0,0,1,0,0,1,3,4,328,1,135
경상남도,하동군,청암면,청암면제2투,365,257,89,106,39,3,12,0,0,0,0,0,0,4,2,255,2,108
경상남도,하동군,옥종면,관내사전투표,1138,1138,342,566,122,51,32,3,0,1,3,1,1,6,4,1132,6,0
경상남도,하동군,옥종면,합계,3591,2800,771,1432,312,126,90,9,1,1,3,4,4,15,13,2781,19,791
경상남도,하동군,옥종면,옥종면투표소,2453,1662,429,866,190,75,58,6,1,0,0,3,3,9,9,1649,13,791
경상남도,하동군,잘못 투입·구분된 투표지,,0,0,0,0,0,0,0,0,0,0,0,0,0,0,0,0,0,0
경상남도,남해군,합계,,40197,30208,8680,14166,3906,1627,1248,36,13,27,15,20,35,68,87,29928,280,9989
경상남도,남해군,거소·선상투표,,192,170,44,54,38,7,4,2,2,1,0,0,1,3,5,161,9,22
경상남도,남해군,관외사전투표,,2993,2993,1190,786,426,284,264,4,0,0,0,1,1,1,7,2964,29,0
경상남도,남해군,재외투표,,336,170,82,15,54,8,10,1,0,0,0,0,0,0,0,170,0,166
경상남도,남해군,남해읍,관내사전투표,2780,2780,1031,1025,297,201,189,3,0,3,1,1,0,2,6,2759,21,0
경상남도,남해군,남해읍,합계,10153,7648,2380,3241,990,476,432,4,3,13,4,3,9,9,15,7579,69,2505
경상남도,남해군,남해읍,남해읍제1투,1899,1250,345,549,198,77,69,0,0,1,1,0,2,1,1,1244,6,649
경상남도,남해군,남해읍,남해읍제2투,1145,740,199,391,88,31,20,0,2,1,0,0,1,3,0,736,4,405
경상남도,남해군,남해읍,남해읍제3투,1840,1257,375,540,165,81,65,0,1,6,1,1,2,2,2,1241,16,583
경상남도,남해군,남해읍,남해읍제4투,2489,1621,430,736,242,86,89,1,0,2,1,1,4,1,6,1599,22,868
경상남도,남해군,이동면,합계,3479,2597,649,1374,351,108,67,2,3,0,1,2,4,7,5,2573,24,882
경상남도,남해군,이동면,관내사전투표,749,749,224,373,80,36,23,1,3,0,0,1,0,1,1,743,6,0
경상남도,남해군,이동면,이동면제1투,1097,732,161,392,113,31,20,0,0,0,0,0,1,1,2,721,11,365
경상남도,남해군,이동면,이동면제2투,805,550,139,290,80,22,9,1,0,0,0,0,2,1,1,545,5,255
경상남도,남해군,이동면,이동면제3투,828,566,125,319,78,19,15,0,0,0,1,1,1,4,1,564,2,262
경상남도,남해군,상주면,합계,1420,1054,288,524,128,59,32,1,1,1,0,0,2,6,3,1045,9,366
경상남도,남해군,상주면,관내사전투표,320,320,105,148,33,14,11,1,0,0,0,0,1,3,2,318,2,0
경상남도,남해군,상주면,상주면투표소,1100,734,183,376,95,45,21,0,1,1,0,0,1,3,1,727,7,366
경상남도,남해군,삼동면,관내사전투표,488,488,165,193,69,27,29,1,0,0,1,0,0,1,0,486,2,0
경상남도,남해군,삼동면,합계,3332,2404,655,1205,322,108,81,2,0,1,1,1,4,5,5,2390,14,928
경상남도,남해군,삼동면,삼동면제1투,1283,852,199,475,115,33,19,0,0,0,0,0,2,1,2,846,6,431
경상남도,남해군,삼동면,삼동면제2투,1561,1064,291,537,138,48,33,1,0,1,0,1,2,3,3,1058,6,497
경상남도,남해군,미조면,합계,2175,1550,386,799,192,80,64,5,2,1,1,2,1,2,4,1539,11,625
경상남도,남해군,미조면,관내사전투표,537,537,159,245,53,31,39,2,0,1,0,0,0,0,1,531,6,0
경상남도,남해군,미조면,미조면투표소,1638,1013,227,554,139,49,25,3,2,0,1,2,1,2,3,1008,5,625
경상남도,남해군,남면,관내사전투표,952,952,242,508,101,46,28,2,1,0,0,3,0,3,4,938,14,0
경상남도,남해군,남면,합계,3239,2264,576,1201,281,92,61,5,1,1,2,4,3,7,7,2241,23,975
경상남도,남해군,남면,남면제1투,1251,749,180,418,98,22,23,1,0,1,1,1,1,0,0,746,3,502
경상남도,남해군,남면,남면제2투,1036,563,154,275,82,24,10,2,0,0,1,0,2,4,3,557,6,473
경상남도,남해군,서면,합계,2364,1750,435,992,181,70,42,0,1,2,0,0,1,6,6,1736,14,614
경상남도,남해군,서면,관내사전투표,414,414,130,210,41,20,8,0,0,0,0,0,0,1,2,412,2,0
경상남도,남해군,서면,서면제1투,1255,833,202,485,78,28,26,0,1,2,0,0,1,3,3,829,4,422
경상남도,남해군,서면,서면제2투,695,503,103,297,62,22,8,0,0,0,0,0,0,2,1,495,8,192
경상남도,남해군,고현면,합계,3092,2251,711,1006,290,119,77,5,0,2,1,3,2,5,16,2237,14,841
경상남도,남해군,고현면,관내사전투표,770,770,252,350,90,39,22,2,0,1,1,2,1,1,7,768,2,0
경상남도,남해군,고현면,고현면제1투,1206,727,193,357,95,42,21,3,0,0,0,1,1,2,5,720,7,479
경상남도,남해군,고현면,고현면제2투,1116,754,266,299,105,38,34,0,0,1,0,0,0,2,4,749,5,362
경상남도,남해군,설천면,합계,2565,1919,576,936,238,83,45,0,0,2,1,3,1,4,7,1896,23,646
경상남도,남해군,설천면,관내사전투표,534,534,177,244,69,21,17,0,0,1,0,0,1,0,0,530,4,0
경상남도,남해군,설천면,설천면제1투,1343,857,257,411,108,45,17,0,0,0,1,2,0,2,2,845,12,486
경상남도,남해군,설천면,설천면제2투,688,528,142,281,61,17,11,0,0,1,0,1,0,2,5,521,7,160
경상남도,남해군,창선면,합계,4857,3438,708,2033,415,133,69,5,0,3,4,1,6,13,7,3397,41,1419
경상남도,남해군,창선면,관내사전투표,861,861,222,464,104,36,17,2,0,2,1,0,3,2,3,856,5,0
경상남도,남해군,창선면,창선면제1투,1930,1250,263,729,157,45,32,1,0,0,1,1,0,4,3,1236,14,680
경상남도,남해군,창선면,창선면제2투,1161,735,115,494,66,32,10,1,0,0,1,0,1,2,0,722,13,426
경상남도,남해군,창선면,창선면제3투,905,592,108,346,88,20,10,1,0,1,1,0,2,5,1,583,9,313
경상남도,남해군,잘못 투입·구분된 투표지,,0,0,0,0,0,0,0,0,0,0,0,0,0,0,0,0,0,0
경상남도,함양군,합계,,34899,26640,7388,13008,3203,1315,1118,44,14,32,16,27,27,111,61,26364,276,8259
경상남도,함양군,거소·선상투표,,262,242,80,67,28,11,12,2,3,1,4,5,1,2,3,219,23,20
경상남도,함양군,관외사전투표,,2747,2747,1090,754,368,211,272,6,0,1,0,0,2,3,5,2712,35,0
경상남도,함양군,재외투표,,299,152,73,19,41,5,12,0,0,0,0,0,0,0,0,150,2,147
경상남도,함양군,함양읍,합계,13716,10146,2928,4753,1274,565,458,21,5,14,4,7,6,20,11,10066,80,3570
경상남도,함양군,함양읍,관내사전투표,3150,3150,1146,1182,371,201,202,6,1,3,2,1,1,7,4,3127,23,0
경상남도,함양군,함양읍,함양읍제1투,1473,901,204,483,123,34,35,2,0,7,0,1,1,3,1,894,7,572
경상남도,함양군,함양읍,함양읍제2투,1799,1232,252,739,117,64,37,2,1,1,0,1,0,1,3,1218,14,567
경상남도,함양군,함양읍,함양읍제3투,2610,1741,531,747,242,109,87,4,1,1,1,1,2,1,1,1728,13,869
경상남도,함양군,함양읍,함양읍제4투,910,605,139,331,91,24,9,0,1,1,1,1,0,2,1,601,4,305
경상남도,함양군,함양읍,함양읍제5투,1820,1322,392,611,173,76,50,3,1,1,0,1,1,2,1,1312,10,498
경상남도,함양군,함양읍,함양읍제6투,1306,797,187,439,96,42,20,3,0,0,0,1,0,2,0,790,7,509
경상남도,함양군,함양읍,함양읍제7투,648,398,77,221,61,15,18,1,0,0,0,0,1,2,0,396,2,250
경상남도,함양군,마천면,관내사전투표,512,512,186,239,49,11,18,0,0,1,0,0,0,4,2,510,2,0
경상남도,함양군,마천면,합계,1918,1404,423,687,164,44,41,0,1,2,4,3,5,11,5,1390,14,514
경상남도,함양군,마천면,마천면투표소,1406,892,237,448,115,33,23,0,1,1,4,3,5,7,3,880,12,514
경상남도,함양군,휴천면,합계,1324,927,238,503,108,34,24,1,1,0,0,0,5,3,1,918,9,397
경상남도,함양군,휴천면,관내사전투표,284,284,81,141,33,14,9,1,1,0,0,0,0,0,0,280,4,0
경상남도,함양군,휴천면,휴천면투표소,1040,643,157,362,75,20,15,0,0,0,0,0,5,3,1,638,5,397
경상남도,함양군,유림면,합계,1518,1087,251,609,120,47,20,1,0,5,0,0,0,17,5,1075,12,431
경상남도,함양군,유림면,관내사전투표,325,325,100,159,32,22,3,0,0,2,0,0,0,6,0,324,1,0
경상남도,함양군,유림면,유림면투표소,1193,762,151,450,88,25,17,1,0,3,0,0,0,11,5,751,11,431
경상남도,함양군,수동면,합계,2070,1585,331,950,166,65,38,5,1,2,1,1,1,7,3,1571,14,485
경상남도,함양군,수동면,관내사전투표,601,601,161,335,55,23,13,1,1,1,1,0,0,5,1,597,4,0
경상남도,함양군,수동면,수동면투표소,1469,984,170,615,111,42,25,4,0,1,0,1,1,2,2,974,10,485
경상남도,함양군,지곡면,합계,1774,1363,341,727,171,55,43,3,0,0,1,2,1,3,5,1352,11,411
경상남도,함양군,지곡면,관내사전투표,461,461,125,225,70,18,18,2,0,0,0,1,0,0,0,459,2,0
경상남도,함양군,지곡면,지곡면투표소,1313,902,216,502,101,37,25,1,0,0,1,1,1,3,5,893,9,411
경상남도,함양군,안의면,합계,4088,3062,621,1836,326,110,81,3,3,5,1,5,3,14,13,3021,41,1026
경상남도,함양군,안의면,관내사전투표,1251,1251,266,751,129,31,31,3,2,3,1,2,2,7,5,1233,18,0
경상남도,함양군,안의면,안의면제1투,1548,1041,196,633,111,52,24,0,0,0,0,2,0,5,5,1028,13,507
경상남도,함양군,안의면,안의면제2투,1289,770,159,452,86,27,26,0,1,2,0,1,1,2,3,760,10,519
경상남도,함양군,서하면,합계,1161,897,221,474,105,44,21,0,0,2,1,2,1,11,2,884,13,264
경상남도,함양군,서하면,관내사전투표,299,299,83,139,43,19,9,0,0,0,0,0,0,3,0,296,3,0
경상남도,함양군,서하면,서하면투표소,862,598,138,335,62,25,12,0,0,2,1,2,1,8,2,588,10,264
경상남도,함양군,서상면,합계,1568,1177,315,632,118,44,48,1,0,0,0,1,0,5,1,1165,12,391
경상남도,함양군,서상면,관내사전투표,313,313,113,130,35,16,17,0,0,0,0,0,0,1,0,312,1,0
경상남도,함양군,서상면,서상면투표소,1255,864,202,502,83,28,31,1,0,0,0,1,0,4,1,853,11,391
경상남도,함양군,백전면,합계,1320,984,266,513,117,41,28,1,0,0,0,0,2,6,5,979,5,336
경상남도,함양군,백전면,관내사전투표,241,241,87,111,24,10,6,0,0,0,0,0,0,1,0,239,2,0
경상남도,함양군,백전면,백전면투표소,1079,743,179,402,93,31,22,1,0,0,0,0,2,5,5,740,3,336
경상남도,함양군,병곡면,합계,1134,867,210,484,97,39,20,0,0,0,0,1,0,9,2,862,5,267
경상남도,함양군,병곡면,관내사전투표,268,268,80,144,22,14,6,0,0,0,0,0,0,1,0,267,1,0
경상남도,함양군,병곡면,병곡면투표소,866,599,130,340,75,25,14,0,0,0,0,1,0,8,2,595,4,267
경상남도,함양군,잘못 투입·구분된 투표지,,0,0,0,0,0,0,0,0,0,0,0,0,0,0,0,0,0,0
경상남도,산청군,합계,,32215,24513,6561,12544,2753,1196,935,41,6,21,19,21,34,91,73,24295,218,7702
경상남도,산청군,거소·선상투표,,155,134,42,45,29,7,2,1,0,1,1,0,0,0,1,129,5,21
경상남도,산청군,관외사전투표,,3440,3440,1338,1110,420,279,241,3,2,6,0,3,3,3,8,3416,24,0
경상남도,산청군,재외투표,,292,131,64,8,40,9,8,2,0,0,0,0,0,0,0,131,0,161
경상남도,산청군,산청읍,관내사전투표,1352,1352,477,575,123,85,73,2,0,2,3,3,0,2,2,1347,5,0
경상남도,산청군,산청읍,합계,5221,3899,1088,1943,406,217,169,8,0,6,6,4,3,13,9,3872,27,1322
경상남도,산청군,산청읍,산청읍제1투,3007,1963,464,1053,216,107,82,5,0,3,2,1,1,6,4,1944,19,1044
경상남도,산청군,산청읍,산청읍제2투,862,584,147,315,67,25,14,1,0,1,1,0,2,5,3,581,3,278
경상남도,산청군,차황면,관내사전투표,267,267,90,136,16,12,10,0,0,0,0,0,0,2,1,267,0,0
경상남도,산청군,차황면,합계,1267,943,214,557,91,34,25,0,0,0,0,1,2,7,2,933,10,324
경상남도,산청군,차황면,차황면투표소,1000,676,124,421,75,22,15,0,0,0,0,1,2,5,1,666,10,324
경상남도,산청군,오부면,관내사전투표,210,210,56,114,21,5,9,0,0,0,0,0,1,0,2,208,2,0
경상남도,산청군,오부면,합계,917,695,155,409,67,11,22,1,0,0,0,0,4,11,6,686,9,222
경상남도,산청군,오부면,오부면투표소,707,485,99,295,46,6,13,1,0,0,0,0,3,11,4,478,7,222
경상남도,산청군,생초면,합계,1863,1372,275,852,128,49,33,0,1,0,0,0,4,4,2,1348,24,491
경상남도,산청군,생초면,관내사전투표,368,368,92,188,42,16,18,0,0,0,0,0,1,0,1,358,10,0
경상남도,산청군,생초면,생초면투표소,1495,1004,183,664,86,33,15,0,1,0,0,0,3,4,1,990,14,491
경상남도,산청군,금서면,합계,2396,1731,419,931,190,90,62,0,0,0,2,1,4,10,9,1718,13,665
경상남도,산청군,금서면,관내사전투표,435,435,154,181,45,26,24,0,0,0,0,0,1,2,1,434,1,0
경상남도,산청군,금서면,금서면제1투,1317,818,147,484,100,39,27,0,0,0,2,0,2,5,5,811,7,499
경상남도,산청군,금서면,금서면제2투,644,478,118,266,45,25,11,0,0,0,0,1,1,3,3,473,5,166
경상남도,산청군,삼장면,합계,1496,1135,244,685,121,43,30,1,0,1,0,1,1,3,1,1131,4,361
경상남도,산청군,삼장면,관내사전투표,278,278,69,157,34,8,6,1,0,0,0,0,1,0,0,276,2,0
경상남도,산청군,삼장면,삼장면투표소,1218,857,175,528,87,35,24,0,0,1,0,1,0,3,1,855,2,361
경상남도,산청군,시천면,관내사전투표,771,771,235,391,61,33,30,0,1,0,3,0,0,3,2,759,12,0
경상남도,산청군,시천면,합계,3318,2432,561,1392,260,105,65,1,1,2,5,1,0,7,10,2410,22,886
경상남도,산청군,시천면,시천면제1투,1400,902,174,525,120,47,21,1,0,1,1,1,0,2,4,897,5,498
경상남도,산청군,시천면,시천면제2투,1147,759,152,476,79,25,14,0,0,1,1,0,0,2,4,754,5,388
경상남도,산청군,단성면,합계,4546,3207,732,1839,366,119,81,9,1,1,1,6,4,17,6,3182,25,1339
경상남도,산청군,단성면,관내사전투표,980,980,250,533,119,31,30,2,0,1,0,1,2,2,1,972,8,0
경상남도,산청군,단성면,단성면제1투,2810,1693,374,974,197,68,41,6,1,0,1,1,1,12,2,1678,15,1117
경상남도,산청군,단성면,단성면제2투,756,534,108,332,50,20,10,1,0,0,0,4,1,3,3,532,2,222
경상남도,산청군,신안면,합계,4462,3256,960,1554,403,148,137,7,0,1,2,2,4,7,8,3233,23,1206
경상남도,산청군,신안면,관내사전투표,977,977,345,393,132,51,44,1,0,1,1,0,1,1,3,973,4,0
경상남도,산청군,신안면,신안면제1투,2401,1613,453,771,204,78,73,6,0,0,1,2,2,5,3,1598,15,788
경상남도,산청군,신안면,신안면제2투,1084,666,162,390,67,19,20,0,0,0,0,0,1,1,2,662,4,418
경상남도,산청군,생비량면,관내사전투표,164,164,45,85,10,12,7,1,0,1,0,0,0,0,0,161,3,0
경상남도,산청군,생비량면,합계,1007,761,137,472,73,27,19,2,0,1,0,0,2,6,8,747,14,246
경상남도,산청군,생비량면,생비량면투표소,843,597,92,387,63,15,12,1,0,0,0,0,2,6,8,586,11,246
경상남도,산청군,신등면,관내사전투표,435,435,103,214,68,24,12,5,0,2,1,0,1,1,1,432,3,0
경상남도,산청군,신등면,합계,1835,1377,332,747,159,58,41,6,1,2,2,2,3,3,3,1359,18,458
경상남도,산청군,신등면,신등면투표소,1400,942,229,533,91,34,29,1,1,0,1,2,2,2,2,927,15,458
경상남도,산청군,잘못 투입·구분된 투표지,,0,0,0,0,0,0,0,0,0,0,0,0,0,0,0,0,0,0
경상남도,거창군,합계,,53345,41325,11256,19976,4923,2447,1923,46,12,37,22,48,54,105,100,40949,376,12020
경상남도,거창군,거소·선상투표,,153,139,34,61,26,8,5,0,0,0,1,0,0,0,0,135,4,14
경상남도,거창군,관외사전투표,,3978,3978,1592,919,616,397,372,2,0,8,3,3,5,8,17,3942,36,0
경상남도,거창군,재외투표,,513,258,148,17,62,3,20,6,0,0,0,1,0,0,0,257,1,255
경상남도,거창군,거창읍,합계,29150,21656,6340,9916,2594,1456,1068,23,2,15,5,21,12,34,33,21519,137,7494
경상남도,거창군,거창읍,관내사전투표,6187,6187,2307,2167,679,500,454,5,1,5,2,7,4,6,13,6150,37,0
경상남도,거창군,거창읍,거창읍제1투,2356,1590,509,684,219,86,73,3,0,0,0,1,0,1,3,1579,11,766
경상남도,거창군,거창읍,거창읍제2투,2465,1611,371,874,197,104,42,2,0,0,0,2,1,2,3,1598,13,854
경상남도,거창군,거창읍,거창읍제3투,2726,1832,505,891,230,105,78,0,0,4,0,2,1,2,1,1819,13,894
경상남도,거창군,거창읍,거창읍제4투,3396,2236,601,1087,271,155,96,2,0,2,0,1,1,3,4,2223,13,1160
경상남도,거창군,거창읍,거창읍제5투,3095,2109,513,1028,272,169,101,3,0,3,0,0,1,3,1,2094,15,986
경상남도,거창군,거창읍,거창읍제6투,2203,1507,373,777,193,92,50,3,0,1,0,3,0,4,2,1498,9,696
경상남도,거창군,거창읍,거창읍제7투,1305,872,198,520,86,28,26,1,0,0,1,0,0,7,2,869,3,433
경상남도,거창군,거창읍,거창읍제8투,1328,967,185,603,82,36,38,0,1,0,0,3,2,4,0,954,13,361
경상남도,거창군,거창읍,거창읍제9투,1505,1118,359,465,168,80,34,3,0,0,0,1,1,0,3,1114,4,387
경상남도,거창군,거창읍,거창읍제10투,2584,1627,419,820,197,101,76,1,0,0,2,1,1,2,1,1621,6,957
경상남도,거창군,주상면,관내사전투표,399,399,103,225,32,22,9,0,0,1,0,0,0,0,3,395,4,0
경상남도,거창군,주상면,합계,1452,1166,215,741,121,39,20,2,0,1,3,1,1,3,5,1152,14,286
경상남도,거창군,주상면,주상면투표소,1053,767,112,516,89,17,11,2,0,0,3,1,1,3,2,757,10,286
경상남도,거창군,웅양면,합계,1746,1393,348,770,146,38,57,0,1,2,1,2,4,6,4,1379,14,353
경상남도,거창군,웅양면,관내사전투표,519,519,151,256,57,15,29,0,1,1,1,2,0,2,1,516,3,0
경상남도,거창군,웅양면,웅양면투표소,1227,874,197,514,89,23,28,0,0,1,0,0,4,4,3,863,11,353
경상남도,거창군,고제면,관내사전투표,396,396,98,223,40,15,12,2,0,1,0,0,1,2,0,394,2,0
경상남도,거창군,고제면,합계,1364,1086,236,618,122,39,37,4,0,3,1,1,1,5,1,1068,18,278
경상남도,거창군,고제면,고제면투표소,968,690,138,395,82,24,25,2,0,2,1,1,0,3,1,674,16,278
경상남도,거창군,북상면,합계,1413,1088,246,579,131,53,49,1,2,2,0,2,2,3,2,1072,16,325
경상남도,거창군,북상면,관내사전투표,438,438,111,224,45,23,26,0,0,1,0,2,0,0,0,432,6,0
경상남도,거창군,북상면,북상면투표소,975,650,135,355,86,30,23,1,2,1,0,0,2,3,2,640,10,325
경상남도,거창군,위천면,합계,1837,1448,321,815,165,75,35,1,0,2,1,2,4,3,5,1429,19,389
경상남도,거창군,위천면,관내사전투표,481,481,138,249,45,24,11,0,0,1,1,0,2,1,4,476,5,0
경상남도,거창군,위천면,위천면투표소,1356,967,183,566,120,51,24,1,0,1,0,2,2,2,1,953,14,389
경상남도,거창군,마리면,관내사전투표,506,506,132,260,58,20,24,1,1,0,0,0,1,2,0,499,7,0
경상남도,거창군,마리면,합계,1906,1474,287,872,184,53,52,2,1,0,0,2,4,3,3,1463,11,432
경상남도,거창군,마리면,마리면투표소,1400,968,155,612,126,33,28,1,0,0,0,2,3,1,3,964,4,432
경상남도,거창군,남상면,합계,2290,1774,334,1080,168,80,53,0,2,4,1,2,2,9,8,1743,31,516
경상남도,거창군,남상면,관내사전투표,619,619,151,342,50,32,24,0,0,1,1,1,0,3,2,607,12,0
경상남도,거창군,남상면,남상면투표소,1671,1155,183,738,118,48,29,0,2,3,0,1,2,6,6,1136,19,516
경상남도,거창군,남하면,합계,1471,1163,235,680,131,53,40,1,0,0,0,0,3,5,1,1149,14,308
경상남도,거창군,남하면,관내사전투표,460,460,127,234,54,27,16,0,0,0,0,0,0,0,1,459,1,0
경상남도,거창군,남하면,남하면투표소,1011,703,108,446,77,26,24,1,0,0,0,0,3,5,0,690,13,308
경상남도,거창군,신원면,합계,1394,1094,234,638,113,47,18,0,0,0,2,2,5,10,11,1080,14,300
경상남도,거창군,신원면,관내사전투표,367,367,89,203,38,12,11,0,0,0,0,0,1,4,4,362,5,0
경상남도,거창군,신원면,신원면투표소,1027,727,145,435,75,35,7,0,0,0,2,2,4,6,7,718,9,300
경상남도,거창군,가조면,합계,3449,2688,520,1712,240,75,72,2,4,0,0,4,8,9,7,2653,35,761
경상남도,거창군,가조면,관내사전투표,1014,1014,251,600,85,26,30,0,1,0,0,2,3,2,2,1002,12,0
경상남도,거창군,가조면,가조면투표소,2435,1674,269,1112,155,49,42,2,3,0,0,2,5,7,5,1651,23,761
경상남도,거창군,가북면,관내사전투표,220,220,51,112,24,11,11,2,0,0,0,0,0,5,0,216,4,0
경상남도,거창군,가북면,합계,1229,920,166,558,104,31,25,2,0,0,4,5,3,7,3,908,12,309
경상남도,거창군,가북면,가북면투표소,1009,700,115,446,80,20,14,0,0,0,4,5,3,2,3,692,8,309
경상남도,거창군,잘못 투입·구분된 투표지,,0,0,0,0,0,0,0,0,0,0,0,0,0,0,0,0,0,0
경상남도,합천군,합계,,42887,33021,7143,19699,3077,1317,1065,37,23,26,16,28,51,153,76,32711,310,9866
경상남도,합천군,거소·선상투표,,321,304,51,150,42,12,4,2,3,3,0,0,1,2,3,273,31,17
경상남도,합천군,관외사전투표,,4100,4100,1392,1482,505,372,302,6,2,3,2,3,0,2,4,4075,25,0
경상남도,합천군,재외투표,,548,223,96,22,78,9,13,0,1,0,0,0,0,0,2,221,2,325
경상남도,합천군,합천읍,합계,8931,6908,1719,3836,637,334,290,7,1,5,2,4,4,8,5,6852,56,2023
경상남도,합천군,합천읍,관내사전투표,2700,2700,816,1266,275,152,154,2,1,3,1,1,0,3,1,2675,25,0
경상남도,합천군,합천읍,합천읍제1투,1797,1256,253,739,125,77,49,0,0,0,0,0,0,2,1,1246,10,541
경상남도,합천군,합천읍,합천읍제2투,2579,1758,385,1105,152,48,43,2,0,1,0,1,4,3,1,1745,13,821
경상남도,합천군,합천읍,합천읍제3투,1855,1194,265,726,85,57,44,3,0,1,1,2,0,0,2,1186,8,661
경상남도,합천군,봉산면,관내사전투표,298,298,52,196,26,10,6,0,0,0,0,0,0,1,1,292,6,0
경상남도,합천군,봉산면,합계,1284,904,139,610,90,23,13,0,2,0,0,0,4,8,3,892,12,380
경상남도,합천군,봉산면,봉산면투표소,986,606,87,414,64,13,7,0,2,0,0,0,4,7,2,600,6,380
경상남도,합천군,묘산면,합계,1476,1116,166,796,77,32,19,3,0,1,0,1,2,7,5,1109,7,360
경상남도,합천군,묘산면,관내사전투표,394,394,85,254,27,13,7,0,0,1,0,0,1,0,2,390,4,0
경상남도,합천군,묘산면,묘산면투표소,1082,722,81,542,50,19,12,3,0,0,0,1,1,7,3,719,3,360
경상남도,합천군,가야면,합계,3744,2793,556,1793,256,92,67,2,0,2,3,0,2,9,2,2784,9,951
경상남도,합천군,가야면,관내사전투표,838,838,197,492,73,35,29,2,0,0,2,0,0,4,0,834,4,0
경상남도,합천군,가야면,가야면제1투,1253,828,142,556,70,28,26,0,0,0,0,0,0,2,0,824,4,425
경상남도,합천군,가야면,가야면제2투,1081,769,136,537,65,17,5,0,0,1,1,0,2,2,2,768,1,312
경상남도,합천군,가야면,가야면제3투,572,358,81,208,48,12,7,0,0,1,0,0,0,1,0,358,0,214
경상남도,합천군,야로면,합계,2172,1647,294,1103,123,50,42,2,1,1,3,1,1,10,2,1633,14,525
경상남도,합천군,야로면,관내사전투표,489,489,104,291,38,26,17,1,1,0,0,0,0,6,0,484,5,0
경상남도,합천군,야로면,야로면투표소,1683,1158,190,812,85,24,25,1,0,1,3,1,1,4,2,1149,9,525
경상남도,합천군,율곡면,합계,2040,1522,248,1022,145,45,23,1,2,0,0,1,4,15,5,1511,11,518
경상남도,합천군,율곡면,관내사전투표,490,490,80,334,43,13,8,0,0,0,0,1,0,5,2,486,4,0
경상남도,합천군,율곡면,율곡면제1투,1153,745,135,488,68,24,10,1,1,0,0,0,3,7,3,740,5,408
경상남도,합천군,율곡면,율곡면제2투,397,287,33,200,34,8,5,0,1,0,0,0,1,3,0,285,2,110
경상남도,합천군,초계면,합계,2228,1648,313,1065,160,49,33,1,1,3,0,0,2,6,2,1635,13,580
경상남도,합천군,초계면,관내사전투표,618,618,126,392,53,19,12,1,1,1,0,0,1,4,1,611,7,0
경상남도,합천군,초계면,초계면투표소,1610,1030,187,673,107,30,21,0,0,2,0,0,1,2,1,1024,6,580
경상남도,합천군,쌍책면,합계,1197,946,120,690,70,22,19,1,2,2,0,1,3,5,2,937,9,251
경상남도,합천군,쌍책면,관내사전투표,171,171,33,113,9,4,9,0,0,1,0,0,0,1,0,170,1,0
경상남도,합천군,쌍책면,쌍책면제1투,618,462,56,345,33,10,5,1,0,1,0,1,2,2,2,458,4,156
경상남도,합천군,쌍책면,쌍책면제2투,408,313,31,232,28,8,5,0,2,0,0,0,1,2,0,309,4,95
경상남도,합천군,덕곡면,합계,745,610,64,481,30,12,5,1,2,0,0,1,1,4,3,604,6,135
경상남도,합천군,덕곡면,관내사전투표,403,403,37,327,15,8,3,0,2,0,0,0,1,2,3,398,5,0
경상남도,합천군,덕곡면,덕곡면투표소,342,207,27,154,15,4,2,1,0,0,0,1,0,2,0,206,1,135
경상남도,합천군,청덕면,합계,1489,1076,186,702,119,24,16,0,1,0,1,1,6,5,2,1063,13,413
경상남도,합천군,청덕면,관내사전투표,196,196,54,109,18,3,11,0,0,0,0,0,0,0,0,195,1,0
경상남도,합천군,청덕면,청덕면제1투,833,558,90,362,67,13,4,0,1,0,1,1,5,4,2,550,8,275
경상남도,합천군,청덕면,청덕면제2투,460,322,42,231,34,8,1,0,0,0,0,0,1,1,0,318,4,138
경상남도,합천군,적중면,관내사전투표,329,329,75,201,23,15,5,0,0,0,1,0,0,5,0,325,4,0
경상남도,합천군,적중면,합계,1324,981,175,640,87,30,18,0,0,1,1,0,2,10,5,969,12,343
경상남도,합천군,적중면,적중면투표소,995,652,100,439,64,15,13,0,0,1,0,0,2,5,5,644,8,343
경상남도,합천군,대양면,합계,1410,1024,196,654,79,28,36,0,0,0,1,1,2,8,4,1009,15,386
경상남도,합천군,대양면,관내사전투표,305,305,66,182,23,10,15,0,0,0,0,1,0,2,1,300,5,0
경상남도,합천군,대양면,대양면투표소,1105,719,130,472,56,18,21,0,0,0,1,0,2,6,3,709,10,386
경상남도,합천군,쌍백면,합계,1630,1184,193,809,85,23,21,2,1,1,0,2,4,13,5,1159,25,446
경상남도,합천군,쌍백면,관내사전투표,447,447,79,301,34,9,9,1,0,0,0,1,3,3,1,441,6,0
경상남도,합천군,쌍백면,쌍백면투표소,1183,737,114,508,51,14,12,1,1,1,0,1,1,10,4,718,19,446
경상남도,합천군,삼가면,관내사전투표,635,635,163,353,63,25,24,1,0,0,0,3,0,1,2,635,0,0
경상남도,합천군,삼가면,합계,2990,2177,487,1316,209,62,59,2,0,0,0,7,4,9,7,2162,15,813
경상남도,합천군,삼가면,삼가면제1투,1161,736,152,471,62,20,17,1,0,0,0,1,1,6,0,731,5,425
경상남도,합천군,삼가면,삼가면제2투,1194,806,172,492,84,17,18,0,0,0,0,3,3,2,5,796,10,388
경상남도,합천군,가회면,합계,1542,1120,232,683,89,40,36,2,1,3,1,1,2,12,5,1107,13,422
경상남도,합천군,가회면,관내사전투표,394,394,98,234,25,14,11,1,0,1,0,1,1,4,0,390,4,0
경상남도,합천군,가회면,가회면투표소,1148,726,134,449,64,26,25,1,1,2,1,0,1,8,5,717,9,422
경상남도,합천군,대병면,관내사전투표,469,469,101,288,39,8,20,0,1,0,0,1,2,2,2,464,5,0
경상남도,합천군,대병면,합계,1785,1333,284,847,108,29,29,2,2,0,0,3,3,7,6,1320,13,452
경상남도,합천군,대병면,대병면투표소,1316,864,183,559,69,21,9,2,1,0,0,2,1,5,4,856,8,452
경상남도,합천군,용주면,합계,1931,1405,232,998,88,29,20,3,1,1,2,1,4,13,4,1396,9,526
경상남도,합천군,용주면,관내사전투표,303,303,59,200,21,10,7,0,0,0,2,0,0,1,1,301,2,0
경상남도,합천군,용주면,용주면투표소,1628,1102,173,798,67,19,13,3,1,1,0,1,4,12,3,1095,7,526
경상남도,합천군,잘못 투입·구분된 투표지,,0,0,0,0,0,0,0,0,0,0,0,0,0,0,0,0,0,0
제주특별자치도,합계,,,518000,374459,169493,68063,77861,22784,31716,385,269,312,113,335,236,289,556,372412,2047,143541
제주특별자치도,제주시,합계,,375292,273163,125717,48027,55971,16885,23592,270,96,193,73,257,153,178,368,271780,1383,102129
제주특별자치도,제주시,거소·선상투표,,1182,1116,474,152,277,65,54,4,5,5,3,5,8,6,6,1064,52,66
제주특별자치도,제주시,관외사전투표,,22492,22491,10799,2512,4218,2146,2501,15,7,15,3,19,11,8,52,22306,185,1
제주특별자치도,제주시,재외투표,,4418,2259,1178,130,628,62,246,5,0,0,0,3,1,0,0,2253,6,2159
제주특별자치도,제주시,한림읍,합계,15995,10696,4431,2628,2289,476,700,8,4,14,2,7,10,16,36,10621,75,5299
제주특별자치도,제주시,한림읍,관내사전투표,2271,2271,1146,363,424,106,204,2,0,3,0,3,0,3,4,2258,13,0
제주특별자치도,제주시,한림읍,한림읍제1투,1301,863,331,245,166,53,58,1,0,1,0,1,0,2,2,860,3,438
제주특별자치도,제주시,한림읍,한림읍제2투,1205,722,275,201,158,29,48,0,0,2,0,0,3,0,5,721,1,483
제주특별자치도,제주시,한림읍,한림읍제3투,2002,1135,420,306,296,47,54,0,0,1,0,0,0,0,3,1127,8,867
제주특별자치도,제주시,한림읍,한림읍제4투,717,506,283,95,91,10,22,0,0,0,0,0,1,0,2,504,2,211
제주특별자치도,제주시,한림읍,한림읍제5투,1004,639,212,202,159,30,24,3,0,1,0,0,0,1,1,633,6,365
제주특별자치도,제주시,한림읍,한림읍제6투,976,587,248,173,113,15,28,0,0,1,0,0,1,1,3,583,4,389
제주특별자치도,제주시,한림읍,한림읍제7투,1396,897,352,221,194,51,61,0,2,1,0,2,0,0,4,888,9,499
제주특별자치도,제주시,한림읍,한림읍제8투,1063,711,289,197,132,34,38,1,1,1,0,0,0,2,5,700,11,352
제주특별자치도,제주시,한림읍,한림읍제9투,1286,757,273,160,186,35,90,1,0,0,0,1,0,3,1,750,7,529
제주특별자치도,제주시,한림읍,한림읍제10투,1605,854,325,227,199,46,46,0,0,0,1,0,2,1,3,850,4,751
제주특별자치도,제주시,한림읍,한림읍제11투,115,76,5,45,21,3,0,0,1,0,0,0,0,0,0,75,1,39
제주특별자치도,제주시,한림읍,한림읍제12투,488,307,142,72,70,5,11,0,0,2,1,0,2,0,1,306,1,181
제주특별자치도,제주시,한림읍,한림읍제13투,566,371,130,121,80,12,16,0,0,1,0,0,1,3,2,366,5,195
제주특별자치도,제주시,애월읍,합계,22638,15516,6782,3137,3380,777,1217,12,5,10,6,15,17,22,29,15409,107,7122
제주특별자치도,제주시,애월읍,관내사전투표,1832,1832,980,235,332,89,165,1,1,3,1,3,0,2,3,1815,17,0
제주특별자치도,제주시,애월읍,애월읍제1투,2088,1160,452,293,256,61,78,0,0,5,1,1,1,1,2,1151,9,928
제주특별자치도,제주시,애월읍,애월읍제2투,1085,723,287,145,180,28,71,2,1,1,1,0,2,1,1,720,3,362
제주특별자치도,제주시,애월읍,애월읍제3투,2231,1401,548,324,339,78,84,3,0,0,0,1,4,5,4,1390,11,830
제주특별자치도,제주시,애월읍,애월읍제4투,2874,1878,777,401,439,87,153,3,0,0,1,2,2,3,3,1871,7,996
제주특별자치도,제주시,애월읍,애월읍제5투,896,625,252,125,155,33,50,0,0,1,0,0,1,2,2,621,4,271
제주특별자치도,제주시,애월읍,애월읍제6투,2733,1799,782,369,381,82,170,3,0,0,0,1,1,0,2,1791,8,934
제주특별자치도,제주시,애월읍,애월읍제7투,907,641,265,154,138,24,43,0,0,0,0,4,1,1,2,632,9,266
제주특별자치도,제주시,애월읍,애월읍제8투,1077,735,334,148,151,48,39,0,0,0,0,0,0,5,4,729,6,342
제주특별자치도,제주시,애월읍,애월읍제9투,902,617,270,143,127,28,41,0,0,0,1,0,1,1,0,612,5,285
제주특별자치도,제주시,애월읍,애월읍제10투,838,607,232,129,153,33,48,0,1,0,0,0,0,0,1,597,10,231
제주특별자치도,제주시,애월읍,애월읍제11투,3045,2110,992,371,453,122,161,0,0,0,0,0,2,1,1,2103,7,935
제주특별자치도,제주시,애월읍,애월읍제12투,986,687,311,145,135,26,57,0,0,0,0,3,1,0,3,681,6,299
제주특별자치도,제주시,애월읍,애월읍제13투,1144,701,300,155,141,38,57,0,2,0,1,0,1,0,1,696,5,443
제주특별자치도,제주시,구좌읍,관내사전투표,1334,1334,668,216,231,75,127,1,0,1,0,2,0,2,4,1327,7,0
제주특별자치도,제주시,구좌읍,합계,11556,7691,2978,1987,1664,360,547,11,3,9,1,11,15,13,18,7617,74,3865
제주특별자치도,제주시,구좌읍,구좌읍제1투,2012,1360,498,372,301,71,90,2,0,3,0,0,3,5,3,1348,12,652
제주특별자치도,제주시,구좌읍,구좌읍제2투,1224,716,236,227,152,38,42,2,1,1,1,3,4,0,3,710,6,508
제주특별자치도,제주시,구좌읍,구좌읍제3투,964,559,247,139,108,25,32,0,0,0,0,1,1,0,1,554,5,405
제주특별자치도,제주시,구좌읍,구좌읍제4투,839,554,230,122,118,13,48,0,1,0,0,3,0,2,5,542,12,285
제주특별자치도,제주시,구좌읍,구좌읍제5투,1680,908,324,248,216,35,67,2,0,1,0,1,3,2,0,899,9,772
제주특별자치도,제주시,구좌읍,구좌읍제6투,1240,742,253,217,173,37,49,1,0,3,0,0,1,2,0,736,6,498
제주특별자치도,제주시,구좌읍,구좌읍제7투,858,598,219,125,179,26,35,1,0,0,0,1,2,0,0,588,10,260
제주특별자치도,제주시,구좌읍,구좌읍제8투,538,379,115,127,85,23,23,1,0,0,0,0,0,0,1,375,4,159
제주특별자치도,제주시,구좌읍,구좌읍제9투,867,541,188,194,101,17,34,1,1,0,0,0,1,0,1,538,3,326
제주특별자치도,제주시,조천읍,합계,16798,11725,4804,2669,2533,634,920,14,6,17,4,9,9,13,20,11652,73,5073
제주특별자치도,제주시,조천읍,관내사전투표,2335,2335,1165,395,393,122,216,8,1,1,0,4,2,1,4,2312,23,0
제주특별자치도,제주시,조천읍,조천읍제1투,2818,1915,733,424,442,119,174,0,1,3,2,2,0,3,2,1905,10,903
제주특별자치도,제주시,조천읍,조천읍제2투,1704,973,342,275,229,53,62,0,0,1,0,1,1,3,2,969,4,731
제주특별자치도,제주시,조천읍,조천읍제3투,1701,1114,431,260,281,54,76,1,0,0,0,0,2,1,3,1109,5,587
제주특별자치도,제주시,조천읍,조천읍제4투,889,621,226,168,146,31,43,1,1,1,0,0,1,0,1,619,2,268
제주특별자치도,제주시,조천읍,조천읍제5투,922,619,281,152,107,17,44,0,0,8,0,0,0,2,2,613,6,303
제주특별자치도,제주시,조천읍,조천읍제6투,1919,1237,457,293,301,81,86,2,1,2,1,0,1,2,3,1230,7,682
제주특별자치도,제주시,조천읍,조천읍제7투,1875,1205,477,280,276,65,91,2,0,0,1,2,1,0,1,1196,9,670
제주특별자치도,제주시,조천읍,조천읍제8투,2635,1706,692,422,358,92,128,0,2,1,0,0,1,1,2,1699,7,929
제주특별자치도,제주시,한경면,합계,6647,4540,1916,1124,910,186,301,6,1,3,0,5,6,15,24,4497,43,2107
제주특별자치도,제주시,한경면,관내사전투표,839,839,383,178,158,40,59,1,1,1,0,1,2,3,3,830,9,0
제주특별자치도,제주시,한경면,한경면제1투,557,377,148,92,78,19,32,0,0,0,0,1,0,1,1,372,5,180
제주특별자치도,제주시,한경면,한경면제2투,814,546,219,153,102,29,23,1,0,0,0,1,0,3,6,537,9,268
제주특별자치도,제주시,한경면,한경면제3투,1588,934,407,230,176,29,71,3,0,2,0,0,2,2,6,928,6,654
제주특별자치도,제주시,한경면,한경면제4투,1356,845,322,238,179,36,54,1,0,0,0,2,1,4,1,838,7,511
제주특별자치도,제주시,한경면,한경면제5투,1493,999,437,233,217,33,62,0,0,0,0,0,1,2,7,992,7,494
제주특별자치도,제주시,추자면,합계,1542,930,373,209,270,27,28,1,0,1,1,2,2,2,5,921,9,612
제주특별자치도,제주시,추자면,관내사전투표,321,321,140,62,82,17,15,0,0,0,1,1,0,1,0,319,2,0
제주특별자치도,제주시,추자면,추자면제1투,739,332,102,85,122,3,10,0,0,1,0,0,2,1,3,329,3,407
제주특별자치도,제주시,추자면,추자면제2투,482,277,131,62,66,7,3,1,0,0,0,1,0,0,2,273,4,205
제주특별자치도,제주시,우도면,합계,1457,950,451,202,178,49,56,1,0,1,0,1,0,2,2,943,7,507
제주특별자치도,제주시,우도면,관내사전투표,358,358,185,65,67,19,18,0,0,1,0,0,0,0,0,355,3,0
제주특별자치도,제주시,우도면,우도면투표소,1099,592,266,137,111,30,38,1,0,0,0,1,0,2,2,588,4,507
제주특별자치도,제주시,일도1동,합계,3028,1954,807,407,456,91,174,3,0,4,0,0,0,2,4,1948,6,1074
제주특별자치도,제주시,일도1동,관내사전투표,828,828,416,133,137,40,95,2,0,1,0,0,0,0,3,827,1,0
제주특별자치도,제주시,일도1동,일도1동투표소,2200,1126,391,274,319,51,79,1,0,3,0,0,0,2,1,1121,5,1074
제주특별자치도,제주시,일도2동,합계,25306,18387,8085,3605,3891,1109,1521,24,3,16,12,23,3,8,12,18312,75,6919
제주특별자치도,제주시,일도2동,관내사전투표,3576,3576,1840,557,613,224,302,5,0,5,2,8,0,5,1,3562,14,0
제주특별자치도,제주시,일도2동,일도2동제1투,2173,1379,567,305,320,74,100,1,1,0,1,4,1,0,1,1375,4,794
제주특별자치도,제주시,일도2동,일도2동제2투,2480,1480,576,358,336,74,106,2,0,3,2,3,1,1,2,1464,16,1000
제주특별자치도,제주시,일도2동,일도2동제3투,2222,1550,616,365,338,87,125,3,0,1,1,5,0,0,0,1541,9,672
제주특별자치도,제주시,일도2동,일도2동제4투,2453,1526,597,356,348,88,127,1,1,1,1,0,0,1,1,1522,4,927
제주특별자치도,제주시,일도2동,일도2동제5투,1792,1232,519,230,287,78,105,2,0,1,2,0,1,0,0,1225,7,560
제주특별자치도,제주시,일도2동,일도2동제6투,2513,1662,695,349,388,104,113,3,0,0,3,0,0,1,0,1656,6,851
제주특별자치도,제주시,일도2동,일도2동제7투,2984,2185,1015,364,428,145,217,1,1,2,0,0,0,0,3,2176,9,799
제주특별자치도,제주시,일도2동,일도2동제8투,2867,2071,910,385,464,114,187,2,0,2,0,2,0,0,2,2068,3,796
제주특별자치도,제주시,일도2동,일도2동제9투,2246,1726,750,336,369,121,139,4,0,1,0,1,0,0,2,1723,3,520
제주특별자치도,제주시,이도1동,합계,6753,4820,2070,967,1043,324,380,6,2,2,1,5,2,0,0,4802,18,1933
제주특별자치도,제주시,이도1동,관내사전투표,1674,1674,834,285,305,105,131,4,2,2,0,2,1,0,0,1671,3,0
제주특별자치도,제주시,이도1동,이도1동제1투,1582,896,348,210,197,56,75,0,0,0,1,1,1,0,0,889,7,686
제주특별자치도,제주시,이도1동,이도1동제2투,1844,1167,485,238,258,84,96,0,0,0,0,1,0,0,0,1162,5,677
제주특별자치도,제주시,이도1동,이도1동제3투,1653,1083,403,234,283,79,78,2,0,0,0,1,0,0,0,1080,3,570
제주특별자치도,제주시,이도2동,합계,36405,26863,12865,4370,5053,1746,2592,21,9,13,7,20,12,6,20,26734,129,9542
제주특별자치도,제주시,이도2동,관내사전투표,6369,6369,3363,802,939,421,795,3,1,3,2,3,1,1,5,6339,30,0
제주특별자치도,제주시,이도2동,이도2동제1투,2849,1859,791,358,397,118,166,3,0,3,0,1,4,1,3,1845,14,990
제주특별자치도,제주시,이도2동,이도2동제2투,4301,3119,1617,397,628,189,266,2,1,0,0,5,1,1,1,3108,11,1182
제주특별자치도,제주시,이도2동,이도2동제3투,3243,1909,800,397,397,113,178,2,1,2,3,3,1,1,3,1901,8,1334
제주특별자치도,제주시,이도2동,이도2동제4투,3591,2535,1196,411,493,186,231,2,1,0,0,0,1,1,2,2524,11,1056
제주특별자치도,제주시,이도2동,이도2동제5투,2154,1531,843,164,286,103,128,0,0,0,1,0,1,0,1,1527,4,623
제주특별자치도,제주시,이도2동,이도2동제6투,2687,1669,667,428,353,80,130,0,2,0,0,1,0,0,1,1662,7,1018
제주특별자치도,제주시,이도2동,이도2동제7투,3323,2197,968,416,434,145,210,4,2,2,0,1,2,0,3,2187,10,1126
제주특별자치도,제주시,이도2동,이도2동제8투,2075,1567,644,321,361,102,123,5,0,1,0,1,1,1,1,1561,6,508
제주특별자치도,제주시,이도2동,이도2동제9투,2136,1471,705,251,278,101,123,0,0,1,0,4,0,0,0,1463,8,665
제주특별자치도,제주시,이도2동,이도2동제10투,3677,2637,1271,425,487,188,242,0,1,1,1,1,0,0,0,2617,20,1040
제주특별자치도,제주시,삼도1동,합계,11076,7760,3246,1744,1626,426,654,11,2,5,2,8,1,1,7,7733,27,3316
제주특별자치도,제주시,삼도1동,관내사전투표,1890,1890,937,339,305,86,201,6,0,1,1,2,0,0,2,1880,10,0
제주특별자치도,제주시,삼도1동,삼도1동제1투,2462,1625,667,382,338,100,130,0,1,1,0,2,0,0,1,1622,3,837
제주특별자치도,제주시,삼도1동,삼도1동제2투,1803,1139,425,256,287,69,88,5,1,2,0,1,1,0,1,1136,3,664
제주특별자치도,제주시,삼도1동,삼도1동제3투,2605,1575,651,385,335,80,116,0,0,0,1,1,0,0,2,1571,4,1030
제주특별자치도,제주시,삼도1동,삼도1동제4투,2316,1531,566,382,361,91,119,0,0,1,0,2,0,1,1,1524,7,785
제주특별자치도,제주시,삼도2동,합계,6914,4598,1877,1008,1065,274,338,5,3,5,1,0,3,1,4,4584,14,2316
제주특별자치도,제주시,삼도2동,관내사전투표,1018,1018,523,163,169,65,92,0,0,2,0,0,0,1,1,1016,2,0
제주특별자치도,제주시,삼도2동,삼도2동제1투,2078,1274,515,245,335,72,96,2,1,0,0,0,3,0,2,1271,3,804
제주특별자치도,제주시,삼도2동,삼도2동제2투,1763,1012,352,278,253,55,69,1,0,1,0,0,0,0,0,1009,3,751
제주특별자치도,제주시,삼도2동,삼도2동제3투,2055,1294,487,322,308,82,81,2,2,2,1,0,0,0,1,1288,6,761
제주특별자치도,제주시,용담1동,합계,6095,4033,1702,899,872,230,295,4,1,2,2,5,2,2,1,4017,16,2062
제주특별자치도,제주시,용담1동,관내사전투표,921,921,445,166,165,55,83,3,0,0,0,2,0,0,0,919,2,0
제주특별자치도,제주시,용담1동,용담1동제1투,2010,1153,477,276,248,62,80,1,0,1,1,0,0,1,0,1147,6,857
제주특별자치도,제주시,용담1동,용담1동제2투,1644,958,402,212,229,52,53,0,0,1,1,2,2,0,0,954,4,686
제주특별자치도,제주시,용담1동,용담1동제3투,1520,1001,378,245,230,61,79,0,1,0,0,1,0,1,1,997,4,519
제주특별자치도,제주시,용담2동,관내사전투표,1756,1756,883,307,300,107,148,1,0,0,0,1,1,1,1,1750,6,0
제주특별자치도,제주시,용담2동,합계,12115,8272,3506,1728,1773,489,704,8,2,2,2,5,5,8,12,8244,28,3843
제주특별자치도,제주시,용담2동,용담2동제1투,2129,1315,529,299,287,80,112,0,0,0,0,2,0,2,3,1314,1,814
제주특별자치도,제주시,용담2동,용담2동제2투,2345,1369,549,301,319,81,108,3,0,0,1,1,0,0,2,1365,4,976
제주특별자치도,제주시,용담2동,용담2동제3투,1826,1197,496,259,257,63,102,2,2,1,0,1,2,4,2,1191,6,629
제주특별자치도,제주시,용담2동,용담2동제4투,1955,1205,478,260,259,74,122,0,0,1,1,0,1,1,2,1199,6,750
제주특별자치도,제주시,용담2동,용담2동제5투,2104,1430,571,302,351,84,112,2,0,0,0,0,1,0,2,1425,5,674
제주특별자치도,제주시,건입동,관내사전투표,1570,1570,769,285,307,81,114,1,2,0,0,2,2,0,0,1563,7,0
제주특별자치도,제주시,건입동,합계,7974,5479,2329,1177,1213,288,413,3,5,6,3,9,4,2,6,5458,21,2495
제주특별자치도,제주시,건입동,건입동제1투,714,315,112,96,73,14,16,0,0,0,0,0,0,0,1,312,3,399
제주특별자치도,제주시,건입동,건입동제2투,1818,1091,437,244,256,69,73,0,0,3,1,2,0,1,2,1088,3,727
제주특별자치도,제주시,건입동,건입동제3투,2094,1386,554,306,318,71,120,1,2,1,2,1,1,1,3,1381,5,708
제주특별자치도,제주시,건입동,건입동제4투,1778,1117,457,246,259,53,90,1,1,2,0,4,1,0,0,1114,3,661
제주특별자치도,제주시,화북동,합계,17614,12719,5954,1976,2751,773,1143,16,6,12,4,12,5,7,15,12674,45,4895
제주특별자치도,제주시,화북동,관내사전투표,2580,2580,1383,336,429,162,256,3,0,2,1,1,0,2,0,2575,5,0
제주특별자치도,제주시,화북동,화북동제1투,1884,1250,456,239,367,74,99,3,0,1,1,1,1,1,2,1245,5,634
제주특별자치도,제주시,화북동,화북동제2투,2049,1309,584,246,285,63,117,1,0,2,0,2,0,0,5,1305,4,740
제주특별자치도,제주시,화북동,화북동제3투,1443,925,347,192,238,58,72,2,2,2,0,1,2,2,1,919,6,518
제주특별자치도,제주시,화북동,화북동제4투,2183,1349,581,247,303,89,116,1,2,2,0,1,1,1,2,1346,3,834
제주특별자치도,제주시,화북동,화북동제5투,1938,1464,714,207,303,92,132,1,0,2,1,2,1,0,1,1456,8,474
제주특별자치도,제주시,화북동,화북동제6투,2202,1523,742,201,325,95,147,5,1,0,0,2,0,0,0,1518,5,679
제주특별자치도,제주시,화북동,화북동제7투,3335,2319,1147,308,501,140,204,0,1,1,1,2,0,1,4,2310,9,1016
제주특별자치도,제주시,삼양동,합계,15126,11208,5633,1606,2272,634,975,19,4,3,1,8,0,6,14,11175,33,3918
제주특별자치도,제주시,삼양동,관내사전투표,2987,2987,1729,342,488,157,253,0,1,1,0,5,0,2,1,2979,8,0
제주특별자치도,제주시,삼양동,삼양동제1투,1838,1184,469,258,277,63,102,3,2,1,0,1,0,1,3,1180,4,654
제주특별자치도,제주시,삼양동,삼양동제2투,2735,1722,716,313,407,123,150,3,0,1,1,0,0,2,3,1719,3,1013
제주특별자치도,제주시,삼양동,삼양동제3투,1773,1119,511,204,249,52,96,2,0,0,0,0,0,0,0,1114,5,654
제주특별자치도,제주시,삼양동,삼양동제4투,551,380,153,84,90,18,25,2,0,0,0,1,0,0,3,376,4,171
제주특별자치도,제주시,삼양동,삼양동제5투,2115,1602,896,134,314,93,153,8,0,0,0,0,0,0,0,1598,4,513
제주특별자치도,제주시,삼양동,삼양동제6투,3127,2214,1159,271,447,128,196,1,1,0,0,1,0,1,4,2209,5,913
제주특별자치도,제주시,봉개동,합계,3272,2501,1120,486,548,115,196,1,1,2,1,1,1,5,6,2483,18,771
제주특별자치도,제주시,봉개동,관내사전투표,966,966,474,152,197,51,79,1,0,2,0,0,0,1,1,958,8,0
제주특별자치도,제주시,봉개동,봉개동제1투,1613,1037,439,217,233,49,84,0,1,0,1,1,0,2,4,1031,6,576
제주특별자치도,제주시,봉개동,봉개동제2투,385,268,127,56,55,9,17,0,0,0,0,0,1,0,0,265,3,117
제주특별자치도,제주시,봉개동,봉개동제3투,308,230,80,61,63,6,16,0,0,0,0,0,0,2,1,229,1,78
제주특별자치도,제주시,아라동,관내사전투표,5566,5566,3160,539,848,377,570,9,3,8,0,9,6,3,5,5537,29,0
제주특별자치도,제주시,아라동,합계,20401,15388,7884,1927,2964,1038,1423,15,6,14,2,22,10,5,16,15326,62,5013
제주특별자치도,제주시,아라동,아라동제1투,4317,2744,1292,380,632,181,230,2,1,3,1,4,1,0,4,2731,13,1573
제주특별자치도,제주시,아라동,아라동제2투,2865,1925,962,264,371,133,183,0,0,0,0,6,1,0,0,1920,5,940
제주특별자치도,제주시,아라동,아라동제3투,2140,1379,644,207,331,79,104,3,1,1,0,0,0,1,4,1375,4,761
제주특별자치도,제주시,아라동,아라동제4투,1388,943,434,134,215,63,86,1,0,1,1,1,1,0,1,938,5,445
제주특별자치도,제주시,아라동,아라동제5투,4125,2831,1392,403,567,205,250,0,1,1,0,2,1,1,2,2825,6,1294
제주특별자치도,제주시,오라동,합계,9757,7513,3804,1093,1388,452,722,7,4,2,0,11,0,4,5,7492,21,2244
제주특별자치도,제주시,오라동,관내사전투표,2642,2642,1486,305,391,164,272,4,1,1,0,8,0,0,3,2635,7,0
제주특별자치도,제주시,오라동,오라동제1투,2943,1989,868,434,425,96,157,1,3,0,0,0,0,1,1,1986,3,954
제주특별자치도,제주시,오라동,오라동제2투,4172,2882,1450,354,572,192,293,2,0,1,0,3,0,3,1,2871,11,1290
제주특별자치도,제주시,연동,관내사전투표,5728,5728,3025,815,910,395,552,2,1,1,1,2,2,5,1,5712,16,0
제주특별자치도,제주시,연동,합계,31790,21649,9986,3896,4294,1461,1880,18,6,9,4,5,5,6,12,21582,67,10141
제주특별자치도,제주시,연동,연동제1투,2913,1640,691,384,331,113,113,4,0,0,0,0,0,0,1,1637,3,1273
제주특별자치도,제주시,연동,연동제2투,3551,2218,961,438,451,170,185,2,0,4,0,0,0,0,1,2212,6,1333
제주특별자치도,제주시,연동,연동제3투,3241,2011,855,434,415,127,168,0,0,1,1,0,1,1,1,2004,7,1230
제주특별자치도,제주시,연동,연동제4투,3383,1697,697,330,402,105,147,1,3,0,0,1,0,0,2,1688,9,1686
제주특별자치도,제주시,연동,연동제5투,3535,2381,1103,396,506,133,223,3,1,0,1,0,0,0,3,2369,12,1154
제주특별자치도,제주시,연동,연동제6투,2893,1915,893,313,410,134,158,1,1,3,0,0,0,0,1,1914,1,978
제주특별자치도,제주시,연동,연동제7투,2565,1475,598,344,309,97,117,3,0,0,1,1,0,0,0,1470,5,1090
제주특별자치도,제주시,연동,연동제8투,3981,2584,1163,442,560,187,217,2,0,0,0,1,2,0,2,2576,8,1397
제주특별자치도,제주시,노형동,합계,37227,27400,13587,4093,5360,1781,2360,16,8,9,8,28,8,9,23,27290,110,9827
제주특별자치도,제주시,노형동,관내사전투표,7369,7369,4166,720,1191,470,754,5,2,5,1,15,2,3,5,7339,30,0
제주특별자치도,제주시,노형동,노형동제1투,2093,1452,658,243,304,97,134,1,2,0,1,2,1,1,1,1445,7,641
제주특별자치도,제주시,노형동,노형동제2투,2643,1803,843,329,360,103,154,1,0,1,0,0,0,0,5,1796,7,840
제주특별자치도,제주시,노형동,노형동제3투,3467,2041,885,412,435,128,166,1,0,0,0,0,2,1,0,2030,11,1426
제주특별자치도,제주시,노형동,노형동제4투,3596,2727,1342,441,559,178,195,0,0,0,1,2,0,0,2,2720,7,869
제주특별자치도,제주시,노형동,노형동제5투,3174,2036,937,349,445,131,160,4,1,0,1,0,0,0,1,2029,7,1138
제주특별자치도,제주시,노형동,노형동제6투,4513,2829,1345,446,573,183,259,2,1,0,2,3,0,2,3,2819,10,1684
제주특별자치도,제주시,노형동,노형동제7투,968,672,322,127,141,32,44,0,1,0,1,1,0,0,0,669,3,296
제주특별자치도,제주시,노형동,노형동제8투,2986,1998,924,348,397,147,167,1,0,0,0,2,0,1,2,1989,9,988
제주특별자치도,제주시,노형동,노형동제9투,2830,1842,890,292,395,111,133,1,0,3,1,2,2,0,2,1832,10,988
제주특별자치도,제주시,노형동,노형동제10투,3588,2631,1275,386,560,201,194,0,1,0,0,1,1,1,2,2622,9,957
제주특별자치도,제주시,외도동,관내사전투표,3193,3193,1792,399,517,191,267,2,1,2,1,1,4,1,2,3180,13,0
제주특별자치도,제주시,외도동,합계,14185,10641,5308,1483,2165,651,932,13,1,7,2,14,10,5,10,10601,40,3544
제주특별자치도,제주시,외도동,외도동제1투,3304,2128,903,383,489,134,192,5,0,2,1,3,2,3,3,2120,8,1176
제주특별자치도,제주시,외도동,외도동제2투,1337,876,438,100,190,55,78,2,0,2,0,2,0,1,2,870,6,461
제주특별자치도,제주시,외도동,외도동제3투,3731,2485,1171,370,556,154,215,2,0,0,0,1,3,0,1,2473,12,1246
제주특별자치도,제주시,외도동,외도동제4투,2620,1959,1004,231,413,117,180,2,0,1,0,7,1,0,2,1958,1,661
제주특별자치도,제주시,이호동,관내사전투표,571,571,287,92,112,31,45,0,1,0,0,1,0,0,1,570,1,0
제주특별자치도,제주시,이호동,합계,3118,2255,989,467,457,122,191,1,1,4,0,1,2,2,4,2241,14,863
제주특별자치도,제주시,이호동,이호동제1투,927,593,202,154,141,33,53,0,0,1,0,0,2,0,0,586,7,334
제주특별자치도,제주시,이호동,이호동제2투,1620,1091,500,221,204,58,93,1,0,3,0,0,0,2,3,1085,6,529
제주특별자치도,제주시,도두동,관내사전투표,533,533,248,92,122,30,36,0,0,1,0,1,0,1,2,533,0,0
제주특별자치도,제주시,도두동,합계,2411,1809,779,345,433,99,129,2,1,1,1,3,1,2,5,1801,8,602
제주특별자치도,제주시,도두동,도두동제1투,1257,821,323,161,205,53,65,2,1,0,1,1,1,1,2,816,5,436
제주특별자치도,제주시,도두동,도두동제2투,621,455,208,92,106,16,28,0,0,0,0,1,0,0,1,452,3,166
제주특별자치도,제주시,잘못 투입·구분된 투표지,,0,0,0,0,0,0,0,0,0,0,0,0,0,0,0,0,0,0
제주특별자치도,서귀포시,합계,,142708,101296,43776,20036,21890,5899,8124,115,173,119,40,78,83,111,188,100632,664,41412
제주특별자치도,서귀포시,거소·선상투표,,588,562,195,88,145,57,17,6,2,0,1,1,8,1,2,523,39,26
제주특별자치도,서귀포시,관외사전투표,,12687,12687,6111,1658,2276,1048,1437,9,5,7,5,10,3,3,30,12602,85,0
제주특별자치도,서귀포시,재외투표,,1610,834,439,52,210,27,98,0,0,0,0,0,0,1,1,828,6,776
제주특별자치도,서귀포시,대정읍,합계,14212,9418,3895,2098,2103,472,713,16,5,6,0,10,9,8,17,9352,66,4794
제주특별자치도,서귀포시,대정읍,관내사전투표,1897,1897,891,325,367,115,177,4,2,0,0,3,2,2,2,1890,7,0
제주특별자치도,서귀포시,대정읍,대정읍제1투,2365,1368,514,342,326,63,102,2,1,2,0,2,1,1,2,1358,10,997
제주특별자치도,서귀포시,대정읍,대정읍제2투,1827,1044,420,264,237,42,68,1,0,1,0,1,0,0,1,1035,9,783
제주특별자치도,서귀포시,대정읍,대정읍제3투,1135,741,348,141,150,39,52,0,0,0,0,0,1,1,3,735,6,394
제주특별자치도,서귀포시,대정읍,대정읍제4투,491,334,123,91,71,22,23,0,1,0,0,0,0,0,0,331,3,157
제주특별자치도,서귀포시,대정읍,대정읍제5투,1753,1107,429,231,299,59,73,6,0,0,0,1,1,0,3,1102,5,646
제주특별자치도,서귀포시,대정읍,대정읍제6투,183,114,60,28,13,0,8,0,0,0,0,0,0,0,1,110,4,69
제주특별자치도,서귀포시,대정읍,대정읍제7투,611,405,153,109,95,16,24,1,0,0,0,1,0,0,3,402,3,206
제주특별자치도,서귀포시,대정읍,대정읍제8투,2203,1186,464,310,262,50,86,1,0,0,0,2,1,1,2,1179,7,1017
제주특별자치도,서귀포시,대정읍,대정읍제9투,378,244,87,82,49,6,15,0,1,0,0,0,1,0,0,241,3,134
제주특별자치도,서귀포시,대정읍,대정읍제10투,474,328,136,69,68,23,26,0,0,2,0,0,0,0,0,324,4,146
제주특별자치도,서귀포시,대정읍,대정읍제11투,340,256,111,38,70,10,19,1,0,0,0,0,1,3,0,253,3,84
제주특별자치도,서귀포시,대정읍,대정읍제12투,555,394,159,68,96,27,40,0,0,1,0,0,1,0,0,392,2,161
제주특별자치도,서귀포시,남원읍,합계,14023,9585,4007,2088,2084,489,743,5,15,14,5,8,13,21,27,9519,66,4438
제주특별자치도,서귀포시,남원읍,관내사전투표,1392,1392,672,209,295,87,120,1,0,0,0,1,3,2,0,1390,2,0
제주특별자치도,서귀포시,남원읍,남원읍제1투,602,405,150,106,92,14,30,0,1,1,2,0,1,3,4,404,1,197
제주특별자치도,서귀포시,남원읍,남원읍제2투,1082,730,287,163,174,42,44,0,0,1,0,2,1,1,3,718,12,352
제주특별자치도,서귀포시,남원읍,남원읍제3투,783,545,208,121,139,35,29,0,1,2,0,0,2,1,2,540,5,238
제주특별자치도,서귀포시,남원읍,남원읍제4투,2681,1621,678,337,362,82,140,1,0,4,0,0,0,1,3,1608,13,1060
제주특별자치도,서귀포시,남원읍,남원읍제5투,1232,808,298,215,178,39,62,0,3,1,0,1,0,4,2,803,5,424
제주특별자치도,서귀포시,남원읍,남원읍제6투,1357,839,361,161,200,35,66,0,1,0,1,1,2,2,3,833,6,518
제주특별자치도,서귀포시,남원읍,남원읍제7투,744,509,214,146,87,18,34,0,1,0,0,1,1,2,1,505,4,235
제주특별자치도,서귀포시,남원읍,남원읍제8투,1861,1162,475,273,227,75,100,3,1,0,0,0,0,0,3,1157,5,699
제주특별자치도,서귀포시,남원읍,남원읍제9투,369,249,115,66,33,6,21,0,0,1,0,0,0,1,3,246,3,120
제주특별자치도,서귀포시,남원읍,남원읍제10투,508,351,142,90,78,11,21,0,0,0,1,2,1,1,2,349,2,157
제주특별자치도,서귀포시,남원읍,남원읍제11투,278,198,73,50,40,14,18,0,0,1,0,0,0,1,0,197,1,80
제주특별자치도,서귀포시,남원읍,남원읍제12투,408,275,121,60,52,10,22,0,2,1,0,0,1,1,1,271,4,133
제주특별자치도,서귀포시,남원읍,남원읍제13투,401,271,113,50,69,11,22,0,3,0,0,0,0,1,0,269,2,130
제주특별자치도,서귀포시,남원읍,남원읍제14투,325,230,100,41,58,10,14,0,2,2,1,0,1,0,0,229,1,95
제주특별자치도,서귀포시,성산읍,합계,11296,7403,2691,1898,1749,352,570,6,10,10,2,4,10,11,22,7335,68,3893
제주특별자치도,서귀포시,성산읍,관내사전투표,1338,1338,596,282,252,74,119,1,3,0,0,1,0,0,3,1331,7,0
제주특별자치도,서귀포시,성산읍,성산읍제1투,1176,719,255,202,166,37,49,3,0,1,0,0,1,1,2,717,2,457
제주특별자치도,서귀포시,성산읍,성산읍제2투,784,479,157,148,118,19,26,0,0,3,0,0,1,0,0,472,7,305
제주특별자치도,서귀포시,성산읍,성산읍제3투,2217,1138,423,265,278,75,81,0,0,1,0,2,0,1,2,1128,10,1079
제주특별자치도,서귀포시,성산읍,성산읍제4투,932,591,181,170,152,15,64,1,0,0,0,0,0,0,2,585,6,341
제주특별자치도,서귀포시,성산읍,성산읍제5투,998,610,189,163,154,24,63,0,1,2,0,0,2,0,5,603,7,388
제주특별자치도,서귀포시,성산읍,성산읍제6투,781,501,180,124,112,19,56,0,0,0,0,0,0,0,2,493,8,280
제주특별자치도,서귀포시,성산읍,성산읍제7투,456,313,119,82,73,14,14,1,1,1,1,0,1,2,0,309,4,143
제주특별자치도,서귀포시,성산읍,성산읍제8투,376,253,71,78,67,16,16,0,1,0,0,0,2,0,2,253,0,123
제주특별자치도,서귀포시,성산읍,성산읍제9투,627,400,120,116,113,15,18,0,2,1,1,0,1,2,3,392,8,227
제주특별자치도,서귀포시,성산읍,성산읍제10투,444,298,124,69,76,9,17,0,0,0,0,0,0,1,0,296,2,146
제주특별자치도,서귀포시,성산읍,성산읍제11투,734,448,143,133,113,18,29,0,1,1,0,0,1,4,0,443,5,286
제주특별자치도,서귀포시,성산읍,성산읍제12투,433,315,133,66,75,17,18,0,1,0,0,1,1,0,1,313,2,118
제주특별자치도,서귀포시,안덕면,관내사전투표,847,847,414,144,157,43,79,1,0,0,4,0,0,1,1,844,3,0
제주특별자치도,서귀포시,안덕면,합계,7728,5429,2263,1161,1152,276,472,7,6,5,15,5,2,13,10,5387,42,2299
제주특별자치도,서귀포시,안덕면,안덕면제1투,1631,1058,412,261,229,49,87,1,0,1,0,2,0,4,2,1048,10,573
제주특별자치도,서귀포시,안덕면,안덕면제2투,1547,989,389,240,234,38,74,2,0,0,0,0,1,2,1,981,8,558
제주특별자치도,서귀포시,안덕면,안덕면제3투,721,502,196,118,115,24,39,0,3,1,0,0,0,3,0,499,3,219
제주특별자치도,서귀포시,안덕면,안덕면제4투,871,555,211,129,112,44,41,0,1,1,9,2,1,1,0,552,3,316
제주특별자치도,서귀포시,안덕면,안덕면제5투,651,433,210,60,90,31,33,0,0,1,0,0,0,1,4,430,3,218
제주특별자치도,서귀포시,안덕면,안덕면제6투,418,286,119,69,54,13,29,0,0,0,1,1,0,0,0,286,0,132
제주특별자치도,서귀포시,안덕면,안덕면제7투,587,408,173,72,93,20,36,2,2,0,1,0,0,1,1,401,7,179
제주특별자치도,서귀포시,안덕면,안덕면제8투,455,351,139,68,68,14,54,1,0,1,0,0,0,0,1,346,5,104
제주특별자치도,서귀포시,표선면,합계,8989,6156,2392,1507,1449,317,384,14,8,6,0,2,7,17,14,6117,39,2833
제주특별자치도,서귀포시,표선면,관내사전투표,1576,1576,664,376,325,78,112,6,4,1,0,1,0,0,1,1568,8,0
제주특별자치도,서귀포시,표선면,표선면제1투,3010,1593,589,392,400,92,96,4,1,1,0,0,1,5,2,1583,10,1417
제주특별자치도,서귀포시,표선면,표선면제2투,695,459,159,133,99,26,30,0,0,2,0,0,1,2,1,453,6,236
제주특별자치도,서귀포시,표선면,표선면제3투,945,612,188,212,142,33,28,2,2,0,0,0,0,2,0,609,3,333
제주특별자치도,서귀포시,표선면,표선면제4투,553,379,143,102,92,16,18,2,0,1,0,0,1,2,0,377,2,174
제주특별자치도,서귀포시,표선면,표선면제5투,826,573,266,104,127,24,31,0,1,0,0,0,3,5,6,567,6,253
제주특별자치도,서귀포시,표선면,표선면제6투,306,233,104,37,61,7,21,0,0,0,0,0,1,1,1,233,0,73
제주특별자치도,서귀포시,표선면,표선면제7투,474,313,116,65,84,16,27,0,0,1,0,0,0,0,2,311,2,161
제주특별자치도,서귀포시,표선면,표선면제8투,420,279,89,58,92,21,16,0,0,0,0,0,0,0,1,277,2,141
제주특별자치도,서귀포시,표선면,표선면제9투,184,139,74,28,27,4,5,0,0,0,0,1,0,0,0,139,0,45
제주특별자치도,서귀포시,송산동,합계,3685,2357,954,561,506,129,185,3,0,1,0,1,1,4,4,2349,8,1328
제주특별자치도,서귀포시,송산동,관내사전투표,537,537,250,92,108,30,55,1,0,0,0,0,0,1,0,537,0,0
제주특별자치도,서귀포시,송산동,송산동제1투,1549,838,316,230,212,31,41,1,0,0,0,1,0,2,1,835,3,711
제주특별자치도,서귀포시,송산동,송산동제2투,1599,982,388,239,186,68,89,1,0,1,0,0,1,1,3,977,5,617
제주특별자치도,서귀포시,정방동,합계,2369,1477,607,357,302,75,120,4,2,4,1,0,0,0,1,1473,4,892
제주특별자치도,서귀포시,정방동,관내사전투표,575,575,276,99,109,26,61,0,1,2,1,0,0,0,0,575,0,0
제주특별자치도,서귀포시,정방동,정방동투표소,1794,902,331,258,193,49,59,4,1,2,0,0,0,0,1,898,4,892
제주특별자치도,서귀포시,중앙동,합계,3448,2095,803,513,526,99,132,1,1,2,0,0,0,1,3,2081,14,1353
제주특별자치도,서귀포시,중앙동,관내사전투표,623,623,275,125,138,31,49,0,1,0,0,0,0,0,1,620,3,0
제주특별자치도,서귀포시,중앙동,중앙동투표소,2825,1472,528,388,388,68,83,1,0,2,0,0,0,1,2,1461,11,1353
제주특별자치도,서귀포시,천지동,합계,3249,2160,823,536,539,102,133,3,2,7,0,3,1,0,1,2150,10,1089
제주특별자치도,서귀포시,천지동,관내사전투표,686,686,320,130,141,31,57,0,0,4,0,0,1,0,0,684,2,0
제주특별자치도,서귀포시,천지동,천지동제1투,2372,1344,452,377,362,64,70,3,2,3,0,3,0,0,1,1337,7,1028
제주특별자치도,서귀포시,천지동,천지동제2투,191,130,51,29,36,7,6,0,0,0,0,0,0,0,0,129,1,61
제주특별자치도,서귀포시,효돈동,합계,4226,3038,1275,687,624,148,195,3,76,5,1,2,2,4,4,3026,12,1188
제주특별자치도,서귀포시,효돈동,관내사전투표,849,849,428,127,170,40,62,1,12,0,0,1,1,0,2,844,5,0
제주특별자치도,서귀포시,효돈동,효돈동제1투,1390,904,370,217,188,51,62,0,8,3,0,0,1,2,0,902,2,486
제주특별자치도,서귀포시,효돈동,효돈동제2투,1987,1285,477,343,266,57,71,2,56,2,1,1,0,2,2,1280,5,702
제주특별자치도,서귀포시,영천동,합계,3957,2672,1108,595,598,133,199,2,1,1,2,3,7,4,3,2656,16,1285
제주특별자치도,서귀포시,영천동,관내사전투표,579,579,260,98,123,38,57,0,0,0,1,0,0,0,0,577,2,0
제주특별자치도,서귀포시,영천동,영천동제1투,2403,1468,621,316,327,72,106,2,1,1,1,3,6,3,1,1460,8,935
제주특별자치도,서귀포시,영천동,영천동제2투,523,339,131,94,77,14,19,0,0,0,0,0,0,1,0,336,3,184
제주특별자치도,서귀포시,영천동,영천동제3투,452,286,96,87,71,9,17,0,0,0,0,0,1,0,2,283,3,166
제주특별자치도,서귀포시,동홍동,합계,15265,10336,4816,1757,2214,596,818,13,14,18,2,12,2,10,13,10285,51,4929
제주특별자치도,서귀포시,동홍동,관내사전투표,2524,2524,1320,355,436,149,230,5,2,5,0,5,0,1,1,2509,15,0
제주특별자치도,서귀포시,동홍동,동홍동제1투,2968,1674,750,283,413,80,126,2,3,1,0,3,0,1,4,1666,8,1294
제주특별자치도,서귀포시,동홍동,동홍동제2투,3592,2154,959,385,475,136,181,2,2,1,0,1,1,2,0,2145,9,1438
제주특별자치도,서귀포시,동홍동,동홍동제3투,3501,2247,1037,379,495,132,180,3,5,3,0,2,0,1,3,2240,7,1254
제주특별자치도,서귀포시,동홍동,동홍동제4투,2680,1737,750,355,395,99,101,1,2,8,2,1,1,5,5,1725,12,943
제주특별자치도,서귀포시,서홍동,합계,7386,5114,2397,855,1087,307,421,4,5,3,0,2,1,0,2,5084,30,2272
제주특별자치도,서귀포시,서홍동,관내사전투표,1450,1450,719,218,293,82,125,0,0,0,0,2,1,0,1,1441,9,0
제주특별자치도,서귀포시,서홍동,서홍동제1투,3705,2309,1096,359,522,129,183,3,1,1,0,0,0,0,1,2295,14,1396
제주특별자치도,서귀포시,서홍동,서홍동제2투,2231,1355,582,278,272,96,113,1,4,2,0,0,0,0,0,1348,7,876
제주특별자치도,서귀포시,대륜동,합계,10312,7664,3490,1399,1614,517,555,9,13,9,2,1,6,2,10,7627,37,2648
제주특별자치도,서귀포시,대륜동,관내사전투표,2574,2574,1396,343,413,194,205,2,4,3,1,0,0,0,4,2565,9,0
제주특별자치도,서귀포시,대륜동,대륜동제1투,1738,1112,391,290,258,68,87,2,3,1,0,0,2,1,3,1106,6,626
제주특별자치도,서귀포시,대륜동,대륜동제2투,2717,1829,834,312,418,128,127,2,0,3,1,0,1,1,1,1828,1,888
제주특별자치도,서귀포시,대륜동,대륜동제3투,1338,877,338,188,229,46,50,1,4,2,0,0,3,0,1,862,15,461
제주특별자치도,서귀포시,대륜동,대륜동제4투,1945,1272,531,266,296,81,86,2,2,0,0,1,0,0,1,1266,6,673
제주특별자치도,서귀포시,대천동,합계,6990,4737,2118,883,1067,287,337,5,3,5,0,2,4,4,4,4719,18,2253
제주특별자치도,서귀포시,대천동,관내사전투표,701,701,364,102,139,52,42,0,0,1,0,0,0,0,0,700,1,0
제주특별자치도,서귀포시,대천동,대천동제1투,1337,865,382,196,185,32,61,1,0,1,0,0,1,0,2,861,4,472
제주특별자치도,서귀포시,대천동,대천동제2투,2184,1381,620,215,349,91,91,2,0,3,0,1,0,3,1,1376,5,803
제주특별자치도,서귀포시,대천동,대천동제3투,662,420,139,99,112,26,36,0,0,0,0,0,1,1,0,414,6,242
제주특별자치도,서귀포시,대천동,대천동제4투,412,284,149,41,53,12,25,1,0,0,0,0,1,0,1,283,1,128
제주특별자치도,서귀포시,대천동,대천동제5투,1694,1086,464,230,229,74,82,1,3,0,0,1,1,0,0,1085,1,608
제주특별자치도,서귀포시,중문동,관내사전투표,1473,1473,790,172,254,95,142,1,0,3,0,3,1,0,3,1464,9,0
제주특별자치도,서귀포시,중문동,합계,7821,5609,2567,940,1200,352,458,3,2,13,1,7,7,3,15,5568,41,2212
제주특별자치도,서귀포시,중문동,중문동제1투,3755,2376,1052,414,550,152,176,1,0,7,1,3,2,2,3,2363,13,1379
제주특별자치도,서귀포시,중문동,중문동제2투,1144,761,300,164,161,49,60,0,1,1,0,0,2,1,8,747,14,383
제주특별자치도,서귀포시,중문동,중문동제3투,982,680,304,110,163,36,58,1,1,2,0,0,1,0,1,677,3,302
제주특별자치도,서귀포시,중문동,중문동제4투,467,319,121,80,72,20,22,0,0,0,0,1,1,0,0,317,2,148
제주특별자치도,서귀포시,예래동,합계,2867,1963,825,403,445,116,137,2,3,3,3,5,0,4,5,1951,12,904
제주특별자치도,서귀포시,예래동,관내사전투표,359,359,161,63,83,18,27,0,2,1,0,1,0,1,1,358,1,0
제주특별자치도,서귀포시,예래동,예래동제1투,693,446,182,95,96,24,41,1,1,1,0,0,0,0,3,444,2,247
제주특별자치도,서귀포시,예래동,예래동제2투,1452,899,375,193,199,55,59,1,0,1,0,4,0,3,1,891,8,553
제주특별자치도,서귀포시,예래동,예래동제3투,363,259,107,52,67,19,10,0,0,0,3,0,0,0,0,258,1,104
제주특별자치도,서귀포시,잘못 투입·구분된 투표지,,0,0,0,0,0,0,0,0,0,0,0,0,0,0,0,0,0,0
